date,hexsha,author,insertions,deletions,lines,files,files_json
2022-11-06 12:25:47,69a8bb8dc13571102537762b047747cc36b53d5d,Yee Cheng Chin,4,1,5,2,"{""src/testdir/test_vim9_script.vim"": {""insertions"": 2, ""deletions"": 1, ""lines"": 3}, ""src/version.c"": {""insertions"": 2, ""deletions"": 0, ""lines"": 2}}"
2022-11-06 11:27:46,a25f718431ae001242a6a8b74733ee7685ccf07d,Bram Moolenaar,7,8,15,4,"{""src/gui.c"": {""insertions"": 5, ""deletions"": 2, ""lines"": 7}, ""src/gui_w32.c"": {""insertions"": 0, ""deletions"": 3, ""lines"": 3}, ""src/os_win32.c"": {""insertions"": 0, ""deletions"": 3, ""lines"": 3}, ""src/version.c"": {""insertions"": 2, ""deletions"": 0, ""lines"": 2}}"
2022-11-05 23:46:43,cd9c8d400c1eb9cbb4ff6a33be02f91a30ab13b2,Bram Moolenaar,37,22,59,6,"{""runtime/doc/builtin.txt"": {""insertions"": 14, ""deletions"": 8, ""lines"": 22}, ""src/evalbuffer.c"": {""insertions"": 1, ""deletions"": 3, ""lines"": 4}, ""src/testdir/test_bufline.vim"": {""insertions"": 11, ""deletions"": 6, ""lines"": 17}, ""src/testdir/test_functions.vim"": {""insertions"": 7, ""deletions"": 3, ""lines"": 10}, ""src/testdir/test_vim9_builtin.vim"": {""insertions"": 2, ""deletions"": 2, ""lines"": 4}, ""src/version.c"": {""insertions"": 2, ""deletions"": 0, ""lines"": 2}}"
2022-11-05 20:21:58,91c75d18d9cdc32df57e648640de7476fbcb4d76,zeertzjq,29,13,42,5,"{""src/dict.c"": {""insertions"": 5, ""deletions"": 12, ""lines"": 17}, ""src/eval.c"": {""insertions"": 2, ""deletions"": 1, ""lines"": 3}, ""src/testdir/test_functions.vim"": {""insertions"": 19, ""deletions"": 0, ""lines"": 19}, ""src/testdir/test_let.vim"": {""insertions"": 1, ""deletions"": 0, ""lines"": 1}, ""src/version.c"": {""insertions"": 2, ""deletions"": 0, ""lines"": 2}}"
2022-11-05 18:31:19,845bbb72ed2da4b5fb2a503d91cfd6435df2f584,K.Takata,8,12,20,2,"{""src/option.c"": {""insertions"": 6, ""deletions"": 12, ""lines"": 18}, ""src/version.c"": {""insertions"": 2, ""deletions"": 0, ""lines"": 2}}"
2022-11-05 15:13:50,f8ea10677d007befbb6f24cd20f35c3bf71c1296,Sam James,4,2,6,3,"{""src/auto/configure"": {""insertions"": 1, ""deletions"": 1, ""lines"": 2}, ""src/configure.ac"": {""insertions"": 1, ""deletions"": 1, ""lines"": 2}, ""src/version.c"": {""insertions"": 2, ""deletions"": 0, ""lines"": 2}}"
2022-11-05 14:23:14,25b8420c2b4c65f8e0292fbc006db1ea12d4b1c6,Yee Cheng Chin,3,1,4,2,"{""src/version.c"": {""insertions"": 2, ""deletions"": 0, ""lines"": 2}, ""src/vim.h"": {""insertions"": 1, ""deletions"": 1, ""lines"": 2}}"
2022-11-05 14:05:31,5a5f17f9b3fa14c36a7d6c96ac55acaddb6247e1,Philip H,7,0,7,2,"{""src/if_python3.c"": {""insertions"": 5, ""deletions"": 0, ""lines"": 5}, ""src/version.c"": {""insertions"": 2, ""deletions"": 0, ""lines"": 2}}"
2022-11-04 22:38:11,6c3d3e69047438ff5b7f58d44fe66af9e2c4212b,ichizok,5,0,5,2,"{""src/if_python3.c"": {""insertions"": 3, ""deletions"": 0, ""lines"": 3}, ""src/version.c"": {""insertions"": 2, ""deletions"": 0, ""lines"": 2}}"
2022-11-04 22:32:21,5375205761b5ed247f992abce341cf745dded38d,Philip H,7,0,7,2,"{""src/if_perl.xs"": {""insertions"": 5, ""deletions"": 0, ""lines"": 5}, ""src/version.c"": {""insertions"": 2, ""deletions"": 0, ""lines"": 2}}"
2022-11-04 21:58:36,3d19c81a116e7923d8295e7d2795fb3edb45acb1,zeertzjq,4,2,6,2,"{""src/version.c"": {""insertions"": 2, ""deletions"": 0, ""lines"": 2}, ""src/vim.h"": {""insertions"": 2, ""deletions"": 2, ""lines"": 4}}"
2022-11-02 13:30:51,c57b5bcd22826e0852c2bc9c7d4382e1cac7cb74,dundargoc,86,84,170,56,"{""src/GvimExt/Make_ming.mak"": {""insertions"": 1, ""deletions"": 1, ""lines"": 2}, ""src/INSTALLpc.txt"": {""insertions"": 1, ""deletions"": 1, ""lines"": 2}, ""src/blob.c"": {""insertions"": 1, ""deletions"": 1, ""lines"": 2}, ""src/bufwrite.c"": {""insertions"": 1, ""deletions"": 1, ""lines"": 2}, ""src/change.c"": {""insertions"": 1, ""deletions"": 1, ""lines"": 2}, ""src/charset.c"": {""insertions"": 1, ""deletions"": 1, ""lines"": 2}, ""src/config.h.in"": {""insertions"": 1, ""deletions"": 1, ""lines"": 2}, ""src/dict.c"": {""insertions"": 1, ""deletions"": 1, ""lines"": 2}, ""src/drawline.c"": {""insertions"": 1, ""deletions"": 1, ""lines"": 2}, ""src/errors.h"": {""insertions"": 5, ""deletions"": 5, ""lines"": 10}, ""src/eval.c"": {""insertions"": 1, ""deletions"": 1, ""lines"": 2}, ""src/getchar.c"": {""insertions"": 1, ""deletions"": 1, ""lines"": 2}, ""src/gui_gtk_x11.c"": {""insertions"": 3, ""deletions"": 3, ""lines"": 6}, ""src/gui_w32.c"": {""insertions"": 2, ""deletions"": 2, ""lines"": 4}, ""src/highlight.c"": {""insertions"": 1, ""deletions"": 1, ""lines"": 2}, ""src/message_test.c"": {""insertions"": 1, ""deletions"": 1, ""lines"": 2}, ""src/os_macosx.m"": {""insertions"": 1, ""deletions"": 1, ""lines"": 2}, ""src/os_win32.c"": {""insertions"": 1, ""deletions"": 1, ""lines"": 2}, ""src/proto/usercmd.pro"": {""insertions"": 1, ""deletions"": 1, ""lines"": 2}, ""src/proto/vim9execute.pro"": {""insertions"": 1, ""deletions"": 1, ""lines"": 2}, ""src/regexp.c"": {""insertions"": 1, ""deletions"": 1, ""lines"": 2}, ""src/register.c"": {""insertions"": 1, ""deletions"": 1, ""lines"": 2}, ""src/screen.c"": {""insertions"": 2, ""deletions"": 2, ""lines"": 4}, ""src/scriptfile.c"": {""insertions"": 1, ""deletions"": 1, ""lines"": 2}, ""src/spell.c"": {""insertions"": 1, ""deletions"": 1, ""lines"": 2}, ""src/spell.h"": {""insertions"": 2, ""deletions"": 2, ""lines"": 4}, ""src/spellfile.c"": {""insertions"": 1, ""deletions"": 1, ""lines"": 2}, ""src/structs.h"": {""insertions"": 3, ""deletions"": 3, ""lines"": 6}, ""src/tag.c"": {""insertions"": 1, ""deletions"": 1, ""lines"": 2}, ""src/term.c"": {""insertions"": 1, ""deletions"": 1, ""lines"": 2}, ""src/terminal.c"": {""insertions"": 1, ""deletions"": 1, ""lines"": 2}, ""src/testdir/test_channel.vim"": {""insertions"": 2, ""deletions"": 2, ""lines"": 4}, ""src/testdir/test_channel_lsp.py"": {""insertions"": 2, ""deletions"": 2, ""lines"": 4}, ""src/testdir/test_cmdmods.vim"": {""insertions"": 1, ""deletions"": 1, ""lines"": 2}, ""src/testdir/test_expr.vim"": {""insertions"": 1, ""deletions"": 1, ""lines"": 2}, ""src/testdir/test_fold.vim"": {""insertions"": 1, ""deletions"": 1, ""lines"": 2}, ""src/testdir/test_langmap.vim"": {""insertions"": 1, ""deletions"": 1, ""lines"": 2}, ""src/testdir/test_map_functions.vim"": {""insertions"": 1, ""deletions"": 1, ""lines"": 2}, ""src/testdir/test_options.vim"": {""insertions"": 1, ""deletions"": 1, ""lines"": 2}, ""src/testdir/test_popupwin.vim"": {""insertions"": 2, ""deletions"": 2, ""lines"": 4}, ""src/testdir/test_termcodes.vim"": {""insertions"": 1, ""deletions"": 1, ""lines"": 2}, ""src/testdir/test_textprop.vim"": {""insertions"": 4, ""deletions"": 4, ""lines"": 8}, ""src/testdir/test_vim9_cmd.vim"": {""insertions"": 1, ""deletions"": 1, ""lines"": 2}, ""src/testdir/test_vim9_script.vim"": {""insertions"": 1, ""deletions"": 1, ""lines"": 2}, ""src/testdir/test_vimscript.vim"": {""insertions"": 1, ""deletions"": 1, ""lines"": 2}, ""src/testdir/test_visual.vim"": {""insertions"": 1, ""deletions"": 1, ""lines"": 2}, ""src/testdir/test_winbar.vim"": {""insertions"": 4, ""deletions"": 4, ""lines"": 8}, ""src/testdir/test_window_cmd.vim"": {""insertions"": 1, ""deletions"": 1, ""lines"": 2}, ""src/textprop.c"": {""insertions"": 1, ""deletions"": 1, ""lines"": 2}, ""src/typval.c"": {""insertions"": 4, ""deletions"": 4, ""lines"": 8}, ""src/usercmd.c"": {""insertions"": 2, ""deletions"": 2, ""lines"": 4}, ""src/userfunc.c"": {""insertions"": 2, ""deletions"": 2, ""lines"": 4}, ""src/version.c"": {""insertions"": 2, ""deletions"": 0, ""lines"": 2}, ""src/vim9cmds.c"": {""insertions"": 1, ""deletions"": 1, ""lines"": 2}, ""src/vim9execute.c"": {""insertions"": 4, ""deletions"": 4, ""lines"": 8}, ""src/vim9expr.c"": {""insertions"": 2, ""deletions"": 2, ""lines"": 4}}"
2022-11-01 22:04:40,1410d1841bfc4370dec1babe24c6664e06d7c9d9,Bram Moolenaar,4,2,6,2,"{""src/term.c"": {""insertions"": 2, ""deletions"": 2, ""lines"": 4}, ""src/version.c"": {""insertions"": 2, ""deletions"": 0, ""lines"": 2}}"
2022-11-01 20:36:19,3af982196b1b973e953c35351961f2a96fe34172,K.Takata,136,19,155,6,"{""runtime/doc/editing.txt"": {""insertions"": 37, ""deletions"": 0, ""lines"": 37}, ""runtime/doc/options.txt"": {""insertions"": 3, ""deletions"": 0, ""lines"": 3}, ""src/bufwrite.c"": {""insertions"": 7, ""deletions"": 4, ""lines"": 11}, ""src/fileio.c"": {""insertions"": 20, ""deletions"": 15, ""lines"": 35}, ""src/testdir/test_fixeol.vim"": {""insertions"": 67, ""deletions"": 0, ""lines"": 67}, ""src/version.c"": {""insertions"": 2, ""deletions"": 0, ""lines"": 2}}"
2022-11-01 18:35:27,8e0ccb6bc21a446e5c6375b7fdf200fb53a129da,zeertzjq,49,30,79,5,"{""src/mouse.c"": {""insertions"": 21, ""deletions"": 22, ""lines"": 43}, ""src/proto/mouse.pro"": {""insertions"": 1, ""deletions"": 1, ""lines"": 2}, ""src/testdir/test_termcodes.vim"": {""insertions"": 23, ""deletions"": 5, ""lines"": 28}, ""src/version.c"": {""insertions"": 2, ""deletions"": 0, ""lines"": 2}, ""src/window.c"": {""insertions"": 2, ""deletions"": 2, ""lines"": 4}}"
2022-11-01 11:44:43,873f41a0187e81a22aa4622fbf938de72a54abba,zeertzjq,27,4,31,4,"{""src/evalwindow.c"": {""insertions"": 5, ""deletions"": 0, ""lines"": 5}, ""src/testdir/test_mapping.vim"": {""insertions"": 10, ""deletions"": 4, ""lines"": 14}, ""src/testdir/test_window_cmd.vim"": {""insertions"": 10, ""deletions"": 0, ""lines"": 10}, ""src/version.c"": {""insertions"": 2, ""deletions"": 0, ""lines"": 2}}"
2022-10-31 23:07:11,7a7db047dcb2336de5103e793345eb5a9d125900,Bram Moolenaar,13,3,16,3,"{""src/testdir/test_termcodes.vim"": {""insertions"": 5, ""deletions"": 1, ""lines"": 6}, ""src/version.c"": {""insertions"": 2, ""deletions"": 0, ""lines"": 2}, ""src/window.c"": {""insertions"": 6, ""deletions"": 2, ""lines"": 8}}"
2022-10-31 13:06:26,8ab9ca93eea32b318235384720200771863ecaee,Bram Moolenaar,44,10,54,5,"{""src/mouse.c"": {""insertions"": 21, ""deletions"": 10, ""lines"": 31}, ""src/proto/mouse.pro"": {""insertions"": 1, ""deletions"": 0, ""lines"": 1}, ""src/testdir/test_mapping.vim"": {""insertions"": 18, ""deletions"": 0, ""lines"": 18}, ""src/version.c"": {""insertions"": 2, ""deletions"": 0, ""lines"": 2}, ""src/window.c"": {""insertions"": 2, ""deletions"": 0, ""lines"": 2}}"
2022-10-31 12:24:12,86e6717ace4f5e00eaeb84b59e3fc92bca548155,Bram Moolenaar,19,0,19,4,"{""src/errors.h"": {""insertions"": 2, ""deletions"": 0, ""lines"": 2}, ""src/evalwindow.c"": {""insertions"": 5, ""deletions"": 0, ""lines"": 5}, ""src/testdir/test_window_cmd.vim"": {""insertions"": 10, ""deletions"": 0, ""lines"": 10}, ""src/version.c"": {""insertions"": 2, ""deletions"": 0, ""lines"": 2}}"
2022-10-29 20:53:08,03d6e6f42b0deeb02d52c8a48c14abe431370c1c,Bram Moolenaar,8,1,9,2,"{""src/ex_cmds.c"": {""insertions"": 6, ""deletions"": 1, ""lines"": 7}, ""src/version.c"": {""insertions"": 2, ""deletions"": 0, ""lines"": 2}}"
2022-10-29 19:01:52,1577537f109d97a975fda9a899cacfb598617767,Bram Moolenaar,20,8,28,6,"{""src/buffer.c"": {""insertions"": 2, ""deletions"": 0, ""lines"": 2}, ""src/change.c"": {""insertions"": 4, ""deletions"": 1, ""lines"": 5}, ""src/fileio.c"": {""insertions"": 7, ""deletions"": 3, ""lines"": 10}, ""src/structs.h"": {""insertions"": 1, ""deletions"": 0, ""lines"": 1}, ""src/testdir/test_fixeol.vim"": {""insertions"": 4, ""deletions"": 4, ""lines"": 8}, ""src/version.c"": {""insertions"": 2, ""deletions"": 0, ""lines"": 2}}"
2022-10-28 19:47:54,6ebe4f970b8b398087076a72a7aae6e680fb92da,Bram Moolenaar,476,305,781,24,"{"".github/CODEOWNERS"": {""insertions"": 4, ""deletions"": 0, ""lines"": 4}, ""runtime/autoload/tohtml.vim"": {""insertions"": 4, ""deletions"": 1, ""lines"": 5}, ""runtime/doc/builtin.txt"": {""insertions"": 4, ""deletions"": 6, ""lines"": 10}, ""runtime/doc/ft_rust.txt"": {""insertions"": 35, ""deletions"": 35, ""lines"": 70}, ""runtime/doc/map.txt"": {""insertions"": 2, ""deletions"": 2, ""lines"": 4}, ""runtime/doc/message.txt"": {""insertions"": 2, ""deletions"": 1, ""lines"": 3}, ""runtime/doc/options.txt"": {""insertions"": 6, ""deletions"": 4, ""lines"": 10}, ""runtime/doc/pi_tar.txt"": {""insertions"": 8, ""deletions"": 8, ""lines"": 16}, ""runtime/doc/pi_zip.txt"": {""insertions"": 9, ""deletions"": 9, ""lines"": 18}, ""runtime/doc/quickref.txt"": {""insertions"": 2, ""deletions"": 1, ""lines"": 3}, ""runtime/doc/scroll.txt"": {""insertions"": 12, ""deletions"": 1, ""lines"": 13}, ""runtime/doc/syntax.txt"": {""insertions"": 30, ""deletions"": 14, ""lines"": 44}, ""runtime/doc/tags"": {""insertions"": 8, ""deletions"": 0, ""lines"": 8}, ""runtime/doc/term.txt"": {""insertions"": 4, ""deletions"": 2, ""lines"": 6}, ""runtime/doc/todo.txt"": {""insertions"": 10, ""deletions"": 5, ""lines"": 15}, ""runtime/doc/various.txt"": {""insertions"": 2, ""deletions"": 3, ""lines"": 5}, ""runtime/ftplugin/apache.vim"": {""insertions"": 16, ""deletions"": 0, ""lines"": 16}, ""runtime/ftplugin/openvpn.vim"": {""insertions"": 14, ""deletions"": 0, ""lines"": 14}, ""runtime/optwin.vim"": {""insertions"": 4, ""deletions"": 1, ""lines"": 5}, ""runtime/plugin/manpager.vim"": {""insertions"": 6, ""deletions"": 1, ""lines"": 7}, ""runtime/syntax/2html.vim"": {""insertions"": 200, ""deletions"": 191, ""lines"": 391}, ""runtime/syntax/help.vim"": {""insertions"": 2, ""deletions"": 2, ""lines"": 4}, ""runtime/syntax/openvpn.vim"": {""insertions"": 72, ""deletions"": 0, ""lines"": 72}, ""runtime/syntax/vim.vim"": {""insertions"": 20, ""deletions"": 18, ""lines"": 38}}"
2022-10-28 16:04:21,3f68a4136eb99840d739af5133ab31948f273f63,Bram Moolenaar,1,0,1,1,"{""src/option.c"": {""insertions"": 1, ""deletions"": 0, ""lines"": 1}}"
2022-10-28 15:51:46,72c8e3c070b30f82bc0d203a62c168e43a13e99b,Bram Moolenaar,1,1,2,1,"{""src/bufwrite.c"": {""insertions"": 1, ""deletions"": 1, ""lines"": 2}}"
2022-10-28 15:47:14,f0b567e32a462fe838170a202919d18b53eff987,Bram Moolenaar,1,1,2,1,"{""src/Makefile"": {""insertions"": 1, ""deletions"": 1, ""lines"": 2}}"
2022-10-22 11:23:12,ad353244f2308b73c2e5d9b50ead693f927337b4,Bram Moolenaar,2,0,2,1,"{""src/version.c"": {""insertions"": 2, ""deletions"": 0, ""lines"": 2}}"
2022-10-22 10:25:19,fb0cf2357e0c85bbfd9f9178705ad8d77b6b3b4e,Bram Moolenaar,37,14,51,10,"{""runtime/doc/options.txt"": {""insertions"": 8, ""deletions"": 1, ""lines"": 9}, ""src/Makefile"": {""insertions"": 1, ""deletions"": 1, ""lines"": 2}, ""src/bufwrite.c"": {""insertions"": 4, ""deletions"": 0, ""lines"": 4}, ""src/ex_cmds.c"": {""insertions"": 0, ""deletions"": 2, ""lines"": 2}, ""src/fileio.c"": {""insertions"": 6, ""deletions"": 3, ""lines"": 9}, ""src/option.h"": {""insertions"": 2, ""deletions"": 0, ""lines"": 2}, ""src/optiondefs.h"": {""insertions"": 5, ""deletions"": 1, ""lines"": 6}, ""src/structs.h"": {""insertions"": 1, ""deletions"": 0, ""lines"": 1}, ""src/testdir/test_fixeol.vim"": {""insertions"": 6, ""deletions"": 6, ""lines"": 12}, ""src/version.c"": {""insertions"": 4, ""deletions"": 0, ""lines"": 4}}"
2022-10-22 08:02:56,9c50eeb40117413bf59a9da904c8d0921ed0a6e6,Martin Tournoij,10,10,20,3,"{""src/ex_cmds.c"": {""insertions"": 6, ""deletions"": 8, ""lines"": 14}, ""src/testdir/test_shell.vim"": {""insertions"": 2, ""deletions"": 2, ""lines"": 4}, ""src/version.c"": {""insertions"": 2, ""deletions"": 0, ""lines"": 2}}"
2022-10-21 13:34:25,436e5d395fd629c8d33b5cf7b373aad007f16851,Justin M. Keyes,4,1,5,3,"{""runtime/filetype.vim"": {""insertions"": 1, ""deletions"": 0, ""lines"": 1}, ""src/testdir/test_filetype.vim"": {""insertions"": 1, ""deletions"": 1, ""lines"": 2}, ""src/version.c"": {""insertions"": 2, ""deletions"": 0, ""lines"": 2}}"
2022-10-21 13:17:24,4bc85f23ed2cf1fab20597ff15cefa675ea5e2c6,Bram Moolenaar,64,12,76,4,"{""runtime/doc/builtin.txt"": {""insertions"": 1, ""deletions"": 0, ""lines"": 1}, ""src/term.c"": {""insertions"": 17, ""deletions"": 2, ""lines"": 19}, ""src/testdir/test_termcodes.vim"": {""insertions"": 44, ""deletions"": 10, ""lines"": 54}, ""src/version.c"": {""insertions"": 2, ""deletions"": 0, ""lines"": 2}}"
2022-10-21 12:03:33,7fa02bcb3b8011961995e617423a6f8f531b6e4d,Christopher Plewright,6,1,7,2,"{""src/getchar.c"": {""insertions"": 4, ""deletions"": 1, ""lines"": 5}, ""src/version.c"": {""insertions"": 2, ""deletions"": 0, ""lines"": 2}}"
2022-10-21 11:05:46,2435adf8eb13736e2b3d012bb70df9ef960ffd60,Bram Moolenaar,9,2,11,3,"{""src/testdir/test_vim9_script.vim"": {""insertions"": 4, ""deletions"": 0, ""lines"": 4}, ""src/version.c"": {""insertions"": 2, ""deletions"": 0, ""lines"": 2}, ""src/vim9compile.c"": {""insertions"": 3, ""deletions"": 2, ""lines"": 5}}"
2022-10-21 10:25:30,5b2a3d77d320d76f12b1666938a9d58c2a848205,Bram Moolenaar,32,13,45,4,"{""runtime/doc/builtin.txt"": {""insertions"": 4, ""deletions"": 2, ""lines"": 6}, ""src/blob.c"": {""insertions"": 17, ""deletions"": 9, ""lines"": 26}, ""src/testdir/test_blob.vim"": {""insertions"": 9, ""deletions"": 2, ""lines"": 11}, ""src/version.c"": {""insertions"": 2, ""deletions"": 0, ""lines"": 2}}"
2022-10-20 20:14:19,63c84731c1802bac36c1d1a82b3ef5960b35b089,Bram Moolenaar,6,1,7,2,"{""src/evalbuffer.c"": {""insertions"": 4, ""deletions"": 1, ""lines"": 5}, ""src/version.c"": {""insertions"": 2, ""deletions"": 0, ""lines"": 2}}"
2022-10-20 19:52:44,6c8bc37a1083d17447156592f6f52da2d40b4855,Maxime Brunet,4,2,6,3,"{""runtime/filetype.vim"": {""insertions"": 1, ""deletions"": 1, ""lines"": 2}, ""src/testdir/test_filetype.vim"": {""insertions"": 1, ""deletions"": 1, ""lines"": 2}, ""src/version.c"": {""insertions"": 2, ""deletions"": 0, ""lines"": 2}}"
2022-10-20 19:15:47,d5337efece7c68e9b4ce864532ea49b02453b674,Bram Moolenaar,64,35,99,3,"{""src/move.c"": {""insertions"": 57, ""deletions"": 30, ""lines"": 87}, ""src/testdir/dumps/Test_smooth_long_9.dump"": {""insertions"": 5, ""deletions"": 5, ""lines"": 10}, ""src/version.c"": {""insertions"": 2, ""deletions"": 0, ""lines"": 2}}"
2022-10-20 16:59:38,49660f5139d3fd55326a54eadf6bb31a3ffec2bf,zeertzjq,55,9,64,3,"{""src/getchar.c"": {""insertions"": 20, ""deletions"": 9, ""lines"": 29}, ""src/testdir/test_langmap.vim"": {""insertions"": 33, ""deletions"": 0, ""lines"": 33}, ""src/version.c"": {""insertions"": 2, ""deletions"": 0, ""lines"": 2}}"
2022-10-20 15:03:33,d0fab10ed2a86698937e3c3fed2f10bd9bb5e731,Bram Moolenaar,24,0,24,3,"{""src/quickfix.c"": {""insertions"": 6, ""deletions"": 0, ""lines"": 6}, ""src/testdir/test_quickfix.vim"": {""insertions"": 16, ""deletions"": 0, ""lines"": 16}, ""src/version.c"": {""insertions"": 2, ""deletions"": 0, ""lines"": 2}}"
2022-10-20 13:17:18,cdef1cefa2a440911c727558562f83ed9b00e16b,Bram Moolenaar,15,1,16,3,"{""src/eval.c"": {""insertions"": 7, ""deletions"": 1, ""lines"": 8}, ""src/testdir/test_expr.vim"": {""insertions"": 6, ""deletions"": 0, ""lines"": 6}, ""src/version.c"": {""insertions"": 2, ""deletions"": 0, ""lines"": 2}}"
2022-10-20 12:28:51,43625762a9751cc6e6e4d8f54fbc8b82d98fb20d,K.Takata,20,4,24,5,"{""runtime/doc/builtin.txt"": {""insertions"": 6, ""deletions"": 1, ""lines"": 7}, ""src/blob.c"": {""insertions"": 6, ""deletions"": 2, ""lines"": 8}, ""src/proto/blob.pro"": {""insertions"": 1, ""deletions"": 1, ""lines"": 2}, ""src/testdir/test_blob.vim"": {""insertions"": 5, ""deletions"": 0, ""lines"": 5}, ""src/version.c"": {""insertions"": 2, ""deletions"": 0, ""lines"": 2}}"
2022-10-20 12:11:15,4c36678ffd1f933a6d4a12415994dea15e4ccec6,Christopher Plewright,25,5,30,3,"{""src/getchar.c"": {""insertions"": 22, ""deletions"": 4, ""lines"": 26}, ""src/os_win32.c"": {""insertions"": 1, ""deletions"": 1, ""lines"": 2}, ""src/version.c"": {""insertions"": 2, ""deletions"": 0, ""lines"": 2}}"
2022-10-19 19:07:09,7609c88eedc113bc80ccf74050b03a2e0c1a3c5e,Bram Moolenaar,7,2,9,2,"{""src/term.c"": {""insertions"": 5, ""deletions"": 2, ""lines"": 7}, ""src/version.c"": {""insertions"": 2, ""deletions"": 0, ""lines"": 2}}"
2022-10-19 18:24:48,d505c8220ddb62a3489f1880a2ff37a3ddd9954b,Bram Moolenaar,3,1,4,2,"{""src/sound.c"": {""insertions"": 1, ""deletions"": 1, ""lines"": 2}, ""src/version.c"": {""insertions"": 2, ""deletions"": 0, ""lines"": 2}}"
2022-10-19 17:04:49,d0fbb41eaa737dd64877c8cebaff19854e2d504f,Bram Moolenaar,22,2,24,3,"{""src/testdir/test_lambda.vim"": {""insertions"": 17, ""deletions"": 0, ""lines"": 17}, ""src/version.c"": {""insertions"": 2, ""deletions"": 0, ""lines"": 2}, ""src/vim9expr.c"": {""insertions"": 3, ""deletions"": 2, ""lines"": 5}}"
2022-10-19 14:39:49,3c708c43908ba44f075bbaa7daf584c6b46d9723,Marwin Glaser,6,1,7,3,"{""runtime/filetype.vim"": {""insertions"": 3, ""deletions"": 0, ""lines"": 3}, ""src/testdir/test_filetype.vim"": {""insertions"": 1, ""deletions"": 1, ""lines"": 2}, ""src/version.c"": {""insertions"": 2, ""deletions"": 0, ""lines"": 2}}"
2022-10-19 14:12:54,df63f05c3a81f726ee9fbfc4954eb675e287c7f7,zeertzjq,5,3,8,2,"{""src/testdir/test_termcodes.vim"": {""insertions"": 3, ""deletions"": 3, ""lines"": 6}, ""src/version.c"": {""insertions"": 2, ""deletions"": 0, ""lines"": 2}}"
2022-10-19 13:48:14,060b8384888ce91b1bc194101091d0f9f85d0490,Bram Moolenaar,7,1,8,2,"{""src/testdir/test_mapping.vim"": {""insertions"": 5, ""deletions"": 1, ""lines"": 6}, ""src/version.c"": {""insertions"": 2, ""deletions"": 0, ""lines"": 2}}"
2022-10-19 13:02:40,11df3aeee548b959ccd4b9a4d3c44651eab6b3ce,K.Takata,98,23,121,7,"{""runtime/doc/builtin.txt"": {""insertions"": 14, ""deletions"": 2, ""lines"": 16}, ""src/blob.c"": {""insertions"": 35, ""deletions"": 5, ""lines"": 40}, ""src/evalfunc.c"": {""insertions"": 2, ""deletions"": 1, ""lines"": 3}, ""src/filepath.c"": {""insertions"": 25, ""deletions"": 14, ""lines"": 39}, ""src/proto/blob.pro"": {""insertions"": 1, ""deletions"": 1, ""lines"": 2}, ""src/testdir/test_blob.vim"": {""insertions"": 19, ""deletions"": 0, ""lines"": 19}, ""src/version.c"": {""insertions"": 2, ""deletions"": 0, ""lines"": 2}}"
2022-10-19 12:07:03,9f62ea01a08e69f44050f59469a0e64beddefac0,Bram Moolenaar,70,41,111,3,"{""runtime/doc/map.txt"": {""insertions"": 5, ""deletions"": 0, ""lines"": 5}, ""src/map.c"": {""insertions"": 63, ""deletions"": 41, ""lines"": 104}, ""src/version.c"": {""insertions"": 2, ""deletions"": 0, ""lines"": 2}}"
2022-10-19 10:54:46,605d02a9b73cb49ac5022a127db3eac7e16a5d83,Christopher Plewright,13,13,26,3,"{""src/getchar.c"": {""insertions"": 4, ""deletions"": 2, ""lines"": 6}, ""src/os_win32.c"": {""insertions"": 7, ""deletions"": 11, ""lines"": 18}, ""src/version.c"": {""insertions"": 2, ""deletions"": 0, ""lines"": 2}}"
2022-10-18 20:48:14,bf72e0c67f26ea7c8fd941fdd1533c24c7b6cb43,Bram Moolenaar,4,1,5,2,"{""src/os_win32.c"": {""insertions"": 2, ""deletions"": 1, ""lines"": 3}, ""src/version.c"": {""insertions"": 2, ""deletions"": 0, ""lines"": 2}}"
2022-10-18 18:22:25,a353282c13287058fde95bb6eb914e342fd4253c,Trygve Aaberge,10,10,20,2,"{""src/term.c"": {""insertions"": 8, ""deletions"": 10, ""lines"": 18}, ""src/version.c"": {""insertions"": 2, ""deletions"": 0, ""lines"": 2}}"
2022-10-18 16:25:03,53c5c9f50ca68d3ed559eebb2c5f7d23f39a768c,Bram Moolenaar,4,1,5,2,"{""src/testdir/test_autocmd.vim"": {""insertions"": 2, ""deletions"": 1, ""lines"": 3}, ""src/version.c"": {""insertions"": 2, ""deletions"": 0, ""lines"": 2}}"
2022-10-18 16:05:54,8f3c3c6cd044e3b5bf08dbfa3b3f04bb3f711bad,Bram Moolenaar,29,0,29,3,"{""src/buffer.c"": {""insertions"": 7, ""deletions"": 0, ""lines"": 7}, ""src/testdir/test_autocmd.vim"": {""insertions"": 20, ""deletions"": 0, ""lines"": 20}, ""src/version.c"": {""insertions"": 2, ""deletions"": 0, ""lines"": 2}}"
2022-10-18 14:10:11,61c4b04799bf114cadc3bbf212ae8b2ad22a6980,Bram Moolenaar,22,1,23,3,"{""src/misc1.c"": {""insertions"": 8, ""deletions"": 1, ""lines"": 9}, ""src/testdir/test_autocmd.vim"": {""insertions"": 12, ""deletions"": 0, ""lines"": 12}, ""src/version.c"": {""insertions"": 2, ""deletions"": 0, ""lines"": 2}}"
2022-10-18 12:33:26,9298a996fc54e483dc29c0700edf3c5fe9d0f6a9,Christopher Plewright,4,2,6,2,"{""src/os_win32.c"": {""insertions"": 2, ""deletions"": 2, ""lines"": 4}, ""src/version.c"": {""insertions"": 2, ""deletions"": 0, ""lines"": 2}}"
2022-10-18 12:11:21,208567e9d744ef7b89bed1f62e951ae4ee2f6f5f,zeertzjq,33,1,34,3,"{""src/testdir/test_usercommands.vim"": {""insertions"": 13, ""deletions"": 0, ""lines"": 13}, ""src/usercmd.c"": {""insertions"": 18, ""deletions"": 1, ""lines"": 19}, ""src/version.c"": {""insertions"": 2, ""deletions"": 0, ""lines"": 2}}"
2022-10-17 19:00:26,9652249a2d02318a28a63a7b5711f25652e8f969,Bram Moolenaar,5,0,5,2,"{""src/ex_cmds.c"": {""insertions"": 3, ""deletions"": 0, ""lines"": 3}, ""src/version.c"": {""insertions"": 2, ""deletions"": 0, ""lines"": 2}}"
2022-10-17 17:55:03,b99e6e6c5fbabbade6431fb555c4fe7409a9269a,Bram Moolenaar,58,5,63,5,"{""src/drawline.c"": {""insertions"": 9, ""deletions"": 5, ""lines"": 14}, ""src/testdir/dumps/Test_prop_above_number_1.dump"": {""insertions"": 8, ""deletions"": 0, ""lines"": 8}, ""src/testdir/dumps/Test_prop_above_number_2.dump"": {""insertions"": 8, ""deletions"": 0, ""lines"": 8}, ""src/testdir/test_textprop.vim"": {""insertions"": 31, ""deletions"": 0, ""lines"": 31}, ""src/version.c"": {""insertions"": 2, ""deletions"": 0, ""lines"": 2}}"
2022-10-17 17:00:23,8107a2a8af80a53a61734b600539c5beb4782991,Bram Moolenaar,41,1,42,5,"{"".gitignore"": {""insertions"": 1, ""deletions"": 0, ""lines"": 1}, ""runtime/doc/various.txt"": {""insertions"": 2, ""deletions"": 1, ""lines"": 3}, ""src/ex_cmds.c"": {""insertions"": 5, ""deletions"": 0, ""lines"": 5}, ""src/testdir/test_shell.vim"": {""insertions"": 31, ""deletions"": 0, ""lines"": 31}, ""src/version.c"": {""insertions"": 2, ""deletions"": 0, ""lines"": 2}}"
2022-10-17 14:28:47,4bf67ec52e938a3edaa4f452adab42a57505f940,ObserverOfTime,7,0,7,3,"{""runtime/filetype.vim"": {""insertions"": 4, ""deletions"": 0, ""lines"": 4}, ""src/testdir/test_filetype.vim"": {""insertions"": 1, ""deletions"": 0, ""lines"": 1}, ""src/version.c"": {""insertions"": 2, ""deletions"": 0, ""lines"": 2}}"
2022-10-17 13:51:36,e6a16e9950111adfcfdb85261b3d5a8c13f1d533,Bram Moolenaar,31,25,56,8,"{""src/libvterm/include/vterm.h"": {""insertions"": 1, ""deletions"": 1, ""lines"": 2}, ""src/libvterm/src/pen.c"": {""insertions"": 6, ""deletions"": 6, ""lines"": 12}, ""src/libvterm/src/rect.h"": {""insertions"": 6, ""deletions"": 6, ""lines"": 12}, ""src/libvterm/src/screen.c"": {""insertions"": 5, ""deletions"": 5, ""lines"": 10}, ""src/libvterm/src/vterm_internal.h"": {""insertions"": 1, ""deletions"": 1, ""lines"": 2}, ""src/libvterm/t/harness.c"": {""insertions"": 6, ""deletions"": 6, ""lines"": 12}, ""src/os_win32.h"": {""insertions"": 4, ""deletions"": 0, ""lines"": 4}, ""src/version.c"": {""insertions"": 2, ""deletions"": 0, ""lines"": 2}}"
2022-10-17 13:22:03,a1a46da87d91cfbf46866627b3e66a757145e8c3,Luuk van Baal,3,2,5,2,"{""src/version.c"": {""insertions"": 2, ""deletions"": 0, ""lines"": 2}, ""src/window.c"": {""insertions"": 1, ""deletions"": 2, ""lines"": 3}}"
2022-10-17 12:32:17,4ac8e7948cb3e07bc4598ede8b274891d14dfa7c,Doug Kearns,55,2,57,5,"{""runtime/autoload/dist/ft.vim"": {""insertions"": 13, ""deletions"": 0, ""lines"": 13}, ""runtime/doc/filetype.txt"": {""insertions"": 1, ""deletions"": 0, ""lines"": 1}, ""runtime/filetype.vim"": {""insertions"": 7, ""deletions"": 1, ""lines"": 8}, ""src/testdir/test_filetype.vim"": {""insertions"": 32, ""deletions"": 1, ""lines"": 33}, ""src/version.c"": {""insertions"": 2, ""deletions"": 0, ""lines"": 2}}"
2022-10-17 12:13:32,4913d420e8e8619cff837372bce87683d6fcaa03,Bram Moolenaar,36,8,44,3,"{""src/testdir/test_vim9_expr.vim"": {""insertions"": 24, ""deletions"": 0, ""lines"": 24}, ""src/version.c"": {""insertions"": 2, ""deletions"": 0, ""lines"": 2}, ""src/vim9expr.c"": {""insertions"": 10, ""deletions"": 8, ""lines"": 18}}"
2022-10-16 20:43:07,3f0092c141824356b55b11cd3985baaf4df65334,Yegappan Lakshmanan,286,282,568,3,"{""src/change.c"": {""insertions"": 48, ""deletions"": 48, ""lines"": 96}, ""src/channel.c"": {""insertions"": 236, ""deletions"": 234, ""lines"": 470}, ""src/version.c"": {""insertions"": 2, ""deletions"": 0, ""lines"": 2}}"
2022-10-16 19:24:16,9d8620b519a84983bc8c24cb6c302f4d6b55a6c0,Bram Moolenaar,27,25,52,7,"{""src/libvterm/include/vterm.h"": {""insertions"": 1, ""deletions"": 1, ""lines"": 2}, ""src/libvterm/src/pen.c"": {""insertions"": 6, ""deletions"": 6, ""lines"": 12}, ""src/libvterm/src/rect.h"": {""insertions"": 6, ""deletions"": 6, ""lines"": 12}, ""src/libvterm/src/screen.c"": {""insertions"": 5, ""deletions"": 5, ""lines"": 10}, ""src/libvterm/src/vterm_internal.h"": {""insertions"": 1, ""deletions"": 1, ""lines"": 2}, ""src/libvterm/t/harness.c"": {""insertions"": 6, ""deletions"": 6, ""lines"": 12}, ""src/version.c"": {""insertions"": 2, ""deletions"": 0, ""lines"": 2}}"
2022-10-16 18:47:45,2a46f81ec7739967265759838afe7972e5f81e5e,Christopher Plewright,158,31,189,4,"{"".gitignore"": {""insertions"": 2, ""deletions"": 0, ""lines"": 2}, ""src/INSTALLpc.txt"": {""insertions"": 24, ""deletions"": 24, ""lines"": 48}, ""src/os_win32.c"": {""insertions"": 130, ""deletions"": 7, ""lines"": 137}, ""src/version.c"": {""insertions"": 2, ""deletions"": 0, ""lines"": 2}}"
2022-10-16 18:26:52,6a12d26f3404e45ce25cf9152857e355b28f392a,Bram Moolenaar,655,254,909,24,"{""src/libvterm/CONTRIBUTING"": {""insertions"": 2, ""deletions"": 2, ""lines"": 4}, ""src/libvterm/Makefile"": {""insertions"": 1, ""deletions"": 1, ""lines"": 2}, ""src/libvterm/README"": {""insertions"": 5, ""deletions"": 2, ""lines"": 7}, ""src/libvterm/doc/seqs.txt"": {""insertions"": 4, ""deletions"": 0, ""lines"": 4}, ""src/libvterm/include/vterm.h"": {""insertions"": 29, ""deletions"": 7, ""lines"": 36}, ""src/libvterm/src/encoding.c"": {""insertions"": 2, ""deletions"": 2, ""lines"": 4}, ""src/libvterm/src/keyboard.c"": {""insertions"": 16, ""deletions"": 16, ""lines"": 32}, ""src/libvterm/src/parser.c"": {""insertions"": 2, ""deletions"": 3, ""lines"": 5}, ""src/libvterm/src/pen.c"": {""insertions"": 44, ""deletions"": 13, ""lines"": 57}, ""src/libvterm/src/screen.c"": {""insertions"": 242, ""deletions"": 80, ""lines"": 322}, ""src/libvterm/src/state.c"": {""insertions"": 51, ""deletions"": 34, ""lines"": 85}, ""src/libvterm/src/unicode.c"": {""insertions"": 57, ""deletions"": 85, ""lines"": 142}, ""src/libvterm/src/vterm.c"": {""insertions"": 8, ""deletions"": 4, ""lines"": 12}, ""src/libvterm/src/vterm_internal.h"": {""insertions"": 2, ""deletions"": 0, ""lines"": 2}, ""src/libvterm/t/10state_putglyph.test"": {""insertions"": 6, ""deletions"": 0, ""lines"": 6}, ""src/libvterm/t/13state_edit.test"": {""insertions"": 5, ""deletions"": 1, ""lines"": 6}, ""src/libvterm/t/26state_query.test"": {""insertions"": 1, ""deletions"": 1, ""lines"": 2}, ""src/libvterm/t/30state_pen.test"": {""insertions"": 11, ""deletions"": 0, ""lines"": 11}, ""src/libvterm/t/64screen_pen.test"": {""insertions"": 6, ""deletions"": 0, ""lines"": 6}, ""src/libvterm/t/69screen_reflow.test"": {""insertions"": 79, ""deletions"": 0, ""lines"": 79}, ""src/libvterm/t/harness.c"": {""insertions"": 77, ""deletions"": 1, ""lines"": 78}, ""src/libvterm/t/run-test.pl"": {""insertions"": 1, ""deletions"": 1, ""lines"": 2}, ""src/terminal.c"": {""insertions"": 2, ""deletions"": 1, ""lines"": 3}, ""src/version.c"": {""insertions"": 2, ""deletions"": 0, ""lines"": 2}}"
2022-10-16 13:53:34,d094e580b0873d67c2d30f60c9fd43c9a0044149,Philip H,4,2,6,2,"{"".github/workflows/ci.yml"": {""insertions"": 2, ""deletions"": 2, ""lines"": 4}, ""src/version.c"": {""insertions"": 2, ""deletions"": 0, ""lines"": 2}}"
2022-10-16 13:35:46,501e77766cd30d8f4bfeb04a67aff1865b5f5a41,Bram Moolenaar,195,96,291,16,"{""src/libvterm/README"": {""insertions"": 1, ""deletions"": 1, ""lines"": 2}, ""src/libvterm/doc/seqs.txt"": {""insertions"": 1, ""deletions"": 0, ""lines"": 1}, ""src/libvterm/include/vterm.h"": {""insertions"": 25, ""deletions"": 1, ""lines"": 26}, ""src/libvterm/src/screen.c"": {""insertions"": 24, ""deletions"": 1, ""lines"": 25}, ""src/libvterm/src/state.c"": {""insertions"": 52, ""deletions"": 39, ""lines"": 91}, ""src/libvterm/src/vterm.c"": {""insertions"": 28, ""deletions"": 10, ""lines"": 38}, ""src/libvterm/src/vterm_internal.h"": {""insertions"": 1, ""deletions"": 1, ""lines"": 2}, ""src/libvterm/t/26state_query.test"": {""insertions"": 8, ""deletions"": 3, ""lines"": 11}, ""src/libvterm/t/60screen_ascii.test"": {""insertions"": 9, ""deletions"": 9, ""lines"": 18}, ""src/libvterm/t/61screen_unicode.test"": {""insertions"": 3, ""deletions"": 3, ""lines"": 6}, ""src/libvterm/t/62screen_damage.test"": {""insertions"": 1, ""deletions"": 1, ""lines"": 2}, ""src/libvterm/t/63screen_resize.test"": {""insertions"": 17, ""deletions"": 17, ""lines"": 34}, ""src/libvterm/t/65screen_protect.test"": {""insertions"": 4, ""deletions"": 4, ""lines"": 8}, ""src/libvterm/t/harness.c"": {""insertions"": 8, ""deletions"": 1, ""lines"": 9}, ""src/libvterm/t/run-test.pl"": {""insertions"": 11, ""deletions"": 5, ""lines"": 16}, ""src/version.c"": {""insertions"": 2, ""deletions"": 0, ""lines"": 2}}"
2022-10-16 12:11:12,3c053a1a5ad2a3c924929e11f2b9af20a8b901e2,Bram Moolenaar,653,223,876,40,"{"".github/CODEOWNERS"": {""insertions"": 6, ""deletions"": 1, ""lines"": 7}, ""runtime/autoload/dist/vimindent.vim"": {""insertions"": 13, ""deletions"": 8, ""lines"": 21}, ""runtime/autoload/netrw.vim"": {""insertions"": 9, ""deletions"": 5, ""lines"": 14}, ""runtime/doc/builtin.txt"": {""insertions"": 3, ""deletions"": 2, ""lines"": 5}, ""runtime/doc/indent.txt"": {""insertions"": 7, ""deletions"": 4, ""lines"": 11}, ""runtime/doc/index.txt"": {""insertions"": 1, ""deletions"": 1, ""lines"": 2}, ""runtime/doc/intro.txt"": {""insertions"": 4, ""deletions"": 4, ""lines"": 8}, ""runtime/doc/options.txt"": {""insertions"": 3, ""deletions"": 3, ""lines"": 6}, ""runtime/doc/os_haiku.txt"": {""insertions"": 3, ""deletions"": 1, ""lines"": 4}, ""runtime/doc/popup.txt"": {""insertions"": 1, ""deletions"": 2, ""lines"": 3}, ""runtime/doc/quickref.txt"": {""insertions"": 2, ""deletions"": 1, ""lines"": 3}, ""runtime/doc/repeat.txt"": {""insertions"": 5, ""deletions"": 0, ""lines"": 5}, ""runtime/doc/rileft.txt"": {""insertions"": 1, ""deletions"": 1, ""lines"": 2}, ""runtime/doc/syntax.txt"": {""insertions"": 13, ""deletions"": 4, ""lines"": 17}, ""runtime/doc/tags"": {""insertions"": 5, ""deletions"": 1, ""lines"": 6}, ""runtime/doc/terminal.txt"": {""insertions"": 1, ""deletions"": 1, ""lines"": 2}, ""runtime/doc/textprop.txt"": {""insertions"": 4, ""deletions"": 1, ""lines"": 5}, ""runtime/doc/todo.txt"": {""insertions"": 24, ""deletions"": 24, ""lines"": 48}, ""runtime/doc/userfunc.txt"": {""insertions"": 4, ""deletions"": 0, ""lines"": 4}, ""runtime/doc/usr_41.txt"": {""insertions"": 1, ""deletions"": 1, ""lines"": 2}, ""runtime/doc/usr_52.txt"": {""insertions"": 1, ""deletions"": 0, ""lines"": 1}, ""runtime/doc/various.txt"": {""insertions"": 1, ""deletions"": 1, ""lines"": 2}, ""runtime/filetype.vim"": {""insertions"": 1, ""deletions"": 1, ""lines"": 2}, ""runtime/ftplugin/abaqus.vim"": {""insertions"": 31, ""deletions"": 12, ""lines"": 43}, ""runtime/ftplugin/lua.vim"": {""insertions"": 5, ""deletions"": 2, ""lines"": 7}, ""runtime/ftplugin/markdown.vim"": {""insertions"": 27, ""deletions"": 9, ""lines"": 36}, ""runtime/ftplugin/poefilter.vim"": {""insertions"": 13, ""deletions"": 0, ""lines"": 13}, ""runtime/ftplugin/ssa.vim"": {""insertions"": 13, ""deletions"": 0, ""lines"": 13}, ""runtime/indent/testdir/vim.in"": {""insertions"": 18, ""deletions"": 0, ""lines"": 18}, ""runtime/indent/testdir/vim.ok"": {""insertions"": 19, ""deletions"": 1, ""lines"": 20}, ""runtime/indent/vim.vim"": {""insertions"": 2, ""deletions"": 2, ""lines"": 4}, ""runtime/optwin.vim"": {""insertions"": 3, ""deletions"": 1, ""lines"": 4}, ""runtime/synmenu.vim"": {""insertions"": 1, ""deletions"": 1, ""lines"": 2}, ""runtime/syntax/c.vim"": {""insertions"": 1, ""deletions"": 1, ""lines"": 2}, ""runtime/syntax/markdown.vim"": {""insertions"": 60, ""deletions"": 29, ""lines"": 89}, ""runtime/syntax/poefilter.vim"": {""insertions"": 167, ""deletions"": 0, ""lines"": 167}, ""runtime/syntax/sed.vim"": {""insertions"": 59, ""deletions"": 46, ""lines"": 105}, ""runtime/syntax/ssa.vim"": {""insertions"": 63, ""deletions"": 0, ""lines"": 63}, ""runtime/tutor/tutor.es"": {""insertions"": 29, ""deletions"": 26, ""lines"": 55}, ""runtime/tutor/tutor.es.utf-8"": {""insertions"": 29, ""deletions"": 26, ""lines"": 55}}"
2022-10-16 11:49:12,bd053f894b0d7652928201faa68c53d1ce2acdc5,Martin Tournoij,8,1,9,3,"{""runtime/autoload/dist/ft.vim"": {""insertions"": 1, ""deletions"": 1, ""lines"": 2}, ""src/testdir/test_filetype.vim"": {""insertions"": 5, ""deletions"": 0, ""lines"": 5}, ""src/version.c"": {""insertions"": 2, ""deletions"": 0, ""lines"": 2}}"
2022-10-16 10:30:48,d8cd6f7427bc89aa38f42cc44f58bf5fb5f0f972,Yegappan Lakshmanan,24,1,25,2,"{""src/quickfix.c"": {""insertions"": 22, ""deletions"": 1, ""lines"": 23}, ""src/version.c"": {""insertions"": 2, ""deletions"": 0, ""lines"": 2}}"
2022-10-15 21:06:06,db4c94788ad70118fa1ccc5fbc821757350ac771,Bram Moolenaar,31,58,89,6,"{""src/testdir/test_winbar.vim"": {""insertions"": 2, ""deletions"": 4, ""lines"": 6}, ""src/testdir/test_winbuf_close.vim"": {""insertions"": 3, ""deletions"": 7, ""lines"": 10}, ""src/testdir/test_window_cmd.vim"": {""insertions"": 6, ""deletions"": 12, ""lines"": 18}, ""src/testdir/test_writefile.vim"": {""insertions"": 14, ""deletions"": 27, ""lines"": 41}, ""src/testdir/test_xxd.vim"": {""insertions"": 4, ""deletions"": 8, ""lines"": 12}, ""src/version.c"": {""insertions"": 2, ""deletions"": 0, ""lines"": 2}}"
2022-10-15 20:35:56,5b148ef2628251b2d79f78c65a614f8aca404329,Bram Moolenaar,50,96,146,7,"{""src/testdir/test_undo.vim"": {""insertions"": 2, ""deletions"": 5, ""lines"": 7}, ""src/testdir/test_user_func.vim"": {""insertions"": 4, ""deletions"": 9, ""lines"": 13}, ""src/testdir/test_usercommands.vim"": {""insertions"": 4, ""deletions"": 8, ""lines"": 12}, ""src/testdir/test_viminfo.vim"": {""insertions"": 22, ""deletions"": 37, ""lines"": 59}, ""src/testdir/test_vimscript.vim"": {""insertions"": 14, ""deletions"": 33, ""lines"": 47}, ""src/testdir/test_visual.vim"": {""insertions"": 2, ""deletions"": 4, ""lines"": 6}, ""src/version.c"": {""insertions"": 2, ""deletions"": 0, ""lines"": 2}}"
2022-10-15 19:52:26,c4860bdd2832feb7ab054c6dc14f68abe24c2373,Bram Moolenaar,169,313,482,14,"{""src/testdir/test_tabline.vim"": {""insertions"": 1, ""deletions"": 3, ""lines"": 4}, ""src/testdir/test_tabpage.vim"": {""insertions"": 1, ""deletions"": 2, ""lines"": 3}, ""src/testdir/test_tagcase.vim"": {""insertions"": 1, ""deletions"": 2, ""lines"": 3}, ""src/testdir/test_tagfunc.vim"": {""insertions"": 1, ""deletions"": 2, ""lines"": 3}, ""src/testdir/test_tagjump.vim"": {""insertions"": 74, ""deletions"": 147, ""lines"": 221}, ""src/testdir/test_taglist.vim"": {""insertions"": 14, ""deletions"": 27, ""lines"": 41}, ""src/testdir/test_tcl.vim"": {""insertions"": 2, ""deletions"": 5, ""lines"": 7}, ""src/testdir/test_termencoding.vim"": {""insertions"": 1, ""deletions"": 2, ""lines"": 3}, ""src/testdir/test_terminal.vim"": {""insertions"": 20, ""deletions"": 41, ""lines"": 61}, ""src/testdir/test_terminal2.vim"": {""insertions"": 32, ""deletions"": 39, ""lines"": 71}, ""src/testdir/test_terminal3.vim"": {""insertions"": 11, ""deletions"": 22, ""lines"": 33}, ""src/testdir/test_timers.vim"": {""insertions"": 5, ""deletions"": 10, ""lines"": 15}, ""src/testdir/test_trycatch.vim"": {""insertions"": 4, ""deletions"": 11, ""lines"": 15}, ""src/version.c"": {""insertions"": 2, ""deletions"": 0, ""lines"": 2}}"
2022-10-15 19:06:33,0e9bdad545e8e75b23c40e44cc6ec51330f5b465,Bram Moolenaar,158,289,447,7,"{""src/testdir/test_vim9_assign.vim"": {""insertions"": 4, ""deletions"": 9, ""lines"": 13}, ""src/testdir/test_vim9_builtin.vim"": {""insertions"": 7, ""deletions"": 14, ""lines"": 21}, ""src/testdir/test_vim9_cmd.vim"": {""insertions"": 3, ""deletions"": 6, ""lines"": 9}, ""src/testdir/test_vim9_disassemble.vim"": {""insertions"": 45, ""deletions"": 50, ""lines"": 95}, ""src/testdir/test_vim9_expr.vim"": {""insertions"": 3, ""deletions"": 7, ""lines"": 10}, ""src/testdir/test_vim9_import.vim"": {""insertions"": 94, ""deletions"": 203, ""lines"": 297}, ""src/version.c"": {""insertions"": 2, ""deletions"": 0, ""lines"": 2}}"
2022-10-15 18:04:05,36343ae0fb7247e060abfd35fb8e4337b33abb4b,Bram Moolenaar,16,0,16,3,"{""src/register.c"": {""insertions"": 2, ""deletions"": 0, ""lines"": 2}, ""src/testdir/test_visual.vim"": {""insertions"": 12, ""deletions"": 0, ""lines"": 12}, ""src/version.c"": {""insertions"": 2, ""deletions"": 0, ""lines"": 2}}"
2022-10-15 15:41:53,c8b673557390e5cd20bc0a4c2786d0db1d77a24c,Bram Moolenaar,9,1,10,3,"{""src/ops.c"": {""insertions"": 6, ""deletions"": 1, ""lines"": 7}, ""src/testdir/gen_opt_test.vim"": {""insertions"": 1, ""deletions"": 0, ""lines"": 1}, ""src/version.c"": {""insertions"": 2, ""deletions"": 0, ""lines"": 2}}"
2022-10-15 15:29:03,a2e4e0fc3b930caf20c4f6d2e70acf5325c3be51,Bram Moolenaar,3,1,4,2,"{""src/time.c"": {""insertions"": 1, ""deletions"": 1, ""lines"": 2}, ""src/version.c"": {""insertions"": 2, ""deletions"": 0, ""lines"": 2}}"
2022-10-15 15:25:27,4b082c4bd05f504fda1acaa9d28fca55a2d04857,Bram Moolenaar,3,0,3,2,"{""src/structs.h"": {""insertions"": 1, ""deletions"": 0, ""lines"": 1}, ""src/version.c"": {""insertions"": 2, ""deletions"": 0, ""lines"": 2}}"
2022-10-15 15:05:33,49846fb1a31de99f49d6a7e70efe685197423c84,Bram Moolenaar,95,24,119,11,"{""runtime/doc/options.txt"": {""insertions"": 12, ""deletions"": 1, ""lines"": 13}, ""src/buffer.c"": {""insertions"": 1, ""deletions"": 0, ""lines"": 1}, ""src/change.c"": {""insertions"": 16, ""deletions"": 13, ""lines"": 29}, ""src/indent.c"": {""insertions"": 24, ""deletions"": 4, ""lines"": 28}, ""src/option.c"": {""insertions"": 3, ""deletions"": 0, ""lines"": 3}, ""src/option.h"": {""insertions"": 2, ""deletions"": 0, ""lines"": 2}, ""src/optiondefs.h"": {""insertions"": 10, ""deletions"": 6, ""lines"": 16}, ""src/optionstr.c"": {""insertions"": 9, ""deletions"": 0, ""lines"": 9}, ""src/proto/indent.pro"": {""insertions"": 1, ""deletions"": 0, ""lines"": 1}, ""src/testdir/test_lispindent.vim"": {""insertions"": 15, ""deletions"": 0, ""lines"": 15}, ""src/version.c"": {""insertions"": 2, ""deletions"": 0, ""lines"": 2}}"
2022-10-15 13:24:29,297164cb7972beff35e375ccac4fbad8196ccbd7,Bram Moolenaar,3,1,4,2,"{""src/testdir/test_display.vim"": {""insertions"": 1, ""deletions"": 1, ""lines"": 2}, ""src/version.c"": {""insertions"": 2, ""deletions"": 0, ""lines"": 2}}"
2022-10-15 13:17:37,fa7bb1d937308a60280e070b01baba5342148ff7,Philip H,4,2,6,2,"{"".github/workflows/ci.yml"": {""insertions"": 2, ""deletions"": 2, ""lines"": 4}, ""src/version.c"": {""insertions"": 2, ""deletions"": 0, ""lines"": 2}}"
2022-10-15 13:07:48,13cdde39520220bb856cba16626327c706752b51,Bram Moolenaar,46,1,47,5,"{""src/drawline.c"": {""insertions"": 3, ""deletions"": 1, ""lines"": 4}, ""src/testdir/dumps/Test_smooth_list_1.dump"": {""insertions"": 8, ""deletions"": 0, ""lines"": 8}, ""src/testdir/dumps/Test_smooth_list_2.dump"": {""insertions"": 8, ""deletions"": 0, ""lines"": 8}, ""src/testdir/test_scroll_opt.vim"": {""insertions"": 25, ""deletions"": 0, ""lines"": 25}, ""src/version.c"": {""insertions"": 2, ""deletions"": 0, ""lines"": 2}}"
2022-10-15 12:42:17,eb4de629315f2682d8b314462d02422ec98d751a,Bram Moolenaar,41,2,43,4,"{""src/drawline.c"": {""insertions"": 13, ""deletions"": 2, ""lines"": 15}, ""src/testdir/dumps/Test_smooth_number_7.dump"": {""insertions"": 12, ""deletions"": 0, ""lines"": 12}, ""src/testdir/test_scroll_opt.vim"": {""insertions"": 14, ""deletions"": 0, ""lines"": 14}, ""src/version.c"": {""insertions"": 2, ""deletions"": 0, ""lines"": 2}}"
2022-10-15 10:48:00,4ccaedfcd7526983f4b6b3b06b0bfb54f333f1f3,Shougo Matsushita,70,0,70,6,"{""runtime/doc/autocmd.txt"": {""insertions"": 5, ""deletions"": 0, ""lines"": 5}, ""src/autocmd.c"": {""insertions"": 1, ""deletions"": 0, ""lines"": 1}, ""src/terminal.c"": {""insertions"": 12, ""deletions"": 0, ""lines"": 12}, ""src/testdir/test_terminal.vim"": {""insertions"": 49, ""deletions"": 0, ""lines"": 49}, ""src/version.c"": {""insertions"": 2, ""deletions"": 0, ""lines"": 2}, ""src/vim.h"": {""insertions"": 1, ""deletions"": 0, ""lines"": 1}}"
2022-10-15 09:54:27,d988ef3a555df2c686899a74393ed53b3186370c,Bram Moolenaar,4,1,5,2,"{"".github/workflows/ci.yml"": {""insertions"": 2, ""deletions"": 1, ""lines"": 3}, ""src/version.c"": {""insertions"": 2, ""deletions"": 0, ""lines"": 2}}"
2022-10-15 09:49:36,a79b35b5781ae770334cec781d17fec3875f8108,Bram Moolenaar,16,4,20,3,"{""src/change.c"": {""insertions"": 3, ""deletions"": 4, ""lines"": 7}, ""src/testdir/test_lispindent.vim"": {""insertions"": 11, ""deletions"": 0, ""lines"": 11}, ""src/version.c"": {""insertions"": 2, ""deletions"": 0, ""lines"": 2}}"
2022-10-15 09:22:19,b77bdce120d7e140d0d0bd535ec9febdef78993d,Yee Cheng Chin,76,1,77,4,"{""runtime/doc/index.txt"": {""insertions"": 4, ""deletions"": 1, ""lines"": 5}, ""src/testdir/Make_all.mak"": {""insertions"": 2, ""deletions"": 0, ""lines"": 2}, ""src/testdir/test_cmd_lists.vim"": {""insertions"": 68, ""deletions"": 0, ""lines"": 68}, ""src/version.c"": {""insertions"": 2, ""deletions"": 0, ""lines"": 2}}"
2022-10-14 19:24:24,7e120ffccbf81ae8acac28f11fbd5eab79a1630d,ObserverOfTime,6,1,7,3,"{""runtime/filetype.vim"": {""insertions"": 3, ""deletions"": 0, ""lines"": 3}, ""src/testdir/test_filetype.vim"": {""insertions"": 1, ""deletions"": 1, ""lines"": 2}, ""src/version.c"": {""insertions"": 2, ""deletions"": 0, ""lines"": 2}}"
2022-10-14 19:09:04,c9121f798f49fa71e814912cb186d89c164090c3,Bram Moolenaar,62,23,85,10,"{""src/charset.c"": {""insertions"": 14, ""deletions"": 3, ""lines"": 17}, ""src/edit.c"": {""insertions"": 2, ""deletions"": 2, ""lines"": 4}, ""src/ex_cmds.c"": {""insertions"": 1, ""deletions"": 1, ""lines"": 2}, ""src/misc2.c"": {""insertions"": 2, ""deletions"": 2, ""lines"": 4}, ""src/move.c"": {""insertions"": 33, ""deletions"": 7, ""lines"": 40}, ""src/normal.c"": {""insertions"": 4, ""deletions"": 4, ""lines"": 8}, ""src/ops.c"": {""insertions"": 1, ""deletions"": 1, ""lines"": 2}, ""src/popupwin.c"": {""insertions"": 1, ""deletions"": 2, ""lines"": 3}, ""src/proto/charset.pro"": {""insertions"": 2, ""deletions"": 1, ""lines"": 3}, ""src/version.c"": {""insertions"": 2, ""deletions"": 0, ""lines"": 2}}"
2022-10-14 16:04:09,0abd6cf62d65180dc2c40d67cd95f13b0691f7ea,Bram Moolenaar,8,4,12,4,"{""src/drawscreen.c"": {""insertions"": 2, ""deletions"": 2, ""lines"": 4}, ""src/proto/syntax.pro"": {""insertions"": 1, ""deletions"": 1, ""lines"": 2}, ""src/syntax.c"": {""insertions"": 3, ""deletions"": 1, ""lines"": 4}, ""src/version.c"": {""insertions"": 2, ""deletions"": 0, ""lines"": 2}}"
2022-10-14 12:11:13,975a665d4811649a51e2c6a97a6ce096290d87ae,Yegappan Lakshmanan,82,52,134,4,"{""src/alloc.c"": {""insertions"": 1, ""deletions"": 9, ""lines"": 10}, ""src/proto/quickfix.pro"": {""insertions"": 1, ""deletions"": 0, ""lines"": 1}, ""src/quickfix.c"": {""insertions"": 78, ""deletions"": 43, ""lines"": 121}, ""src/version.c"": {""insertions"": 2, ""deletions"": 0, ""lines"": 2}}"
2022-10-14 11:08:24,b9c09c118e951bc6ea2059941101939dc572b4ce,Trygve Aaberge,76,12,88,3,"{""src/term.c"": {""insertions"": 56, ""deletions"": 12, ""lines"": 68}, ""src/testdir/test_termcodes.vim"": {""insertions"": 18, ""deletions"": 0, ""lines"": 18}, ""src/version.c"": {""insertions"": 2, ""deletions"": 0, ""lines"": 2}}"
2022-10-13 21:12:15,ba43e76fcd5b2da57dbaa4d9a555793fe8ac344e,Martin Tournoij,40,172,212,25,"{""runtime/doc/options.txt"": {""insertions"": 0, ""deletions"": 4, ""lines"": 4}, ""runtime/doc/various.txt"": {""insertions"": 2, ""deletions"": 1, ""lines"": 3}, ""src/arglist.c"": {""insertions"": 1, ""deletions"": 1, ""lines"": 2}, ""src/buffer.c"": {""insertions"": 1, ""deletions"": 6, ""lines"": 7}, ""src/charset.c"": {""insertions"": 1, ""deletions"": 1, ""lines"": 2}, ""src/digraph.c"": {""insertions"": 0, ""deletions"": 2, ""lines"": 2}, ""src/drawline.c"": {""insertions"": 3, ""deletions"": 1, ""lines"": 4}, ""src/drawscreen.c"": {""insertions"": 1, ""deletions"": 10, ""lines"": 11}, ""src/edit.c"": {""insertions"": 0, ""deletions"": 24, ""lines"": 24}, ""src/errors.h"": {""insertions"": 2, ""deletions"": 2, ""lines"": 4}, ""src/evalfunc.c"": {""insertions"": 3, ""deletions"": 15, ""lines"": 18}, ""src/feature.h"": {""insertions"": 1, ""deletions"": 10, ""lines"": 11}, ""src/getchar.c"": {""insertions"": 0, ""deletions"": 14, ""lines"": 14}, ""src/message.c"": {""insertions"": 1, ""deletions"": 1, ""lines"": 2}, ""src/normal.c"": {""insertions"": 3, ""deletions"": 28, ""lines"": 31}, ""src/option.c"": {""insertions"": 1, ""deletions"": 9, ""lines"": 10}, ""src/option.h"": {""insertions"": 0, ""deletions"": 4, ""lines"": 4}, ""src/optiondefs.h"": {""insertions"": 0, ""deletions"": 8, ""lines"": 8}, ""src/screen.c"": {""insertions"": 4, ""deletions"": 10, ""lines"": 14}, ""src/spell.c"": {""insertions"": 2, ""deletions"": 0, ""lines"": 2}, ""src/spellsuggest.c"": {""insertions"": 2, ""deletions"": 0, ""lines"": 2}, ""src/structs.h"": {""insertions"": 4, ""deletions"": 6, ""lines"": 10}, ""src/terminal.c"": {""insertions"": 4, ""deletions"": 8, ""lines"": 12}, ""src/version.c"": {""insertions"": 2, ""deletions"": 4, ""lines"": 6}, ""src/window.c"": {""insertions"": 2, ""deletions"": 3, ""lines"": 5}}"
2022-10-13 20:54:28,856c5d2bc7c3864f8b63a0ab3e376d5c5e51f1d5,Bram Moolenaar,42,35,77,4,"{""src/move.c"": {""insertions"": 33, ""deletions"": 26, ""lines"": 59}, ""src/structs.h"": {""insertions"": 3, ""deletions"": 3, ""lines"": 6}, ""src/testdir/test_breakindent.vim"": {""insertions"": 4, ""deletions"": 6, ""lines"": 10}, ""src/version.c"": {""insertions"": 2, ""deletions"": 0, ""lines"": 2}}"
2022-10-13 19:23:28,4b6172e108fe06be47c09f8690dc54608be3ee80,Bram Moolenaar,51,17,68,4,"{""src/move.c"": {""insertions"": 12, ""deletions"": 9, ""lines"": 21}, ""src/testdir/test_breakindent.vim"": {""insertions"": 2, ""deletions"": 1, ""lines"": 3}, ""src/testdir/test_normal.vim"": {""insertions"": 35, ""deletions"": 7, ""lines"": 42}, ""src/version.c"": {""insertions"": 2, ""deletions"": 0, ""lines"": 2}}"
2022-10-13 16:47:42,6c4d4a64449ea225b1a568f5517e309b2054b490,Bram Moolenaar,29,5,34,3,"{""src/evalvars.c"": {""insertions"": 6, ""deletions"": 4, ""lines"": 10}, ""src/testdir/test_vim9_import.vim"": {""insertions"": 21, ""deletions"": 1, ""lines"": 22}, ""src/version.c"": {""insertions"": 2, ""deletions"": 0, ""lines"": 2}}"
2022-10-13 15:34:30,66b8d2a89efb6bd482e3160c7494e646e31aea27,Bram Moolenaar,6,1,7,2,"{""src/if_cscope.c"": {""insertions"": 4, ""deletions"": 1, ""lines"": 5}, ""src/version.c"": {""insertions"": 2, ""deletions"": 0, ""lines"": 2}}"
2022-10-13 15:12:57,3558afe9e9e904cabb8475392d859f2d2fc21041,Bram Moolenaar,136,33,169,5,"{""src/testdir/test_vim9_func.vim"": {""insertions"": 27, ""deletions"": 0, ""lines"": 27}, ""src/testdir/test_vim9_script.vim"": {""insertions"": 53, ""deletions"": 2, ""lines"": 55}, ""src/version.c"": {""insertions"": 2, ""deletions"": 0, ""lines"": 2}, ""src/vim9cmds.c"": {""insertions"": 36, ""deletions"": 26, ""lines"": 62}, ""src/vim9compile.c"": {""insertions"": 18, ""deletions"": 5, ""lines"": 23}}"
2022-10-13 13:35:24,d93009eb35c88bfc38781fefdf42ebdb02c61474,Bram Moolenaar,30,9,39,4,"{""runtime/doc/textprop.txt"": {""insertions"": 13, ""deletions"": 7, ""lines"": 20}, ""src/testdir/test_textprop.vim"": {""insertions"": 10, ""deletions"": 0, ""lines"": 10}, ""src/textprop.c"": {""insertions"": 5, ""deletions"": 2, ""lines"": 7}, ""src/version.c"": {""insertions"": 2, ""deletions"": 0, ""lines"": 2}}"
2022-10-13 13:00:45,4997f2a605e15261c4f825494324371f271ef6a8,Bram Moolenaar,17,7,24,4,"{""src/globals.h"": {""insertions"": 2, ""deletions"": 2, ""lines"": 4}, ""src/testdir/test_textprop.vim"": {""insertions"": 3, ""deletions"": 0, ""lines"": 3}, ""src/textprop.c"": {""insertions"": 10, ""deletions"": 5, ""lines"": 15}, ""src/version.c"": {""insertions"": 2, ""deletions"": 0, ""lines"": 2}}"
2022-10-13 12:17:40,17822c507c03d509037c9ee5eee5cfbb201b3f01,Yee Cheng Chin,52,12,64,3,"{""src/mouse.c"": {""insertions"": 16, ""deletions"": 4, ""lines"": 20}, ""src/testdir/test_termcodes.vim"": {""insertions"": 34, ""deletions"": 8, ""lines"": 42}, ""src/version.c"": {""insertions"": 2, ""deletions"": 0, ""lines"": 2}}"
2022-10-13 11:51:13,91ccbad5ded8bcf2cc93a873ff2c3179b0c548c7,=?UTF-8?q?Bj=C3=B6rn=20Linse?=,24,13,37,4,"{""runtime/doc/options.txt"": {""insertions"": 2, ""deletions"": 0, ""lines"": 2}, ""src/insexpand.c"": {""insertions"": 18, ""deletions"": 12, ""lines"": 30}, ""src/option.h"": {""insertions"": 2, ""deletions"": 1, ""lines"": 3}, ""src/version.c"": {""insertions"": 2, ""deletions"": 0, ""lines"": 2}}"
2022-10-13 11:30:08,d26c5805bcbd630dab0478c2d22503a6e32a83c1,Bram Moolenaar,109,102,211,7,"{""src/indent.c"": {""insertions"": 1, ""deletions"": 1, ""lines"": 2}, ""src/testdir/Make_all.mak"": {""insertions"": 2, ""deletions"": 1, ""lines"": 3}, ""src/testdir/test_alot.vim"": {""insertions"": 0, ""deletions"": 1, ""lines"": 1}, ""src/testdir/test_cpoptions.vim"": {""insertions"": 1, ""deletions"": 1, ""lines"": 2}, ""src/testdir/test_lispindent.vim"": {""insertions"": 103, ""deletions"": 0, ""lines"": 103}, ""src/testdir/test_lispwords.vim"": {""insertions"": 0, ""deletions"": 98, ""lines"": 98}, ""src/version.c"": {""insertions"": 2, ""deletions"": 0, ""lines"": 2}}"
2022-10-13 10:59:22,f8412c9d7cc487dacf47a217ae947da68a525c53,Yegappan Lakshmanan,98,76,174,3,"{""src/quickfix.c"": {""insertions"": 58, ""deletions"": 76, ""lines"": 134}, ""src/testdir/test_quickfix.vim"": {""insertions"": 38, ""deletions"": 0, ""lines"": 38}, ""src/version.c"": {""insertions"": 2, ""deletions"": 0, ""lines"": 2}}"
2022-10-12 20:32:42,e42033e735febb163fdc57aadbc11787ca611ba9,Bram Moolenaar,8,3,11,3,"{""src/testdir/test_breakindent.vim"": {""insertions"": 2, ""deletions"": 1, ""lines"": 3}, ""src/testdir/test_normal.vim"": {""insertions"": 4, ""deletions"": 2, ""lines"": 6}, ""src/version.c"": {""insertions"": 2, ""deletions"": 0, ""lines"": 2}}"
2022-10-12 18:53:38,2fbabd238a94022c99506e920186a5b6cdf15426,Bram Moolenaar,132,9,141,11,"{""src/edit.c"": {""insertions"": 3, ""deletions"": 0, ""lines"": 3}, ""src/move.c"": {""insertions"": 85, ""deletions"": 3, ""lines"": 88}, ""src/normal.c"": {""insertions"": 1, ""deletions"": 0, ""lines"": 1}, ""src/proto/move.pro"": {""insertions"": 1, ""deletions"": 0, ""lines"": 1}, ""src/structs.h"": {""insertions"": 1, ""deletions"": 0, ""lines"": 1}, ""src/testdir/dumps/Test_smooth_long_8.dump"": {""insertions"": 1, ""deletions"": 1, ""lines"": 2}, ""src/testdir/dumps/Test_smooth_long_9.dump"": {""insertions"": 5, ""deletions"": 5, ""lines"": 10}, ""src/testdir/dumps/Test_smooth_one_long_1.dump"": {""insertions"": 6, ""deletions"": 0, ""lines"": 6}, ""src/testdir/dumps/Test_smooth_one_long_2.dump"": {""insertions"": 6, ""deletions"": 0, ""lines"": 6}, ""src/testdir/test_scroll_opt.vim"": {""insertions"": 21, ""deletions"": 0, ""lines"": 21}, ""src/version.c"": {""insertions"": 2, ""deletions"": 0, ""lines"": 2}}"
2022-10-12 12:30:25,84d14ccdb50dc9f362066a2c83bfaf331314e5ea,Dominique Pelle,22,11,33,2,"{""src/time.c"": {""insertions"": 20, ""deletions"": 11, ""lines"": 31}, ""src/version.c"": {""insertions"": 2, ""deletions"": 0, ""lines"": 2}}"
2022-10-12 11:58:54,d987642626f84fe2f0b32a1ca5ede31b436ce677,Bram Moolenaar,31,3,34,3,"{""src/evalvars.c"": {""insertions"": 10, ""deletions"": 3, ""lines"": 13}, ""src/testdir/test_vim9_assign.vim"": {""insertions"": 19, ""deletions"": 0, ""lines"": 19}, ""src/version.c"": {""insertions"": 2, ""deletions"": 0, ""lines"": 2}}"
2022-10-12 11:09:40,af40f9af335e0c8b167eac31ceace45b6a2e0565,dundargoc,6,1,7,3,"{""runtime/filetype.vim"": {""insertions"": 3, ""deletions"": 0, ""lines"": 3}, ""src/testdir/test_filetype.vim"": {""insertions"": 1, ""deletions"": 1, ""lines"": 2}, ""src/version.c"": {""insertions"": 2, ""deletions"": 0, ""lines"": 2}}"
2022-10-12 10:54:34,9ce7915d0667e6cb8f930634473f0caf2967f4e3,Bram Moolenaar,5,1,6,2,"{""src/testdir/test_startup.vim"": {""insertions"": 3, ""deletions"": 1, ""lines"": 4}, ""src/version.c"": {""insertions"": 2, ""deletions"": 0, ""lines"": 2}}"
2022-10-12 10:12:49,ae906c8b1bf023f4a15f38b4abef9dedc2f18467,Bram Moolenaar,10,13,23,3,"{""runtime/doc/rileft.txt"": {""insertions"": 5, ""deletions"": 0, ""lines"": 5}, ""src/feature.h"": {""insertions"": 3, ""deletions"": 13, ""lines"": 16}, ""src/version.c"": {""insertions"": 2, ""deletions"": 0, ""lines"": 2}}"
2022-10-11 22:12:59,a4962cd7bac8464d9f8d95d37614ecf595c5487e,Bram Moolenaar,4,2,6,2,"{""src/testdir/test_vim9_builtin.vim"": {""insertions"": 2, ""deletions"": 2, ""lines"": 4}, ""src/version.c"": {""insertions"": 2, ""deletions"": 0, ""lines"": 2}}"
2022-10-11 20:54:04,7c6cd443757348aa987eed87506549ab6b2079fe,Bram Moolenaar,9,5,14,4,"{""runtime/doc/builtin.txt"": {""insertions"": 3, ""deletions"": 3, ""lines"": 6}, ""runtime/doc/eval.txt"": {""insertions"": 1, ""deletions"": 1, ""lines"": 2}, ""runtime/doc/vim9.txt"": {""insertions"": 3, ""deletions"": 1, ""lines"": 4}, ""src/version.c"": {""insertions"": 2, ""deletions"": 0, ""lines"": 2}}"
2022-10-11 20:41:25,159b2d5bfc4edc013024e8c996141d37542ebc15,Bram Moolenaar,17,1,18,3,"{""src/testdir/test_vim9_script.vim"": {""insertions"": 14, ""deletions"": 0, ""lines"": 14}, ""src/version.c"": {""insertions"": 2, ""deletions"": 0, ""lines"": 2}, ""src/vim9cmds.c"": {""insertions"": 1, ""deletions"": 1, ""lines"": 2}}"
2022-10-11 20:02:09,7e017461e21ac534f8a0d59c1165d11358c69d87,Bram Moolenaar,35,3,38,4,"{""src/drawline.c"": {""insertions"": 5, ""deletions"": 3, ""lines"": 8}, ""src/testdir/dumps/Test_text_after_nowrap_5.dump"": {""insertions"": 8, ""deletions"": 0, ""lines"": 8}, ""src/testdir/test_textprop.vim"": {""insertions"": 20, ""deletions"": 0, ""lines"": 20}, ""src/version.c"": {""insertions"": 2, ""deletions"": 0, ""lines"": 2}}"
2022-10-11 19:04:09,a275f2cdcc4353e7653a69c7c818422db5da599d,Bram Moolenaar,49,18,67,4,"{""src/testdir/test_vim9_script.vim"": {""insertions"": 30, ""deletions"": 0, ""lines"": 30}, ""src/version.c"": {""insertions"": 2, ""deletions"": 0, ""lines"": 2}, ""src/vim9cmds.c"": {""insertions"": 15, ""deletions"": 17, ""lines"": 32}, ""src/vim9compile.c"": {""insertions"": 2, ""deletions"": 1, ""lines"": 3}}"
2022-10-11 15:47:22,a9a364872e41932990aba1787af65f67c7e14917,Bram Moolenaar,15,2,17,4,"{""src/drawline.c"": {""insertions"": 2, ""deletions"": 2, ""lines"": 4}, ""src/testdir/dumps/Test_long_text_with_padding_2.dump"": {""insertions"": 8, ""deletions"": 0, ""lines"": 8}, ""src/testdir/test_textprop.vim"": {""insertions"": 3, ""deletions"": 0, ""lines"": 3}, ""src/version.c"": {""insertions"": 2, ""deletions"": 0, ""lines"": 2}}"
2022-10-11 14:29:50,877151b3d8f6dacca56ce8e7f20fa5b27142d782,Bram Moolenaar,62,3,65,5,"{""src/drawline.c"": {""insertions"": 7, ""deletions"": 3, ""lines"": 10}, ""src/testdir/dumps/Test_props_after_1.dump"": {""insertions"": 8, ""deletions"": 0, ""lines"": 8}, ""src/testdir/dumps/Test_props_after_2.dump"": {""insertions"": 8, ""deletions"": 0, ""lines"": 8}, ""src/testdir/test_textprop.vim"": {""insertions"": 37, ""deletions"": 0, ""lines"": 37}, ""src/version.c"": {""insertions"": 2, ""deletions"": 0, ""lines"": 2}}"
2022-10-11 13:54:42,9466fb8001227a4bc9045e91045426bc40680366,Bram Moolenaar,21,2,23,4,"{""src/drawline.c"": {""insertions"": 2, ""deletions"": 2, ""lines"": 4}, ""src/testdir/dumps/Test_prop_with_text_above_9.dump"": {""insertions"": 9, ""deletions"": 0, ""lines"": 9}, ""src/testdir/test_textprop.vim"": {""insertions"": 8, ""deletions"": 0, ""lines"": 8}, ""src/version.c"": {""insertions"": 2, ""deletions"": 0, ""lines"": 2}}"
2022-10-11 11:48:44,0c502d2e7031611788c301c7da0896f0fd9515fd,Bram Moolenaar,24,0,24,2,"{""src/screen.c"": {""insertions"": 22, ""deletions"": 0, ""lines"": 22}, ""src/version.c"": {""insertions"": 2, ""deletions"": 0, ""lines"": 2}}"
2022-10-10 21:39:42,56564964e6d0956c29687e8a10cb94fe42f5c097,Bram Moolenaar,150,282,432,22,"{""src/testdir/test_scriptnames.vim"": {""insertions"": 2, ""deletions"": 5, ""lines"": 7}, ""src/testdir/test_search.vim"": {""insertions"": 20, ""deletions"": 41, ""lines"": 61}, ""src/testdir/test_search_stat.vim"": {""insertions"": 5, ""deletions"": 10, ""lines"": 15}, ""src/testdir/test_shell.vim"": {""insertions"": 1, ""deletions"": 2, ""lines"": 3}, ""src/testdir/test_shortpathname.vim"": {""insertions"": 6, ""deletions"": 13, ""lines"": 19}, ""src/testdir/test_signals.vim"": {""insertions"": 2, ""deletions"": 4, ""lines"": 6}, ""src/testdir/test_signs.vim"": {""insertions"": 11, ""deletions"": 22, ""lines"": 33}, ""src/testdir/test_sort.vim"": {""insertions"": 1, ""deletions"": 2, ""lines"": 3}, ""src/testdir/test_source.vim"": {""insertions"": 2, ""deletions"": 4, ""lines"": 6}, ""src/testdir/test_source_utf8.vim"": {""insertions"": 1, ""deletions"": 2, ""lines"": 3}, ""src/testdir/test_spell.vim"": {""insertions"": 4, ""deletions"": 5, ""lines"": 9}, ""src/testdir/test_spell_utf8.vim"": {""insertions"": 3, ""deletions"": 3, ""lines"": 6}, ""src/testdir/test_spellfile.vim"": {""insertions"": 30, ""deletions"": 57, ""lines"": 87}, ""src/testdir/test_startup.vim"": {""insertions"": 26, ""deletions"": 45, ""lines"": 71}, ""src/testdir/test_startup_utf8.vim"": {""insertions"": 5, ""deletions"": 6, ""lines"": 11}, ""src/testdir/test_stat.vim"": {""insertions"": 3, ""deletions"": 9, ""lines"": 12}, ""src/testdir/test_statusline.vim"": {""insertions"": 3, ""deletions"": 6, ""lines"": 9}, ""src/testdir/test_substitute.vim"": {""insertions"": 2, ""deletions"": 4, ""lines"": 6}, ""src/testdir/test_swap.vim"": {""insertions"": 15, ""deletions"": 30, ""lines"": 45}, ""src/testdir/test_syntax.vim"": {""insertions"": 5, ""deletions"": 10, ""lines"": 15}, ""src/testdir/test_system.vim"": {""insertions"": 1, ""deletions"": 2, ""lines"": 3}, ""src/version.c"": {""insertions"": 2, ""deletions"": 0, ""lines"": 2}}"
2022-10-10 20:10:03,ccf2837a05cef0ea4913ebff4f2f6000bc050271,Bram Moolenaar,15,2,17,4,"{""src/drawline.c"": {""insertions"": 2, ""deletions"": 2, ""lines"": 4}, ""src/testdir/dumps/Test_prop_with_text_after_below_trunc_2.dump"": {""insertions"": 8, ""deletions"": 0, ""lines"": 8}, ""src/testdir/test_textprop.vim"": {""insertions"": 3, ""deletions"": 0, ""lines"": 3}, ""src/version.c"": {""insertions"": 2, ""deletions"": 0, ""lines"": 2}}"
2022-10-10 19:33:25,d3283fba2593d093593fc692702aabfaa2a68523,Bram Moolenaar,6,0,6,2,"{""src/drawline.c"": {""insertions"": 4, ""deletions"": 0, ""lines"": 4}, ""src/version.c"": {""insertions"": 2, ""deletions"": 0, ""lines"": 2}}"
2022-10-10 18:50:42,cd105417a53fcf97c0935f3468201ef11516c9f1,Bram Moolenaar,100,17,117,7,"{""src/drawline.c"": {""insertions"": 48, ""deletions"": 5, ""lines"": 53}, ""src/testdir/dumps/Test_text_after_nowrap_1.dump"": {""insertions"": 3, ""deletions"": 3, ""lines"": 6}, ""src/testdir/dumps/Test_text_after_nowrap_2.dump"": {""insertions"": 8, ""deletions"": 0, ""lines"": 8}, ""src/testdir/dumps/Test_text_after_nowrap_3.dump"": {""insertions"": 8, ""deletions"": 0, ""lines"": 8}, ""src/testdir/dumps/Test_text_after_nowrap_4.dump"": {""insertions"": 8, ""deletions"": 0, ""lines"": 8}, ""src/testdir/test_textprop.vim"": {""insertions"": 23, ""deletions"": 9, ""lines"": 32}, ""src/version.c"": {""insertions"": 2, ""deletions"": 0, ""lines"": 2}}"
2022-10-10 15:08:16,801cd35e7e3b21e519e12a1610ee1d721e40893e,Bram Moolenaar,7,1,8,3,"{""src/testdir/test_functions.vim"": {""insertions"": 2, ""deletions"": 0, ""lines"": 2}, ""src/typval.c"": {""insertions"": 3, ""deletions"": 1, ""lines"": 4}, ""src/version.c"": {""insertions"": 2, ""deletions"": 0, ""lines"": 2}}"
2022-10-10 14:40:04,1206c163dbc8caace86e53f375f298af6cfab75a,Bram Moolenaar,53,3,56,4,"{""src/drawline.c"": {""insertions"": 14, ""deletions"": 3, ""lines"": 17}, ""src/testdir/dumps/Test_text_below_nowrap_1.dump"": {""insertions"": 8, ""deletions"": 0, ""lines"": 8}, ""src/testdir/test_textprop.vim"": {""insertions"": 29, ""deletions"": 0, ""lines"": 29}, ""src/version.c"": {""insertions"": 2, ""deletions"": 0, ""lines"": 2}}"
2022-10-10 12:46:15,c601d988b6b1a672f71e3d61f4aaa4f7742a3a21,zeertzjq,32,0,32,3,"{""src/autocmd.c"": {""insertions"": 1, ""deletions"": 0, ""lines"": 1}, ""src/testdir/test_menu.vim"": {""insertions"": 29, ""deletions"": 0, ""lines"": 29}, ""src/version.c"": {""insertions"": 2, ""deletions"": 0, ""lines"": 2}}"
2022-10-10 11:42:57,79f234499b6692cc16970b7455bc9b002242632f,Bram Moolenaar,29,15,44,4,"{""src/eval.c"": {""insertions"": 7, ""deletions"": 3, ""lines"": 10}, ""src/evalfunc.c"": {""insertions"": 14, ""deletions"": 12, ""lines"": 26}, ""src/testdir/test_cursor_func.vim"": {""insertions"": 6, ""deletions"": 0, ""lines"": 6}, ""src/version.c"": {""insertions"": 2, ""deletions"": 0, ""lines"": 2}}"
2022-10-10 11:08:59,084f2620ec7d08d6043de30436197c002fffe3ec,ObserverOfTime,6,0,6,3,"{""runtime/filetype.vim"": {""insertions"": 3, ""deletions"": 0, ""lines"": 3}, ""src/testdir/test_filetype.vim"": {""insertions"": 1, ""deletions"": 0, ""lines"": 1}, ""src/version.c"": {""insertions"": 2, ""deletions"": 0, ""lines"": 2}}"
2022-10-10 10:46:16,4282633ba63f6e11f2fe42c4b7758dace184f30d,Yee Cheng Chin,46,11,57,4,"{""runtime/doc/terminal.txt"": {""insertions"": 2, ""deletions"": 3, ""lines"": 5}, ""src/buffer.c"": {""insertions"": 17, ""deletions"": 5, ""lines"": 22}, ""src/testdir/test_terminal.vim"": {""insertions"": 25, ""deletions"": 3, ""lines"": 28}, ""src/version.c"": {""insertions"": 2, ""deletions"": 0, ""lines"": 2}}"
2022-10-09 20:53:58,f167c7b42476f8ab5b32c3c5ccbdca914316e96b,Bram Moolenaar,55,10,65,6,"{""src/charset.c"": {""insertions"": 1, ""deletions"": 1, ""lines"": 2}, ""src/drawline.c"": {""insertions"": 13, ""deletions"": 8, ""lines"": 21}, ""src/proto/drawline.pro"": {""insertions"": 1, ""deletions"": 1, ""lines"": 2}, ""src/testdir/dumps/Test_text_after_nowrap_1.dump"": {""insertions"": 8, ""deletions"": 0, ""lines"": 8}, ""src/testdir/test_textprop.vim"": {""insertions"": 30, ""deletions"": 0, ""lines"": 30}, ""src/version.c"": {""insertions"": 2, ""deletions"": 0, ""lines"": 2}}"
2022-10-09 17:53:32,15b314ffbb93f934b72cb71aa8f881caea026256,Yee Cheng Chin,242,36,278,8,"{""runtime/menu.vim"": {""insertions"": 6, ""deletions"": 0, ""lines"": 6}, ""src/buffer.c"": {""insertions"": 61, ""deletions"": 20, ""lines"": 81}, ""src/ex_cmds2.c"": {""insertions"": 8, ""deletions"": 0, ""lines"": 8}, ""src/ex_docmd.c"": {""insertions"": 20, ""deletions"": 6, ""lines"": 26}, ""src/proto/terminal.pro"": {""insertions"": 1, ""deletions"": 0, ""lines"": 1}, ""src/terminal.c"": {""insertions"": 21, ""deletions"": 7, ""lines"": 28}, ""src/testdir/test_terminal.vim"": {""insertions"": 123, ""deletions"": 3, ""lines"": 126}, ""src/version.c"": {""insertions"": 2, ""deletions"": 0, ""lines"": 2}}"
2022-10-09 16:19:27,118c235112854f34182d968613d7fe98be3b290b,Bram Moolenaar,68,9,77,7,"{""src/move.c"": {""insertions"": 20, ""deletions"": 9, ""lines"": 29}, ""src/testdir/dumps/Test_smooth_long_6.dump"": {""insertions"": 6, ""deletions"": 0, ""lines"": 6}, ""src/testdir/dumps/Test_smooth_long_7.dump"": {""insertions"": 6, ""deletions"": 0, ""lines"": 6}, ""src/testdir/dumps/Test_smooth_long_8.dump"": {""insertions"": 6, ""deletions"": 0, ""lines"": 6}, ""src/testdir/dumps/Test_smooth_long_9.dump"": {""insertions"": 6, ""deletions"": 0, ""lines"": 6}, ""src/testdir/test_scroll_opt.vim"": {""insertions"": 22, ""deletions"": 0, ""lines"": 22}, ""src/version.c"": {""insertions"": 2, ""deletions"": 0, ""lines"": 2}}"
2022-10-09 14:54:53,28f7e701b7857cfc5ab5531ee7ac26e2542ad662,Bram Moolenaar,3,1,4,2,"{""src/help.c"": {""insertions"": 1, ""deletions"": 1, ""lines"": 2}, ""src/version.c"": {""insertions"": 2, ""deletions"": 0, ""lines"": 2}}"
2022-10-09 14:26:03,13845c48d8ca96e0fa5bb237db519dd00045742f,Bram Moolenaar,43,2,45,4,"{""src/drawline.c"": {""insertions"": 5, ""deletions"": 2, ""lines"": 7}, ""src/testdir/dumps/Test_long_text_with_padding_1.dump"": {""insertions"": 8, ""deletions"": 0, ""lines"": 8}, ""src/testdir/test_textprop.vim"": {""insertions"": 28, ""deletions"": 0, ""lines"": 28}, ""src/version.c"": {""insertions"": 2, ""deletions"": 0, ""lines"": 2}}"
2022-10-09 12:28:36,b7af5a044525b72ad607a8bf4fcfff9b9b7565df,Naruhiko Nishino,4,2,6,2,"{"".github/workflows/ci.yml"": {""insertions"": 2, ""deletions"": 2, ""lines"": 4}, ""src/version.c"": {""insertions"": 2, ""deletions"": 0, ""lines"": 2}}"
2022-10-09 11:55:33,330d64d32cbb8ba7cdfe8dc0bedd4caff3bb01e8,Bram Moolenaar,110,107,217,5,"{""src/evalfunc.c"": {""insertions"": 77, ""deletions"": 107, ""lines"": 184}, ""src/proto/vim9type.pro"": {""insertions"": 1, ""deletions"": 0, ""lines"": 1}, ""src/testdir/test_vim9_script.vim"": {""insertions"": 19, ""deletions"": 0, ""lines"": 19}, ""src/version.c"": {""insertions"": 2, ""deletions"": 0, ""lines"": 2}, ""src/vim9type.c"": {""insertions"": 11, ""deletions"": 0, ""lines"": 11}}"
2022-10-09 10:44:28,30c0c467d6cc2a7af960ccb9002b50115b0e55cf,zeertzjq,28,40,68,4,"{""src/testdir/dumps/Test_linebreak_reset_restore_1.dump"": {""insertions"": 1, ""deletions"": 1, ""lines"": 2}, ""src/testdir/test_listlbr.vim"": {""insertions"": 25, ""deletions"": 6, ""lines"": 31}, ""src/testdir/test_visual.vim"": {""insertions"": 0, ""deletions"": 33, ""lines"": 33}, ""src/version.c"": {""insertions"": 2, ""deletions"": 0, ""lines"": 2}}"
2022-10-08 20:13:40,8cf3459878198c5bb4a96f3c63214b2beccce341,Bram Moolenaar,100,2,102,8,"{""src/move.c"": {""insertions"": 40, ""deletions"": 2, ""lines"": 42}, ""src/testdir/dumps/Test_smooth_long_1.dump"": {""insertions"": 6, ""deletions"": 0, ""lines"": 6}, ""src/testdir/dumps/Test_smooth_long_2.dump"": {""insertions"": 6, ""deletions"": 0, ""lines"": 6}, ""src/testdir/dumps/Test_smooth_long_3.dump"": {""insertions"": 6, ""deletions"": 0, ""lines"": 6}, ""src/testdir/dumps/Test_smooth_long_4.dump"": {""insertions"": 6, ""deletions"": 0, ""lines"": 6}, ""src/testdir/dumps/Test_smooth_long_5.dump"": {""insertions"": 6, ""deletions"": 0, ""lines"": 6}, ""src/testdir/test_scroll_opt.vim"": {""insertions"": 28, ""deletions"": 0, ""lines"": 28}, ""src/version.c"": {""insertions"": 2, ""deletions"": 0, ""lines"": 2}}"
2022-10-08 18:26:41,25f3a146a0e4c731b8608f4cfbbfdf7a71b2d05e,Martin Tournoij,73,105,178,14,"{""runtime/doc/various.txt"": {""insertions"": 19, ""deletions"": 19, ""lines"": 38}, ""src/INSTALL"": {""insertions"": 0, ""deletions"": 8, ""lines"": 8}, ""src/INSTALLvms.txt"": {""insertions"": 3, ""deletions"": 4, ""lines"": 7}, ""src/Make_ami.mak"": {""insertions"": 0, ""deletions"": 8, ""lines"": 8}, ""src/Make_cyg_ming.mak"": {""insertions"": 2, ""deletions"": 2, ""lines"": 4}, ""src/Make_mvc.mak"": {""insertions"": 3, ""deletions"": 3, ""lines"": 6}, ""src/Make_vms.mms"": {""insertions"": 0, ""deletions"": 1, ""lines"": 1}, ""src/Makefile"": {""insertions"": 2, ""deletions"": 4, ""lines"": 6}, ""src/auto/configure"": {""insertions"": 5, ""deletions"": 7, ""lines"": 12}, ""src/config.h.in"": {""insertions"": 0, ""deletions"": 3, ""lines"": 3}, ""src/configure.ac"": {""insertions"": 8, ""deletions"": 8, ""lines"": 16}, ""src/feature.h"": {""insertions"": 28, ""deletions"": 34, ""lines"": 62}, ""src/testdir/test_regexp_utf8.vim"": {""insertions"": 1, ""deletions"": 2, ""lines"": 3}, ""src/version.c"": {""insertions"": 2, ""deletions"": 2, ""lines"": 4}}"
2022-10-08 16:55:32,bf499c0e6f30a94fe062f83ea0190f93178d0d74,Bram Moolenaar,4,0,4,2,"{""src/ops.c"": {""insertions"": 2, ""deletions"": 0, ""lines"": 2}, ""src/version.c"": {""insertions"": 2, ""deletions"": 0, ""lines"": 2}}"
2022-10-08 16:15:28,251c1e2ed810d532f7c7d7eb5d6ed5e28a12e501,Martin Tournoij,13,3298,3311,44,"{""Filelist"": {""insertions"": 0, ""deletions"": 22, ""lines"": 22}, ""Makefile"": {""insertions"": 0, ""deletions"": 4, ""lines"": 4}, ""READMEdir/README_extra.txt"": {""insertions"": 0, ""deletions"": 3, ""lines"": 3}, ""READMEdir/README_ole.txt"": {""insertions"": 1, ""deletions"": 4, ""lines"": 5}, ""READMEdir/README_srcdos.txt"": {""insertions"": 1, ""deletions"": 2, ""lines"": 3}, ""nsis/README.txt"": {""insertions"": 4, ""deletions"": 7, ""lines"": 11}, ""nsis/gvim.nsi"": {""insertions"": 0, ""deletions"": 42, ""lines"": 42}, ""nsis/lang/danish.nsi"": {""insertions"": 0, ""deletions"": 3, ""lines"": 3}, ""nsis/lang/dutch.nsi"": {""insertions"": 0, ""deletions"": 5, ""lines"": 5}, ""nsis/lang/english.nsi"": {""insertions"": 0, ""deletions"": 5, ""lines"": 5}, ""nsis/lang/german.nsi"": {""insertions"": 0, ""deletions"": 5, ""lines"": 5}, ""nsis/lang/italian.nsi"": {""insertions"": 0, ""deletions"": 5, ""lines"": 5}, ""nsis/lang/japanese.nsi"": {""insertions"": 0, ""deletions"": 5, ""lines"": 5}, ""nsis/lang/russian.nsi"": {""insertions"": 0, ""deletions"": 5, ""lines"": 5}, ""nsis/lang/serbian.nsi"": {""insertions"": 0, ""deletions"": 5, ""lines"": 5}, ""nsis/lang/simpchinese.nsi"": {""insertions"": 0, ""deletions"": 5, ""lines"": 5}, ""nsis/lang/tradchinese.nsi"": {""insertions"": 0, ""deletions"": 5, ""lines"": 5}, ""nsis/lang/turkish.nsi"": {""insertions"": 0, ""deletions"": 5, ""lines"": 5}, ""runtime/doc/if_ole.txt"": {""insertions"": 4, ""deletions"": 8, ""lines"": 12}, ""src/VisVim/Commands.cpp"": {""insertions"": 0, ""deletions"": 710, ""lines"": 710}, ""src/VisVim/Commands.h"": {""insertions"": 0, ""deletions"": 127, ""lines"": 127}, ""src/VisVim/DSAddIn.cpp"": {""insertions"": 0, ""deletions"": 160, ""lines"": 160}, ""src/VisVim/DSAddIn.h"": {""insertions"": 0, ""deletions"": 53, ""lines"": 53}, ""src/VisVim/OleAut.cpp"": {""insertions"": 0, ""deletions"": 781, ""lines"": 781}, ""src/VisVim/OleAut.h"": {""insertions"": 0, ""deletions"": 73, ""lines"": 73}, ""src/VisVim/README_VisVim.txt"": {""insertions"": 0, ""deletions"": 326, ""lines"": 326}, ""src/VisVim/Reg.cpp"": {""insertions"": 0, ""deletions"": 56, ""lines"": 56}, ""src/VisVim/Register.bat"": {""insertions"": 0, ""deletions"": 1, ""lines"": 1}, ""src/VisVim/Res/ToolbarL.bmp"": {""insertions"": 0, ""deletions"": 0, ""lines"": 0}, ""src/VisVim/Res/ToolbarM.bmp"": {""insertions"": 0, ""deletions"": 0, ""lines"": 0}, ""src/VisVim/Resource.h"": {""insertions"": 0, ""deletions"": 30, ""lines"": 30}, ""src/VisVim/StdAfx.cpp"": {""insertions"": 0, ""deletions"": 6, ""lines"": 6}, ""src/VisVim/StdAfx.h"": {""insertions"": 0, ""deletions"": 73, ""lines"": 73}, ""src/VisVim/UnRegist.bat"": {""insertions"": 0, ""deletions"": 1, ""lines"": 1}, ""src/VisVim/VisVim.cpp"": {""insertions"": 0, ""deletions"": 152, ""lines"": 152}, ""src/VisVim/VisVim.def"": {""insertions"": 0, ""deletions"": 11, ""lines"": 11}, ""src/VisVim/VisVim.dll"": {""insertions"": 0, ""deletions"": 0, ""lines"": 0}, ""src/VisVim/VisVim.h"": {""insertions"": 0, ""deletions"": 33, ""lines"": 33}, ""src/VisVim/VisVim.mak"": {""insertions"": 0, ""deletions"": 205, ""lines"": 205}, ""src/VisVim/VisVim.odl"": {""insertions"": 0, ""deletions"": 61, ""lines"": 61}, ""src/VisVim/VisVim.rc"": {""insertions"": 0, ""deletions"": 202, ""lines"": 202}, ""src/VisVim/VsReadMe.txt"": {""insertions"": 0, ""deletions"": 91, ""lines"": 91}, ""src/version.c"": {""insertions"": 2, ""deletions"": 0, ""lines"": 2}, ""uninstall.txt"": {""insertions"": 1, ""deletions"": 1, ""lines"": 2}}"
2022-10-08 15:41:32,16dab41537ae206f4cab676ad53edbae5fd5fb45,Bram Moolenaar,108,19,127,5,"{""src/ops.c"": {""insertions"": 45, ""deletions"": 19, ""lines"": 64}, ""src/testdir/dumps/Test_linebreak_reset_restore_1.dump"": {""insertions"": 8, ""deletions"": 0, ""lines"": 8}, ""src/testdir/test_listlbr.vim"": {""insertions"": 21, ""deletions"": 0, ""lines"": 21}, ""src/testdir/test_visual.vim"": {""insertions"": 32, ""deletions"": 0, ""lines"": 32}, ""src/version.c"": {""insertions"": 2, ""deletions"": 0, ""lines"": 2}}"
2022-10-08 14:30:55,fbdce1850098e7e9364993cd8c51e4a686c01ae9,Bram Moolenaar,14,0,14,2,"{""src/feature.h"": {""insertions"": 12, ""deletions"": 0, ""lines"": 12}, ""src/version.c"": {""insertions"": 2, ""deletions"": 0, ""lines"": 2}}"
2022-10-08 13:39:36,0089ce293f885afc2b77f12aa110f33b2101973a,Bram Moolenaar,13,2,15,3,"{""src/testdir/test_vim9_script.vim"": {""insertions"": 8, ""deletions"": 0, ""lines"": 8}, ""src/version.c"": {""insertions"": 2, ""deletions"": 0, ""lines"": 2}, ""src/vim9instr.c"": {""insertions"": 3, ""deletions"": 2, ""lines"": 5}}"
2022-10-08 12:50:05,4314e4f7da4db5d85f63cdf43b73be3689502c93,Yee Cheng Chin,264,35,299,14,"{""runtime/doc/builtin.txt"": {""insertions"": 3, ""deletions"": 0, ""lines"": 3}, ""src/configure.ac"": {""insertions"": 1, ""deletions"": 1, ""lines"": 2}, ""src/feature.h"": {""insertions"": 1, ""deletions"": 1, ""lines"": 2}, ""src/getchar.c"": {""insertions"": 4, ""deletions"": 0, ""lines"": 4}, ""src/os_macosx.m"": {""insertions"": 133, ""deletions"": 0, ""lines"": 133}, ""src/os_unix.c"": {""insertions"": 4, ""deletions"": 0, ""lines"": 4}, ""src/proto.h"": {""insertions"": 3, ""deletions"": 0, ""lines"": 3}, ""src/proto/os_macosx.pro"": {""insertions"": 7, ""deletions"": 0, ""lines"": 7}, ""src/proto/sound.pro"": {""insertions"": 4, ""deletions"": 0, ""lines"": 4}, ""src/sound.c"": {""insertions"": 84, ""deletions"": 26, ""lines"": 110}, ""src/testdir/test_sound.vim"": {""insertions"": 5, ""deletions"": 1, ""lines"": 6}, ""src/ui.c"": {""insertions"": 3, ""deletions"": 3, ""lines"": 6}, ""src/version.c"": {""insertions"": 2, ""deletions"": 0, ""lines"": 2}, ""src/vim.h"": {""insertions"": 10, ""deletions"": 3, ""lines"": 13}}"
2022-10-08 11:52:09,5a049846e4c54d70094c3f29ffbd340c75e9c50e,Bram Moolenaar,3,1,4,2,"{""src/filepath.c"": {""insertions"": 1, ""deletions"": 1, ""lines"": 2}, ""src/version.c"": {""insertions"": 2, ""deletions"": 0, ""lines"": 2}}"
2022-10-08 11:20:28,b7f52f5659c68b61ccc645ef866f8fd82361cd26,ObserverOfTime,6,0,6,3,"{""runtime/filetype.vim"": {""insertions"": 3, ""deletions"": 0, ""lines"": 3}, ""src/testdir/test_filetype.vim"": {""insertions"": 1, ""deletions"": 0, ""lines"": 1}, ""src/version.c"": {""insertions"": 2, ""deletions"": 0, ""lines"": 2}}"
2022-10-08 10:46:02,2b7b4f7670f607704307f7715ce56752757c22e3,Bram Moolenaar,45,36,81,2,"{""src/drawline.c"": {""insertions"": 43, ""deletions"": 36, ""lines"": 79}, ""src/version.c"": {""insertions"": 2, ""deletions"": 0, ""lines"": 2}}"
2022-10-08 10:16:40,a0789478f6ebbb823670b7e14ce13ea3fd3b0217,Bram Moolenaar,5,2,7,2,"{""src/drawline.c"": {""insertions"": 3, ""deletions"": 2, ""lines"": 5}, ""src/version.c"": {""insertions"": 2, ""deletions"": 0, ""lines"": 2}}"
2022-10-07 21:46:24,fcb86b0a99a9abedc408c99dae7591b6da832be8,Bram Moolenaar,4,0,4,2,"{""src/version.c"": {""insertions"": 2, ""deletions"": 0, ""lines"": 2}, ""src/vim9compile.c"": {""insertions"": 2, ""deletions"": 0, ""lines"": 2}}"
2022-10-07 17:51:23,33b55b562b90e5cc0091fa39d87cd60956c73f57,Bram Moolenaar,6,2,8,3,"{""src/ex_docmd.c"": {""insertions"": 4, ""deletions"": 1, ""lines"": 5}, ""src/testdir/test_debugger.vim"": {""insertions"": 0, ""deletions"": 1, ""lines"": 1}, ""src/version.c"": {""insertions"": 2, ""deletions"": 0, ""lines"": 2}}"
2022-10-07 16:26:22,5ab300195b0831cbdba3ce349416a0e6a218e4ef,Bram Moolenaar,59,53,112,5,"{""src/ex_cmds.h"": {""insertions"": 9, ""deletions"": 8, ""lines"": 17}, ""src/ex_docmd.c"": {""insertions"": 28, ""deletions"": 4, ""lines"": 32}, ""src/testdir/test_vim9_import.vim"": {""insertions"": 16, ""deletions"": 1, ""lines"": 17}, ""src/version.c"": {""insertions"": 2, ""deletions"": 0, ""lines"": 2}, ""src/vim9script.c"": {""insertions"": 4, ""deletions"": 40, ""lines"": 44}}"
2022-10-07 15:28:48,8d8b9758ced52b6303af95ad7e28ae9c5636cdf8,Anton Sharonov,9,0,9,2,"{""src/gui_w32.c"": {""insertions"": 7, ""deletions"": 0, ""lines"": 7}, ""src/version.c"": {""insertions"": 2, ""deletions"": 0, ""lines"": 2}}"
2022-10-07 15:00:04,07eaa1ede4a39b6a95203beebd94943b62a216c1,Yee Cheng Chin,6,2,8,2,"{""src/version.c"": {""insertions"": 2, ""deletions"": 0, ""lines"": 2}, ""src/vim9script.c"": {""insertions"": 4, ""deletions"": 2, ""lines"": 6}}"
2022-10-07 14:09:27,2eae3d24d7fe8beed64652bc5c1cbddd09dafc9a,Bram Moolenaar,6,1,7,3,"{""src/version.c"": {""insertions"": 2, ""deletions"": 0, ""lines"": 2}, ""src/vim9compile.c"": {""insertions"": 3, ""deletions"": 1, ""lines"": 4}, ""src/vim9instr.c"": {""insertions"": 1, ""deletions"": 0, ""lines"": 1}}"
2022-10-07 13:31:45,bdc09a18fca32715687d9911a431da69186528cc,Bram Moolenaar,147,25,172,21,"{""runtime/doc/builtin.txt"": {""insertions"": 1, ""deletions"": 0, ""lines"": 1}, ""runtime/doc/eval.txt"": {""insertions"": 4, ""deletions"": 1, ""lines"": 5}, ""runtime/doc/popup.txt"": {""insertions"": 6, ""deletions"": 0, ""lines"": 6}, ""runtime/doc/usr_41.txt"": {""insertions"": 1, ""deletions"": 0, ""lines"": 1}, ""src/eval.c"": {""insertions"": 1, ""deletions"": 1, ""lines"": 2}, ""src/evalfunc.c"": {""insertions"": 2, ""deletions"": 0, ""lines"": 2}, ""src/ex_cmds.h"": {""insertions"": 2, ""deletions"": 2, ""lines"": 4}, ""src/popupwin.c"": {""insertions"": 21, ""deletions"": 1, ""lines"": 22}, ""src/proto/popupwin.pro"": {""insertions"": 2, ""deletions"": 1, ""lines"": 3}, ""src/proto/vim9cmds.pro"": {""insertions"": 1, ""deletions"": 1, ""lines"": 2}, ""src/proto/vim9instr.pro"": {""insertions"": 1, ""deletions"": 0, ""lines"": 1}, ""src/testdir/dumps/Test_echowindow_8.dump"": {""insertions"": 1, ""deletions"": 1, ""lines"": 2}, ""src/testdir/dumps/Test_echowindow_9.dump"": {""insertions"": 8, ""deletions"": 0, ""lines"": 8}, ""src/testdir/test_messages.vim"": {""insertions"": 8, ""deletions"": 1, ""lines"": 9}, ""src/testdir/test_vim9_disassemble.vim"": {""insertions"": 4, ""deletions"": 0, ""lines"": 4}, ""src/version.c"": {""insertions"": 2, ""deletions"": 0, ""lines"": 2}, ""src/vim9.h"": {""insertions"": 7, ""deletions"": 0, ""lines"": 7}, ""src/vim9cmds.c"": {""insertions"": 10, ""deletions"": 8, ""lines"": 18}, ""src/vim9compile.c"": {""insertions"": 37, ""deletions"": 4, ""lines"": 41}, ""src/vim9execute.c"": {""insertions"": 14, ""deletions"": 4, ""lines"": 18}, ""src/vim9instr.c"": {""insertions"": 14, ""deletions"": 0, ""lines"": 14}}"
2022-10-07 10:20:29,cf3d0eaf47a56a52b355d8faf4e59685396f9c05,Bram Moolenaar,34,4,38,5,"{""src/proto/time.pro"": {""insertions"": 1, ""deletions"": 0, ""lines"": 1}, ""src/testdir/test_timers.vim"": {""insertions"": 14, ""deletions"": 0, ""lines"": 14}, ""src/time.c"": {""insertions"": 15, ""deletions"": 3, ""lines"": 18}, ""src/version.c"": {""insertions"": 2, ""deletions"": 0, ""lines"": 2}, ""src/window.c"": {""insertions"": 2, ""deletions"": 1, ""lines"": 3}}"
2022-10-06 20:24:34,0937b9fb244949b7ce9bfcf8398d7495b9b6aa85,Bram Moolenaar,11,4,15,4,"{""src/drawline.c"": {""insertions"": 7, ""deletions"": 2, ""lines"": 9}, ""src/testdir/test_breakindent.vim"": {""insertions"": 1, ""deletions"": 1, ""lines"": 2}, ""src/testdir/test_listlbr_utf8.vim"": {""insertions"": 1, ""deletions"": 1, ""lines"": 2}, ""src/version.c"": {""insertions"": 2, ""deletions"": 0, ""lines"": 2}}"
2022-10-06 19:48:00,3725116f6ec3b5c01e456b151a60c0690e04f76c,Bram Moolenaar,9,1,10,2,"{""src/drawline.c"": {""insertions"": 7, ""deletions"": 1, ""lines"": 8}, ""src/version.c"": {""insertions"": 2, ""deletions"": 0, ""lines"": 2}}"
2022-10-06 19:18:16,35b251d2c2c9d415887d334473669ea886117356,Bram Moolenaar,6,2,8,2,"{""src/drawline.c"": {""insertions"": 4, ""deletions"": 2, ""lines"": 6}, ""src/version.c"": {""insertions"": 2, ""deletions"": 0, ""lines"": 2}}"
2022-10-06 18:49:13,97f0eb169bf805c372b13c6bc9a03da2e75e3354,Bram Moolenaar,34,32,66,7,"{""src/testdir/script_util.vim"": {""insertions"": 3, ""deletions"": 3, ""lines"": 6}, ""src/testdir/test_cursorline.vim"": {""insertions"": 8, ""deletions"": 8, ""lines"": 16}, ""src/testdir/test_popup.vim"": {""insertions"": 2, ""deletions"": 2, ""lines"": 4}, ""src/testdir/test_prompt_buffer.vim"": {""insertions"": 1, ""deletions"": 1, ""lines"": 2}, ""src/testdir/test_vimscript.vim"": {""insertions"": 10, ""deletions"": 10, ""lines"": 20}, ""src/testdir/view_util.vim"": {""insertions"": 8, ""deletions"": 8, ""lines"": 16}, ""src/version.c"": {""insertions"": 2, ""deletions"": 0, ""lines"": 2}}"
2022-10-06 18:21:20,06618f94f1c9ed73a84ad5d6a8e1933b0b8da846,Bram Moolenaar,18,19,37,3,"{""src/drawline.c"": {""insertions"": 3, ""deletions"": 4, ""lines"": 7}, ""src/testdir/test_breakindent.vim"": {""insertions"": 13, ""deletions"": 15, ""lines"": 28}, ""src/version.c"": {""insertions"": 2, ""deletions"": 0, ""lines"": 2}}"
2022-10-06 15:56:44,d459020c62f945ca089a6f7349d559cc9db8596b,ichizok,6,17,23,2,"{"".cirrus.yml"": {""insertions"": 4, ""deletions"": 17, ""lines"": 21}, ""src/version.c"": {""insertions"": 2, ""deletions"": 0, ""lines"": 2}}"
2022-10-06 15:33:15,851907a7ab2db84e1e93c3f7ef417cc46c5c19c7,Bram Moolenaar,3,1,4,2,"{""src/testdir/dumps/Test_incsearch_substitute_12.dump"": {""insertions"": 1, ""deletions"": 1, ""lines"": 2}, ""src/version.c"": {""insertions"": 2, ""deletions"": 0, ""lines"": 2}}"
2022-10-06 15:03:09,4d31b48a114c106ec18ceaae9cfd084b8ca7faee,Bram Moolenaar,3,1,4,2,"{""src/move.c"": {""insertions"": 1, ""deletions"": 1, ""lines"": 2}, ""src/version.c"": {""insertions"": 2, ""deletions"": 0, ""lines"": 2}}"
2022-10-06 14:46:49,46b54747c5d252c584571a321231bad9330018ec,Bram Moolenaar,34,1,35,4,"{""src/move.c"": {""insertions"": 19, ""deletions"": 1, ""lines"": 20}, ""src/testdir/dumps/Test_smooth_wrap_5.dump"": {""insertions"": 8, ""deletions"": 0, ""lines"": 8}, ""src/testdir/test_scroll_opt.vim"": {""insertions"": 5, ""deletions"": 0, ""lines"": 5}, ""src/version.c"": {""insertions"": 2, ""deletions"": 0, ""lines"": 2}}"
2022-10-06 13:57:53,9bab7a024393200bb2c03b3abddfda86436990a7,Bram Moolenaar,69,0,69,7,"{""src/move.c"": {""insertions"": 10, ""deletions"": 0, ""lines"": 10}, ""src/testdir/dumps/Test_smooth_wrap_1.dump"": {""insertions"": 8, ""deletions"": 0, ""lines"": 8}, ""src/testdir/dumps/Test_smooth_wrap_2.dump"": {""insertions"": 8, ""deletions"": 0, ""lines"": 8}, ""src/testdir/dumps/Test_smooth_wrap_3.dump"": {""insertions"": 8, ""deletions"": 0, ""lines"": 8}, ""src/testdir/dumps/Test_smooth_wrap_4.dump"": {""insertions"": 8, ""deletions"": 0, ""lines"": 8}, ""src/testdir/test_scroll_opt.vim"": {""insertions"": 25, ""deletions"": 0, ""lines"": 25}, ""src/version.c"": {""insertions"": 2, ""deletions"": 0, ""lines"": 2}}"
2022-10-06 12:09:17,1a58e1d97cfc72e501cbf63ad75f46f1bb4c8da2,Bram Moolenaar,47,11,58,4,"{""src/move.c"": {""insertions"": 11, ""deletions"": 11, ""lines"": 22}, ""src/testdir/dumps/Test_smooth_diff_1.dump"": {""insertions"": 8, ""deletions"": 0, ""lines"": 8}, ""src/testdir/test_scroll_opt.vim"": {""insertions"": 26, ""deletions"": 0, ""lines"": 26}, ""src/version.c"": {""insertions"": 2, ""deletions"": 0, ""lines"": 2}}"
2022-10-06 10:39:06,c9f5f73206272ccad0aa536854debc5f9781978a,Bram Moolenaar,22,3,25,5,"{""src/option.c"": {""insertions"": 2, ""deletions"": 1, ""lines"": 3}, ""src/testdir/dumps/Test_cmdheight_tabline_1.dump"": {""insertions"": 6, ""deletions"": 0, ""lines"": 6}, ""src/testdir/test_cmdline.vim"": {""insertions"": 10, ""deletions"": 0, ""lines"": 10}, ""src/version.c"": {""insertions"": 2, ""deletions"": 0, ""lines"": 2}, ""src/window.c"": {""insertions"": 2, ""deletions"": 2, ""lines"": 4}}"
2022-10-05 20:45:30,db77cb3c08784e6038dd029271b2080c1b2d9acb,Bram Moolenaar,80,165,245,6,"{""src/testdir/test_quickfix.vim"": {""insertions"": 60, ""deletions"": 123, ""lines"": 183}, ""src/testdir/test_recover.vim"": {""insertions"": 10, ""deletions"": 21, ""lines"": 31}, ""src/testdir/test_regexp_utf8.vim"": {""insertions"": 2, ""deletions"": 5, ""lines"": 7}, ""src/testdir/test_rename.vim"": {""insertions"": 5, ""deletions"": 14, ""lines"": 19}, ""src/testdir/test_restricted.vim"": {""insertions"": 1, ""deletions"": 2, ""lines"": 3}, ""src/version.c"": {""insertions"": 2, ""deletions"": 0, ""lines"": 2}}"
2022-10-05 19:41:01,3ff71cda986b809e8ffeebee6804b50b3607df63,Philip H,19,2,21,2,"{"".cirrus.yml"": {""insertions"": 17, ""deletions"": 2, ""lines"": 19}, ""src/version.c"": {""insertions"": 2, ""deletions"": 0, ""lines"": 2}}"
2022-10-05 17:26:42,346823d3e5668b99d2c2fd920e7f215e21ad3ea7,Luuk van Baal,11,1,12,3,"{""src/testdir/test_window_cmd.vim"": {""insertions"": 7, ""deletions"": 0, ""lines"": 7}, ""src/version.c"": {""insertions"": 2, ""deletions"": 0, ""lines"": 2}, ""src/window.c"": {""insertions"": 2, ""deletions"": 1, ""lines"": 3}}"
2022-10-05 17:03:00,7beaf6a720ddc7e2989c8831872bfb98ec78a65d,Bram Moolenaar,164,128,292,3,"{""runtime/tools/unicode.vim"": {""insertions"": 2, ""deletions"": 1, ""lines"": 3}, ""src/mbyte.c"": {""insertions"": 160, ""deletions"": 127, ""lines"": 287}, ""src/version.c"": {""insertions"": 2, ""deletions"": 0, ""lines"": 2}}"
2022-10-05 14:42:32,0816f473ab2f6cf7d8311c0f97371cada7f20d18,Bram Moolenaar,28,3,31,5,"{""src/option.c"": {""insertions"": 3, ""deletions"": 2, ""lines"": 5}, ""src/testdir/dumps/Test_changing_cmdheight_6.dump"": {""insertions"": 8, ""deletions"": 0, ""lines"": 8}, ""src/testdir/test_cmdline.vim"": {""insertions"": 11, ""deletions"": 0, ""lines"": 11}, ""src/version.c"": {""insertions"": 2, ""deletions"": 0, ""lines"": 2}, ""src/window.c"": {""insertions"": 4, ""deletions"": 1, ""lines"": 5}}"
2022-10-05 12:29:15,f3ef026c9897f1d2e3fba47166a4771d507dae91,Bram Moolenaar,50,7,57,6,"{""src/change.c"": {""insertions"": 4, ""deletions"": 1, ""lines"": 5}, ""src/edit.c"": {""insertions"": 2, ""deletions"": 2, ""lines"": 4}, ""src/testdir/dumps/Test_spell_compatible_1.dump"": {""insertions"": 8, ""deletions"": 0, ""lines"": 8}, ""src/testdir/dumps/Test_spell_compatible_2.dump"": {""insertions"": 8, ""deletions"": 0, ""lines"": 8}, ""src/testdir/test_spell.vim"": {""insertions"": 26, ""deletions"": 4, ""lines"": 30}, ""src/version.c"": {""insertions"": 2, ""deletions"": 0, ""lines"": 2}}"
2022-10-05 10:24:46,d1955987147a299d7bca30cd1b5792535ff0745c,zeertzjq,13,24,37,7,"{""src/testdir/test_arglist.vim"": {""insertions"": 0, ""deletions"": 2, ""lines"": 2}, ""src/testdir/test_autocmd.vim"": {""insertions"": 11, ""deletions"": 14, ""lines"": 25}, ""src/testdir/test_cmdwin.vim"": {""insertions"": 0, ""deletions"": 2, ""lines"": 2}, ""src/testdir/test_tabpage.vim"": {""insertions"": 0, ""deletions"": 2, ""lines"": 2}, ""src/testdir/test_termcodes.vim"": {""insertions"": 0, ""deletions"": 2, ""lines"": 2}, ""src/testdir/test_window_cmd.vim"": {""insertions"": 0, ""deletions"": 2, ""lines"": 2}, ""src/version.c"": {""insertions"": 2, ""deletions"": 0, ""lines"": 2}}"
2022-10-04 21:40:56,75008661821eee6989476908feaf64a9dea03e05,Bram Moolenaar,38,2,40,4,"{""src/drawline.c"": {""insertions"": 2, ""deletions"": 2, ""lines"": 4}, ""src/testdir/dumps/Test_conceal_linebreak_1.dump"": {""insertions"": 8, ""deletions"": 0, ""lines"": 8}, ""src/testdir/test_conceal.vim"": {""insertions"": 26, ""deletions"": 0, ""lines"": 26}, ""src/version.c"": {""insertions"": 2, ""deletions"": 0, ""lines"": 2}}"
2022-10-04 19:35:37,18b3500b8c517e44c23197e558aa36aed1c6916c,zeertzjq,30,4,34,5,"{""src/drawscreen.c"": {""insertions"": 4, ""deletions"": 4, ""lines"": 8}, ""src/testdir/dumps/Test_display_lastline_6.dump"": {""insertions"": 10, ""deletions"": 0, ""lines"": 10}, ""src/testdir/dumps/Test_display_lastline_euro_6.dump"": {""insertions"": 10, ""deletions"": 0, ""lines"": 10}, ""src/testdir/test_display.vim"": {""insertions"": 4, ""deletions"": 0, ""lines"": 4}, ""src/version.c"": {""insertions"": 2, ""deletions"": 0, ""lines"": 2}}"
2022-10-04 19:14:28,2cd0f27b75c4497bec872819a965b3d6b4d55030,zeertzjq,26,1,27,3,"{""src/map.c"": {""insertions"": 5, ""deletions"": 1, ""lines"": 6}, ""src/testdir/test_gui.vim"": {""insertions"": 19, ""deletions"": 0, ""lines"": 19}, ""src/version.c"": {""insertions"": 2, ""deletions"": 0, ""lines"": 2}}"
2022-10-04 17:42:10,caf05f504e062642c35a919b04f1b5638f994602,Bram Moolenaar,3,1,4,2,"{""runtime/synmenu.vim"": {""insertions"": 1, ""deletions"": 1, ""lines"": 2}, ""src/version.c"": {""insertions"": 2, ""deletions"": 0, ""lines"": 2}}"
2022-10-04 15:50:21,351523f8938bcc77b68a55010338401436af8ec8,Bram Moolenaar,4,1,5,2,"{""src/version.c"": {""insertions"": 2, ""deletions"": 0, ""lines"": 2}, ""src/vim.h"": {""insertions"": 2, ""deletions"": 1, ""lines"": 3}}"
2022-10-04 15:28:45,7904fa420eb577274c4c3711295240100167d495,Martin Tournoij,151,315,466,46,"{"".appveyor.yml"": {""insertions"": 0, ""deletions"": 1, ""lines"": 1}, ""runtime/doc/cmdline.txt"": {""insertions"": 0, ""deletions"": 1, ""lines"": 1}, ""runtime/doc/various.txt"": {""insertions"": 2, ""deletions"": 2, ""lines"": 4}, ""src/INSTALLvms.txt"": {""insertions"": 1, ""deletions"": 3, ""lines"": 4}, ""src/Make_ami.mak"": {""insertions"": 2, ""deletions"": 2, ""lines"": 4}, ""src/Make_cyg_ming.mak"": {""insertions"": 2, ""deletions"": 2, ""lines"": 4}, ""src/Make_mvc.mak"": {""insertions"": 2, ""deletions"": 2, ""lines"": 4}, ""src/Make_vms.mms"": {""insertions"": 1, ""deletions"": 2, ""lines"": 3}, ""src/Makefile"": {""insertions"": 5, ""deletions"": 5, ""lines"": 10}, ""src/arglist.c"": {""insertions"": 0, ""deletions"": 2, ""lines"": 2}, ""src/auto/configure"": {""insertions"": 21, ""deletions"": 19, ""lines"": 40}, ""src/config.h.in"": {""insertions"": 0, ""deletions"": 3, ""lines"": 3}, ""src/configure.ac"": {""insertions"": 18, ""deletions"": 14, ""lines"": 32}, ""src/drawline.c"": {""insertions"": 1, ""deletions"": 7, ""lines"": 8}, ""src/drawscreen.c"": {""insertions"": 0, ""deletions"": 2, ""lines"": 2}, ""src/edit.c"": {""insertions"": 0, ""deletions"": 4, ""lines"": 4}, ""src/errors.h"": {""insertions"": 1, ""deletions"": 7, ""lines"": 8}, ""src/evalfunc.c"": {""insertions"": 1, ""deletions"": 7, ""lines"": 8}, ""src/evalwindow.c"": {""insertions"": 0, ""deletions"": 6, ""lines"": 6}, ""src/ex_cmds.c"": {""insertions"": 1, ""deletions"": 4, ""lines"": 5}, ""src/ex_docmd.c"": {""insertions"": 38, ""deletions"": 54, ""lines"": 92}, ""src/ex_getln.c"": {""insertions"": 2, ""deletions"": 20, ""lines"": 22}, ""src/feature.h"": {""insertions"": 18, ""deletions"": 16, ""lines"": 34}, ""src/getchar.c"": {""insertions"": 1, ""deletions"": 8, ""lines"": 9}, ""src/globals.h"": {""insertions"": 0, ""deletions"": 4, ""lines"": 4}, ""src/gui.c"": {""insertions"": 1, ""deletions"": 7, ""lines"": 8}, ""src/gui_gtk_x11.c"": {""insertions"": 1, ""deletions"": 5, ""lines"": 6}, ""src/gui_motif.c"": {""insertions"": 9, ""deletions"": 5, ""lines"": 14}, ""src/gui_w32.c"": {""insertions"": 1, ""deletions"": 5, ""lines"": 6}, ""src/if_mzsch.c"": {""insertions"": 1, ""deletions"": 1, ""lines"": 2}, ""src/insexpand.c"": {""insertions"": 0, ""deletions"": 2, ""lines"": 2}, ""src/main.c"": {""insertions"": 1, ""deletions"": 5, ""lines"": 6}, ""src/map.c"": {""insertions"": 0, ""deletions"": 3, ""lines"": 3}, ""src/mouse.c"": {""insertions"": 7, ""deletions"": 19, ""lines"": 26}, ""src/move.c"": {""insertions"": 0, ""deletions"": 2, ""lines"": 2}, ""src/normal.c"": {""insertions"": 2, ""deletions"": 16, ""lines"": 18}, ""src/option.c"": {""insertions"": 0, ""deletions"": 4, ""lines"": 4}, ""src/option.h"": {""insertions"": 0, ""deletions"": 2, ""lines"": 2}, ""src/optiondefs.h"": {""insertions"": 0, ""deletions"": 9, ""lines"": 9}, ""src/optionstr.c"": {""insertions"": 0, ""deletions"": 2, ""lines"": 2}, ""src/terminal.c"": {""insertions"": 0, ""deletions"": 2, ""lines"": 2}, ""src/testdir/Make_all.mak"": {""insertions"": 1, ""deletions"": 1, ""lines"": 2}, ""src/textformat.c"": {""insertions"": 0, ""deletions"": 2, ""lines"": 2}, ""src/version.c"": {""insertions"": 2, ""deletions"": 2, ""lines"": 4}, ""src/vim.h"": {""insertions"": 3, ""deletions"": 5, ""lines"": 8}, ""src/window.c"": {""insertions"": 5, ""deletions"": 19, ""lines"": 24}}"
2022-10-04 13:36:29,4ba5f1dab656103e8f4a4505452d1816b9e83c1e,Bram Moolenaar,120,24,144,17,"{""runtime/doc/options.txt"": {""insertions"": 5, ""deletions"": 0, ""lines"": 5}, ""src/drawscreen.c"": {""insertions"": 15, ""deletions"": 6, ""lines"": 21}, ""src/optiondefs.h"": {""insertions"": 2, ""deletions"": 1, ""lines"": 3}, ""src/screen.c"": {""insertions"": 3, ""deletions"": 1, ""lines"": 4}, ""src/structs.h"": {""insertions"": 1, ""deletions"": 0, ""lines"": 1}, ""src/testdir/dumps/Test_display_lastline_1.dump"": {""insertions"": 2, ""deletions"": 2, ""lines"": 4}, ""src/testdir/dumps/Test_display_lastline_2.dump"": {""insertions"": 2, ""deletions"": 2, ""lines"": 4}, ""src/testdir/dumps/Test_display_lastline_3.dump"": {""insertions"": 2, ""deletions"": 2, ""lines"": 4}, ""src/testdir/dumps/Test_display_lastline_4.dump"": {""insertions"": 2, ""deletions"": 2, ""lines"": 4}, ""src/testdir/dumps/Test_display_lastline_5.dump"": {""insertions"": 10, ""deletions"": 0, ""lines"": 10}, ""src/testdir/dumps/Test_display_lastline_euro_1.dump"": {""insertions"": 10, ""deletions"": 0, ""lines"": 10}, ""src/testdir/dumps/Test_display_lastline_euro_2.dump"": {""insertions"": 10, ""deletions"": 0, ""lines"": 10}, ""src/testdir/dumps/Test_display_lastline_euro_3.dump"": {""insertions"": 10, ""deletions"": 0, ""lines"": 10}, ""src/testdir/dumps/Test_display_lastline_euro_4.dump"": {""insertions"": 10, ""deletions"": 0, ""lines"": 10}, ""src/testdir/dumps/Test_display_lastline_euro_5.dump"": {""insertions"": 10, ""deletions"": 0, ""lines"": 10}, ""src/testdir/test_display.vim"": {""insertions"": 24, ""deletions"": 8, ""lines"": 32}, ""src/version.c"": {""insertions"": 2, ""deletions"": 0, ""lines"": 2}}"
2022-10-04 12:17:31,2f7e1b8b40dbc97752b8b816560f752f16e0207a,Bram Moolenaar,23,6,29,5,"{""src/os_unix.c"": {""insertions"": 2, ""deletions"": 1, ""lines"": 3}, ""src/os_win32.c"": {""insertions"": 1, ""deletions"": 1, ""lines"": 2}, ""src/proto/term.pro"": {""insertions"": 1, ""deletions"": 1, ""lines"": 2}, ""src/term.c"": {""insertions"": 17, ""deletions"": 3, ""lines"": 20}, ""src/version.c"": {""insertions"": 2, ""deletions"": 0, ""lines"": 2}}"
2022-10-03 21:10:37,ec32c781a282398e3da27f4aec4b03fcd20f8b0d,Bram Moolenaar,6,2,8,2,"{""src/testdir/test_breakindent.vim"": {""insertions"": 4, ""deletions"": 2, ""lines"": 6}, ""src/version.c"": {""insertions"": 2, ""deletions"": 0, ""lines"": 2}}"
2022-10-03 19:24:39,01c34e7d10e3dbd73d18a3dd79a48748c4147eaf,Bram Moolenaar,11,6,17,5,"{""src/os_unix.c"": {""insertions"": 1, ""deletions"": 1, ""lines"": 2}, ""src/os_win32.c"": {""insertions"": 1, ""deletions"": 1, ""lines"": 2}, ""src/proto/term.pro"": {""insertions"": 1, ""deletions"": 1, ""lines"": 2}, ""src/term.c"": {""insertions"": 6, ""deletions"": 3, ""lines"": 9}, ""src/version.c"": {""insertions"": 2, ""deletions"": 0, ""lines"": 2}}"
2022-10-03 19:01:16,b6aab8f44beb8c5d99393abdc2c9faab085c72aa,Bram Moolenaar,133,3,136,11,"{""src/drawline.c"": {""insertions"": 3, ""deletions"": 2, ""lines"": 5}, ""src/drawscreen.c"": {""insertions"": 20, ""deletions"": 0, ""lines"": 20}, ""src/move.c"": {""insertions"": 1, ""deletions"": 1, ""lines"": 2}, ""src/testdir/dumps/Test_smooth_number_1.dump"": {""insertions"": 12, ""deletions"": 0, ""lines"": 12}, ""src/testdir/dumps/Test_smooth_number_2.dump"": {""insertions"": 12, ""deletions"": 0, ""lines"": 12}, ""src/testdir/dumps/Test_smooth_number_3.dump"": {""insertions"": 12, ""deletions"": 0, ""lines"": 12}, ""src/testdir/dumps/Test_smooth_number_4.dump"": {""insertions"": 12, ""deletions"": 0, ""lines"": 12}, ""src/testdir/dumps/Test_smooth_number_5.dump"": {""insertions"": 12, ""deletions"": 0, ""lines"": 12}, ""src/testdir/dumps/Test_smooth_number_6.dump"": {""insertions"": 12, ""deletions"": 0, ""lines"": 12}, ""src/testdir/test_scroll_opt.vim"": {""insertions"": 35, ""deletions"": 0, ""lines"": 35}, ""src/version.c"": {""insertions"": 2, ""deletions"": 0, ""lines"": 2}}"
2022-10-03 17:04:35,f269eabc6c4f5bdcef989cd5b4b95ba8ccaa4d8a,Bram Moolenaar,281,187,468,22,"{""runtime/autoload/dist/vimindent.vim"": {""insertions"": 19, ""deletions"": 19, ""lines"": 38}, ""runtime/doc/builtin.txt"": {""insertions"": 20, ""deletions"": 11, ""lines"": 31}, ""runtime/doc/diff.txt"": {""insertions"": 1, ""deletions"": 1, ""lines"": 2}, ""runtime/doc/fold.txt"": {""insertions"": 5, ""deletions"": 2, ""lines"": 7}, ""runtime/doc/insert.txt"": {""insertions"": 8, ""deletions"": 7, ""lines"": 15}, ""runtime/doc/options.txt"": {""insertions"": 6, ""deletions"": 4, ""lines"": 10}, ""runtime/doc/os_vms.txt"": {""insertions"": 4, ""deletions"": 4, ""lines"": 8}, ""runtime/doc/print.txt"": {""insertions"": 1, ""deletions"": 1, ""lines"": 2}, ""runtime/doc/quickref.txt"": {""insertions"": 1, ""deletions"": 1, ""lines"": 2}, ""runtime/doc/syntax.txt"": {""insertions"": 6, ""deletions"": 5, ""lines"": 11}, ""runtime/doc/tags"": {""insertions"": 7, ""deletions"": 4, ""lines"": 11}, ""runtime/doc/todo.txt"": {""insertions"": 17, ""deletions"": 44, ""lines"": 61}, ""runtime/doc/vim9.txt"": {""insertions"": 7, ""deletions"": 7, ""lines"": 14}, ""runtime/ftplugin/erlang.vim"": {""insertions"": 23, ""deletions"": 1, ""lines"": 24}, ""runtime/ftplugin/man.vim"": {""insertions"": 4, ""deletions"": 3, ""lines"": 7}, ""runtime/indent/erlang.vim"": {""insertions"": 98, ""deletions"": 45, ""lines"": 143}, ""runtime/indent/testdir/vim.in"": {""insertions"": 12, ""deletions"": 0, ""lines"": 12}, ""runtime/indent/testdir/vim.ok"": {""insertions"": 12, ""deletions"": 0, ""lines"": 12}, ""runtime/optwin.vim"": {""insertions"": 1, ""deletions"": 1, ""lines"": 2}, ""runtime/plugin/manpager.vim"": {""insertions"": 2, ""deletions"": 5, ""lines"": 7}, ""runtime/syntax/erlang.vim"": {""insertions"": 11, ""deletions"": 6, ""lines"": 17}, ""runtime/syntax/vim.vim"": {""insertions"": 16, ""deletions"": 16, ""lines"": 32}}"
2022-10-03 16:45:55,eb47d6d20a47707d810360fd1684b21f67d5dec8,Bram Moolenaar,3,1,4,2,"{""src/drawline.c"": {""insertions"": 1, ""deletions"": 1, ""lines"": 2}, ""src/version.c"": {""insertions"": 2, ""deletions"": 0, ""lines"": 2}}"
2022-10-03 16:07:34,0466d398a550623126fba3a2a08208a798b28bda,Bram Moolenaar,17,15,32,6,"{""src/testdir/test_breakindent.vim"": {""insertions"": 10, ""deletions"": 10, ""lines"": 20}, ""src/testdir/test_display.vim"": {""insertions"": 1, ""deletions"": 1, ""lines"": 2}, ""src/testdir/test_listlbr.vim"": {""insertions"": 1, ""deletions"": 1, ""lines"": 2}, ""src/testdir/test_listlbr_utf8.vim"": {""insertions"": 2, ""deletions"": 2, ""lines"": 4}, ""src/testdir/test_number.vim"": {""insertions"": 1, ""deletions"": 1, ""lines"": 2}, ""src/version.c"": {""insertions"": 2, ""deletions"": 0, ""lines"": 2}}"
2022-10-03 15:44:12,406b5d89e18742ac6e6256ffc72fb70a27f0148b,Bram Moolenaar,38,13,51,6,"{""src/drawline.c"": {""insertions"": 32, ""deletions"": 9, ""lines"": 41}, ""src/testdir/dumps/Test_smoothscroll_2.dump"": {""insertions"": 1, ""deletions"": 1, ""lines"": 2}, ""src/testdir/dumps/Test_smoothscroll_3.dump"": {""insertions"": 1, ""deletions"": 1, ""lines"": 2}, ""src/testdir/dumps/Test_smoothscroll_5.dump"": {""insertions"": 1, ""deletions"": 1, ""lines"": 2}, ""src/testdir/dumps/Test_smoothscroll_6.dump"": {""insertions"": 1, ""deletions"": 1, ""lines"": 2}, ""src/version.c"": {""insertions"": 2, ""deletions"": 0, ""lines"": 2}}"
2022-10-03 15:05:28,0a016671b96ae7d27926e9d36dc11945c8f5749d,Yegappan Lakshmanan,91,49,140,3,"{""src/ex_cmds.c"": {""insertions"": 77, ""deletions"": 49, ""lines"": 126}, ""src/testdir/test_shell.vim"": {""insertions"": 12, ""deletions"": 0, ""lines"": 12}, ""src/version.c"": {""insertions"": 2, ""deletions"": 0, ""lines"": 2}}"
2022-10-03 14:28:08,13ece2ae1d09009d3fb8acf858c288e7848ecdac,Luuk van Baal,142,130,272,21,"{""runtime/doc/options.txt"": {""insertions"": 16, ""deletions"": 12, ""lines"": 28}, ""runtime/doc/quickref.txt"": {""insertions"": 1, ""deletions"": 1, ""lines"": 2}, ""runtime/optwin.vim"": {""insertions"": 2, ""deletions"": 2, ""lines"": 4}, ""src/globals.h"": {""insertions"": 2, ""deletions"": 2, ""lines"": 4}, ""src/move.c"": {""insertions"": 5, ""deletions"": 2, ""lines"": 7}, ""src/option.h"": {""insertions"": 1, ""deletions"": 1, ""lines"": 2}, ""src/optiondefs.h"": {""insertions"": 3, ""deletions"": 3, ""lines"": 6}, ""src/optionstr.c"": {""insertions"": 9, ""deletions"": 1, ""lines"": 10}, ""src/structs.h"": {""insertions"": 2, ""deletions"": 2, ""lines"": 4}, ""src/testdir/dumps/{Test_nosplitscroll_callback_1.dump => Test_splitkeep_callback_1.dump}"": {""insertions"": 0, ""deletions"": 0, ""lines"": 0}, ""src/testdir/dumps/{Test_nosplitscroll_callback_2.dump => Test_splitkeep_callback_2.dump}"": {""insertions"": 0, ""deletions"": 0, ""lines"": 0}, ""src/testdir/dumps/{Test_nosplitscroll_callback_3.dump => Test_splitkeep_callback_3.dump}"": {""insertions"": 0, ""deletions"": 0, ""lines"": 0}, ""src/testdir/dumps/{Test_nosplitscroll_callback_4.dump => Test_splitkeep_callback_4.dump}"": {""insertions"": 0, ""deletions"": 0, ""lines"": 0}, ""src/testdir/dumps/{Test_nosplitscroll_fold_1.dump => Test_splitkeep_fold_1.dump}"": {""insertions"": 0, ""deletions"": 0, ""lines"": 0}, ""src/testdir/dumps/{Test_nosplitscroll_fold_2.dump => Test_splitkeep_fold_2.dump}"": {""insertions"": 0, ""deletions"": 0, ""lines"": 0}, ""src/testdir/dumps/{Test_nosplitscroll_fold_3.dump => Test_splitkeep_fold_3.dump}"": {""insertions"": 0, ""deletions"": 0, ""lines"": 0}, ""src/testdir/dumps/{Test_nosplitscroll_fold_4.dump => Test_splitkeep_fold_4.dump}"": {""insertions"": 0, ""deletions"": 0, ""lines"": 0}, ""src/testdir/gen_opt_test.vim"": {""insertions"": 1, ""deletions"": 0, ""lines"": 1}, ""src/testdir/test_window_cmd.vim"": {""insertions"": 70, ""deletions"": 72, ""lines"": 142}, ""src/version.c"": {""insertions"": 2, ""deletions"": 0, ""lines"": 2}, ""src/window.c"": {""insertions"": 28, ""deletions"": 32, ""lines"": 60}}"
2022-10-03 13:06:02,6b2d4ff7148e0b416ba745d20d061e6f7bb53ee7,Bram Moolenaar,77,53,130,3,"{""src/move.c"": {""insertions"": 60, ""deletions"": 53, ""lines"": 113}, ""src/testdir/test_scroll_opt.vim"": {""insertions"": 15, ""deletions"": 0, ""lines"": 15}, ""src/version.c"": {""insertions"": 2, ""deletions"": 0, ""lines"": 2}}"
2022-10-03 11:11:13,8df9748edb2ac8bd025e34e06194ac210667c97a,Bram Moolenaar,21,2,23,3,"{""src/move.c"": {""insertions"": 6, ""deletions"": 2, ""lines"": 8}, ""src/testdir/test_scroll_opt.vim"": {""insertions"": 13, ""deletions"": 0, ""lines"": 13}, ""src/version.c"": {""insertions"": 2, ""deletions"": 0, ""lines"": 2}}"
2022-10-03 10:23:02,b1fd26d208aadc96d3e8b9215f761150f40a9f91,Bram Moolenaar,106,1,107,3,"{""src/option.c"": {""insertions"": 1, ""deletions"": 0, ""lines"": 1}, ""src/testdir/test_options.vim"": {""insertions"": 103, ""deletions"": 1, ""lines"": 104}, ""src/version.c"": {""insertions"": 2, ""deletions"": 0, ""lines"": 2}}"
2022-10-02 21:32:08,b34c4b7863af8718ad726173585dd38a7c292f0f,Bram Moolenaar,4,0,4,2,"{""src/normal.c"": {""insertions"": 2, ""deletions"": 0, ""lines"": 2}, ""src/version.c"": {""insertions"": 2, ""deletions"": 0, ""lines"": 2}}"
2022-10-02 21:10:25,693729ae58bd30fc1a4c08042ebe9923b45f5763,Bram Moolenaar,3,1,4,2,"{""src/drawline.c"": {""insertions"": 1, ""deletions"": 1, ""lines"": 2}, ""src/version.c"": {""insertions"": 2, ""deletions"": 0, ""lines"": 2}}"
2022-10-02 20:46:58,bbbda8fd81f6d720962b67ae885825bad9be4456,Bram Moolenaar,3,0,3,2,"{""src/option.h"": {""insertions"": 1, ""deletions"": 0, ""lines"": 1}, ""src/version.c"": {""insertions"": 2, ""deletions"": 0, ""lines"": 2}}"
2022-10-02 20:29:55,f6196f424474e2a9c160f2a995fc2691f82b58f9,Bram Moolenaar,312,29,341,18,"{""runtime/doc/options.txt"": {""insertions"": 8, ""deletions"": 0, ""lines"": 8}, ""runtime/doc/quickref.txt"": {""insertions"": 1, ""deletions"": 0, ""lines"": 1}, ""runtime/optwin.vim"": {""insertions"": 3, ""deletions"": 0, ""lines"": 3}, ""src/drawline.c"": {""insertions"": 8, ""deletions"": 8, ""lines"": 16}, ""src/move.c"": {""insertions"": 127, ""deletions"": 17, ""lines"": 144}, ""src/option.c"": {""insertions"": 10, ""deletions"": 0, ""lines"": 10}, ""src/optiondefs.h"": {""insertions"": 4, ""deletions"": 0, ""lines"": 4}, ""src/structs.h"": {""insertions"": 6, ""deletions"": 3, ""lines"": 9}, ""src/testdir/dumps/Test_smoothscroll_1.dump"": {""insertions"": 12, ""deletions"": 0, ""lines"": 12}, ""src/testdir/dumps/Test_smoothscroll_2.dump"": {""insertions"": 12, ""deletions"": 0, ""lines"": 12}, ""src/testdir/dumps/Test_smoothscroll_3.dump"": {""insertions"": 12, ""deletions"": 0, ""lines"": 12}, ""src/testdir/dumps/Test_smoothscroll_4.dump"": {""insertions"": 12, ""deletions"": 0, ""lines"": 12}, ""src/testdir/dumps/Test_smoothscroll_5.dump"": {""insertions"": 12, ""deletions"": 0, ""lines"": 12}, ""src/testdir/dumps/Test_smoothscroll_6.dump"": {""insertions"": 12, ""deletions"": 0, ""lines"": 12}, ""src/testdir/dumps/Test_smoothscroll_7.dump"": {""insertions"": 12, ""deletions"": 0, ""lines"": 12}, ""src/testdir/dumps/Test_smoothscroll_8.dump"": {""insertions"": 12, ""deletions"": 0, ""lines"": 12}, ""src/testdir/test_scroll_opt.vim"": {""insertions"": 47, ""deletions"": 1, ""lines"": 48}, ""src/version.c"": {""insertions"": 2, ""deletions"": 0, ""lines"": 2}}"
2022-10-02 14:21:04,ff85d4a1076dc7d6fc3102f6560df3ad1af696ae,Bram Moolenaar,28,31,59,2,"{""src/screen.c"": {""insertions"": 26, ""deletions"": 31, ""lines"": 57}, ""src/version.c"": {""insertions"": 2, ""deletions"": 0, ""lines"": 2}}"
2022-10-02 13:28:30,393f8d61f55cb6127a100e812ba4d66097a32d2e,Bram Moolenaar,114,17,131,7,"{""src/screen.c"": {""insertions"": 25, ""deletions"": 17, ""lines"": 42}, ""src/testdir/dumps/Test_pum_preview_1.dump"": {""insertions"": 12, ""deletions"": 0, ""lines"": 12}, ""src/testdir/dumps/Test_pum_preview_2.dump"": {""insertions"": 12, ""deletions"": 0, ""lines"": 12}, ""src/testdir/dumps/Test_pum_preview_3.dump"": {""insertions"": 12, ""deletions"": 0, ""lines"": 12}, ""src/testdir/dumps/Test_pum_preview_4.dump"": {""insertions"": 12, ""deletions"": 0, ""lines"": 12}, ""src/testdir/test_popupwin.vim"": {""insertions"": 39, ""deletions"": 0, ""lines"": 39}, ""src/version.c"": {""insertions"": 2, ""deletions"": 0, ""lines"": 2}}"
2022-10-02 11:59:00,eda29c971c0592d85c5856da7708f3edfdc54cfa,Bram Moolenaar,39,24,63,6,"{""src/errors.h"": {""insertions"": 2, ""deletions"": 0, ""lines"": 2}, ""src/ex_docmd.c"": {""insertions"": 10, ""deletions"": 24, ""lines"": 34}, ""src/testdir/Make_all.mak"": {""insertions"": 2, ""deletions"": 0, ""lines"": 2}, ""src/testdir/test10.in"": {""insertions"": 21, ""deletions"": 0, ""lines"": 21}, ""src/testdir/test10.ok"": {""insertions"": 2, ""deletions"": 0, ""lines"": 2}, ""src/version.c"": {""insertions"": 2, ""deletions"": 0, ""lines"": 2}}"
2022-10-01 20:22:17,b393275ae91eb9a8df7a9a611bd75590db9b22db,Bram Moolenaar,7,2,9,2,"{""src/term.c"": {""insertions"": 5, ""deletions"": 2, ""lines"": 7}, ""src/version.c"": {""insertions"": 2, ""deletions"": 0, ""lines"": 2}}"
2022-10-01 19:17:17,3292a229402c9892f5ab90645fbfe2b1db342f5b,Bram Moolenaar,5,3,8,3,"{""src/if_cscope.c"": {""insertions"": 2, ""deletions"": 2, ""lines"": 4}, ""src/indent.c"": {""insertions"": 1, ""deletions"": 1, ""lines"": 2}, ""src/version.c"": {""insertions"": 2, ""deletions"": 0, ""lines"": 2}}"
2022-10-01 18:43:52,a4e0b9785e409e9e660171cea76dfcc5fdafad9b,Bram Moolenaar,174,74,248,24,"{""runtime/doc/diff.txt"": {""insertions"": 6, ""deletions"": 0, ""lines"": 6}, ""runtime/doc/options.txt"": {""insertions"": 19, ""deletions"": 5, ""lines"": 24}, ""runtime/doc/print.txt"": {""insertions"": 7, ""deletions"": 4, ""lines"": 11}, ""src/beval.c"": {""insertions"": 1, ""deletions"": 1, ""lines"": 2}, ""src/buffer.c"": {""insertions"": 2, ""deletions"": 2, ""lines"": 4}, ""src/clientserver.c"": {""insertions"": 1, ""deletions"": 1, ""lines"": 2}, ""src/eval.c"": {""insertions"": 97, ""deletions"": 32, ""lines"": 129}, ""src/evalvars.c"": {""insertions"": 10, ""deletions"": 6, ""lines"": 16}, ""src/ex_docmd.c"": {""insertions"": 1, ""deletions"": 1, ""lines"": 2}, ""src/ex_eval.c"": {""insertions"": 3, ""deletions"": 3, ""lines"": 6}, ""src/filepath.c"": {""insertions"": 1, ""deletions"": 1, ""lines"": 2}, ""src/findfile.c"": {""insertions"": 2, ""deletions"": 1, ""lines"": 3}, ""src/fold.c"": {""insertions"": 2, ""deletions"": 1, ""lines"": 3}, ""src/if_ole.cpp"": {""insertions"": 1, ""deletions"": 1, ""lines"": 2}, ""src/if_perl.xs"": {""insertions"": 3, ""deletions"": 2, ""lines"": 5}, ""src/if_tcl.c"": {""insertions"": 1, ""deletions"": 1, ""lines"": 2}, ""src/map.c"": {""insertions"": 1, ""deletions"": 1, ""lines"": 2}, ""src/proto/eval.pro"": {""insertions"": 8, ""deletions"": 5, ""lines"": 13}, ""src/regexp.c"": {""insertions"": 1, ""deletions"": 1, ""lines"": 2}, ""src/register.c"": {""insertions"": 1, ""deletions"": 1, ""lines"": 2}, ""src/screen.c"": {""insertions"": 2, ""deletions"": 2, ""lines"": 4}, ""src/scriptfile.c"": {""insertions"": 1, ""deletions"": 1, ""lines"": 2}, ""src/textformat.c"": {""insertions"": 1, ""deletions"": 1, ""lines"": 2}, ""src/version.c"": {""insertions"": 2, ""deletions"": 0, ""lines"": 2}}"
2022-10-01 14:47:04,b850c39676db21c6f1aa3afed0e2e48d407dd60e,rbtnn,3,1,4,2,"{""src/gui_gtk_x11.c"": {""insertions"": 1, ""deletions"": 1, ""lines"": 2}, ""src/version.c"": {""insertions"": 2, ""deletions"": 0, ""lines"": 2}}"
2022-10-01 14:32:46,87b4e5c5db9d1cfd6f2e79656e1a6cff3c69d15f,Bram Moolenaar,144,11,155,8,"{""runtime/doc/fold.txt"": {""insertions"": 4, ""deletions"": 2, ""lines"": 6}, ""runtime/doc/vim9.txt"": {""insertions"": 15, ""deletions"": 0, ""lines"": 15}, ""src/eval.c"": {""insertions"": 17, ""deletions"": 2, ""lines"": 19}, ""src/proto/userfunc.pro"": {""insertions"": 2, ""deletions"": 1, ""lines"": 3}, ""src/testdir/test_fold.vim"": {""insertions"": 25, ""deletions"": 0, ""lines"": 25}, ""src/userfunc.c"": {""insertions"": 76, ""deletions"": 4, ""lines"": 80}, ""src/version.c"": {""insertions"": 2, ""deletions"": 0, ""lines"": 2}, ""src/vim9execute.c"": {""insertions"": 3, ""deletions"": 2, ""lines"": 5}}"
2022-09-30 20:57:11,145d1fd91041bd2a22a11eef0357702e420796e2,Bram Moolenaar,95,183,278,11,"{""src/testdir/test_options.vim"": {""insertions"": 6, ""deletions"": 11, ""lines"": 17}, ""src/testdir/test_packadd.vim"": {""insertions"": 0, ""deletions"": 1, ""lines"": 1}, ""src/testdir/test_paste.vim"": {""insertions"": 3, ""deletions"": 6, ""lines"": 9}, ""src/testdir/test_plus_arg_edit.vim"": {""insertions"": 3, ""deletions"": 6, ""lines"": 9}, ""src/testdir/test_popupwin.vim"": {""insertions"": 60, ""deletions"": 123, ""lines"": 183}, ""src/testdir/test_popupwin_textprop.vim"": {""insertions"": 3, ""deletions"": 6, ""lines"": 9}, ""src/testdir/test_preview.vim"": {""insertions"": 1, ""deletions"": 2, ""lines"": 3}, ""src/testdir/test_profile.vim"": {""insertions"": 13, ""deletions"": 22, ""lines"": 35}, ""src/testdir/test_prompt_buffer.vim"": {""insertions"": 1, ""deletions"": 2, ""lines"": 3}, ""src/testdir/test_python3.vim"": {""insertions"": 3, ""deletions"": 4, ""lines"": 7}, ""src/version.c"": {""insertions"": 2, ""deletions"": 0, ""lines"": 2}}"
2022-09-30 18:19:04,cfb4d4f312e740c2fbb70c29c47cf74a76f8b605,Bram Moolenaar,23,1,24,3,"{""src/testdir/test_vim9_func.vim"": {""insertions"": 19, ""deletions"": 0, ""lines"": 19}, ""src/userfunc.c"": {""insertions"": 2, ""deletions"": 1, ""lines"": 3}, ""src/version.c"": {""insertions"": 2, ""deletions"": 0, ""lines"": 2}}"
2022-09-30 16:57:47,a5d1a67bee5672786c4b172f66ae4391e7b0cc57,Bram Moolenaar,136,11,147,3,"{""src/evalfunc.c"": {""insertions"": 55, ""deletions"": 10, ""lines"": 65}, ""src/testdir/test_vim9_builtin.vim"": {""insertions"": 79, ""deletions"": 1, ""lines"": 80}, ""src/version.c"": {""insertions"": 2, ""deletions"": 0, ""lines"": 2}}"
2022-09-30 11:00:06,d0121c63cfb0922a7048ece3efe994df6f444bed,Bram Moolenaar,8,11,19,2,"{""src/version.c"": {""insertions"": 2, ""deletions"": 0, ""lines"": 2}, ""src/vim9type.c"": {""insertions"": 6, ""deletions"": 11, ""lines"": 17}}"
2022-09-30 10:04:50,6586a015144f15a979d573a79d91e700e4b3009f,Bram Moolenaar,36,11,47,6,"{""src/testdir/test_vim9_builtin.vim"": {""insertions"": 14, ""deletions"": 0, ""lines"": 14}, ""src/version.c"": {""insertions"": 2, ""deletions"": 0, ""lines"": 2}, ""src/vim.h"": {""insertions"": 1, ""deletions"": 0, ""lines"": 1}, ""src/vim9.h"": {""insertions"": 3, ""deletions"": 1, ""lines"": 4}, ""src/vim9cmds.c"": {""insertions"": 5, ""deletions"": 4, ""lines"": 9}, ""src/vim9compile.c"": {""insertions"": 11, ""deletions"": 6, ""lines"": 17}}"
2022-09-29 20:37:33,b152b6a40f729ed81a25d2fa541a4e73e201bec4,Bram Moolenaar,52,96,148,11,"{""src/testdir/test_mapping.vim"": {""insertions"": 7, ""deletions"": 14, ""lines"": 21}, ""src/testdir/test_match.vim"": {""insertions"": 3, ""deletions"": 6, ""lines"": 9}, ""src/testdir/test_matchadd_conceal.vim"": {""insertions"": 2, ""deletions"": 4, ""lines"": 6}, ""src/testdir/test_memory_usage.vim"": {""insertions"": 2, ""deletions"": 4, ""lines"": 6}, ""src/testdir/test_messages.vim"": {""insertions"": 7, ""deletions"": 10, ""lines"": 17}, ""src/testdir/test_mksession.vim"": {""insertions"": 2, ""deletions"": 4, ""lines"": 6}, ""src/testdir/test_modeline.vim"": {""insertions"": 10, ""deletions"": 20, ""lines"": 30}, ""src/testdir/test_netbeans.vim"": {""insertions"": 6, ""deletions"": 12, ""lines"": 18}, ""src/testdir/test_normal.vim"": {""insertions"": 9, ""deletions"": 18, ""lines"": 27}, ""src/testdir/test_number.vim"": {""insertions"": 2, ""deletions"": 4, ""lines"": 6}, ""src/version.c"": {""insertions"": 2, ""deletions"": 0, ""lines"": 2}}"
2022-09-29 20:01:57,7dd5a78b88af7734bdbf236fdfafb49f27a0ca2e,Bram Moolenaar,47,80,127,10,"{""src/testdir/test_iminsert.vim"": {""insertions"": 1, ""deletions"": 2, ""lines"": 3}, ""src/testdir/test_indent.vim"": {""insertions"": 1, ""deletions"": 2, ""lines"": 3}, ""src/testdir/test_ins_complete.vim"": {""insertions"": 24, ""deletions"": 38, ""lines"": 62}, ""src/testdir/test_jumplist.vim"": {""insertions"": 1, ""deletions"": 3, ""lines"": 4}, ""src/testdir/test_lambda.vim"": {""insertions"": 1, ""deletions"": 2, ""lines"": 3}, ""src/testdir/test_let.vim"": {""insertions"": 5, ""deletions"": 10, ""lines"": 15}, ""src/testdir/test_listchars.vim"": {""insertions"": 1, ""deletions"": 2, ""lines"": 3}, ""src/testdir/test_lua.vim"": {""insertions"": 2, ""deletions"": 5, ""lines"": 7}, ""src/testdir/test_popup.vim"": {""insertions"": 9, ""deletions"": 16, ""lines"": 25}, ""src/version.c"": {""insertions"": 2, ""deletions"": 0, ""lines"": 2}}"
2022-09-29 19:23:35,ac38ec7c7f7cb0ab94397dc19bd72b0a84afdbe5,Bram Moolenaar,6,7,13,2,"{""src/version.c"": {""insertions"": 2, ""deletions"": 0, ""lines"": 2}, ""src/vim9type.c"": {""insertions"": 4, ""deletions"": 7, ""lines"": 11}}"
2022-09-29 18:14:42,fa1039760e8c1a0c7a2a722160bd3d71a4736e61,Bram Moolenaar,454,70,524,12,"{""src/errors.h"": {""insertions"": 2, ""deletions"": 0, ""lines"": 2}, ""src/evalfunc.c"": {""insertions"": 47, ""deletions"": 3, ""lines"": 50}, ""src/globals.h"": {""insertions"": 291, ""deletions"": 55, ""lines"": 346}, ""src/proto/evalfunc.pro"": {""insertions"": 1, ""deletions"": 0, ""lines"": 1}, ""src/proto/vim9type.pro"": {""insertions"": 1, ""deletions"": 0, ""lines"": 1}, ""src/structs.h"": {""insertions"": 4, ""deletions"": 4, ""lines"": 8}, ""src/testdir/test_vim9_builtin.vim"": {""insertions"": 38, ""deletions"": 0, ""lines"": 38}, ""src/testdir/test_vim9_script.vim"": {""insertions"": 3, ""deletions"": 2, ""lines"": 5}, ""src/version.c"": {""insertions"": 2, ""deletions"": 0, ""lines"": 2}, ""src/vim9compile.c"": {""insertions"": 36, ""deletions"": 5, ""lines"": 41}, ""src/vim9instr.c"": {""insertions"": 5, ""deletions"": 1, ""lines"": 6}, ""src/vim9type.c"": {""insertions"": 24, ""deletions"": 0, ""lines"": 24}}"
2022-09-29 12:50:08,9f573a8df02d9f699a43d2afbd1d2841d700b9ad,Bram Moolenaar,26,27,53,5,"{""runtime/doc/builtin.txt"": {""insertions"": 1, ""deletions"": 1, ""lines"": 2}, ""src/match.c"": {""insertions"": 15, ""deletions"": 17, ""lines"": 32}, ""src/testdir/test_match.vim"": {""insertions"": 7, ""deletions"": 7, ""lines"": 14}, ""src/version.c"": {""insertions"": 2, ""deletions"": 0, ""lines"": 2}, ""src/window.c"": {""insertions"": 1, ""deletions"": 2, ""lines"": 3}}"
2022-09-29 12:07:18,fc06cda8379031890ee8852cdca61eb8af8e1ba2,Dominique Pelle,3,1,4,2,"{""src/testdir/test_filetype.vim"": {""insertions"": 1, ""deletions"": 1, ""lines"": 2}, ""src/version.c"": {""insertions"": 2, ""deletions"": 0, ""lines"": 2}}"
2022-09-29 11:50:17,50faf02f43d7f1a56ec2023028fca7c72dbce83e,Bram Moolenaar,184,145,329,7,"{""runtime/doc/builtin.txt"": {""insertions"": 0, ""deletions"": 2, ""lines"": 2}, ""src/drawscreen.c"": {""insertions"": 3, ""deletions"": 3, ""lines"": 6}, ""src/match.c"": {""insertions"": 130, ""deletions"": 113, ""lines"": 243}, ""src/structs.h"": {""insertions"": 20, ""deletions"": 27, ""lines"": 47}, ""src/testdir/dumps/Test_matchaddpos_1.dump"": {""insertions"": 14, ""deletions"": 0, ""lines"": 14}, ""src/testdir/test_match.vim"": {""insertions"": 15, ""deletions"": 0, ""lines"": 15}, ""src/version.c"": {""insertions"": 2, ""deletions"": 0, ""lines"": 2}}"
2022-09-28 20:07:03,572a4433c8276d8e8f228a09f43b11afe0c85f6f,Bram Moolenaar,33,61,94,6,"{""src/testdir/test_gf.vim"": {""insertions"": 10, ""deletions"": 16, ""lines"": 26}, ""src/testdir/test_global.vim"": {""insertions"": 1, ""deletions"": 2, ""lines"": 3}, ""src/testdir/test_gui.vim"": {""insertions"": 7, ""deletions"": 16, ""lines"": 23}, ""src/testdir/test_help.vim"": {""insertions"": 4, ""deletions"": 9, ""lines"": 13}, ""src/testdir/test_highlight.vim"": {""insertions"": 9, ""deletions"": 18, ""lines"": 27}, ""src/version.c"": {""insertions"": 2, ""deletions"": 0, ""lines"": 2}}"
2022-09-28 15:16:15,82418263fa91792e851cb0de879d1595327d5531,Bram Moolenaar,94,27,121,10,"{""src/blob.c"": {""insertions"": 10, ""deletions"": 4, ""lines"": 14}, ""src/dict.c"": {""insertions"": 8, ""deletions"": 3, ""lines"": 11}, ""src/eval.c"": {""insertions"": 33, ""deletions"": 4, ""lines"": 37}, ""src/evalfunc.c"": {""insertions"": 1, ""deletions"": 1, ""lines"": 2}, ""src/filepath.c"": {""insertions"": 1, ""deletions"": 1, ""lines"": 2}, ""src/list.c"": {""insertions"": 20, ""deletions"": 8, ""lines"": 28}, ""src/proto/eval.pro"": {""insertions"": 2, ""deletions"": 1, ""lines"": 3}, ""src/proto/list.pro"": {""insertions"": 1, ""deletions"": 1, ""lines"": 2}, ""src/strings.c"": {""insertions"": 16, ""deletions"": 4, ""lines"": 20}, ""src/version.c"": {""insertions"": 2, ""deletions"": 0, ""lines"": 2}}"
2022-09-28 14:19:10,1936c765364d6a771cea5df9971318060db82730,Bram Moolenaar,14,5,19,3,"{""src/list.c"": {""insertions"": 3, ""deletions"": 1, ""lines"": 4}, ""src/version.c"": {""insertions"": 2, ""deletions"": 0, ""lines"": 2}, ""src/vim9execute.c"": {""insertions"": 9, ""deletions"": 4, ""lines"": 13}}"
2022-09-28 13:08:23,371951d0c34d4f44b50ad8bc8d30a4ef7effade6,Bram Moolenaar,3,1,4,2,"{""src/testdir/test_spell.vim"": {""insertions"": 1, ""deletions"": 1, ""lines"": 2}, ""src/version.c"": {""insertions"": 2, ""deletions"": 0, ""lines"": 2}}"
2022-09-28 12:22:59,52df40eb04726f9ee3c54ef8f7d856f1254b191a,Bram Moolenaar,52,12,64,3,"{""src/list.c"": {""insertions"": 43, ""deletions"": 12, ""lines"": 55}, ""src/testdir/test_listdict.vim"": {""insertions"": 7, ""deletions"": 0, ""lines"": 7}, ""src/version.c"": {""insertions"": 2, ""deletions"": 0, ""lines"": 2}}"
2022-09-28 10:48:30,ef976323e770315b5fca544efb6b2faa25674d15,Bram Moolenaar,24,1,25,4,"{""src/buffer.c"": {""insertions"": 6, ""deletions"": 1, ""lines"": 7}, ""src/spell.c"": {""insertions"": 6, ""deletions"": 0, ""lines"": 6}, ""src/testdir/test_autocmd.vim"": {""insertions"": 10, ""deletions"": 0, ""lines"": 10}, ""src/version.c"": {""insertions"": 2, ""deletions"": 0, ""lines"": 2}}"
2022-09-28 09:45:15,caa1d19da1cdfd07f93b578b4fd5214a53197cd6,Dominique Pelle,10,15,25,2,"{""src/testdir/test_source.vim"": {""insertions"": 8, ""deletions"": 15, ""lines"": 23}, ""src/version.c"": {""insertions"": 2, ""deletions"": 0, ""lines"": 2}}"
2022-09-27 21:18:13,47da934844afec7b04d94e0d1f8cf0a86e1b9bea,Bram Moolenaar,15,12,27,2,"{""src/testdir/test_blockedit.vim"": {""insertions"": 13, ""deletions"": 12, ""lines"": 25}, ""src/version.c"": {""insertions"": 2, ""deletions"": 0, ""lines"": 2}}"
2022-09-27 18:34:35,70e672580b39eb79607c304803efb954cc11f4e6,Bram Moolenaar,70,135,205,10,"{""src/testdir/test_file_perm.vim"": {""insertions"": 11, ""deletions"": 12, ""lines"": 23}, ""src/testdir/test_filechanged.vim"": {""insertions"": 5, ""deletions"": 8, ""lines"": 13}, ""src/testdir/test_fileformat.vim"": {""insertions"": 5, ""deletions"": 10, ""lines"": 15}, ""src/testdir/test_filetype.vim"": {""insertions"": 32, ""deletions"": 64, ""lines"": 96}, ""src/testdir/test_find_complete.vim"": {""insertions"": 1, ""deletions"": 2, ""lines"": 3}, ""src/testdir/test_findfile.vim"": {""insertions"": 1, ""deletions"": 5, ""lines"": 6}, ""src/testdir/test_fold.vim"": {""insertions"": 4, ""deletions"": 8, ""lines"": 12}, ""src/testdir/test_function_lists.vim"": {""insertions"": 0, ""deletions"": 6, ""lines"": 6}, ""src/testdir/test_functions.vim"": {""insertions"": 9, ""deletions"": 20, ""lines"": 29}, ""src/version.c"": {""insertions"": 2, ""deletions"": 0, ""lines"": 2}}"
2022-09-27 17:05:38,859ea4bc76699232e41aea0f308463bab887b0c1,Bram Moolenaar,5,2,7,2,"{""src/testdir/test_global.vim"": {""insertions"": 3, ""deletions"": 2, ""lines"": 5}, ""src/version.c"": {""insertions"": 2, ""deletions"": 0, ""lines"": 2}}"
2022-09-27 16:47:12,66000ff9af8e3de93825ce7baa0c43727465eca5,Bram Moolenaar,6,2,8,2,"{""src/testdir/test_blockedit.vim"": {""insertions"": 4, ""deletions"": 2, ""lines"": 6}, ""src/version.c"": {""insertions"": 2, ""deletions"": 0, ""lines"": 2}}"
2022-09-27 16:30:34,9fbdbb814f4ad67a14979aba4a6a49800c2f1a99,Bram Moolenaar,4222,378,4600,45,"{"".github/CODEOWNERS"": {""insertions"": 11, ""deletions"": 1, ""lines"": 12}, ""runtime/autoload/context.vim"": {""insertions"": 7, ""deletions"": 2, ""lines"": 9}, ""runtime/autoload/dist/vimindent.vim"": {""insertions"": 1200, ""deletions"": 0, ""lines"": 1200}, ""runtime/compiler/hare.vim"": {""insertions"": 31, ""deletions"": 0, ""lines"": 31}, ""runtime/doc/cmdline.txt"": {""insertions"": 2, ""deletions"": 2, ""lines"": 4}, ""runtime/doc/develop.txt"": {""insertions"": 1, ""deletions"": 1, ""lines"": 2}, ""runtime/doc/ft_context.txt"": {""insertions"": 19, ""deletions"": 13, ""lines"": 32}, ""runtime/doc/indent.txt"": {""insertions"": 24, ""deletions"": 6, ""lines"": 30}, ""runtime/doc/map.txt"": {""insertions"": 10, ""deletions"": 6, ""lines"": 16}, ""runtime/doc/motion.txt"": {""insertions"": 2, ""deletions"": 2, ""lines"": 4}, ""runtime/doc/options.txt"": {""insertions"": 5, ""deletions"": 2, ""lines"": 7}, ""runtime/doc/pattern.txt"": {""insertions"": 6, ""deletions"": 1, ""lines"": 7}, ""runtime/doc/quickfix.txt"": {""insertions"": 4, ""deletions"": 4, ""lines"": 8}, ""runtime/doc/repeat.txt"": {""insertions"": 10, ""deletions"": 3, ""lines"": 13}, ""runtime/doc/syntax.txt"": {""insertions"": 2, ""deletions"": 2, ""lines"": 4}, ""runtime/doc/tags"": {""insertions"": 5, ""deletions"": 0, ""lines"": 5}, ""runtime/doc/textprop.txt"": {""insertions"": 23, ""deletions"": 16, ""lines"": 39}, ""runtime/doc/todo.txt"": {""insertions"": 10, ""deletions"": 33, ""lines"": 43}, ""runtime/doc/various.txt"": {""insertions"": 3, ""deletions"": 1, ""lines"": 4}, ""runtime/doc/vim9.txt"": {""insertions"": 3, ""deletions"": 1, ""lines"": 4}, ""runtime/filetype.vim"": {""insertions"": 1, ""deletions"": 1, ""lines"": 2}, ""runtime/ftplugin/chatito.vim"": {""insertions"": 15, ""deletions"": 0, ""lines"": 15}, ""runtime/ftplugin/elixir.vim"": {""insertions"": 5, ""deletions"": 1, ""lines"": 6}, ""runtime/ftplugin/gyp.vim"": {""insertions"": 14, ""deletions"": 0, ""lines"": 14}, ""runtime/ftplugin/hare.vim"": {""insertions"": 27, ""deletions"": 0, ""lines"": 27}, ""runtime/ftplugin/heex.vim"": {""insertions"": 16, ""deletions"": 0, ""lines"": 16}, ""runtime/ftplugin/vim.vim"": {""insertions"": 9, ""deletions"": 9, ""lines"": 18}, ""runtime/indent/chatito.vim"": {""insertions"": 32, ""deletions"": 0, ""lines"": 32}, ""runtime/indent/gyp.vim"": {""insertions"": 7, ""deletions"": 0, ""lines"": 7}, ""runtime/indent/hare.vim"": {""insertions"": 138, ""deletions"": 0, ""lines"": 138}, ""runtime/indent/solidity.vim"": {""insertions"": 442, ""deletions"": 0, ""lines"": 442}, ""runtime/indent/testdir/vim.in"": {""insertions"": 762, ""deletions"": 16, ""lines"": 778}, ""runtime/indent/testdir/vim.ok"": {""insertions"": 762, ""deletions"": 16, ""lines"": 778}, ""runtime/indent/vim.vim"": {""insertions"": 16, ""deletions"": 208, ""lines"": 224}, ""runtime/indent/vue.vim"": {""insertions"": 12, ""deletions"": 0, ""lines"": 12}, ""runtime/syntax/chatito.vim"": {""insertions"": 62, ""deletions"": 0, ""lines"": 62}, ""runtime/syntax/desktop.vim"": {""insertions"": 3, ""deletions"": 3, ""lines"": 6}, ""runtime/syntax/gyp.vim"": {""insertions"": 49, ""deletions"": 0, ""lines"": 49}, ""runtime/syntax/hare.vim"": {""insertions"": 133, ""deletions"": 0, ""lines"": 133}, ""runtime/syntax/help.vim"": {""insertions"": 2, ""deletions"": 1, ""lines"": 3}, ""runtime/syntax/hlsplaylist.vim"": {""insertions"": 120, ""deletions"": 0, ""lines"": 120}, ""runtime/syntax/plsql.vim"": {""insertions"": 43, ""deletions"": 25, ""lines"": 68}, ""runtime/syntax/solidity.vim"": {""insertions"": 173, ""deletions"": 0, ""lines"": 173}, ""runtime/syntax/vim.vim"": {""insertions"": 1, ""deletions"": 1, ""lines"": 2}, ""src/INSTALLpc.txt"": {""insertions"": 0, ""deletions"": 1, ""lines"": 1}}"
2022-09-27 15:29:38,26f09ea54b2c60abf21df42c60bdfc60eca17b0d,Bram Moolenaar,42,7,49,7,"{""src/change.c"": {""insertions"": 7, ""deletions"": 0, ""lines"": 7}, ""src/edit.c"": {""insertions"": 0, ""deletions"": 7, ""lines"": 7}, ""src/testdir/dumps/Test_spell_4.dump"": {""insertions"": 8, ""deletions"": 0, ""lines"": 8}, ""src/testdir/dumps/Test_spell_5.dump"": {""insertions"": 8, ""deletions"": 0, ""lines"": 8}, ""src/testdir/test_spell.vim"": {""insertions"": 8, ""deletions"": 0, ""lines"": 8}, ""src/undo.c"": {""insertions"": 9, ""deletions"": 0, ""lines"": 9}, ""src/version.c"": {""insertions"": 2, ""deletions"": 0, ""lines"": 2}}"
2022-09-27 14:55:43,f802767df7b4532651fcf11d49e812ead32db45b,Bram Moolenaar,12,1,13,3,"{""src/testdir/check.vim"": {""insertions"": 8, ""deletions"": 0, ""lines"": 8}, ""src/testdir/test_messages.vim"": {""insertions"": 2, ""deletions"": 1, ""lines"": 3}, ""src/version.c"": {""insertions"": 2, ""deletions"": 0, ""lines"": 2}}"
2022-09-27 14:48:20,524c853e5ef0392fcf28e449946e05e7e3046e67,Bram Moolenaar,4,1,5,2,"{""src/os_unix.c"": {""insertions"": 2, ""deletions"": 1, ""lines"": 3}, ""src/version.c"": {""insertions"": 2, ""deletions"": 0, ""lines"": 2}}"
2022-09-27 14:06:46,439a2ba1749463718b6ce1e1375b68c7b7cff808,Luuk van Baal,12,0,12,2,"{""src/testdir/dumps/Test_nosplitscroll_fold_4.dump"": {""insertions"": 10, ""deletions"": 0, ""lines"": 10}, ""src/version.c"": {""insertions"": 2, ""deletions"": 0, ""lines"": 2}}"
2022-09-27 12:07:05,49c311c9b18e18c05f93728d1f8a552923a18423,ObserverOfTime,6,1,7,3,"{""runtime/filetype.vim"": {""insertions"": 3, ""deletions"": 0, ""lines"": 3}, ""src/testdir/test_filetype.vim"": {""insertions"": 1, ""deletions"": 1, ""lines"": 2}, ""src/version.c"": {""insertions"": 2, ""deletions"": 0, ""lines"": 2}}"
2022-09-27 11:31:15,7c1cbb6cd437c6e0c3ccc05840cc931108b4a60a,Luuk van Baal,204,109,313,8,"{""src/edit.c"": {""insertions"": 100, ""deletions"": 80, ""lines"": 180}, ""src/proto/edit.pro"": {""insertions"": 2, ""deletions"": 0, ""lines"": 2}, ""src/testdir/dumps/Test_nosplitscroll_fold_1.dump"": {""insertions"": 10, ""deletions"": 0, ""lines"": 10}, ""src/testdir/dumps/Test_nosplitscroll_fold_2.dump"": {""insertions"": 10, ""deletions"": 0, ""lines"": 10}, ""src/testdir/dumps/Test_nosplitscroll_fold_3.dump"": {""insertions"": 10, ""deletions"": 0, ""lines"": 10}, ""src/testdir/test_window_cmd.vim"": {""insertions"": 30, ""deletions"": 0, ""lines"": 30}, ""src/version.c"": {""insertions"": 2, ""deletions"": 0, ""lines"": 2}, ""src/window.c"": {""insertions"": 40, ""deletions"": 29, ""lines"": 69}}"
2022-09-27 10:57:13,7fc6c0e4dab4e80b9806a973936af54276468513,rhysd,10,4,14,3,"{""runtime/filetype.vim"": {""insertions"": 7, ""deletions"": 4, ""lines"": 11}, ""src/testdir/test_filetype.vim"": {""insertions"": 1, ""deletions"": 0, ""lines"": 1}, ""src/version.c"": {""insertions"": 2, ""deletions"": 0, ""lines"": 2}}"
2022-09-27 10:46:48,368aa6908862874fdb901c534ee99033ac977e4a,Yegappan Lakshmanan,275,226,501,3,"{""src/beval.c"": {""insertions"": 169, ""deletions"": 152, ""lines"": 321}, ""src/blob.c"": {""insertions"": 104, ""deletions"": 74, ""lines"": 178}, ""src/version.c"": {""insertions"": 2, ""deletions"": 0, ""lines"": 2}}"
2022-09-27 10:35:09,d32474229213276c64cb293885a975dcb406fbc9,ObserverOfTime,6,0,6,3,"{""runtime/filetype.vim"": {""insertions"": 3, ""deletions"": 0, ""lines"": 3}, ""src/testdir/test_filetype.vim"": {""insertions"": 1, ""deletions"": 0, ""lines"": 1}, ""src/version.c"": {""insertions"": 2, ""deletions"": 0, ""lines"": 2}}"
2022-09-27 10:27:23,cde031938537970938437cdbb235bc0da755ae4a,ObserverOfTime,6,1,7,3,"{""runtime/filetype.vim"": {""insertions"": 3, ""deletions"": 0, ""lines"": 3}, ""src/testdir/test_filetype.vim"": {""insertions"": 1, ""deletions"": 1, ""lines"": 2}, ""src/version.c"": {""insertions"": 2, ""deletions"": 0, ""lines"": 2}}"
2022-09-26 22:08:22,8279af514ca7e5fd3c31cf13b0864163d1a0bfeb,Bram Moolenaar,28,1,29,3,"{""src/testdir/test_cmdwin.vim"": {""insertions"": 22, ""deletions"": 0, ""lines"": 22}, ""src/version.c"": {""insertions"": 2, ""deletions"": 0, ""lines"": 2}, ""src/window.c"": {""insertions"": 4, ""deletions"": 1, ""lines"": 5}}"
2022-09-26 19:48:32,3bdef10dc1c836e5e5a6fdcc1c21155cbd80d798,regomne,22,0,22,3,"{""src/gui_gtk_x11.c"": {""insertions"": 6, ""deletions"": 0, ""lines"": 6}, ""src/gui_w32.c"": {""insertions"": 14, ""deletions"": 0, ""lines"": 14}, ""src/version.c"": {""insertions"": 2, ""deletions"": 0, ""lines"": 2}}"
2022-09-26 19:17:26,7381c0ce3f3e79ec5a74b9be8fc34e0c8181463b,Philip H,3,1,4,2,"{"".cirrus.yml"": {""insertions"": 1, ""deletions"": 1, ""lines"": 2}, ""src/version.c"": {""insertions"": 2, ""deletions"": 0, ""lines"": 2}}"
2022-09-26 18:50:44,1190139ed01c27539615beea9559a88b2551daf3,Bram Moolenaar,101,12,113,10,"{""Filelist"": {""insertions"": 1, ""deletions"": 3, ""lines"": 4}, ""src/message.c"": {""insertions"": 2, ""deletions"": 1, ""lines"": 3}, ""src/misc2.c"": {""insertions"": 1, ""deletions"": 1, ""lines"": 2}, ""src/testdir/dumps/Test_verbose_system_1.dump"": {""insertions"": 10, ""deletions"": 0, ""lines"": 10}, ""src/testdir/dumps/Test_verbose_system_1.vim"": {""insertions"": 3, ""deletions"": 0, ""lines"": 3}, ""src/testdir/dumps/Test_verbose_system_2.dump"": {""insertions"": 10, ""deletions"": 0, ""lines"": 10}, ""src/testdir/dumps/Test_verbose_system_2.vim"": {""insertions"": 3, ""deletions"": 0, ""lines"": 3}, ""src/testdir/screendump.vim"": {""insertions"": 35, ""deletions"": 7, ""lines"": 42}, ""src/testdir/test_messages.vim"": {""insertions"": 34, ""deletions"": 0, ""lines"": 34}, ""src/version.c"": {""insertions"": 2, ""deletions"": 0, ""lines"": 2}}"
2022-09-26 15:02:48,2cb4a89797477fc90c9d84b0d45e869369e39c75,dundargoc,3,1,4,2,"{""src/Makefile"": {""insertions"": 1, ""deletions"": 1, ""lines"": 2}, ""src/version.c"": {""insertions"": 2, ""deletions"": 0, ""lines"": 2}}"
2022-09-26 14:52:46,311df6bb0f861154e6a27144c226c805c7554a94,Alex,15,0,15,4,"{"".github/workflows/ci.yml"": {""insertions"": 3, ""deletions"": 0, ""lines"": 3}, "".github/workflows/codeql-analysis.yml"": {""insertions"": 7, ""deletions"": 0, ""lines"": 7}, "".github/workflows/coverity.yml"": {""insertions"": 3, ""deletions"": 0, ""lines"": 3}, ""src/version.c"": {""insertions"": 2, ""deletions"": 0, ""lines"": 2}}"
2022-09-26 14:19:56,838b746cce7ea863acdb81e3f44eec2ea90de92a,Bram Moolenaar,75,12,87,7,"{""src/message.c"": {""insertions"": 13, ""deletions"": 5, ""lines"": 18}, ""src/proto/screen.pro"": {""insertions"": 1, ""deletions"": 1, ""lines"": 2}, ""src/screen.c"": {""insertions"": 13, ""deletions"": 6, ""lines"": 19}, ""src/testdir/dumps/Test_more_scrollback_1.dump"": {""insertions"": 10, ""deletions"": 0, ""lines"": 10}, ""src/testdir/dumps/Test_more_scrollback_2.dump"": {""insertions"": 10, ""deletions"": 0, ""lines"": 10}, ""src/testdir/test_messages.vim"": {""insertions"": 26, ""deletions"": 0, ""lines"": 26}, ""src/version.c"": {""insertions"": 2, ""deletions"": 0, ""lines"": 2}}"
2022-09-26 11:57:11,4569020538f76cab588f723bd7243e3896937568,Bram Moolenaar,16,0,16,4,"{""src/popupwin.c"": {""insertions"": 2, ""deletions"": 0, ""lines"": 2}, ""src/testdir/dumps/Test_echowindow_8.dump"": {""insertions"": 8, ""deletions"": 0, ""lines"": 8}, ""src/testdir/test_messages.vim"": {""insertions"": 4, ""deletions"": 0, ""lines"": 4}, ""src/version.c"": {""insertions"": 2, ""deletions"": 0, ""lines"": 2}}"
2022-09-25 19:58:30,ee09fcc9b6cf24e02899461809da9a5148208ea5,Bram Moolenaar,40,12,52,7,"{""src/drawline.c"": {""insertions"": 1, ""deletions"": 4, ""lines"": 5}, ""src/edit.c"": {""insertions"": 7, ""deletions"": 0, ""lines"": 7}, ""src/proto/spell.pro"": {""insertions"": 1, ""deletions"": 0, ""lines"": 1}, ""src/spell.c"": {""insertions"": 17, ""deletions"": 8, ""lines"": 25}, ""src/testdir/dumps/Test_spell_3.dump"": {""insertions"": 8, ""deletions"": 0, ""lines"": 8}, ""src/testdir/test_spell.vim"": {""insertions"": 4, ""deletions"": 0, ""lines"": 4}, ""src/version.c"": {""insertions"": 2, ""deletions"": 0, ""lines"": 2}}"
2022-09-25 19:12:21,b7e07dc1036b5b02870c72e872bbb248640ade7d,=?UTF-8?q?Ola=20S=C3=B6der?=,5,1,6,2,"{""src/os_amiga.c"": {""insertions"": 3, ""deletions"": 1, ""lines"": 4}, ""src/version.c"": {""insertions"": 2, ""deletions"": 0, ""lines"": 2}}"
2022-09-25 18:36:38,4d2073b2610dd6270cc664224dce9524b2a1d758,=?UTF-8?q?Ola=20S=C3=B6der?=,4,1,5,2,"{""src/Make_ami.mak"": {""insertions"": 2, ""deletions"": 1, ""lines"": 3}, ""src/version.c"": {""insertions"": 2, ""deletions"": 0, ""lines"": 2}}"
2022-09-25 18:25:51,9882e9ddc90abf522809dba4d9fa4de24c74df74,Christian Brabandt,85,45,130,3,"{""runtime/tools/unicode.vim"": {""insertions"": 6, ""deletions"": 5, ""lines"": 11}, ""src/mbyte.c"": {""insertions"": 77, ""deletions"": 40, ""lines"": 117}, ""src/version.c"": {""insertions"": 2, ""deletions"": 0, ""lines"": 2}}"
2022-09-25 17:44:03,124af71a28a633fa655cff41bc21d398481ce45f,Bram Moolenaar,5,4,9,2,"{""src/testdir/test_messages.vim"": {""insertions"": 3, ""deletions"": 4, ""lines"": 7}, ""src/version.c"": {""insertions"": 2, ""deletions"": 0, ""lines"": 2}}"
2022-09-25 17:41:14,6a879878f4e1918a05244e6acd4c73c3135cf941,Bram Moolenaar,6,0,6,2,"{""src/testdir/dumps/Test_quit_long_message.dump"": {""insertions"": 4, ""deletions"": 0, ""lines"": 4}, ""src/version.c"": {""insertions"": 2, ""deletions"": 0, ""lines"": 2}}"
2022-09-25 16:03:26,dc21552c9a83413a018a91e61649cc632929d6a1,Bram Moolenaar,23,20,43,3,"{""src/if_cscope.c"": {""insertions"": 16, ""deletions"": 11, ""lines"": 27}, ""src/testdir/test_cscope.vim"": {""insertions"": 5, ""deletions"": 9, ""lines"": 14}, ""src/version.c"": {""insertions"": 2, ""deletions"": 0, ""lines"": 2}}"
2022-09-25 11:35:49,b9725bc7f6427654eb4e35874034b0ec1b6b96b3,Bram Moolenaar,5,3,8,3,"{""runtime/filetype.vim"": {""insertions"": 2, ""deletions"": 2, ""lines"": 4}, ""src/testdir/test_filetype.vim"": {""insertions"": 1, ""deletions"": 1, ""lines"": 2}, ""src/version.c"": {""insertions"": 2, ""deletions"": 0, ""lines"": 2}}"
2022-09-25 10:21:04,ec1238b4068d0d6d9d02ac1a8e61720224a1be73,Bram Moolenaar,7,0,7,2,"{""src/testdir/test_channel.vim"": {""insertions"": 5, ""deletions"": 0, ""lines"": 5}, ""src/version.c"": {""insertions"": 2, ""deletions"": 0, ""lines"": 2}}"
2022-09-24 20:06:39,d4566c14e71c55dcef05fb34ea94eba835831527,Bram Moolenaar,3,1,4,2,"{""src/move.c"": {""insertions"": 1, ""deletions"": 1, ""lines"": 2}, ""src/version.c"": {""insertions"": 2, ""deletions"": 0, ""lines"": 2}}"
2022-09-24 18:32:11,1d61408af31667669edcbffc876e4eafdcacca96,Philip H,19,1,20,2,"{"".cirrus.yml"": {""insertions"": 17, ""deletions"": 1, ""lines"": 18}, ""src/version.c"": {""insertions"": 2, ""deletions"": 0, ""lines"": 2}}"
2022-09-24 18:20:30,0ff01835a40f549c5c4a550502f62a2ac9ac447c,Bram Moolenaar,52,11,63,4,"{""src/insexpand.c"": {""insertions"": 31, ""deletions"": 9, ""lines"": 40}, ""src/move.c"": {""insertions"": 1, ""deletions"": 0, ""lines"": 1}, ""src/testdir/test_ins_complete.vim"": {""insertions"": 18, ""deletions"": 2, ""lines"": 20}, ""src/version.c"": {""insertions"": 2, ""deletions"": 0, ""lines"": 2}}"
2022-09-24 16:44:22,865bf2ed3039deeaa66312319f3e13db146a9701,Bram Moolenaar,5,0,5,2,"{""src/testdir/test_timers.vim"": {""insertions"": 3, ""deletions"": 0, ""lines"": 3}, ""src/version.c"": {""insertions"": 2, ""deletions"": 0, ""lines"": 2}}"
2022-09-24 16:24:12,96b9bf8f74af8abf1e30054f996708db7dc285be,Bram Moolenaar,284,263,547,3,"{""src/ex_eval.c"": {""insertions"": 260, ""deletions"": 263, ""lines"": 523}, ""src/testdir/test_trycatch.vim"": {""insertions"": 22, ""deletions"": 0, ""lines"": 22}, ""src/version.c"": {""insertions"": 2, ""deletions"": 0, ""lines"": 2}}"
2022-09-24 14:55:27,b2209f213e2931cf3313b24868a9165bbb717cc4,dundargoc,5,3,8,2,"{""src/digraph.c"": {""insertions"": 3, ""deletions"": 3, ""lines"": 6}, ""src/version.c"": {""insertions"": 2, ""deletions"": 0, ""lines"": 2}}"
2022-09-24 14:36:35,78aed95c8d11a06590abb079014887a458b28b36,Bram Moolenaar,21,5,26,2,"{""src/getchar.c"": {""insertions"": 19, ""deletions"": 5, ""lines"": 24}, ""src/version.c"": {""insertions"": 2, ""deletions"": 0, ""lines"": 2}}"
2022-09-24 13:49:07,140f6d0eda7921f2f0b057ec38ed501240903fc3,Bram Moolenaar,8,1,9,2,"{""src/testdir/test_timers.vim"": {""insertions"": 6, ""deletions"": 1, ""lines"": 7}, ""src/version.c"": {""insertions"": 2, ""deletions"": 0, ""lines"": 2}}"
2022-09-24 13:35:21,81fd3b2b4438e2751a1b79049827a5ee315ea38d,Philip H,8,0,8,2,"{"".github/dependabot.yml"": {""insertions"": 6, ""deletions"": 0, ""lines"": 6}, ""src/version.c"": {""insertions"": 2, ""deletions"": 0, ""lines"": 2}}"
2022-09-24 13:08:23,75f4bafabdcc6bce5cf3e09fee29c634bf102c17,zeertzjq,5,2,7,2,"{""src/testdir/test_ins_complete.vim"": {""insertions"": 3, ""deletions"": 2, ""lines"": 5}, ""src/version.c"": {""insertions"": 2, ""deletions"": 0, ""lines"": 2}}"
2022-09-24 12:10:04,f7e7302acb20b6ef6caa0740da1450b677ac91fb,Bram Moolenaar,8,8,16,4,"{""src/main.c"": {""insertions"": 3, ""deletions"": 3, ""lines"": 6}, ""src/normal.c"": {""insertions"": 2, ""deletions"": 5, ""lines"": 7}, ""src/proto/main.pro"": {""insertions"": 1, ""deletions"": 0, ""lines"": 1}, ""src/version.c"": {""insertions"": 2, ""deletions"": 0, ""lines"": 2}}"
2022-09-24 12:00:53,d3eafdd7098e5e47a3e93474a624cb0ba1a874c9,Philip H,3,1,4,2,"{"".github/workflows/ci.yml"": {""insertions"": 1, ""deletions"": 1, ""lines"": 2}, ""src/version.c"": {""insertions"": 2, ""deletions"": 0, ""lines"": 2}}"
2022-09-24 11:50:45,5939c357431f8e43853ad80b03303167f39763df,Bram Moolenaar,50,2,52,3,"{""src/normal.c"": {""insertions"": 25, ""deletions"": 2, ""lines"": 27}, ""src/testdir/test_startup.vim"": {""insertions"": 23, ""deletions"": 0, ""lines"": 23}, ""src/version.c"": {""insertions"": 2, ""deletions"": 0, ""lines"": 2}}"
2022-09-24 10:30:41,e9dcf13a3007d4f603e007e0526b0005fd026bc5,Yegappan Lakshmanan,157,150,307,3,"{""src/autocmd.c"": {""insertions"": 126, ""deletions"": 119, ""lines"": 245}, ""src/userfunc.c"": {""insertions"": 29, ""deletions"": 31, ""lines"": 60}, ""src/version.c"": {""insertions"": 2, ""deletions"": 0, ""lines"": 2}}"
2022-09-24 10:17:51,87af60c91503e37c9144f8e48022b12994ce2c85,bfredl,32,3,35,3,"{""src/insexpand.c"": {""insertions"": 10, ""deletions"": 3, ""lines"": 13}, ""src/testdir/test_ins_complete.vim"": {""insertions"": 20, ""deletions"": 0, ""lines"": 20}, ""src/version.c"": {""insertions"": 2, ""deletions"": 0, ""lines"": 2}}"
2022-09-24 10:04:38,9fd1583c839c5e43b0d48ec815a79005a2364776,Nbiba Bedis,6,0,6,3,"{""runtime/filetype.vim"": {""insertions"": 3, ""deletions"": 0, ""lines"": 3}, ""src/testdir/test_filetype.vim"": {""insertions"": 1, ""deletions"": 0, ""lines"": 1}, ""src/version.c"": {""insertions"": 2, ""deletions"": 0, ""lines"": 2}}"
2022-09-23 22:19:18,dfa8be4944b49c228d401e788aaade47b4abb658,Bram Moolenaar,4,1,5,2,"{""src/testdir/test_cscope.vim"": {""insertions"": 2, ""deletions"": 1, ""lines"": 3}, ""src/version.c"": {""insertions"": 2, ""deletions"": 0, ""lines"": 2}}"
2022-09-23 20:26:39,0056ca71374feadf6bad27f5b66eaa18b6f7dad7,Bram Moolenaar,33,8,41,4,"{""src/testdir/check.vim"": {""insertions"": 8, ""deletions"": 0, ""lines"": 8}, ""src/testdir/test_autocmd.vim"": {""insertions"": 2, ""deletions"": 0, ""lines"": 2}, ""src/testdir/test_timers.vim"": {""insertions"": 21, ""deletions"": 8, ""lines"": 29}, ""src/version.c"": {""insertions"": 2, ""deletions"": 0, ""lines"": 2}}"
2022-09-23 20:01:54,a9b0f8f7f35ddd281f4fa464d163dc4fb05e1d7b,Bram Moolenaar,7,3,10,3,"{""src/testdir/test_vim9_builtin.vim"": {""insertions"": 1, ""deletions"": 1, ""lines"": 2}, ""src/testdir/test_vimscript.vim"": {""insertions"": 4, ""deletions"": 2, ""lines"": 6}, ""src/version.c"": {""insertions"": 2, ""deletions"": 0, ""lines"": 2}}"
2022-09-23 19:33:39,35fdd9a67d73d4750152c419d4193ebb6b6d6eee,=?UTF-8?q?Beno=C3=AEt=20Ryder?=,6,0,6,3,"{""runtime/filetype.vim"": {""insertions"": 3, ""deletions"": 0, ""lines"": 3}, ""src/testdir/test_filetype.vim"": {""insertions"": 1, ""deletions"": 0, ""lines"": 1}, ""src/version.c"": {""insertions"": 2, ""deletions"": 0, ""lines"": 2}}"
2022-09-23 19:25:55,3bcd0ddc2deb34794c735c6ea0b8f964b510c6db,Bram Moolenaar,23,0,23,2,"{""src/testdir/runtest.vim"": {""insertions"": 21, ""deletions"": 0, ""lines"": 21}, ""src/version.c"": {""insertions"": 2, ""deletions"": 0, ""lines"": 2}}"
2022-09-23 18:42:31,b9093d50098ccff3848c2a404b9d0324a074c7b7,Bram Moolenaar,35,9,44,6,"{""src/testdir/Make_all.mak"": {""insertions"": 3, ""deletions"": 0, ""lines"": 3}, ""src/testdir/Make_ming.mak"": {""insertions"": 4, ""deletions"": 0, ""lines"": 4}, ""src/testdir/Make_mvc.mak"": {""insertions"": 4, ""deletions"": 0, ""lines"": 4}, ""src/testdir/Makefile"": {""insertions"": 7, ""deletions"": 5, ""lines"": 12}, ""src/testdir/runtest.vim"": {""insertions"": 15, ""deletions"": 4, ""lines"": 19}, ""src/version.c"": {""insertions"": 2, ""deletions"": 0, ""lines"": 2}}"
2022-09-23 17:22:21,4ecf16bbf951f10fd32c918c9d8bc004b7f8f7c9,Bram Moolenaar,6,2,8,2,"{""src/testdir/test_timers.vim"": {""insertions"": 4, ""deletions"": 2, ""lines"": 6}, ""src/version.c"": {""insertions"": 2, ""deletions"": 0, ""lines"": 2}}"
2022-09-23 15:37:18,7f9a5a68fe363db467a505502237c1e8479c1436,Bram Moolenaar,4,1,5,2,"{""src/eval.c"": {""insertions"": 2, ""deletions"": 1, ""lines"": 3}, ""src/version.c"": {""insertions"": 2, ""deletions"": 0, ""lines"": 2}}"
2022-09-23 15:11:37,259a741044812df739457e25eb5195d9c5c0e6f8,Bram Moolenaar,36,28,64,3,"{""src/testdir/test_vim9_fails.vim"": {""insertions"": 34, ""deletions"": 0, ""lines"": 34}, ""src/testdir/test_vim9_func.vim"": {""insertions"": 0, ""deletions"": 28, ""lines"": 28}, ""src/version.c"": {""insertions"": 2, ""deletions"": 0, ""lines"": 2}}"
2022-09-23 12:27:57,86fb3f8b99d155fe6bcbb553b5596c3e9fd570a9,Bram Moolenaar,3,0,3,2,"{""src/eval.c"": {""insertions"": 1, ""deletions"": 0, ""lines"": 1}, ""src/version.c"": {""insertions"": 2, ""deletions"": 0, ""lines"": 2}}"
2022-09-23 11:57:09,20e58561abc4116f3bfbafaef242d886dd77b303,Luuk van Baal,68,1,69,7,"{""src/testdir/dumps/Test_nosplitscroll_callback_1.dump"": {""insertions"": 8, ""deletions"": 0, ""lines"": 8}, ""src/testdir/dumps/Test_nosplitscroll_callback_2.dump"": {""insertions"": 8, ""deletions"": 0, ""lines"": 8}, ""src/testdir/dumps/Test_nosplitscroll_callback_3.dump"": {""insertions"": 8, ""deletions"": 0, ""lines"": 8}, ""src/testdir/dumps/Test_nosplitscroll_callback_4.dump"": {""insertions"": 8, ""deletions"": 0, ""lines"": 8}, ""src/testdir/test_window_cmd.vim"": {""insertions"": 31, ""deletions"": 0, ""lines"": 31}, ""src/version.c"": {""insertions"": 2, ""deletions"": 0, ""lines"": 2}, ""src/window.c"": {""insertions"": 3, ""deletions"": 1, ""lines"": 4}}"
2022-09-23 11:44:25,f8addf1ca1d8c7801f6dded2341b7084d2b93e5e,Bram Moolenaar,37,7,44,4,"{""src/eval.c"": {""insertions"": 16, ""deletions"": 5, ""lines"": 21}, ""src/testdir/test_vim9_func.vim"": {""insertions"": 14, ""deletions"": 0, ""lines"": 14}, ""src/version.c"": {""insertions"": 2, ""deletions"": 0, ""lines"": 2}, ""src/vim9expr.c"": {""insertions"": 5, ""deletions"": 2, ""lines"": 7}}"
2022-09-22 21:03:14,f5f4e85f0189790ab81c0005b703604721db13d4,Bram Moolenaar,29,2,31,3,"{""src/testdir/test_vim9_func.vim"": {""insertions"": 23, ""deletions"": 0, ""lines"": 23}, ""src/userfunc.c"": {""insertions"": 4, ""deletions"": 2, ""lines"": 6}, ""src/version.c"": {""insertions"": 2, ""deletions"": 0, ""lines"": 2}}"
2022-09-22 20:35:19,69082916c8b5d321545d60b9f5facad0a2dd5a4e,Bram Moolenaar,21,2,23,3,"{""src/eval.c"": {""insertions"": 2, ""deletions"": 2, ""lines"": 4}, ""src/testdir/test_source.vim"": {""insertions"": 17, ""deletions"": 0, ""lines"": 17}, ""src/version.c"": {""insertions"": 2, ""deletions"": 0, ""lines"": 2}}"
2022-09-22 18:02:38,f87eeb43fb29f5e3d39807e6ce49e5e2d72eb38b,Bram Moolenaar,17,4,21,2,"{""src/popupwin.c"": {""insertions"": 15, ""deletions"": 4, ""lines"": 19}, ""src/version.c"": {""insertions"": 2, ""deletions"": 0, ""lines"": 2}}"
2022-09-22 17:08:37,62de54b48d6354d4622ec0b21ffa4cf3cf312505,zeertzjq,30,17,47,4,"{""src/ex_docmd.c"": {""insertions"": 0, ""deletions"": 5, ""lines"": 5}, ""src/testdir/test_autocmd.vim"": {""insertions"": 20, ""deletions"": 0, ""lines"": 20}, ""src/version.c"": {""insertions"": 2, ""deletions"": 0, ""lines"": 2}, ""src/window.c"": {""insertions"": 8, ""deletions"": 12, ""lines"": 20}}"
2022-09-22 16:34:01,5800c798385b4a7eded9ea63cfd4f57d1499a673,Bram Moolenaar,14,22,36,2,"{""src/version.c"": {""insertions"": 2, ""deletions"": 0, ""lines"": 2}, ""src/vim9execute.c"": {""insertions"": 12, ""deletions"": 22, ""lines"": 34}}"
2022-09-22 16:07:00,f1c60d4bf10794265b828afd9c5f7eddacada10b,Bram Moolenaar,30,34,64,7,"{""src/blob.c"": {""insertions"": 7, ""deletions"": 6, ""lines"": 13}, ""src/list.c"": {""insertions"": 11, ""deletions"": 19, ""lines"": 30}, ""src/proto/blob.pro"": {""insertions"": 1, ""deletions"": 1, ""lines"": 2}, ""src/proto/strings.pro"": {""insertions"": 1, ""deletions"": 1, ""lines"": 2}, ""src/strings.c"": {""insertions"": 7, ""deletions"": 6, ""lines"": 13}, ""src/testdir/test_listdict.vim"": {""insertions"": 1, ""deletions"": 1, ""lines"": 2}, ""src/version.c"": {""insertions"": 2, ""deletions"": 0, ""lines"": 2}}"
2022-09-22 15:36:25,6d313bec535d9ccc24f6f82025280a61caad7416,Bram Moolenaar,8,6,14,3,"{""src/structs.h"": {""insertions"": 1, ""deletions"": 0, ""lines"": 1}, ""src/version.c"": {""insertions"": 2, ""deletions"": 0, ""lines"": 2}, ""src/vim9execute.c"": {""insertions"": 5, ""deletions"": 6, ""lines"": 11}}"
2022-09-22 15:12:06,236ccbf6f8a671a45b773de4b34558ecfdf9ac02,K.Takata,101,235,336,6,"{""src/Make_cyg_ming.mak"": {""insertions"": 7, ""deletions"": 21, ""lines"": 28}, ""src/Make_mvc.mak"": {""insertions"": 16, ""deletions"": 35, ""lines"": 51}, ""src/auto/configure"": {""insertions"": 4, ""deletions"": 4, ""lines"": 8}, ""src/configure.ac"": {""insertions"": 3, ""deletions"": 3, ""lines"": 6}, ""src/if_ruby.c"": {""insertions"": 69, ""deletions"": 172, ""lines"": 241}, ""src/version.c"": {""insertions"": 2, ""deletions"": 0, ""lines"": 2}}"
2022-09-22 14:13:00,daaa3d9965d74faf1f75aea218822bfb7ba687a7,Bram Moolenaar,13,4,17,3,"{""src/testdir/Makefile"": {""insertions"": 4, ""deletions"": 1, ""lines"": 5}, ""src/testdir/runtest.vim"": {""insertions"": 7, ""deletions"": 3, ""lines"": 10}, ""src/version.c"": {""insertions"": 2, ""deletions"": 0, ""lines"": 2}}"
2022-09-22 12:57:32,fcba86c0316dc0d6341078b50e7967206a1627a0,zeertzjq,21,7,28,3,"{""src/option.c"": {""insertions"": 5, ""deletions"": 7, ""lines"": 12}, ""src/testdir/test_options.vim"": {""insertions"": 14, ""deletions"": 0, ""lines"": 14}, ""src/version.c"": {""insertions"": 2, ""deletions"": 0, ""lines"": 2}}"
2022-09-22 12:44:00,e24b5e0b0f5ab015215ef2761baa98ccb1ba8606,Yegappan Lakshmanan,63,0,63,4,"{""src/testdir/test_assert.vim"": {""insertions"": 52, ""deletions"": 0, ""lines"": 52}, ""src/testdir/test_options.vim"": {""insertions"": 1, ""deletions"": 0, ""lines"": 1}, ""src/testdir/test_vimscript.vim"": {""insertions"": 8, ""deletions"": 0, ""lines"": 8}, ""src/version.c"": {""insertions"": 2, ""deletions"": 0, ""lines"": 2}}"
2022-09-22 12:17:30,f1d2ddcb9b298d8ed7d31c792c56531211fbd771,Bram Moolenaar,25,114,139,5,"{""src/Make_mvc.mak"": {""insertions"": 23, ""deletions"": 111, ""lines"": 134}, ""src/if_perl_msvc/stdbool.h"": {""insertions"": 0, ""deletions"": 3, ""lines"": 3}, ""src/version.c"": {""insertions"": 2, ""deletions"": 0, ""lines"": 2}, ""src/xpm/x64/lib/libXpm.lib"": {""insertions"": 0, ""deletions"": 0, ""lines"": 0}, ""src/xpm/x86/lib/libXpm.lib"": {""insertions"": 0, ""deletions"": 0, ""lines"": 0}}"
2022-09-22 11:57:06,ee7c8d999beb847457f768757b1bdcd76391c1f4,Bram Moolenaar,5,1,6,2,"{""src/testdir/test_terminal.vim"": {""insertions"": 3, ""deletions"": 1, ""lines"": 4}, ""src/version.c"": {""insertions"": 2, ""deletions"": 0, ""lines"": 2}}"
2022-09-22 11:48:58,6f98114e4a5db3917c4f9d2fec09e11b4b0d0be5,Bram Moolenaar,28,24,52,2,"{""src/option.c"": {""insertions"": 26, ""deletions"": 24, ""lines"": 50}, ""src/version.c"": {""insertions"": 2, ""deletions"": 0, ""lines"": 2}}"
2022-09-22 11:01:34,21d393a12be86126d9326ea0c244d3a101b77151,Bram Moolenaar,4,1,5,2,"{""src/testdir/test_messages.vim"": {""insertions"": 2, ""deletions"": 1, ""lines"": 3}, ""src/version.c"": {""insertions"": 2, ""deletions"": 0, ""lines"": 2}}"
2022-09-21 21:00:03,5c645a25bb8e6d766db720a44b9ceeff39d1e92b,Bram Moolenaar,38,73,111,9,"{""src/testdir/test_eval_stuff.vim"": {""insertions"": 7, ""deletions"": 13, ""lines"": 20}, ""src/testdir/test_ex_mode.vim"": {""insertions"": 3, ""deletions"": 7, ""lines"": 10}, ""src/testdir/test_excmd.vim"": {""insertions"": 17, ""deletions"": 34, ""lines"": 51}, ""src/testdir/test_execute_func.vim"": {""insertions"": 1, ""deletions"": 2, ""lines"": 3}, ""src/testdir/test_exit.vim"": {""insertions"": 1, ""deletions"": 2, ""lines"": 3}, ""src/testdir/test_expand.vim"": {""insertions"": 4, ""deletions"": 9, ""lines"": 13}, ""src/testdir/test_expand_func.vim"": {""insertions"": 2, ""deletions"": 4, ""lines"": 6}, ""src/testdir/test_expr.vim"": {""insertions"": 1, ""deletions"": 2, ""lines"": 3}, ""src/version.c"": {""insertions"": 2, ""deletions"": 0, ""lines"": 2}}"
2022-09-21 20:12:53,4740394f230dda09d6e9337465305741d8ee4fa3,Bram Moolenaar,442,435,877,2,"{""src/option.c"": {""insertions"": 440, ""deletions"": 435, ""lines"": 875}, ""src/version.c"": {""insertions"": 2, ""deletions"": 0, ""lines"": 2}}"
2022-09-21 18:41:54,6a434e93a9a4fe9dbe5fee78f1ad4dac449a5ed6,Philip H,3,1,4,2,"{"".github/workflows/ci.yml"": {""insertions"": 1, ""deletions"": 1, ""lines"": 2}, ""src/version.c"": {""insertions"": 2, ""deletions"": 0, ""lines"": 2}}"
2022-09-21 17:59:14,e8e369a796e110760d033e937b40c84e0c5e8b36,Bram Moolenaar,34,5,39,5,"{""src/evalvars.c"": {""insertions"": 2, ""deletions"": 2, ""lines"": 4}, ""src/ex_eval.c"": {""insertions"": 8, ""deletions"": 2, ""lines"": 10}, ""src/structs.h"": {""insertions"": 1, ""deletions"": 1, ""lines"": 2}, ""src/testdir/test_vim9_script.vim"": {""insertions"": 21, ""deletions"": 0, ""lines"": 21}, ""src/version.c"": {""insertions"": 2, ""deletions"": 0, ""lines"": 2}}"
2022-09-21 15:38:13,ec5e1483ebda577e0b7f638c485203cd0e479c47,Bram Moolenaar,84,67,151,7,"{""src/drawline.c"": {""insertions"": 62, ""deletions"": 47, ""lines"": 109}, ""src/testdir/dumps/Test_prop_with_text_above_4.dump"": {""insertions"": 4, ""deletions"": 4, ""lines"": 8}, ""src/testdir/dumps/Test_prop_with_text_above_5.dump"": {""insertions"": 4, ""deletions"": 4, ""lines"": 8}, ""src/testdir/dumps/Test_prop_with_text_above_6.dump"": {""insertions"": 4, ""deletions"": 4, ""lines"": 8}, ""src/testdir/dumps/Test_prop_with_text_above_7.dump"": {""insertions"": 4, ""deletions"": 4, ""lines"": 8}, ""src/testdir/dumps/Test_prop_with_text_above_8.dump"": {""insertions"": 4, ""deletions"": 4, ""lines"": 8}, ""src/version.c"": {""insertions"": 2, ""deletions"": 0, ""lines"": 2}}"
2022-09-21 14:41:28,e49f9acecc03755db850410b2590ad7312c5224b,Bram Moolenaar,102,89,191,2,"{""src/drawline.c"": {""insertions"": 100, ""deletions"": 89, ""lines"": 189}, ""src/version.c"": {""insertions"": 2, ""deletions"": 0, ""lines"": 2}}"
2022-09-21 14:13:52,14f91765c07e147e0c8554a50560ae24dbd5ecea,Bram Moolenaar,25,28,53,2,"{""src/testdir/test_edit.vim"": {""insertions"": 23, ""deletions"": 28, ""lines"": 51}, ""src/version.c"": {""insertions"": 2, ""deletions"": 0, ""lines"": 2}}"
2022-09-21 13:34:28,c20a41972c61ab4bc211327d535c73c9b30cc166,Bram Moolenaar,180,156,336,2,"{""src/drawline.c"": {""insertions"": 178, ""deletions"": 156, ""lines"": 334}, ""src/version.c"": {""insertions"": 2, ""deletions"": 0, ""lines"": 2}}"
2022-09-21 12:07:22,8ecfa2c56b4992c7f067b92488aa9acea5a454ad,Bram Moolenaar,22,5,27,3,"{""src/mark.c"": {""insertions"": 7, ""deletions"": 5, ""lines"": 12}, ""src/testdir/test_marks.vim"": {""insertions"": 13, ""deletions"": 0, ""lines"": 13}, ""src/version.c"": {""insertions"": 2, ""deletions"": 0, ""lines"": 2}}"
2022-09-21 11:19:44,8eaee1fa5c0ce474132a04e1b70b73c49c41cc45,K.Takata,3,4,7,2,"{"".appveyor.yml"": {""insertions"": 1, ""deletions"": 4, ""lines"": 5}, ""src/version.c"": {""insertions"": 2, ""deletions"": 0, ""lines"": 2}}"
2022-09-21 10:56:41,c3430cb583ff05722e33195e4818c88a59bb2fee,K.Takata,123,1,124,7,"{""Filelist"": {""insertions"": 4, ""deletions"": 0, ""lines"": 4}, ""src/INSTALLpc.txt"": {""insertions"": 6, ""deletions"": 1, ""lines"": 7}, ""src/msvc-latest.bat"": {""insertions"": 72, ""deletions"": 0, ""lines"": 72}, ""src/msvc2017.bat"": {""insertions"": 13, ""deletions"": 0, ""lines"": 13}, ""src/msvc2019.bat"": {""insertions"": 13, ""deletions"": 0, ""lines"": 13}, ""src/msvc2022.bat"": {""insertions"": 13, ""deletions"": 0, ""lines"": 13}, ""src/version.c"": {""insertions"": 2, ""deletions"": 0, ""lines"": 2}}"
2022-09-21 10:21:57,2b1ddf19f8f14365d0b998b4ac12ca85c0923475,Bram Moolenaar,23,5,28,3,"{""src/drawline.c"": {""insertions"": 7, ""deletions"": 5, ""lines"": 12}, ""src/testdir/test_signs.vim"": {""insertions"": 14, ""deletions"": 0, ""lines"": 14}, ""src/version.c"": {""insertions"": 2, ""deletions"": 0, ""lines"": 2}}"
2022-09-21 09:51:13,f7c7aa3594b9f917b0b9571e1e60bef69b55244d,K.Takata,4,29,33,3,"{""src/Make_mvc.mak"": {""insertions"": 2, ""deletions"": 7, ""lines"": 9}, ""src/msvc2015.bat"": {""insertions"": 0, ""deletions"": 22, ""lines"": 22}, ""src/version.c"": {""insertions"": 2, ""deletions"": 0, ""lines"": 2}}"
2022-09-20 21:01:33,5917341f65d4fc669b9d15343ccdb00c160201da,Bram Moolenaar,59,102,161,5,"{""src/testdir/test_debugger.vim"": {""insertions"": 30, ""deletions"": 48, ""lines"": 78}, ""src/testdir/test_diffmode.vim"": {""insertions"": 16, ""deletions"": 32, ""lines"": 48}, ""src/testdir/test_digraph.vim"": {""insertions"": 1, ""deletions"": 2, ""lines"": 3}, ""src/testdir/test_display.vim"": {""insertions"": 10, ""deletions"": 20, ""lines"": 30}, ""src/version.c"": {""insertions"": 2, ""deletions"": 0, ""lines"": 2}}"
2022-09-20 20:23:12,4cbdcbda2d0abef3d7443320d7716f0e63e2df68,Bram Moolenaar,32,73,105,6,"{""Filelist"": {""insertions"": 0, ""deletions"": 2, ""lines"": 2}, ""runtime/doc/develop.txt"": {""insertions"": 13, ""deletions"": 4, ""lines"": 17}, ""src/INSTALLpc.txt"": {""insertions"": 17, ""deletions"": 53, ""lines"": 70}, ""src/msvc2008.bat"": {""insertions"": 0, ""deletions"": 7, ""lines"": 7}, ""src/msvc2010.bat"": {""insertions"": 0, ""deletions"": 7, ""lines"": 7}, ""src/version.c"": {""insertions"": 2, ""deletions"": 0, ""lines"": 2}}"
2022-09-20 20:09:42,2d2e25b3e3c932e76f53e9cc49b60e92a7dc8715,Bram Moolenaar,10,1,11,2,"{""src/drawline.c"": {""insertions"": 8, ""deletions"": 1, ""lines"": 9}, ""src/version.c"": {""insertions"": 2, ""deletions"": 0, ""lines"": 2}}"
2022-09-20 19:52:33,f64b75b1d90182d04c9f9bc2ff20c9fa59227c93,Bram Moolenaar,4,0,4,2,"{"".appveyor.yml"": {""insertions"": 2, ""deletions"": 0, ""lines"": 2}, ""src/version.c"": {""insertions"": 2, ""deletions"": 0, ""lines"": 2}}"
2022-09-20 19:25:36,31724238c8798113e0e11f61c52e0dc98bb21970,Bram Moolenaar,3,1,4,2,"{""src/drawline.c"": {""insertions"": 1, ""deletions"": 1, ""lines"": 2}, ""src/version.c"": {""insertions"": 2, ""deletions"": 0, ""lines"": 2}}"
2022-09-20 18:04:32,848db57e52ed787f7b62fc1619143934291f619f,Bram Moolenaar,10,14,24,2,"{""src/evalfunc.c"": {""insertions"": 8, ""deletions"": 14, ""lines"": 22}, ""src/version.c"": {""insertions"": 2, ""deletions"": 0, ""lines"": 2}}"
2022-09-20 17:59:30,d7657e95b21f660a202a5118af059aa17ad37120,Bram Moolenaar,191,187,378,2,"{""src/drawline.c"": {""insertions"": 189, ""deletions"": 187, ""lines"": 376}, ""src/version.c"": {""insertions"": 2, ""deletions"": 0, ""lines"": 2}}"
2022-09-20 16:57:53,b84d565c623c00ca40bb4c1269a6860f780dda09,Bram Moolenaar,21,4,25,4,"{""src/drawline.c"": {""insertions"": 8, ""deletions"": 4, ""lines"": 12}, ""src/testdir/dumps/Test_prop_below_split_line_3.dump"": {""insertions"": 8, ""deletions"": 0, ""lines"": 8}, ""src/testdir/test_textprop.vim"": {""insertions"": 3, ""deletions"": 0, ""lines"": 3}, ""src/version.c"": {""insertions"": 2, ""deletions"": 0, ""lines"": 2}}"
2022-09-20 16:12:13,320d910064320f894a09ffdd1cd800ff5371e97f,zeertzjq,45,7,52,8,"{""src/ex_docmd.c"": {""insertions"": 5, ""deletions"": 2, ""lines"": 7}, ""src/testdir/dumps/Test_redrawstatus_in_autocmd_1.dump"": {""insertions"": 1, ""deletions"": 1, ""lines"": 2}, ""src/testdir/dumps/Test_redrawstatus_in_autocmd_2.dump"": {""insertions"": 2, ""deletions"": 2, ""lines"": 4}, ""src/testdir/dumps/Test_redrawstatus_in_autocmd_3.dump"": {""insertions"": 8, ""deletions"": 0, ""lines"": 8}, ""src/testdir/dumps/Test_redrawstatus_in_autocmd_4.dump"": {""insertions"": 8, ""deletions"": 0, ""lines"": 8}, ""src/testdir/dumps/Test_redrawstatus_in_autocmd_5.dump"": {""insertions"": 8, ""deletions"": 0, ""lines"": 8}, ""src/testdir/test_cmdline.vim"": {""insertions"": 11, ""deletions"": 2, ""lines"": 13}, ""src/version.c"": {""insertions"": 2, ""deletions"": 0, ""lines"": 2}}"
2022-09-20 15:15:30,ccfaa075918639b57925b16902cad339ab39b18c,Bram Moolenaar,48,46,94,13,"{""src/drawline.c"": {""insertions"": 1, ""deletions"": 1, ""lines"": 2}, ""src/testdir/dumps/Test_prop_with_text_above_1.dump"": {""insertions"": 5, ""deletions"": 5, ""lines"": 10}, ""src/testdir/dumps/Test_prop_with_text_above_1a.dump"": {""insertions"": 5, ""deletions"": 5, ""lines"": 10}, ""src/testdir/dumps/Test_prop_with_text_above_1b.dump"": {""insertions"": 5, ""deletions"": 5, ""lines"": 10}, ""src/testdir/dumps/Test_prop_with_text_above_1c.dump"": {""insertions"": 5, ""deletions"": 5, ""lines"": 10}, ""src/testdir/dumps/Test_prop_with_text_above_2.dump"": {""insertions"": 5, ""deletions"": 5, ""lines"": 10}, ""src/testdir/dumps/Test_prop_with_text_above_3.dump"": {""insertions"": 5, ""deletions"": 5, ""lines"": 10}, ""src/testdir/dumps/Test_prop_with_text_above_4.dump"": {""insertions"": 3, ""deletions"": 3, ""lines"": 6}, ""src/testdir/dumps/Test_prop_with_text_above_5.dump"": {""insertions"": 3, ""deletions"": 3, ""lines"": 6}, ""src/testdir/dumps/Test_prop_with_text_above_6.dump"": {""insertions"": 3, ""deletions"": 3, ""lines"": 6}, ""src/testdir/dumps/Test_prop_with_text_above_7.dump"": {""insertions"": 3, ""deletions"": 3, ""lines"": 6}, ""src/testdir/dumps/Test_prop_with_text_above_8.dump"": {""insertions"": 3, ""deletions"": 3, ""lines"": 6}, ""src/version.c"": {""insertions"": 2, ""deletions"": 0, ""lines"": 2}}"
2022-09-20 14:59:22,2fdc9b541918237168ca05ac09eb4bb245e5c6c5,Bram Moolenaar,48,63,111,5,"{""src/drawline.c"": {""insertions"": 3, ""deletions"": 0, ""lines"": 3}, ""src/testdir/dumps/Test_prop_below_split_line_1.dump"": {""insertions"": 1, ""deletions"": 1, ""lines"": 2}, ""src/testdir/dumps/Test_prop_below_split_line_2.dump"": {""insertions"": 8, ""deletions"": 0, ""lines"": 8}, ""src/testdir/test_textprop.vim"": {""insertions"": 34, ""deletions"": 62, ""lines"": 96}, ""src/version.c"": {""insertions"": 2, ""deletions"": 0, ""lines"": 2}}"
2022-09-20 14:10:31,a22c56a59a1e60f6976e61d16001623424a26b3a,Bram Moolenaar,12,0,12,2,"{""src/testdir/runtest.vim"": {""insertions"": 10, ""deletions"": 0, ""lines"": 10}, ""src/version.c"": {""insertions"": 2, ""deletions"": 0, ""lines"": 2}}"
2022-09-20 12:51:25,9781d9c00517a67c44b50b040cca2c5804daf15c,Bram Moolenaar,34,0,34,4,"{""src/debugger.c"": {""insertions"": 2, ""deletions"": 0, ""lines"": 2}, ""src/proto/regexp.pro"": {""insertions"": 2, ""deletions"": 0, ""lines"": 2}, ""src/regexp.c"": {""insertions"": 28, ""deletions"": 0, ""lines"": 28}, ""src/version.c"": {""insertions"": 2, ""deletions"": 0, ""lines"": 2}}"
2022-09-20 12:17:57,c14bfc31d907cbee6a3636f780561ad1787cdb9b,zeertzjq,19,4,23,5,"{""src/ex_docmd.c"": {""insertions"": 1, ""deletions"": 1, ""lines"": 2}, ""src/testdir/dumps/Test_redrawstatus_in_autocmd_1.dump"": {""insertions"": 2, ""deletions"": 2, ""lines"": 4}, ""src/testdir/dumps/Test_redrawstatus_in_autocmd_2.dump"": {""insertions"": 8, ""deletions"": 0, ""lines"": 8}, ""src/testdir/test_cmdline.vim"": {""insertions"": 6, ""deletions"": 1, ""lines"": 7}, ""src/version.c"": {""insertions"": 2, ""deletions"": 0, ""lines"": 2}}"
2022-09-20 11:45:15,bdedd2bcce3a59028c7504a397ff77d901b1b12a,zeertzjq,36,2,38,3,"{""src/message.c"": {""insertions"": 2, ""deletions"": 2, ""lines"": 4}, ""src/testdir/test_messages.vim"": {""insertions"": 32, ""deletions"": 0, ""lines"": 32}, ""src/version.c"": {""insertions"": 2, ""deletions"": 0, ""lines"": 2}}"
2022-09-20 11:02:28,7c046ae99ba85a4fdf1a546157e2ed6f12b79ea6,ObserverOfTime,6,0,6,3,"{""runtime/filetype.vim"": {""insertions"": 3, ""deletions"": 0, ""lines"": 3}, ""src/testdir/test_filetype.vim"": {""insertions"": 1, ""deletions"": 0, ""lines"": 1}, ""src/version.c"": {""insertions"": 2, ""deletions"": 0, ""lines"": 2}}"
2022-09-20 10:49:10,500a1f9972afa354f0bc77bc535aabf9f5f0116d,Bram Moolenaar,12,3,15,4,"{""src/bufwrite.c"": {""insertions"": 2, ""deletions"": 1, ""lines"": 3}, ""src/errors.h"": {""insertions"": 2, ""deletions"": 2, ""lines"": 4}, ""src/testdir/test_writefile.vim"": {""insertions"": 6, ""deletions"": 0, ""lines"": 6}, ""src/version.c"": {""insertions"": 2, ""deletions"": 0, ""lines"": 2}}"
2022-09-20 10:04:47,cd9fa256b587b2805faeaaa4b7a8c7d483a8ac54,K.Takata,18,4,22,2,"{""src/testdir/test_channel.vim"": {""insertions"": 16, ""deletions"": 4, ""lines"": 20}, ""src/version.c"": {""insertions"": 2, ""deletions"": 0, ""lines"": 2}}"
2022-09-19 20:16:12,bcd6924245c0e73d8be256282656c06aaf91f17c,Bram Moolenaar,34,2,36,4,"{""src/ex_docmd.c"": {""insertions"": 5, ""deletions"": 2, ""lines"": 7}, ""src/testdir/dumps/Test_redrawstatus_in_autocmd_1.dump"": {""insertions"": 8, ""deletions"": 0, ""lines"": 8}, ""src/testdir/test_cmdline.vim"": {""insertions"": 19, ""deletions"": 0, ""lines"": 19}, ""src/version.c"": {""insertions"": 2, ""deletions"": 0, ""lines"": 2}}"
2022-09-19 17:20:08,a2b91036d12e1b406ed5d17bf03f8d1ed05221f6,Bram Moolenaar,16,2,18,3,"{""src/ex_cmds.c"": {""insertions"": 7, ""deletions"": 2, ""lines"": 9}, ""src/testdir/test_buffer.vim"": {""insertions"": 7, ""deletions"": 0, ""lines"": 7}, ""src/version.c"": {""insertions"": 2, ""deletions"": 0, ""lines"": 2}}"
2022-09-19 15:45:29,faf1d412f5e3665021500b528c0e7301eb02bf0b,Luuk van Baal,30,26,56,5,"{""src/globals.h"": {""insertions"": 4, ""deletions"": 0, ""lines"": 4}, ""src/move.c"": {""insertions"": 1, ""deletions"": 1, ""lines"": 2}, ""src/testdir/test_window_cmd.vim"": {""insertions"": 15, ""deletions"": 17, ""lines"": 32}, ""src/version.c"": {""insertions"": 2, ""deletions"": 0, ""lines"": 2}, ""src/window.c"": {""insertions"": 8, ""deletions"": 8, ""lines"": 16}}"
2022-09-19 15:08:04,c9e4a6f1910dea250af69a3774bcf1fee7e7b8f5,Bram Moolenaar,9,5,14,3,"{""src/version.c"": {""insertions"": 2, ""deletions"": 0, ""lines"": 2}, ""src/vim9execute.c"": {""insertions"": 3, ""deletions"": 3, ""lines"": 6}, ""src/vim9expr.c"": {""insertions"": 4, ""deletions"": 2, ""lines"": 6}}"
2022-09-19 15:02:43,65449bd1ee5cebde288a8f0150fe7d54c6c6ef31,Bram Moolenaar,7,4,11,2,"{""src/version.c"": {""insertions"": 2, ""deletions"": 0, ""lines"": 2}, ""src/vim9compile.c"": {""insertions"": 5, ""deletions"": 4, ""lines"": 9}}"
2022-09-19 14:54:34,cc34181f9994d64f8c8fa2f5845eaf0cc963067f,Bram Moolenaar,391,175,566,15,"{""src/errors.h"": {""insertions"": 4, ""deletions"": 0, ""lines"": 4}, ""src/eval.c"": {""insertions"": 15, ""deletions"": 7, ""lines"": 22}, ""src/proto/userfunc.pro"": {""insertions"": 1, ""deletions"": 1, ""lines"": 2}, ""src/proto/vim9cmds.pro"": {""insertions"": 2, ""deletions"": 2, ""lines"": 4}, ""src/proto/vim9execute.pro"": {""insertions"": 2, ""deletions"": 2, ""lines"": 4}, ""src/proto/vim9instr.pro"": {""insertions"": 3, ""deletions"": 3, ""lines"": 6}, ""src/structs.h"": {""insertions"": 19, ""deletions"": 5, ""lines"": 24}, ""src/testdir/test_vim9_disassemble.vim"": {""insertions"": 5, ""deletions"": 5, ""lines"": 10}, ""src/testdir/test_vim9_script.vim"": {""insertions"": 66, ""deletions"": 4, ""lines"": 70}, ""src/userfunc.c"": {""insertions"": 5, ""deletions"": 8, ""lines"": 13}, ""src/version.c"": {""insertions"": 2, ""deletions"": 0, ""lines"": 2}, ""src/vim9.h"": {""insertions"": 16, ""deletions"": 14, ""lines"": 30}, ""src/vim9cmds.c"": {""insertions"": 95, ""deletions"": 35, ""lines"": 130}, ""src/vim9execute.c"": {""insertions"": 133, ""deletions"": 68, ""lines"": 201}, ""src/vim9instr.c"": {""insertions"": 23, ""deletions"": 21, ""lines"": 44}}"
2022-09-19 10:44:11,18ee0feb5dfbe51993dc715d24cf419ac92ebf92,Bram Moolenaar,5,1,6,2,"{""src/screen.c"": {""insertions"": 3, ""deletions"": 1, ""lines"": 4}, ""src/version.c"": {""insertions"": 2, ""deletions"": 0, ""lines"": 2}}"
2022-09-18 14:08:19,b2f0ca820eae50994745106d824e215d87bd7926,Bram Moolenaar,57,11,68,6,"{""src/errors.h"": {""insertions"": 1, ""deletions"": 1, ""lines"": 2}, ""src/ex_getln.c"": {""insertions"": 13, ""deletions"": 6, ""lines"": 19}, ""src/testdir/dumps/Test_cmdwin_wrong_command_1.dump"": {""insertions"": 12, ""deletions"": 0, ""lines"": 12}, ""src/testdir/dumps/Test_cmdwin_wrong_command_2.dump"": {""insertions"": 12, ""deletions"": 0, ""lines"": 12}, ""src/testdir/test_cmdwin.vim"": {""insertions"": 17, ""deletions"": 4, ""lines"": 21}, ""src/version.c"": {""insertions"": 2, ""deletions"": 0, ""lines"": 2}}"
2022-09-18 12:46:08,566badc76ba7c0fbdc75e62f79486182304fc7cc,Bram Moolenaar,10,0,10,3,"{""src/testdir/test_vim9_assign.vim"": {""insertions"": 7, ""deletions"": 0, ""lines"": 7}, ""src/version.c"": {""insertions"": 2, ""deletions"": 0, ""lines"": 2}, ""src/vim9execute.c"": {""insertions"": 1, ""deletions"": 0, ""lines"": 1}}"
2022-09-18 12:06:41,747f110420a0b0f4c2e40e00e8456f1e45b6f0de,Bram Moolenaar,30,28,58,8,"{""src/arglist.c"": {""insertions"": 4, ""deletions"": 2, ""lines"": 6}, ""src/cmdexpand.c"": {""insertions"": 1, ""deletions"": 0, ""lines"": 1}, ""src/debugger.c"": {""insertions"": 1, ""deletions"": 1, ""lines"": 2}, ""src/findfile.c"": {""insertions"": 6, ""deletions"": 5, ""lines"": 11}, ""src/if_xcmdsrv.c"": {""insertions"": 1, ""deletions"": 1, ""lines"": 2}, ""src/testdir/test_lambda.vim"": {""insertions"": 1, ""deletions"": 3, ""lines"": 4}, ""src/testdir/test_vim9_cmd.vim"": {""insertions"": 14, ""deletions"": 16, ""lines"": 30}, ""src/version.c"": {""insertions"": 2, ""deletions"": 0, ""lines"": 2}}"
2022-09-18 12:04:22,9712ff1288f942736ed76c0dec014909f067eec9,Bram Moolenaar,683,311,994,32,"{"".github/CODEOWNERS"": {""insertions"": 4, ""deletions"": 0, ""lines"": 4}, ""runtime/colors/lunaperche.vim"": {""insertions"": 145, ""deletions"": 105, ""lines"": 250}, ""runtime/colors/pablo.vim"": {""insertions"": 1, ""deletions"": 2, ""lines"": 3}, ""runtime/colors/quiet.vim"": {""insertions"": 22, ""deletions"": 22, ""lines"": 44}, ""runtime/doc/builtin.txt"": {""insertions"": 1, ""deletions"": 1, ""lines"": 2}, ""runtime/doc/change.txt"": {""insertions"": 15, ""deletions"": 6, ""lines"": 21}, ""runtime/doc/eval.txt"": {""insertions"": 1, ""deletions"": 1, ""lines"": 2}, ""runtime/doc/intro.txt"": {""insertions"": 5, ""deletions"": 1, ""lines"": 6}, ""runtime/doc/map.txt"": {""insertions"": 2, ""deletions"": 2, ""lines"": 4}, ""runtime/doc/mlang.txt"": {""insertions"": 1, ""deletions"": 1, ""lines"": 2}, ""runtime/doc/os_win32.txt"": {""insertions"": 1, ""deletions"": 1, ""lines"": 2}, ""runtime/doc/quickref.txt"": {""insertions"": 2, ""deletions"": 2, ""lines"": 4}, ""runtime/doc/spell.txt"": {""insertions"": 1, ""deletions"": 1, ""lines"": 2}, ""runtime/doc/tags"": {""insertions"": 11, ""deletions"": 1, ""lines"": 12}, ""runtime/doc/textprop.txt"": {""insertions"": 5, ""deletions"": 3, ""lines"": 8}, ""runtime/doc/todo.txt"": {""insertions"": 42, ""deletions"": 10, ""lines"": 52}, ""runtime/doc/userfunc.txt"": {""insertions"": 2, ""deletions"": 2, ""lines"": 4}, ""runtime/doc/various.txt"": {""insertions"": 1, ""deletions"": 1, ""lines"": 2}, ""runtime/doc/vim9.txt"": {""insertions"": 12, ""deletions"": 13, ""lines"": 25}, ""runtime/filetype.vim"": {""insertions"": 1, ""deletions"": 1, ""lines"": 2}, ""runtime/ftplugin/crontab.vim"": {""insertions"": 16, ""deletions"": 0, ""lines"": 16}, ""runtime/ftplugin/gdscript.vim"": {""insertions"": 16, ""deletions"": 11, ""lines"": 27}, ""runtime/ftplugin/gdshader.vim"": {""insertions"": 1, ""deletions"": 0, ""lines"": 1}, ""runtime/ftplugin/vdf.vim"": {""insertions"": 14, ""deletions"": 0, ""lines"": 14}, ""runtime/indent/lua.vim"": {""insertions"": 3, ""deletions"": 0, ""lines"": 3}, ""runtime/optwin.vim"": {""insertions"": 1, ""deletions"": 1, ""lines"": 2}, ""runtime/syntax/gdscript.vim"": {""insertions"": 5, ""deletions"": 7, ""lines"": 12}, ""runtime/syntax/lua.vim"": {""insertions"": 171, ""deletions"": 94, ""lines"": 265}, ""runtime/syntax/lyrics.vim"": {""insertions"": 43, ""deletions"": 0, ""lines"": 43}, ""runtime/syntax/srt.vim"": {""insertions"": 62, ""deletions"": 0, ""lines"": 62}, ""runtime/syntax/vdf.vim"": {""insertions"": 54, ""deletions"": 0, ""lines"": 54}, ""runtime/syntax/vim.vim"": {""insertions"": 22, ""deletions"": 22, ""lines"": 44}}"
2022-09-18 11:46:22,65ee49decf5677690cd695d5d288e39344965fff,ObserverOfTime,6,0,6,3,"{""runtime/filetype.vim"": {""insertions"": 3, ""deletions"": 0, ""lines"": 3}, ""src/testdir/test_filetype.vim"": {""insertions"": 1, ""deletions"": 0, ""lines"": 1}, ""src/version.c"": {""insertions"": 2, ""deletions"": 0, ""lines"": 2}}"
2022-09-18 11:25:49,27b53be3a6a340f1858bcd31233fe2efc86f8e15,K.Takata,70,131,201,10,"{""README.md"": {""insertions"": 4, ""deletions"": 4, ""lines"": 8}, ""README.txt"": {""insertions"": 3, ""deletions"": 3, ""lines"": 6}, ""runtime/doc/gui_w32.txt"": {""insertions"": 1, ""deletions"": 2, ""lines"": 3}, ""runtime/doc/os_win32.txt"": {""insertions"": 5, ""deletions"": 2, ""lines"": 7}, ""src/INSTALLpc.txt"": {""insertions"": 18, ""deletions"": 17, ""lines"": 35}, ""src/Make_cyg_ming.mak"": {""insertions"": 3, ""deletions"": 4, ""lines"": 7}, ""src/Make_mvc.mak"": {""insertions"": 21, ""deletions"": 21, ""lines"": 42}, ""src/os_mswin.c"": {""insertions"": 2, ""deletions"": 23, ""lines"": 25}, ""src/os_win32.c"": {""insertions"": 11, ""deletions"": 55, ""lines"": 66}, ""src/version.c"": {""insertions"": 2, ""deletions"": 0, ""lines"": 2}}"
2022-09-18 11:00:21,dbbb02bc770646776a04122ff58313d170873e67,Bram Moolenaar,30,2,32,3,"{""src/testdir/test_vim9_script.vim"": {""insertions"": 26, ""deletions"": 0, ""lines"": 26}, ""src/version.c"": {""insertions"": 2, ""deletions"": 0, ""lines"": 2}, ""src/vim9execute.c"": {""insertions"": 2, ""deletions"": 2, ""lines"": 4}}"
2022-09-17 20:57:43,96caa557f92f7e1fd61d4b401fefd30c91eb44f0,Bram Moolenaar,8,5,13,2,"{""src/macros.h"": {""insertions"": 6, ""deletions"": 5, ""lines"": 11}, ""src/version.c"": {""insertions"": 2, ""deletions"": 0, ""lines"": 2}}"
2022-09-17 20:24:49,1e8009e34a68b0fa5a47ef485d88a0cb11ec5687,Bram Moolenaar,2,2,4,2,"{""src/if_perl.xs"": {""insertions"": 0, ""deletions"": 2, ""lines"": 2}, ""src/version.c"": {""insertions"": 2, ""deletions"": 0, ""lines"": 2}}"
2022-09-17 20:20:42,312af65d1ac763c060cb5adfcf8ae5beeec97f59,Bram Moolenaar,5,0,5,2,"{""src/testdir/test_cmdwin.vim"": {""insertions"": 3, ""deletions"": 0, ""lines"": 3}, ""src/version.c"": {""insertions"": 2, ""deletions"": 0, ""lines"": 2}}"
2022-09-17 20:08:33,73e28dcc6125f616cf1f2d56443d22428a79e434,Bram Moolenaar,605,1168,1773,74,"{""runtime/doc/builtin.txt"": {""insertions"": 1, ""deletions"": 52, ""lines"": 53}, ""runtime/doc/eval.txt"": {""insertions"": 0, ""deletions"": 2, ""lines"": 2}, ""runtime/doc/mlang.txt"": {""insertions"": 3, ""deletions"": 3, ""lines"": 6}, ""runtime/doc/various.txt"": {""insertions"": 1, ""deletions"": 1, ""lines"": 2}, ""src/auto/configure"": {""insertions"": 0, ""deletions"": 42, ""lines"": 42}, ""src/config.h.in"": {""insertions"": 0, ""deletions"": 1, ""lines"": 1}, ""src/configure.ac"": {""insertions"": 1, ""deletions"": 25, ""lines"": 26}, ""src/dict.c"": {""insertions"": 0, ""deletions"": 2, ""lines"": 2}, ""src/errors.h"": {""insertions"": 3, ""deletions"": 16, ""lines"": 19}, ""src/eval.c"": {""insertions"": 6, ""deletions"": 59, ""lines"": 65}, ""src/evalfunc.c"": {""insertions"": 26, ""deletions"": 39, ""lines"": 65}, ""src/ex_cmds.c"": {""insertions"": 2, ""deletions"": 20, ""lines"": 22}, ""src/feature.h"": {""insertions"": 1, ""deletions"": 4, ""lines"": 5}, ""src/float.c"": {""insertions"": 1, ""deletions"": 1, ""lines"": 2}, ""src/gui_gtk_x11.c"": {""insertions"": 1, ""deletions"": 1, ""lines"": 2}, ""src/gui_x11.c"": {""insertions"": 1, ""deletions"": 1, ""lines"": 2}, ""src/if_lua.c"": {""insertions"": 0, ""deletions"": 7, ""lines"": 7}, ""src/if_mzsch.c"": {""insertions"": 0, ""deletions"": 4, ""lines"": 4}, ""src/if_py_both.h"": {""insertions"": 0, ""deletions"": 6, ""lines"": 6}, ""src/if_ruby.c"": {""insertions"": 0, ""deletions"": 4, ""lines"": 4}, ""src/json.c"": {""insertions"": 9, ""deletions"": 16, ""lines"": 25}, ""src/list.c"": {""insertions"": 0, ""deletions"": 8, ""lines"": 8}, ""src/locale.c"": {""insertions"": 2, ""deletions"": 2, ""lines"": 4}, ""src/macros.h"": {""insertions"": 1, ""deletions"": 1, ""lines"": 2}, ""src/message_test.c"": {""insertions"": 0, ""deletions"": 2, ""lines"": 2}, ""src/os_mac_conv.c"": {""insertions"": 1, ""deletions"": 1, ""lines"": 2}, ""src/os_vms_conf.h"": {""insertions"": 0, ""deletions"": 1, ""lines"": 1}, ""src/profiler.c"": {""insertions"": 4, ""deletions"": 6, ""lines"": 10}, ""src/session.c"": {""insertions"": 0, ""deletions"": 2, ""lines"": 2}, ""src/strings.c"": {""insertions"": 6, ""deletions"": 16, ""lines"": 22}, ""src/structs.h"": {""insertions"": 0, ""deletions"": 2, ""lines"": 2}, ""src/syntax.c"": {""insertions"": 2, ""deletions"": 4, ""lines"": 6}, ""src/testdir/runtest.vim"": {""insertions"": 2, ""deletions"": 2, ""lines"": 4}, ""src/testdir/test_assert.vim"": {""insertions"": 13, ""deletions"": 15, ""lines"": 28}, ""src/testdir/test_blob.vim"": {""insertions"": 1, ""deletions"": 3, ""lines"": 4}, ""src/testdir/test_cscope.vim"": {""insertions"": 17, ""deletions"": 19, ""lines"": 36}, ""src/testdir/test_eval_stuff.vim"": {""insertions"": 6, ""deletions"": 12, ""lines"": 18}, ""src/testdir/test_execute_func.vim"": {""insertions"": 3, ""deletions"": 5, ""lines"": 8}, ""src/testdir/test_expr.vim"": {""insertions"": 115, ""deletions"": 129, ""lines"": 244}, ""src/testdir/test_float_func.vim"": {""insertions"": 0, ""deletions"": 1, ""lines"": 1}, ""src/testdir/test_functions.vim"": {""insertions"": 13, ""deletions"": 23, ""lines"": 36}, ""src/testdir/test_glob2regpat.vim"": {""insertions"": 2, ""deletions"": 4, ""lines"": 6}, ""src/testdir/test_json.vim"": {""insertions"": 22, ""deletions"": 34, ""lines"": 56}, ""src/testdir/test_listdict.vim"": {""insertions"": 14, ""deletions"": 20, ""lines"": 34}, ""src/testdir/test_lua.vim"": {""insertions"": 0, ""deletions"": 1, ""lines"": 1}, ""src/testdir/test_messages.vim"": {""insertions"": 2, ""deletions"": 6, ""lines"": 8}, ""src/testdir/test_method.vim"": {""insertions"": 0, ""deletions"": 1, ""lines"": 1}, ""src/testdir/test_perl.vim"": {""insertions"": 1, ""deletions"": 5, ""lines"": 6}, ""src/testdir/test_python2.vim"": {""insertions"": 1, ""deletions"": 4, ""lines"": 5}, ""src/testdir/test_python3.vim"": {""insertions"": 9, ""deletions"": 14, ""lines"": 23}, ""src/testdir/test_random.vim"": {""insertions"": 1, ""deletions"": 3, ""lines"": 4}, ""src/testdir/test_reltime.vim"": {""insertions"": 0, ""deletions"": 1, ""lines"": 1}, ""src/testdir/test_ruby.vim"": {""insertions"": 2, ""deletions"": 4, ""lines"": 6}, ""src/testdir/test_sort.vim"": {""insertions"": 26, ""deletions"": 31, ""lines"": 57}, ""src/testdir/test_substitute.vim"": {""insertions"": 0, ""deletions"": 2, ""lines"": 2}, ""src/testdir/test_terminal.vim"": {""insertions"": 1, ""deletions"": 3, ""lines"": 4}, ""src/testdir/test_true_false.vim"": {""insertions"": 1, ""deletions"": 4, ""lines"": 5}, ""src/testdir/test_user_func.vim"": {""insertions"": 3, ""deletions"": 5, ""lines"": 8}, ""src/testdir/test_vim9_assign.vim"": {""insertions"": 23, ""deletions"": 35, ""lines"": 58}, ""src/testdir/test_vim9_builtin.vim"": {""insertions"": 8, ""deletions"": 18, ""lines"": 26}, ""src/testdir/test_vim9_disassemble.vim"": {""insertions"": 33, ""deletions"": 41, ""lines"": 74}, ""src/testdir/test_vim9_expr.vim"": {""insertions"": 144, ""deletions"": 198, ""lines"": 342}, ""src/testdir/test_vimscript.vim"": {""insertions"": 63, ""deletions"": 89, ""lines"": 152}, ""src/testing.c"": {""insertions"": 0, ""deletions"": 2, ""lines"": 2}, ""src/time.c"": {""insertions"": 4, ""deletions"": 6, ""lines"": 10}, ""src/typval.c"": {""insertions"": 0, ""deletions"": 18, ""lines"": 18}, ""src/version.c"": {""insertions"": 2, ""deletions"": 4, ""lines"": 6}, ""src/vim9.h"": {""insertions"": 0, ""deletions"": 2, ""lines"": 2}, ""src/vim9compile.c"": {""insertions"": 0, ""deletions"": 4, ""lines"": 4}, ""src/vim9execute.c"": {""insertions"": 0, ""deletions"": 24, ""lines"": 24}, ""src/vim9expr.c"": {""insertions"": 0, ""deletions"": 2, ""lines"": 2}, ""src/vim9instr.c"": {""insertions"": 1, ""deletions"": 13, ""lines"": 14}, ""src/vim9type.c"": {""insertions"": 0, ""deletions"": 6, ""lines"": 6}, ""src/viminfo.c"": {""insertions"": 0, ""deletions"": 4, ""lines"": 4}}"
2022-09-17 18:43:23,1c3dd8ddcba63c1af5112e567215b3cec2de11d0,Bram Moolenaar,18,2,20,3,"{""src/ex_getln.c"": {""insertions"": 6, ""deletions"": 2, ""lines"": 8}, ""src/testdir/test_cmdwin.vim"": {""insertions"": 10, ""deletions"": 0, ""lines"": 10}, ""src/version.c"": {""insertions"": 2, ""deletions"": 0, ""lines"": 2}}"
2022-09-17 17:57:36,fb593c5350e8fe23b608ded5a011cd7eefe73922,Bram Moolenaar,25,2,27,4,"{""src/errors.h"": {""insertions"": 4, ""deletions"": 0, ""lines"": 4}, ""src/testdir/test_textprop.vim"": {""insertions"": 11, ""deletions"": 2, ""lines"": 13}, ""src/textprop.c"": {""insertions"": 8, ""deletions"": 0, ""lines"": 8}, ""src/version.c"": {""insertions"": 2, ""deletions"": 0, ""lines"": 2}}"
2022-09-17 16:15:33,4c7fd4d68f69b4e420a5448f144f4d57eda22f8c,Bram Moolenaar,19,0,19,4,"{""src/charset.c"": {""insertions"": 3, ""deletions"": 0, ""lines"": 3}, ""src/testdir/dumps/Test_prop_with_text_above_1c.dump"": {""insertions"": 9, ""deletions"": 0, ""lines"": 9}, ""src/testdir/test_textprop.vim"": {""insertions"": 5, ""deletions"": 0, ""lines"": 5}, ""src/version.c"": {""insertions"": 2, ""deletions"": 0, ""lines"": 2}}"
2022-09-17 15:27:39,acd6b9976bd939035025a16ceb4213a680827927,Bram Moolenaar,31,19,50,4,"{""src/eval.c"": {""insertions"": 7, ""deletions"": 2, ""lines"": 9}, ""src/proto/vim9execute.pro"": {""insertions"": 1, ""deletions"": 1, ""lines"": 2}, ""src/version.c"": {""insertions"": 2, ""deletions"": 0, ""lines"": 2}, ""src/vim9execute.c"": {""insertions"": 21, ""deletions"": 16, ""lines"": 37}}"
2022-09-17 15:16:35,d5bc762dea1fd32fa04342f8149f95ccfc3b9709,Luuk van Baal,35,6,41,3,"{""src/testdir/test_window_cmd.vim"": {""insertions"": 30, ""deletions"": 0, ""lines"": 30}, ""src/version.c"": {""insertions"": 2, ""deletions"": 0, ""lines"": 2}, ""src/window.c"": {""insertions"": 3, ""deletions"": 6, ""lines"": 9}}"
2022-09-17 14:44:52,0cdfb7ce462393595b0308dcabf343e82f05319d,Bram Moolenaar,222,23,245,6,"{""src/eval.c"": {""insertions"": 17, ""deletions"": 2, ""lines"": 19}, ""src/proto/vim9execute.pro"": {""insertions"": 2, ""deletions"": 0, ""lines"": 2}, ""src/structs.h"": {""insertions"": 19, ""deletions"": 2, ""lines"": 21}, ""src/testdir/test_vim9_script.vim"": {""insertions"": 2, ""deletions"": 6, ""lines"": 8}, ""src/version.c"": {""insertions"": 2, ""deletions"": 0, ""lines"": 2}, ""src/vim9execute.c"": {""insertions"": 180, ""deletions"": 13, ""lines"": 193}}"
2022-09-17 11:39:58,8abb584ab85d5855d810d1c6e2b260f45ec839b7,Bram Moolenaar,167,67,234,4,"{""src/testdir/test_vim9_disassemble.vim"": {""insertions"": 79, ""deletions"": 0, ""lines"": 79}, ""src/version.c"": {""insertions"": 2, ""deletions"": 0, ""lines"": 2}, ""src/vim9.h"": {""insertions"": 9, ""deletions"": 6, ""lines"": 15}, ""src/vim9cmds.c"": {""insertions"": 77, ""deletions"": 61, ""lines"": 138}}"
2022-09-16 21:16:59,c249913edc35c0e666d783bfc21595cf9f7d9e0d,Bram Moolenaar,26,2,28,3,"{""src/ops.c"": {""insertions"": 10, ""deletions"": 2, ""lines"": 12}, ""src/testdir/test_virtualedit.vim"": {""insertions"": 14, ""deletions"": 0, ""lines"": 14}, ""src/version.c"": {""insertions"": 2, ""deletions"": 0, ""lines"": 2}}"
2022-09-16 19:51:14,e24b4aba1fbf782954897abdbfc084c4221428eb,Bram Moolenaar,74,28,102,7,"{""src/move.c"": {""insertions"": 19, ""deletions"": 9, ""lines"": 28}, ""src/normal.c"": {""insertions"": 29, ""deletions"": 19, ""lines"": 48}, ""src/proto/move.pro"": {""insertions"": 1, ""deletions"": 0, ""lines"": 1}, ""src/testdir/dumps/Test_prop_with_text_above_1a.dump"": {""insertions"": 9, ""deletions"": 0, ""lines"": 9}, ""src/testdir/dumps/Test_prop_with_text_above_1b.dump"": {""insertions"": 9, ""deletions"": 0, ""lines"": 9}, ""src/testdir/test_textprop.vim"": {""insertions"": 5, ""deletions"": 0, ""lines"": 5}, ""src/version.c"": {""insertions"": 2, ""deletions"": 0, ""lines"": 2}}"
2022-09-16 18:04:24,8fa745e7be3a791ac25f93ef0227bbc48ade8a37,Bram Moolenaar,285,77,362,13,"{""src/proto/userfunc.pro"": {""insertions"": 1, ""deletions"": 1, ""lines"": 2}, ""src/proto/vim9cmds.pro"": {""insertions"": 2, ""deletions"": 0, ""lines"": 2}, ""src/proto/vim9execute.pro"": {""insertions"": 1, ""deletions"": 1, ""lines"": 2}, ""src/proto/vim9instr.pro"": {""insertions"": 2, ""deletions"": 2, ""lines"": 4}, ""src/structs.h"": {""insertions"": 11, ""deletions"": 3, ""lines"": 14}, ""src/userfunc.c"": {""insertions"": 8, ""deletions"": 2, ""lines"": 10}, ""src/version.c"": {""insertions"": 2, ""deletions"": 0, ""lines"": 2}, ""src/vim9.h"": {""insertions"": 20, ""deletions"": 4, ""lines"": 24}, ""src/vim9cmds.c"": {""insertions"": 43, ""deletions"": 0, ""lines"": 43}, ""src/vim9compile.c"": {""insertions"": 4, ""deletions"": 2, ""lines"": 6}, ""src/vim9execute.c"": {""insertions"": 93, ""deletions"": 34, ""lines"": 127}, ""src/vim9expr.c"": {""insertions"": 4, ""deletions"": 1, ""lines"": 5}, ""src/vim9instr.c"": {""insertions"": 94, ""deletions"": 27, ""lines"": 121}}"
2022-09-16 15:06:32,abd58d8aee7fec2b9e07c829eb925b0a1f7118db,zeertzjq,7,1,8,3,"{""src/regexp.c"": {""insertions"": 1, ""deletions"": 1, ""lines"": 2}, ""src/testdir/test_substitute.vim"": {""insertions"": 4, ""deletions"": 0, ""lines"": 4}, ""src/version.c"": {""insertions"": 2, ""deletions"": 0, ""lines"": 2}}"
2022-09-16 14:47:09,1aea184a0dc558a222cc5bcbaad9ab0fd700c7b9,Bram Moolenaar,6,0,6,3,"{""runtime/filetype.vim"": {""insertions"": 3, ""deletions"": 0, ""lines"": 3}, ""src/testdir/test_filetype.vim"": {""insertions"": 1, ""deletions"": 0, ""lines"": 1}, ""src/version.c"": {""insertions"": 2, ""deletions"": 0, ""lines"": 2}}"
2022-09-16 11:52:58,594f9e09cd68e6277b8aa08094405bc642c5792a,Luuk van Baal,122,124,246,4,"{""runtime/optwin.vim"": {""insertions"": 1, ""deletions"": 1, ""lines"": 2}, ""src/testdir/test_window_cmd.vim"": {""insertions"": 113, ""deletions"": 120, ""lines"": 233}, ""src/version.c"": {""insertions"": 2, ""deletions"": 0, ""lines"": 2}, ""src/window.c"": {""insertions"": 6, ""deletions"": 3, ""lines"": 9}}"
2022-09-16 11:28:34,3e8b7a6056986caf561f1b6168af7837919df9b9,Bram Moolenaar,8,1,9,3,"{""src/Makefile"": {""insertions"": 1, ""deletions"": 1, ""lines"": 2}, ""src/version.c"": {""insertions"": 2, ""deletions"": 0, ""lines"": 2}, ""src/vim9type.c"": {""insertions"": 5, ""deletions"": 0, ""lines"": 5}}"
2022-09-16 11:10:03,48db5dafecacced4a9e42de3f92838b2d59beb4c,zeertzjq,20,14,34,5,"{""src/regexp.c"": {""insertions"": 2, ""deletions"": 2, ""lines"": 4}, ""src/structs.h"": {""insertions"": 4, ""deletions"": 4, ""lines"": 8}, ""src/testdir/test_substitute.vim"": {""insertions"": 11, ""deletions"": 7, ""lines"": 18}, ""src/userfunc.c"": {""insertions"": 1, ""deletions"": 1, ""lines"": 2}, ""src/version.c"": {""insertions"": 2, ""deletions"": 0, ""lines"": 2}}"
2022-09-15 21:26:18,dd674774bbe3774ff41b817bee0e32060ebcfdad,Bram Moolenaar,42,62,104,2,"{""src/testdir/test_vim9_script.vim"": {""insertions"": 40, ""deletions"": 62, ""lines"": 102}, ""src/version.c"": {""insertions"": 2, ""deletions"": 0, ""lines"": 2}}"
2022-09-15 21:03:57,dd44b58f64a173ffc976cc96ccdd00cd5493b273,Bram Moolenaar,3,1,4,2,"{""src/evalfunc.c"": {""insertions"": 1, ""deletions"": 1, ""lines"": 2}, ""src/version.c"": {""insertions"": 2, ""deletions"": 0, ""lines"": 2}}"
2022-09-15 20:46:02,aa5341477c9f3840d63f709de3b9e5d0266f93d7,Bram Moolenaar,45,11,56,5,"{""runtime/doc/builtin.txt"": {""insertions"": 10, ""deletions"": 4, ""lines"": 14}, ""src/ex_docmd.c"": {""insertions"": 23, ""deletions"": 7, ""lines"": 30}, ""src/testdir/test_cmdline.vim"": {""insertions"": 3, ""deletions"": 0, ""lines"": 3}, ""src/testdir/test_vim9_builtin.vim"": {""insertions"": 7, ""deletions"": 0, ""lines"": 7}, ""src/version.c"": {""insertions"": 2, ""deletions"": 0, ""lines"": 2}}"
2022-09-15 18:44:09,a4abe514ecd9b7a038feed89f48476809775c80f,Bram Moolenaar,18,0,18,4,"{""src/drawline.c"": {""insertions"": 5, ""deletions"": 0, ""lines"": 5}, ""src/testdir/dumps/Test_prop_text_with_padding_4.dump"": {""insertions"": 8, ""deletions"": 0, ""lines"": 8}, ""src/testdir/test_textprop.vim"": {""insertions"": 3, ""deletions"": 0, ""lines"": 3}, ""src/version.c"": {""insertions"": 2, ""deletions"": 0, ""lines"": 2}}"
2022-09-15 16:44:07,12167d8b84c4a99751d9928f1a9a59c90b14931f,mityu,28,0,28,2,"{""src/testdir/test_window_cmd.vim"": {""insertions"": 26, ""deletions"": 0, ""lines"": 26}, ""src/version.c"": {""insertions"": 2, ""deletions"": 0, ""lines"": 2}}"
2022-09-15 16:19:37,b46c083a5ed9e0c4ac5f3aec577946dcbe8c9dc5,Bram Moolenaar,315,58,373,8,"{""src/proto/vim9instr.pro"": {""insertions"": 2, ""deletions"": 1, ""lines"": 3}, ""src/testdir/test_vim9_disassemble.vim"": {""insertions"": 35, ""deletions"": 14, ""lines"": 49}, ""src/version.c"": {""insertions"": 2, ""deletions"": 0, ""lines"": 2}, ""src/vim9.h"": {""insertions"": 29, ""deletions"": 2, ""lines"": 31}, ""src/vim9cmds.c"": {""insertions"": 102, ""deletions"": 24, ""lines"": 126}, ""src/vim9compile.c"": {""insertions"": 6, ""deletions"": 0, ""lines"": 6}, ""src/vim9execute.c"": {""insertions"": 96, ""deletions"": 16, ""lines"": 112}, ""src/vim9instr.c"": {""insertions"": 43, ""deletions"": 1, ""lines"": 44}}"
2022-09-15 11:43:26,3735f11050616652525bf80b4fbcb2b3bfeab113,Luuk van Baal,13,4,17,4,"{""src/ex_getln.c"": {""insertions"": 2, ""deletions"": 4, ""lines"": 6}, ""src/globals.h"": {""insertions"": 5, ""deletions"": 0, ""lines"": 5}, ""src/version.c"": {""insertions"": 2, ""deletions"": 0, ""lines"": 2}, ""src/window.c"": {""insertions"": 4, ""deletions"": 0, ""lines"": 4}}"
2022-09-15 11:20:18,aeef1f7f6d8f6d4e84ffc9a24874f10403e4ddcd,Bram Moolenaar,5,0,5,2,"{""src/scriptfile.c"": {""insertions"": 3, ""deletions"": 0, ""lines"": 3}, ""src/version.c"": {""insertions"": 2, ""deletions"": 0, ""lines"": 2}}"
2022-09-14 21:30:59,d3922afbd6f56e82c7b5fd7a7ebc0769e416cae8,Bram Moolenaar,4,1,5,2,"{""src/ex_cmds.c"": {""insertions"": 2, ""deletions"": 1, ""lines"": 3}, ""src/version.c"": {""insertions"": 2, ""deletions"": 0, ""lines"": 2}}"
2022-09-14 21:13:59,ebd0e8bb853cb744b60bf4f57011c4379ae4aaed,Bram Moolenaar,60,12,72,6,"{""src/change.c"": {""insertions"": 8, ""deletions"": 1, ""lines"": 9}, ""src/proto/textprop.pro"": {""insertions"": 1, ""deletions"": 1, ""lines"": 2}, ""src/testdir/dumps/Test_prop_below_split_line_1.dump"": {""insertions"": 8, ""deletions"": 0, ""lines"": 8}, ""src/testdir/test_textprop.vim"": {""insertions"": 24, ""deletions"": 2, ""lines"": 26}, ""src/textprop.c"": {""insertions"": 17, ""deletions"": 8, ""lines"": 25}, ""src/version.c"": {""insertions"": 2, ""deletions"": 0, ""lines"": 2}}"
2022-09-14 16:27:36,e697d488901b6321ddaad68b553f0a434c97d849,mityu,13,2,15,3,"{""src/ex_getln.c"": {""insertions"": 5, ""deletions"": 0, ""lines"": 5}, ""src/testdir/test_window_cmd.vim"": {""insertions"": 6, ""deletions"": 2, ""lines"": 8}, ""src/version.c"": {""insertions"": 2, ""deletions"": 0, ""lines"": 2}}"
2022-09-14 15:09:57,702bd6c7c61073c0907fd7608911aebee4acd337,Bram Moolenaar,28,1,29,5,"{""src/charset.c"": {""insertions"": 1, ""deletions"": 1, ""lines"": 2}, ""src/globals.h"": {""insertions"": 3, ""deletions"": 0, ""lines"": 3}, ""src/indent.c"": {""insertions"": 6, ""deletions"": 0, ""lines"": 6}, ""src/testdir/test_textprop.vim"": {""insertions"": 16, ""deletions"": 0, ""lines"": 16}, ""src/version.c"": {""insertions"": 2, ""deletions"": 0, ""lines"": 2}}"
2022-09-14 11:51:49,febe13892ede37d2a8462b9921e05a55e059db0c,Dominique Pelle,4,2,6,2,"{""src/testdir/test_cmdline.vim"": {""insertions"": 2, ""deletions"": 2, ""lines"": 4}, ""src/version.c"": {""insertions"": 2, ""deletions"": 0, ""lines"": 2}}"
2022-09-14 11:06:53,98b373075e9a2ed642bc89f4f543e31d1428466f,Bram Moolenaar,3,1,4,2,"{""src/textprop.c"": {""insertions"": 1, ""deletions"": 1, ""lines"": 2}, ""src/version.c"": {""insertions"": 2, ""deletions"": 0, ""lines"": 2}}"
2022-09-14 00:27:23,470a14140bc06f1653edf26ab0b3c9b801080353,Luuk van Baal,6,1,7,4,"{""src/main.c"": {""insertions"": 2, ""deletions"": 1, ""lines"": 3}, ""src/testdir/test_window_cmd.vim"": {""insertions"": 1, ""deletions"": 0, ""lines"": 1}, ""src/version.c"": {""insertions"": 2, ""deletions"": 0, ""lines"": 2}, ""src/window.c"": {""insertions"": 1, ""deletions"": 0, ""lines"": 1}}"
2022-09-13 23:30:51,766ae5b252eaa6ee2bff70f1913d1cbfb51101bd,Bram Moolenaar,86,25,111,11,"{""src/eval.c"": {""insertions"": 2, ""deletions"": 17, ""lines"": 19}, ""src/evalvars.c"": {""insertions"": 8, ""deletions"": 0, ""lines"": 8}, ""src/ex_eval.c"": {""insertions"": 12, ""deletions"": 1, ""lines"": 13}, ""src/proto/vim9compile.pro"": {""insertions"": 1, ""deletions"": 0, ""lines"": 1}, ""src/structs.h"": {""insertions"": 17, ""deletions"": 0, ""lines"": 17}, ""src/testdir/dumps/Test_vim9_closure_fails.dump"": {""insertions"": 5, ""deletions"": 5, ""lines"": 10}, ""src/testdir/test_vim9_func.vim"": {""insertions"": 4, ""deletions"": 2, ""lines"": 6}, ""src/testdir/test_vim9_script.vim"": {""insertions"": 14, ""deletions"": 0, ""lines"": 14}, ""src/version.c"": {""insertions"": 2, ""deletions"": 0, ""lines"": 2}, ""src/vim.h"": {""insertions"": 1, ""deletions"": 0, ""lines"": 1}, ""src/vim9compile.c"": {""insertions"": 20, ""deletions"": 0, ""lines"": 20}}"
2022-09-13 20:10:45,353b68a99189875a8460124d44fc33eae6def74e,Bram Moolenaar,21,6,27,3,"{""src/ex_eval.c"": {""insertions"": 11, ""deletions"": 2, ""lines"": 13}, ""src/testdir/test_vim9_script.vim"": {""insertions"": 8, ""deletions"": 4, ""lines"": 12}, ""src/version.c"": {""insertions"": 2, ""deletions"": 0, ""lines"": 2}}"
2022-09-13 17:34:18,3b93cf218fc70897c11de0415221e7899e9a527a,Bram Moolenaar,23,5,28,4,"{""src/testdir/dumps/Test_prop_with_text_above_8.dump"": {""insertions"": 9, ""deletions"": 0, ""lines"": 9}, ""src/testdir/test_textprop.vim"": {""insertions"": 3, ""deletions"": 0, ""lines"": 3}, ""src/textprop.c"": {""insertions"": 9, ""deletions"": 5, ""lines"": 14}, ""src/version.c"": {""insertions"": 2, ""deletions"": 0, ""lines"": 2}}"
2022-09-13 12:45:26,a04f457a6c071179bac4088c9314007d39d5c5e0,Bram Moolenaar,30,0,30,4,"{""src/ex_cmds.c"": {""insertions"": 4, ""deletions"": 0, ""lines"": 4}, ""src/testdir/dumps/Test_sub_highlight_zer_match_1.dump"": {""insertions"": 8, ""deletions"": 0, ""lines"": 8}, ""src/testdir/test_substitute.vim"": {""insertions"": 16, ""deletions"": 0, ""lines"": 16}, ""src/version.c"": {""insertions"": 2, ""deletions"": 0, ""lines"": 2}}"
2022-09-13 11:36:57,b1842de5ca77205993e8ef76cf29803822e0e3ab,Bram Moolenaar,7,0,7,2,"{""src/debugger.c"": {""insertions"": 5, ""deletions"": 0, ""lines"": 5}, ""src/version.c"": {""insertions"": 2, ""deletions"": 0, ""lines"": 2}}"
2022-09-13 10:55:10,5ed391708a62b4ebaa84dd23e32a416e5c3383d9,Luuk van Baal,28,15,43,5,"{""src/main.c"": {""insertions"": 1, ""deletions"": 1, ""lines"": 2}, ""src/menu.c"": {""insertions"": 1, ""deletions"": 0, ""lines"": 1}, ""src/testdir/test_window_cmd.vim"": {""insertions"": 15, ""deletions"": 10, ""lines"": 25}, ""src/version.c"": {""insertions"": 2, ""deletions"": 0, ""lines"": 2}, ""src/window.c"": {""insertions"": 9, ""deletions"": 4, ""lines"": 13}}"
2022-09-13 10:25:54,810cb5a3bf73ff4b084f483aa87cd49c1111bfa9,Your Name,4,6,10,2,"{""src/gui_gtk_x11.c"": {""insertions"": 2, ""deletions"": 6, ""lines"": 8}, ""src/version.c"": {""insertions"": 2, ""deletions"": 0, ""lines"": 2}}"
2022-09-12 19:35:28,83a19c5fda0556330860899bfb484addf9178cd0,Bram Moolenaar,5,1,6,2,"{""src/misc2.c"": {""insertions"": 3, ""deletions"": 1, ""lines"": 4}, ""src/version.c"": {""insertions"": 2, ""deletions"": 0, ""lines"": 2}}"
2022-09-12 18:25:11,6eda17d881c9b2880ccb2a4d11951939a58f233d,Bram Moolenaar,52,5,57,6,"{""src/drawline.c"": {""insertions"": 8, ""deletions"": 1, ""lines"": 9}, ""src/testdir/dumps/Test_prop_with_text_above_6.dump"": {""insertions"": 9, ""deletions"": 0, ""lines"": 9}, ""src/testdir/dumps/Test_prop_with_text_above_7.dump"": {""insertions"": 9, ""deletions"": 0, ""lines"": 9}, ""src/testdir/test_textprop.vim"": {""insertions"": 10, ""deletions"": 0, ""lines"": 10}, ""src/textprop.c"": {""insertions"": 14, ""deletions"": 4, ""lines"": 18}, ""src/version.c"": {""insertions"": 2, ""deletions"": 0, ""lines"": 2}}"
2022-09-12 16:51:07,c9dc03fff5acf6fb91a923fb95006f9c2bca6141,Bram Moolenaar,50,13,63,8,"{""src/drawline.c"": {""insertions"": 11, ""deletions"": 6, ""lines"": 17}, ""src/misc1.c"": {""insertions"": 2, ""deletions"": 2, ""lines"": 4}, ""src/move.c"": {""insertions"": 13, ""deletions"": 0, ""lines"": 13}, ""src/proto/textprop.pro"": {""insertions"": 1, ""deletions"": 1, ""lines"": 2}, ""src/testdir/dumps/Test_prop_with_text_above_5.dump"": {""insertions"": 9, ""deletions"": 0, ""lines"": 9}, ""src/testdir/test_textprop.vim"": {""insertions"": 3, ""deletions"": 0, ""lines"": 3}, ""src/textprop.c"": {""insertions"": 9, ""deletions"": 4, ""lines"": 13}, ""src/version.c"": {""insertions"": 2, ""deletions"": 0, ""lines"": 2}}"
2022-09-12 14:16:29,7b2d87220c6c974d5cdae672b6f9620a6bcbd1dc,Bram Moolenaar,2,0,2,1,"{""runtime/doc/usr_41.txt"": {""insertions"": 2, ""deletions"": 0, ""lines"": 2}}"
2022-09-12 13:09:30,cd2d5c181a0b91585a591bc9d2c0438937f19814,zeertzjq,14,11,25,2,"{""src/typval.c"": {""insertions"": 12, ""deletions"": 11, ""lines"": 23}, ""src/version.c"": {""insertions"": 2, ""deletions"": 0, ""lines"": 2}}"
2022-09-12 12:38:41,cdc839353f68ca43db6446e1b727fc7ba657b738,zeertzjq,83,15,98,9,"{""runtime/doc/builtin.txt"": {""insertions"": 12, ""deletions"": 0, ""lines"": 12}, ""src/evalfunc.c"": {""insertions"": 21, ""deletions"": 0, ""lines"": 21}, ""src/map.c"": {""insertions"": 3, ""deletions"": 3, ""lines"": 6}, ""src/menu.c"": {""insertions"": 1, ""deletions"": 1, ""lines"": 2}, ""src/message.c"": {""insertions"": 13, ""deletions"": 7, ""lines"": 20}, ""src/option.c"": {""insertions"": 3, ""deletions"": 2, ""lines"": 5}, ""src/proto/message.pro"": {""insertions"": 2, ""deletions"": 2, ""lines"": 4}, ""src/testdir/test_functions.vim"": {""insertions"": 26, ""deletions"": 0, ""lines"": 26}, ""src/version.c"": {""insertions"": 2, ""deletions"": 0, ""lines"": 2}}"
2022-09-12 11:43:23,5a4eb55122e45444d3a6c56ce108ce29bc8e52ab,ObserverOfTime,6,0,6,3,"{""runtime/filetype.vim"": {""insertions"": 3, ""deletions"": 0, ""lines"": 3}, ""src/testdir/test_filetype.vim"": {""insertions"": 1, ""deletions"": 0, ""lines"": 1}, ""src/version.c"": {""insertions"": 2, ""deletions"": 0, ""lines"": 2}}"
2022-09-11 20:36:17,cf0995d7d7301e36c81cafa14e68782f1d3be2ad,Bram Moolenaar,85,7,92,8,"{""src/ex_getln.c"": {""insertions"": 2, ""deletions"": 1, ""lines"": 3}, ""src/message.c"": {""insertions"": 4, ""deletions"": 0, ""lines"": 4}, ""src/popupwin.c"": {""insertions"": 25, ""deletions"": 2, ""lines"": 27}, ""src/screen.c"": {""insertions"": 4, ""deletions"": 4, ""lines"": 8}, ""src/testdir/dumps/Test_echowindow_6.dump"": {""insertions"": 8, ""deletions"": 0, ""lines"": 8}, ""src/testdir/dumps/Test_echowindow_7.dump"": {""insertions"": 8, ""deletions"": 0, ""lines"": 8}, ""src/testdir/test_messages.vim"": {""insertions"": 32, ""deletions"": 0, ""lines"": 32}, ""src/version.c"": {""insertions"": 2, ""deletions"": 0, ""lines"": 2}}"
2022-09-11 19:12:15,87e74d0e03c6c0267546b2e3a49316f3e84d9794,Bram Moolenaar,16,1,17,3,"{""src/popupwin.c"": {""insertions"": 6, ""deletions"": 1, ""lines"": 7}, ""src/testdir/dumps/Test_echowindow_5.dump"": {""insertions"": 8, ""deletions"": 0, ""lines"": 8}, ""src/version.c"": {""insertions"": 2, ""deletions"": 0, ""lines"": 2}}"
2022-09-11 15:59:53,29ab524358ba429bcf6811710afc97a978641f0b,Luuk van Baal,287,10,297,10,"{""runtime/doc/options.txt"": {""insertions"": 12, ""deletions"": 0, ""lines"": 12}, ""runtime/doc/quickref.txt"": {""insertions"": 1, ""deletions"": 0, ""lines"": 1}, ""runtime/optwin.vim"": {""insertions"": 2, ""deletions"": 0, ""lines"": 2}, ""src/move.c"": {""insertions"": 2, ""deletions"": 1, ""lines"": 3}, ""src/option.h"": {""insertions"": 1, ""deletions"": 0, ""lines"": 1}, ""src/optiondefs.h"": {""insertions"": 3, ""deletions"": 0, ""lines"": 3}, ""src/structs.h"": {""insertions"": 2, ""deletions"": 0, ""lines"": 2}, ""src/testdir/test_window_cmd.vim"": {""insertions"": 128, ""deletions"": 0, ""lines"": 128}, ""src/version.c"": {""insertions"": 2, ""deletions"": 0, ""lines"": 2}, ""src/window.c"": {""insertions"": 134, ""deletions"": 9, ""lines"": 143}}"
2022-09-11 14:14:05,9510d22463055f56548ff461ccbc54caa1ba1a2f,Bram Moolenaar,51,20,71,9,"{""src/errors.h"": {""insertions"": 2, ""deletions"": 0, ""lines"": 2}, ""src/eval.c"": {""insertions"": 5, ""deletions"": 1, ""lines"": 6}, ""src/evalvars.c"": {""insertions"": 13, ""deletions"": 2, ""lines"": 15}, ""src/ex_docmd.c"": {""insertions"": 2, ""deletions"": 2, ""lines"": 4}, ""src/proto/evalvars.pro"": {""insertions"": 1, ""deletions"": 0, ""lines"": 1}, ""src/testdir/test_vim9_assign.vim"": {""insertions"": 22, ""deletions"": 10, ""lines"": 32}, ""src/testdir/test_vim9_cmd.vim"": {""insertions"": 2, ""deletions"": 2, ""lines"": 4}, ""src/testdir/test_vim9_script.vim"": {""insertions"": 2, ""deletions"": 3, ""lines"": 5}, ""src/version.c"": {""insertions"": 2, ""deletions"": 0, ""lines"": 2}}"
2022-09-11 12:37:37,cce82a55b8105560a2ef724999c856966337b48e,Gabriele Musco,7,2,9,3,"{""runtime/filetype.vim"": {""insertions"": 4, ""deletions"": 2, ""lines"": 6}, ""src/testdir/test_filetype.vim"": {""insertions"": 1, ""deletions"": 0, ""lines"": 1}, ""src/version.c"": {""insertions"": 2, ""deletions"": 0, ""lines"": 2}}"
2022-09-11 12:31:01,79f8b8494cd4f738f25272ece94d8b524b99cb09,Bram Moolenaar,23,7,30,7,"{""src/drawline.c"": {""insertions"": 5, ""deletions"": 3, ""lines"": 8}, ""src/testdir/dumps/Test_prop_with_text_above_1.dump"": {""insertions"": 1, ""deletions"": 1, ""lines"": 2}, ""src/testdir/dumps/Test_prop_with_text_above_2.dump"": {""insertions"": 1, ""deletions"": 1, ""lines"": 2}, ""src/testdir/dumps/Test_prop_with_text_above_3.dump"": {""insertions"": 1, ""deletions"": 1, ""lines"": 2}, ""src/testdir/dumps/Test_prop_with_text_above_4.dump"": {""insertions"": 9, ""deletions"": 0, ""lines"": 9}, ""src/testdir/test_textprop.vim"": {""insertions"": 4, ""deletions"": 1, ""lines"": 5}, ""src/version.c"": {""insertions"": 2, ""deletions"": 0, ""lines"": 2}}"
2022-09-11 11:01:04,c069edeab28bdd7289d7096cd92804cb54841557,Bram Moolenaar,3,1,4,2,"{""src/testdir/test_vim9_func.vim"": {""insertions"": 1, ""deletions"": 1, ""lines"": 2}, ""src/version.c"": {""insertions"": 2, ""deletions"": 0, ""lines"": 2}}"
2022-09-11 10:49:22,f5fec05c7fd0df4c934a838e82882e601dc920cb,Bram Moolenaar,35,48,83,4,"{""src/testdir/test_vim9_func.vim"": {""insertions"": 19, ""deletions"": 41, ""lines"": 60}, ""src/version.c"": {""insertions"": 2, ""deletions"": 0, ""lines"": 2}, ""src/vim9execute.c"": {""insertions"": 10, ""deletions"": 4, ""lines"": 14}, ""src/vim9expr.c"": {""insertions"": 4, ""deletions"": 3, ""lines"": 7}}"
2022-09-10 21:32:14,88b79cb7d47e2e1fee1baf4016c50b861e6b21c4,Bram Moolenaar,28,0,28,5,"{""src/charset.c"": {""insertions"": 3, ""deletions"": 0, ""lines"": 3}, ""src/testdir/dumps/Test_prop_with_text_above_2.dump"": {""insertions"": 9, ""deletions"": 0, ""lines"": 9}, ""src/testdir/dumps/Test_prop_with_text_above_3.dump"": {""insertions"": 9, ""deletions"": 0, ""lines"": 9}, ""src/testdir/test_textprop.vim"": {""insertions"": 5, ""deletions"": 0, ""lines"": 5}, ""src/version.c"": {""insertions"": 2, ""deletions"": 0, ""lines"": 2}}"
2022-09-10 19:00:56,04e0ed1ddf399d609dbcb7dbf19e531da1fe6172,Bram Moolenaar,200,105,305,11,"{""runtime/doc/textprop.txt"": {""insertions"": 1, ""deletions"": 0, ""lines"": 1}, ""src/charset.c"": {""insertions"": 14, ""deletions"": 37, ""lines"": 51}, ""src/drawline.c"": {""insertions"": 86, ""deletions"": 36, ""lines"": 122}, ""src/misc2.c"": {""insertions"": 20, ""deletions"": 11, ""lines"": 31}, ""src/move.c"": {""insertions"": 13, ""deletions"": 1, ""lines"": 14}, ""src/proto/charset.pro"": {""insertions"": 0, ""deletions"": 1, ""lines"": 1}, ""src/structs.h"": {""insertions"": 11, ""deletions"": 4, ""lines"": 15}, ""src/testdir/dumps/Test_prop_with_text_above_1.dump"": {""insertions"": 9, ""deletions"": 0, ""lines"": 9}, ""src/testdir/test_textprop.vim"": {""insertions"": 20, ""deletions"": 0, ""lines"": 20}, ""src/textprop.c"": {""insertions"": 24, ""deletions"": 15, ""lines"": 39}, ""src/version.c"": {""insertions"": 2, ""deletions"": 0, ""lines"": 2}}"
2022-09-10 12:52:26,55e9366e32bc0e1056478d1d0ae935f9cf039d6a,Bram Moolenaar,9,2,11,4,"{""src/errors.h"": {""insertions"": 2, ""deletions"": 0, ""lines"": 2}, ""src/eval.c"": {""insertions"": 3, ""deletions"": 0, ""lines"": 3}, ""src/testdir/test_usercommands.vim"": {""insertions"": 2, ""deletions"": 2, ""lines"": 4}, ""src/version.c"": {""insertions"": 2, ""deletions"": 0, ""lines"": 2}}"
2022-09-10 12:13:14,71b6d3397649fed68ef587aa863fcbdf5fdb057a,Bram Moolenaar,499,141,640,26,"{"".github/CODEOWNERS"": {""insertions"": 18, ""deletions"": 1, ""lines"": 19}, ""runtime/doc/builtin.txt"": {""insertions"": 1, ""deletions"": 1, ""lines"": 2}, ""runtime/doc/eval.txt"": {""insertions"": 6, ""deletions"": 2, ""lines"": 8}, ""runtime/doc/options.txt"": {""insertions"": 1, ""deletions"": 1, ""lines"": 2}, ""runtime/doc/tags"": {""insertions"": 3, ""deletions"": 0, ""lines"": 3}, ""runtime/doc/tagsrch.txt"": {""insertions"": 8, ""deletions"": 3, ""lines"": 11}, ""runtime/doc/todo.txt"": {""insertions"": 13, ""deletions"": 10, ""lines"": 23}, ""runtime/doc/userfunc.txt"": {""insertions"": 4, ""deletions"": 3, ""lines"": 7}, ""runtime/doc/version9.txt"": {""insertions"": 3, ""deletions"": 3, ""lines"": 6}, ""runtime/doc/vim9.txt"": {""insertions"": 27, ""deletions"": 3, ""lines"": 30}, ""runtime/filetype.vim"": {""insertions"": 1, ""deletions"": 1, ""lines"": 2}, ""runtime/ftplugin/gitattributes.vim"": {""insertions"": 13, ""deletions"": 0, ""lines"": 13}, ""runtime/ftplugin/gitignore.vim"": {""insertions"": 13, ""deletions"": 0, ""lines"": 13}, ""runtime/ftplugin/jsonnet.vim"": {""insertions"": 17, ""deletions"": 0, ""lines"": 17}, ""runtime/ftplugin/lua.vim"": {""insertions"": 19, ""deletions"": 19, ""lines"": 38}, ""runtime/ftplugin/lynx.vim"": {""insertions"": 29, ""deletions"": 0, ""lines"": 29}, ""runtime/ftplugin/sh.vim"": {""insertions"": 30, ""deletions"": 23, ""lines"": 53}, ""runtime/ftplugin/vim.vim"": {""insertions"": 6, ""deletions"": 6, ""lines"": 12}, ""runtime/ftplugin/zimbu.vim"": {""insertions"": 2, ""deletions"": 2, ""lines"": 4}, ""runtime/ftplugin/zsh.vim"": {""insertions"": 1, ""deletions"": 1, ""lines"": 2}, ""runtime/indent/json.vim"": {""insertions"": 3, ""deletions"": 0, ""lines"": 3}, ""runtime/syntax/gitattributes.vim"": {""insertions"": 63, ""deletions"": 0, ""lines"": 63}, ""runtime/syntax/gitignore.vim"": {""insertions"": 29, ""deletions"": 0, ""lines"": 29}, ""runtime/syntax/lua.vim"": {""insertions"": 36, ""deletions"": 34, ""lines"": 70}, ""runtime/syntax/vim.vim"": {""insertions"": 9, ""deletions"": 9, ""lines"": 18}, ""runtime/syntax/zsh.vim"": {""insertions"": 144, ""deletions"": 19, ""lines"": 163}}"
2022-09-10 12:03:12,2da11a4124989e3be917fa8024025d2e1452b363,K.Takata,100,106,206,5,"{"".github/workflows/ci.yml"": {""insertions"": 90, ""deletions"": 100, ""lines"": 190}, ""src/errors.h"": {""insertions"": 2, ""deletions"": 2, ""lines"": 4}, ""src/gui_w32.c"": {""insertions"": 1, ""deletions"": 3, ""lines"": 4}, ""src/os_win32.c"": {""insertions"": 5, ""deletions"": 1, ""lines"": 6}, ""src/version.c"": {""insertions"": 2, ""deletions"": 0, ""lines"": 2}}"
2022-09-10 11:36:00,f21d546d8f80b85a1770fc4c9f48f2d92e2e82fa,Bram Moolenaar,3,1,4,2,"{""src/eval.c"": {""insertions"": 1, ""deletions"": 1, ""lines"": 2}, ""src/version.c"": {""insertions"": 2, ""deletions"": 0, ""lines"": 2}}"
2022-09-10 10:04:24,9ba2786f15f0b53a90fd221832a5bedfc6dbfe20,ObserverOfTime,10,4,14,3,"{""runtime/filetype.vim"": {""insertions"": 7, ""deletions"": 4, ""lines"": 11}, ""src/testdir/test_filetype.vim"": {""insertions"": 1, ""deletions"": 0, ""lines"": 1}, ""src/version.c"": {""insertions"": 2, ""deletions"": 0, ""lines"": 2}}"
2022-09-10 09:42:20,12553ada3b1ceee0179527abc9980b8392fd6c7e,Bram Moolenaar,9,3,12,2,"{""src/eval.c"": {""insertions"": 7, ""deletions"": 3, ""lines"": 10}, ""src/version.c"": {""insertions"": 2, ""deletions"": 0, ""lines"": 2}}"
2022-09-09 20:35:36,6de2296e5e696b894576d48239aaab0ae84486ff,Bram Moolenaar,41,2,43,5,"{""src/errors.h"": {""insertions"": 2, ""deletions"": 0, ""lines"": 2}, ""src/testdir/dumps/Test_vim9_closure_fails.dump"": {""insertions"": 6, ""deletions"": 0, ""lines"": 6}, ""src/testdir/test_vim9_func.vim"": {""insertions"": 25, ""deletions"": 2, ""lines"": 27}, ""src/version.c"": {""insertions"": 2, ""deletions"": 0, ""lines"": 2}, ""src/vim9execute.c"": {""insertions"": 6, ""deletions"": 0, ""lines"": 6}}"
2022-09-09 19:19:40,7cf5839287de6f65c981a876d8a1c7e6f8d2494b,Bram Moolenaar,32,1,33,4,"{""src/popupwin.c"": {""insertions"": 2, ""deletions"": 1, ""lines"": 3}, ""src/testdir/dumps/Test_echowin_showmode.dump"": {""insertions"": 8, ""deletions"": 0, ""lines"": 8}, ""src/testdir/test_messages.vim"": {""insertions"": 20, ""deletions"": 0, ""lines"": 20}, ""src/version.c"": {""insertions"": 2, ""deletions"": 0, ""lines"": 2}}"
2022-09-09 17:46:47,375141e1f80dced9be738568a3418f65813f4a2f,Bakudankun,87,8,95,9,"{""runtime/doc/builtin.txt"": {""insertions"": 4, ""deletions"": 3, ""lines"": 7}, ""src/errors.h"": {""insertions"": 2, ""deletions"": 0, ""lines"": 2}, ""src/evalfunc.c"": {""insertions"": 38, ""deletions"": 3, ""lines"": 41}, ""src/proto/typval.pro"": {""insertions"": 1, ""deletions"": 0, ""lines"": 1}, ""src/testdir/test_blob.vim"": {""insertions"": 12, ""deletions"": 0, ""lines"": 12}, ""src/testdir/test_vim9_builtin.vim"": {""insertions"": 4, ""deletions"": 2, ""lines"": 6}, ""src/testdir/test_vim9_func.vim"": {""insertions"": 6, ""deletions"": 0, ""lines"": 6}, ""src/typval.c"": {""insertions"": 18, ""deletions"": 0, ""lines"": 18}, ""src/version.c"": {""insertions"": 2, ""deletions"": 0, ""lines"": 2}}"
2022-09-09 16:39:02,0adae2da17598669e442ba38547ab18a6c1406de,Yegappan Lakshmanan,80,50,130,2,"{""src/testdir/test_gui.vim"": {""insertions"": 78, ""deletions"": 50, ""lines"": 128}, ""src/version.c"": {""insertions"": 2, ""deletions"": 0, ""lines"": 2}}"
2022-09-09 16:09:35,be9fc5b60cbdf697c4f6d12345dd7fcdb5d6ca01,Bram Moolenaar,27,25,52,3,"{""src/testdir/test_autocmd.vim"": {""insertions"": 9, ""deletions"": 9, ""lines"": 18}, ""src/testdir/test_startup.vim"": {""insertions"": 16, ""deletions"": 16, ""lines"": 32}, ""src/version.c"": {""insertions"": 2, ""deletions"": 0, ""lines"": 2}}"
2022-09-09 15:10:26,8995c4cd4e697141faf74da9a87e0c1221bfb161,Rodrigo Aguilera,13,10,23,3,"{""runtime/filetype.vim"": {""insertions"": 3, ""deletions"": 2, ""lines"": 5}, ""src/testdir/test_filetype.vim"": {""insertions"": 8, ""deletions"": 8, ""lines"": 16}, ""src/version.c"": {""insertions"": 2, ""deletions"": 0, ""lines"": 2}}"
2022-09-09 14:09:59,65258d36ddfab371c7982343efc9b2533ba39075,Bram Moolenaar,4,1,5,2,"{""src/testdir/runtest.vim"": {""insertions"": 2, ""deletions"": 1, ""lines"": 3}, ""src/version.c"": {""insertions"": 2, ""deletions"": 0, ""lines"": 2}}"
2022-09-09 14:08:10,ae04a6049b3f0e30a671966ed2dda1979e0b5f20,Bram Moolenaar,5,1,6,2,"{""src/testdir/test_autocmd.vim"": {""insertions"": 3, ""deletions"": 1, ""lines"": 4}, ""src/version.c"": {""insertions"": 2, ""deletions"": 0, ""lines"": 2}}"
2022-09-09 13:11:41,7d56cfc861e57145f003315efd835cf5dfd5b145,ObserverOfTime,7,0,7,3,"{""runtime/filetype.vim"": {""insertions"": 4, ""deletions"": 0, ""lines"": 4}, ""src/testdir/test_filetype.vim"": {""insertions"": 1, ""deletions"": 0, ""lines"": 1}, ""src/version.c"": {""insertions"": 2, ""deletions"": 0, ""lines"": 2}}"
2022-09-09 12:27:59,9132426334a8c7e159db93ec1b08ed61ac600aae,Bram Moolenaar,52,1,53,5,"{""src/ex_docmd.c"": {""insertions"": 4, ""deletions"": 1, ""lines"": 5}, ""src/testdir/Make_all.mak"": {""insertions"": 2, ""deletions"": 0, ""lines"": 2}, ""src/testdir/test_cmdmods.vim"": {""insertions"": 35, ""deletions"": 0, ""lines"": 35}, ""src/testdir/test_eval_stuff.vim"": {""insertions"": 9, ""deletions"": 0, ""lines"": 9}, ""src/version.c"": {""insertions"": 2, ""deletions"": 0, ""lines"": 2}}"
2022-09-09 10:27:59,0dc2fd307ffc223cf010d1fdea6e3d5c4524d43c,Yegappan Lakshmanan,128,0,128,2,"{""src/testdir/test_arglist.vim"": {""insertions"": 126, ""deletions"": 0, ""lines"": 126}, ""src/version.c"": {""insertions"": 2, ""deletions"": 0, ""lines"": 2}}"
2022-09-09 09:52:47,5bc13453b2dd8067597793e32c4f94aa3031054a,K.Takata,310,299,609,13,"{"".appveyor.yml"": {""insertions"": 3, ""deletions"": 3, ""lines"": 6}, "".github/workflows/ci.yml"": {""insertions"": 3, ""deletions"": 3, ""lines"": 6}, ""Filelist"": {""insertions"": 5, ""deletions"": 6, ""lines"": 11}, ""src/GvimExt/Make_mvc.mak"": {""insertions"": 98, ""deletions"": 0, ""lines"": 98}, ""src/GvimExt/Makefile"": {""insertions"": 3, ""deletions"": 97, ""lines"": 100}, ""src/Make_cyg_ming.mak"": {""insertions"": 2, ""deletions"": 2, ""lines"": 4}, ""src/Make_mvc.mak"": {""insertions"": 15, ""deletions"": 15, ""lines"": 30}, ""src/tee/Make_ming.mak"": {""insertions"": 21, ""deletions"": 0, ""lines"": 21}, ""src/tee/Makefile"": {""insertions"": 2, ""deletions"": 21, ""lines"": 23}, ""src/testdir/Make_dos.mak"": {""insertions"": 3, ""deletions"": 151, ""lines"": 154}, ""src/testdir/Make_mvc.mak"": {""insertions"": 152, ""deletions"": 0, ""lines"": 152}, ""src/testdir/README.txt"": {""insertions"": 1, ""deletions"": 1, ""lines"": 2}, ""src/version.c"": {""insertions"": 2, ""deletions"": 0, ""lines"": 2}}"
2022-09-08 19:49:22,c572ad508f53bd89aa29081fc583f17ef1f0f123,Bram Moolenaar,23,0,23,2,"{""src/version.c"": {""insertions"": 2, ""deletions"": 0, ""lines"": 2}, ""src/vim9cmds.c"": {""insertions"": 21, ""deletions"": 0, ""lines"": 21}}"
2022-09-08 18:51:45,169003289fb4b2ad18fd7f5807e0d05efff0be85,Bram Moolenaar,226,95,321,6,"{""src/proto/vim9instr.pro"": {""insertions"": 3, ""deletions"": 0, ""lines"": 3}, ""src/testdir/test_user_func.vim"": {""insertions"": 58, ""deletions"": 2, ""lines"": 60}, ""src/userfunc.c"": {""insertions"": 40, ""deletions"": 1, ""lines"": 41}, ""src/version.c"": {""insertions"": 2, ""deletions"": 0, ""lines"": 2}, ""src/vim9cmds.c"": {""insertions"": 18, ""deletions"": 28, ""lines"": 46}, ""src/vim9instr.c"": {""insertions"": 105, ""deletions"": 64, ""lines"": 169}}"
2022-09-08 15:39:22,45bbaef0382c5468d9fac511775bd99ea7bf5b84,Bram Moolenaar,85,162,247,11,"{""src/testdir/test_cd.vim"": {""insertions"": 8, ""deletions"": 17, ""lines"": 25}, ""src/testdir/test_changelist.vim"": {""insertions"": 2, ""deletions"": 4, ""lines"": 6}, ""src/testdir/test_channel.vim"": {""insertions"": 5, ""deletions"": 8, ""lines"": 13}, ""src/testdir/test_checkpath.vim"": {""insertions"": 5, ""deletions"": 10, ""lines"": 15}, ""src/testdir/test_cmdline.vim"": {""insertions"": 40, ""deletions"": 78, ""lines"": 118}, ""src/testdir/test_cmdwin.vim"": {""insertions"": 2, ""deletions"": 4, ""lines"": 6}, ""src/testdir/test_conceal.vim"": {""insertions"": 4, ""deletions"": 8, ""lines"": 12}, ""src/testdir/test_cpoptions.vim"": {""insertions"": 10, ""deletions"": 18, ""lines"": 28}, ""src/testdir/test_cscope.vim"": {""insertions"": 1, ""deletions"": 3, ""lines"": 4}, ""src/testdir/test_cursorline.vim"": {""insertions"": 6, ""deletions"": 12, ""lines"": 18}, ""src/version.c"": {""insertions"": 2, ""deletions"": 0, ""lines"": 2}}"
2022-09-08 13:41:48,2a4c885d54171f68ec2c2d6eb4ae281c7fefb802,=?UTF-8?q?Cezary=20Dro=C5=BCak?=,6,0,6,3,"{""runtime/filetype.vim"": {""insertions"": 3, ""deletions"": 0, ""lines"": 3}, ""src/testdir/test_filetype.vim"": {""insertions"": 1, ""deletions"": 0, ""lines"": 1}, ""src/version.c"": {""insertions"": 2, ""deletions"": 0, ""lines"": 2}}"
2022-09-08 12:43:10,58a3cae3eb590c375bf4823052e8d9d4165050de,Bram Moolenaar,45,1,46,4,"{""src/evalbuffer.c"": {""insertions"": 5, ""deletions"": 1, ""lines"": 6}, ""src/testdir/dumps/Test_term_popup_bufline.dump"": {""insertions"": 15, ""deletions"": 0, ""lines"": 15}, ""src/testdir/test_popupwin.vim"": {""insertions"": 23, ""deletions"": 0, ""lines"": 23}, ""src/version.c"": {""insertions"": 2, ""deletions"": 0, ""lines"": 2}}"
2022-09-08 11:28:02,0500e87eba7b2a82392dbb5d573de19f8ff138e7,K.Takata,19,0,19,8,"{""src/testdir/test_autocmd.vim"": {""insertions"": 1, ""deletions"": 0, ""lines"": 1}, ""src/testdir/test_buffer.vim"": {""insertions"": 2, ""deletions"": 0, ""lines"": 2}, ""src/testdir/test_bufline.vim"": {""insertions"": 1, ""deletions"": 0, ""lines"": 1}, ""src/testdir/test_profile.vim"": {""insertions"": 1, ""deletions"": 0, ""lines"": 1}, ""src/testdir/test_shell.vim"": {""insertions"": 5, ""deletions"": 0, ""lines"": 5}, ""src/testdir/test_undo.vim"": {""insertions"": 5, ""deletions"": 0, ""lines"": 5}, ""src/testdir/test_viminfo.vim"": {""insertions"": 2, ""deletions"": 0, ""lines"": 2}, ""src/version.c"": {""insertions"": 2, ""deletions"": 0, ""lines"": 2}}"
2022-09-08 11:17:06,753aead960f163d0d3f8ce523ea523f2e0cec06d,Bram Moolenaar,22,10,32,4,"{""src/regexp_bt.c"": {""insertions"": 6, ""deletions"": 4, ""lines"": 10}, ""src/regexp_nfa.c"": {""insertions"": 8, ""deletions"": 6, ""lines"": 14}, ""src/testdir/test_regexp_latin.vim"": {""insertions"": 6, ""deletions"": 0, ""lines"": 6}, ""src/version.c"": {""insertions"": 2, ""deletions"": 0, ""lines"": 2}}"
2022-09-08 09:55:38,b0d12e63e8c763ce940dc4c162111fedde2507ef,K.Takata,5,2,7,2,"{""src/clientserver.c"": {""insertions"": 3, ""deletions"": 2, ""lines"": 5}, ""src/version.c"": {""insertions"": 2, ""deletions"": 0, ""lines"": 2}}"
2022-09-07 20:46:56,e5a420fb33518e08313f653f3031bc36f949e086,Bram Moolenaar,3,1,4,2,"{""src/charset.c"": {""insertions"": 1, ""deletions"": 1, ""lines"": 2}, ""src/version.c"": {""insertions"": 2, ""deletions"": 0, ""lines"": 2}}"
2022-09-07 20:30:44,6f14da15ac900589f2f413d77898b9bff3b31ece,Bram Moolenaar,163,27,190,9,"{""runtime/doc/builtin.txt"": {""insertions"": 20, ""deletions"": 2, ""lines"": 22}, ""src/filepath.c"": {""insertions"": 46, ""deletions"": 9, ""lines"": 55}, ""src/proto/userfunc.pro"": {""insertions"": 1, ""deletions"": 0, ""lines"": 1}, ""src/testdir/test_autochdir.vim"": {""insertions"": 5, ""deletions"": 10, ""lines"": 15}, ""src/testdir/test_autocmd.vim"": {""insertions"": 3, ""deletions"": 6, ""lines"": 9}, ""src/testdir/test_eval_stuff.vim"": {""insertions"": 58, ""deletions"": 0, ""lines"": 58}, ""src/testdir/test_writefile.vim"": {""insertions"": 13, ""deletions"": 0, ""lines"": 13}, ""src/userfunc.c"": {""insertions"": 15, ""deletions"": 0, ""lines"": 15}, ""src/version.c"": {""insertions"": 2, ""deletions"": 0, ""lines"": 2}}"
2022-09-07 19:01:17,d7633114af2365e32080b61af473db347a3489c2,Bram Moolenaar,2,2,4,3,"{""src/charset.c"": {""insertions"": 0, ""deletions"": 1, ""lines"": 1}, ""src/structs.h"": {""insertions"": 0, ""deletions"": 1, ""lines"": 1}, ""src/version.c"": {""insertions"": 2, ""deletions"": 0, ""lines"": 2}}"
2022-09-07 18:40:17,7c7e1e9b98d4e5dbe7358c795a635c6f1f36f418,ii14,10,2,12,3,"{""src/dict.c"": {""insertions"": 4, ""deletions"": 2, ""lines"": 6}, ""src/testdir/test_listdict.vim"": {""insertions"": 4, ""deletions"": 0, ""lines"": 4}, ""src/version.c"": {""insertions"": 2, ""deletions"": 0, ""lines"": 2}}"
2022-09-07 18:03:42,fef38d86a1fc3790d2ca7fc4b3e45071c1d8c79c,K.Takata,3,0,3,2,"{""src/gui_w32.c"": {""insertions"": 1, ""deletions"": 0, ""lines"": 1}, ""src/version.c"": {""insertions"": 2, ""deletions"": 0, ""lines"": 2}}"
2022-09-07 17:21:24,75a115e8d632e96b4f45dc5145ba261876a83dcf,Bram Moolenaar,17,2,19,4,"{""src/regexp_bt.c"": {""insertions"": 1, ""deletions"": 1, ""lines"": 2}, ""src/regexp_nfa.c"": {""insertions"": 1, ""deletions"": 1, ""lines"": 2}, ""src/testdir/test_regexp_latin.vim"": {""insertions"": 13, ""deletions"": 0, ""lines"": 13}, ""src/version.c"": {""insertions"": 2, ""deletions"": 0, ""lines"": 2}}"
2022-09-07 16:28:09,9667b2c888351b04751bdb43cba0d4ffc8c13ab1,Bram Moolenaar,73,11,84,5,"{""src/eval.c"": {""insertions"": 10, ""deletions"": 3, ""lines"": 13}, ""src/proto/userfunc.pro"": {""insertions"": 2, ""deletions"": 0, ""lines"": 2}, ""src/testdir/test_user_func.vim"": {""insertions"": 23, ""deletions"": 0, ""lines"": 23}, ""src/userfunc.c"": {""insertions"": 36, ""deletions"": 8, ""lines"": 44}, ""src/version.c"": {""insertions"": 2, ""deletions"": 0, ""lines"": 2}}"
2022-09-07 15:48:46,c9c967da09d9faf5ba989c943352274fea365841,Bram Moolenaar,44,15,59,7,"{""src/eval.c"": {""insertions"": 2, ""deletions"": 1, ""lines"": 3}, ""src/proto/vim9execute.pro"": {""insertions"": 1, ""deletions"": 1, ""lines"": 2}, ""src/testdir/test_user_func.vim"": {""insertions"": 15, ""deletions"": 0, ""lines"": 15}, ""src/userfunc.c"": {""insertions"": 1, ""deletions"": 1, ""lines"": 2}, ""src/version.c"": {""insertions"": 2, ""deletions"": 0, ""lines"": 2}, ""src/vim9.h"": {""insertions"": 2, ""deletions"": 0, ""lines"": 2}, ""src/vim9execute.c"": {""insertions"": 21, ""deletions"": 12, ""lines"": 33}}"
2022-09-07 14:20:26,1540d334a04d874c2aa9d26b82dbbcd4bc5a78de,Bram Moolenaar,28,2,30,3,"{""src/testdir/test_assert.vim"": {""insertions"": 17, ""deletions"": 2, ""lines"": 19}, ""src/testing.c"": {""insertions"": 9, ""deletions"": 0, ""lines"": 9}, ""src/version.c"": {""insertions"": 2, ""deletions"": 0, ""lines"": 2}}"
2022-09-07 13:42:49,fd7e60a33ddd83a82da4eb6267f1c12fa926f32b,Luuk van Baal,25,6,31,3,"{""src/testdir/test_window_cmd.vim"": {""insertions"": 15, ""deletions"": 0, ""lines"": 15}, ""src/version.c"": {""insertions"": 2, ""deletions"": 0, ""lines"": 2}, ""src/window.c"": {""insertions"": 8, ""deletions"": 6, ""lines"": 14}}"
2022-09-07 13:13:31,bb6c4073e79e86ef69c315338e00c12f0d8d6395,Brett Holman,4,2,6,3,"{""runtime/filetype.vim"": {""insertions"": 1, ""deletions"": 1, ""lines"": 2}, ""src/testdir/test_filetype.vim"": {""insertions"": 1, ""deletions"": 1, ""lines"": 2}, ""src/version.c"": {""insertions"": 2, ""deletions"": 0, ""lines"": 2}}"
2022-09-07 12:30:19,bd01f476ea8751ce9787271742017b69149edc22,Philip H,9,7,16,2,"{"".github/workflows/ci.yml"": {""insertions"": 7, ""deletions"": 7, ""lines"": 14}, ""src/version.c"": {""insertions"": 2, ""deletions"": 0, ""lines"": 2}}"
2022-09-07 12:01:11,e68f1348f25766c669e27e1f7da2453c46e4c981,K.Takata,6,2,8,2,"{""src/testdir/test_gui.vim"": {""insertions"": 4, ""deletions"": 2, ""lines"": 6}, ""src/version.c"": {""insertions"": 2, ""deletions"": 0, ""lines"": 2}}"
2022-09-06 20:02:35,98aff658d5f97629d7c3a9fccac6c79fc9c6029d,Bram Moolenaar,69,4,73,5,"{""src/proto/vim9execute.pro"": {""insertions"": 2, ""deletions"": 0, ""lines"": 2}, ""src/testdir/test_user_func.vim"": {""insertions"": 32, ""deletions"": 0, ""lines"": 32}, ""src/userfunc.c"": {""insertions"": 11, ""deletions"": 3, ""lines"": 14}, ""src/version.c"": {""insertions"": 2, ""deletions"": 0, ""lines"": 2}, ""src/vim9execute.c"": {""insertions"": 22, ""deletions"": 1, ""lines"": 23}}"
2022-09-06 17:57:08,ca16c60f337ed33d5dd66a6e90aaf95b619c5e47,Bram Moolenaar,170,165,335,6,"{""src/evalvars.c"": {""insertions"": 2, ""deletions"": 1, ""lines"": 3}, ""src/profiler.c"": {""insertions"": 10, ""deletions"": 10, ""lines"": 20}, ""src/structs.h"": {""insertions"": 17, ""deletions"": 17, ""lines"": 34}, ""src/userfunc.c"": {""insertions"": 136, ""deletions"": 134, ""lines"": 270}, ""src/version.c"": {""insertions"": 2, ""deletions"": 0, ""lines"": 2}, ""src/vim9execute.c"": {""insertions"": 3, ""deletions"": 3, ""lines"": 6}}"
2022-09-06 17:31:14,58779858fb5a82a3233af5d4237a3cece88c10d4,Bram Moolenaar,123,19,142,9,"{""src/eval.c"": {""insertions"": 2, ""deletions"": 1, ""lines"": 3}, ""src/main.c"": {""insertions"": 5, ""deletions"": 0, ""lines"": 5}, ""src/proto/userfunc.pro"": {""insertions"": 1, ""deletions"": 1, ""lines"": 2}, ""src/proto/vim9execute.pro"": {""insertions"": 3, ""deletions"": 1, ""lines"": 4}, ""src/structs.h"": {""insertions"": 4, ""deletions"": 0, ""lines"": 4}, ""src/testdir/test_user_func.vim"": {""insertions"": 44, ""deletions"": 0, ""lines"": 44}, ""src/userfunc.c"": {""insertions"": 31, ""deletions"": 7, ""lines"": 38}, ""src/version.c"": {""insertions"": 2, ""deletions"": 0, ""lines"": 2}, ""src/vim9execute.c"": {""insertions"": 31, ""deletions"": 9, ""lines"": 40}}"
2022-09-06 16:00:15,2834ebdee473c838e50e60d0aa160f0e62fc8ef9,matveyt,12,2,14,3,"{""src/gui.c"": {""insertions"": 4, ""deletions"": 2, ""lines"": 6}, ""src/testdir/test_gui.vim"": {""insertions"": 6, ""deletions"": 0, ""lines"": 6}, ""src/version.c"": {""insertions"": 2, ""deletions"": 0, ""lines"": 2}}"
2022-09-06 15:31:26,635bb4908577738c5658a95672259b8537d97d49,Philip H,2,3,5,2,"{""src/version.c"": {""insertions"": 2, ""deletions"": 0, ""lines"": 2}, ""src/xxd/xxd.c"": {""insertions"": 0, ""deletions"": 3, ""lines"": 3}}"
2022-09-06 10:26:56,5903aaf7eb4586cf7e4fa5a219092334b05c89de,K.Takata,22,6,28,2,"{""src/channel.c"": {""insertions"": 20, ""deletions"": 6, ""lines"": 26}, ""src/version.c"": {""insertions"": 2, ""deletions"": 0, ""lines"": 2}}"
2022-09-06 09:56:19,a9480dbc8c4381e4139db1ab7969722f4d100bac,K.Takata,15,7,22,2,"{""src/testdir/test_signals.vim"": {""insertions"": 13, ""deletions"": 7, ""lines"": 20}, ""src/version.c"": {""insertions"": 2, ""deletions"": 0, ""lines"": 2}}"
2022-09-05 20:45:11,e53a0d44090753d6284b34cc7fb5cf6c765d562c,K.Takata,10,8,18,2,"{""src/os_win32.c"": {""insertions"": 8, ""deletions"": 8, ""lines"": 16}, ""src/version.c"": {""insertions"": 2, ""deletions"": 0, ""lines"": 2}}"
2022-09-05 20:40:44,3411265a3698c3d5ef56d9b0c3bb237a9f5fdba1,Bram Moolenaar,46,61,107,6,"{""src/testdir/test_backup.vim"": {""insertions"": 2, ""deletions"": 2, ""lines"": 4}, ""src/testdir/test_balloon.vim"": {""insertions"": 2, ""deletions"": 4, ""lines"": 6}, ""src/testdir/test_breakindent.vim"": {""insertions"": 1, ""deletions"": 2, ""lines"": 3}, ""src/testdir/test_buffer.vim"": {""insertions"": 37, ""deletions"": 49, ""lines"": 86}, ""src/testdir/test_bufline.vim"": {""insertions"": 2, ""deletions"": 4, ""lines"": 6}, ""src/version.c"": {""insertions"": 2, ""deletions"": 0, ""lines"": 2}}"
2022-09-05 20:21:25,86d87256c4005c6215da5af2597fbf6f6304421f,Bram Moolenaar,57,5,62,4,"{""src/errors.h"": {""insertions"": 4, ""deletions"": 0, ""lines"": 4}, ""src/testdir/test_user_func.vim"": {""insertions"": 23, ""deletions"": 2, ""lines"": 25}, ""src/userfunc.c"": {""insertions"": 28, ""deletions"": 3, ""lines"": 31}, ""src/version.c"": {""insertions"": 2, ""deletions"": 0, ""lines"": 2}}"
2022-09-05 18:51:13,ccfde4d028e891a41e3548323c3d47b06fb0b83e,Bram Moolenaar,27,0,27,4,"{""src/errors.h"": {""insertions"": 2, ""deletions"": 0, ""lines"": 2}, ""src/tag.c"": {""insertions"": 10, ""deletions"": 0, ""lines"": 10}, ""src/testdir/test_tagfunc.vim"": {""insertions"": 13, ""deletions"": 0, ""lines"": 13}, ""src/version.c"": {""insertions"": 2, ""deletions"": 0, ""lines"": 2}}"
2022-09-05 17:27:47,8894761daf68220504932c8b3e75f59138cdb617,Yegappan Lakshmanan,181,127,308,2,"{""src/arglist.c"": {""insertions"": 179, ""deletions"": 127, ""lines"": 306}, ""src/version.c"": {""insertions"": 2, ""deletions"": 0, ""lines"": 2}}"
2022-09-05 15:53:21,ddf7dba96e05a41c7a228b153146237e0a21b146,Bram Moolenaar,113,4,117,6,"{""src/getchar.c"": {""insertions"": 72, ""deletions"": 4, ""lines"": 76}, ""src/keymap.h"": {""insertions"": 2, ""deletions"": 0, ""lines"": 2}, ""src/normal.c"": {""insertions"": 7, ""deletions"": 0, ""lines"": 7}, ""src/proto/getchar.pro"": {""insertions"": 1, ""deletions"": 0, ""lines"": 1}, ""src/testdir/test_mapping.vim"": {""insertions"": 29, ""deletions"": 0, ""lines"": 29}, ""src/version.c"": {""insertions"": 2, ""deletions"": 0, ""lines"": 2}}"
2022-09-05 13:33:47,b1f471ee20b0fa783ecd6e29aa69067e6c821376,Yegappan Lakshmanan,162,148,310,3,"{""src/alloc.c"": {""insertions"": 34, ""deletions"": 34, ""lines"": 68}, ""src/arglist.c"": {""insertions"": 126, ""deletions"": 114, ""lines"": 240}, ""src/version.c"": {""insertions"": 2, ""deletions"": 0, ""lines"": 2}}"
2022-09-05 12:05:29,c47b16a47063735413ebe3885604c4460f724246,zeertzjq,3,1,4,2,"{""src/getchar.c"": {""insertions"": 1, ""deletions"": 1, ""lines"": 2}, ""src/version.c"": {""insertions"": 2, ""deletions"": 0, ""lines"": 2}}"
2022-09-05 10:04:14,c7d2ff2ca03f1f36544a92cb93300eae06bcd0c0,Bram Moolenaar,5,3,8,2,"{""src/spellfile.c"": {""insertions"": 3, ""deletions"": 3, ""lines"": 6}, ""src/version.c"": {""insertions"": 2, ""deletions"": 0, ""lines"": 2}}"
2022-09-05 09:55:27,963ab26842be22c0d210c3e950fecac28578f8be,Bram Moolenaar,4,2,6,2,"{""src/spellfile.c"": {""insertions"": 2, ""deletions"": 2, ""lines"": 4}, ""src/version.c"": {""insertions"": 2, ""deletions"": 0, ""lines"": 2}}"
2022-09-05 09:47:13,31ea6bf530a814991f669122dbc9921117a862c3,Bram Moolenaar,8,5,13,2,"{""src/version.c"": {""insertions"": 2, ""deletions"": 0, ""lines"": 2}, ""src/vim9execute.c"": {""insertions"": 6, ""deletions"": 5, ""lines"": 11}}"
2022-09-04 20:29:46,b40ad4ff148404b1226bea7051278a1c3c79d4f3,Dominique Pelle,4,2,6,2,"{""src/testdir/test_writefile.vim"": {""insertions"": 2, ""deletions"": 2, ""lines"": 4}, ""src/version.c"": {""insertions"": 2, ""deletions"": 0, ""lines"": 2}}"
2022-09-04 20:29:08,e1f3ab73bc7c4b3eee03b673c2983ed7eca6ea80,Bram Moolenaar,46,81,127,4,"{""src/testdir/test_arglist.vim"": {""insertions"": 5, ""deletions"": 10, ""lines"": 15}, ""src/testdir/test_assert.vim"": {""insertions"": 2, ""deletions"": 5, ""lines"": 7}, ""src/testdir/test_autocmd.vim"": {""insertions"": 37, ""deletions"": 66, ""lines"": 103}, ""src/version.c"": {""insertions"": 2, ""deletions"": 0, ""lines"": 2}}"
2022-09-04 17:22:16,8f7116caddc6f0725cf1211407d97645c4eb7b65,Bram Moolenaar,0,21,21,1,"{""src/vim9cmds.c"": {""insertions"": 0, ""deletions"": 21, ""lines"": 21}}"
2022-09-04 17:10:11,fed6bdae6f5f15d842d2e33eda6d3ffbc5b258a7,Bram Moolenaar,21,0,21,1,"{""src/vim9cmds.c"": {""insertions"": 21, ""deletions"": 0, ""lines"": 21}}"
2022-09-04 16:45:43,0daafaa7d99ef500f76b1b12f5fe8153e2fcaea0,Bram Moolenaar,922,687,1609,39,"{""runtime/colors/blue.vim"": {""insertions"": 12, ""deletions"": 4, ""lines"": 16}, ""runtime/colors/darkblue.vim"": {""insertions"": 5, ""deletions"": 1, ""lines"": 6}, ""runtime/colors/delek.vim"": {""insertions"": 7, ""deletions"": 3, ""lines"": 10}, ""runtime/colors/desert.vim"": {""insertions"": 5, ""deletions"": 1, ""lines"": 6}, ""runtime/colors/elflord.vim"": {""insertions"": 3, ""deletions"": 1, ""lines"": 4}, ""runtime/colors/evening.vim"": {""insertions"": 29, ""deletions"": 10, ""lines"": 39}, ""runtime/colors/habamax.vim"": {""insertions"": 5, ""deletions"": 1, ""lines"": 6}, ""runtime/colors/industry.vim"": {""insertions"": 10, ""deletions"": 4, ""lines"": 14}, ""runtime/colors/koehler.vim"": {""insertions"": 3, ""deletions"": 1, ""lines"": 4}, ""runtime/colors/lunaperche.vim"": {""insertions"": 73, ""deletions"": 22, ""lines"": 95}, ""runtime/colors/morning.vim"": {""insertions"": 5, ""deletions"": 1, ""lines"": 6}, ""runtime/colors/murphy.vim"": {""insertions"": 5, ""deletions"": 1, ""lines"": 6}, ""runtime/colors/pablo.vim"": {""insertions"": 10, ""deletions"": 12, ""lines"": 22}, ""runtime/colors/peachpuff.vim"": {""insertions"": 5, ""deletions"": 1, ""lines"": 6}, ""runtime/colors/quiet.vim"": {""insertions"": 3, ""deletions"": 1, ""lines"": 4}, ""runtime/colors/ron.vim"": {""insertions"": 3, ""deletions"": 1, ""lines"": 4}, ""runtime/colors/shine.vim"": {""insertions"": 5, ""deletions"": 1, ""lines"": 6}, ""runtime/colors/slate.vim"": {""insertions"": 5, ""deletions"": 1, ""lines"": 6}, ""runtime/colors/torte.vim"": {""insertions"": 5, ""deletions"": 1, ""lines"": 6}, ""runtime/colors/zellner.vim"": {""insertions"": 5, ""deletions"": 1, ""lines"": 6}, ""runtime/doc/Makefile"": {""insertions"": 2, ""deletions"": 0, ""lines"": 2}, ""runtime/doc/autocmd.txt"": {""insertions"": 2, ""deletions"": 0, ""lines"": 2}, ""runtime/doc/builtin.txt"": {""insertions"": 9, ""deletions"": 8, ""lines"": 17}, ""runtime/doc/eval.txt"": {""insertions"": 5, ""deletions"": 496, ""lines"": 501}, ""runtime/doc/help.txt"": {""insertions"": 1, ""deletions"": 0, ""lines"": 1}, ""runtime/doc/tags"": {""insertions"": 67, ""deletions"": 61, ""lines"": 128}, ""runtime/doc/todo.txt"": {""insertions"": 13, ""deletions"": 8, ""lines"": 21}, ""runtime/doc/userfunc.txt"": {""insertions"": 530, ""deletions"": 0, ""lines"": 530}, ""runtime/doc/windows.txt"": {""insertions"": 2, ""deletions"": 2, ""lines"": 4}, ""runtime/ftplugin/gdscript.vim"": {""insertions"": 3, ""deletions"": 2, ""lines"": 5}, ""runtime/indent/testdir/runtest.vim"": {""insertions"": 13, ""deletions"": 2, ""lines"": 15}, ""runtime/indent/testdir/vim.in"": {""insertions"": 7, ""deletions"": 0, ""lines"": 7}, ""runtime/indent/testdir/vim.ok"": {""insertions"": 7, ""deletions"": 0, ""lines"": 7}, ""runtime/indent/vim.vim"": {""insertions"": 30, ""deletions"": 14, ""lines"": 44}, ""runtime/indent/yaml.vim"": {""insertions"": 5, ""deletions"": 5, ""lines"": 10}, ""runtime/syntax/gdresource.vim"": {""insertions"": 2, ""deletions"": 1, ""lines"": 3}, ""runtime/syntax/gdscript.vim"": {""insertions"": 2, ""deletions"": 1, ""lines"": 3}, ""runtime/syntax/sh.vim"": {""insertions"": 3, ""deletions"": 3, ""lines"": 6}, ""runtime/syntax/vim.vim"": {""insertions"": 16, ""deletions"": 15, ""lines"": 31}}"
2022-09-04 14:40:36,806a273f3c84ecd475913d901890bb1929be9a0a,Bram Moolenaar,250,81,331,11,"{""runtime/doc/builtin.txt"": {""insertions"": 26, ""deletions"": 17, ""lines"": 43}, ""src/filepath.c"": {""insertions"": 45, ""deletions"": 20, ""lines"": 65}, ""src/proto/userfunc.pro"": {""insertions"": 1, ""deletions"": 0, ""lines"": 1}, ""src/proto/vim9cmds.pro"": {""insertions"": 1, ""deletions"": 0, ""lines"": 1}, ""src/proto/vim9execute.pro"": {""insertions"": 2, ""deletions"": 0, ""lines"": 2}, ""src/testdir/test_writefile.vim"": {""insertions"": 17, ""deletions"": 0, ""lines"": 17}, ""src/userfunc.c"": {""insertions"": 43, ""deletions"": 17, ""lines"": 60}, ""src/version.c"": {""insertions"": 2, ""deletions"": 0, ""lines"": 2}, ""src/vim9cmds.c"": {""insertions"": 26, ""deletions"": 11, ""lines"": 37}, ""src/vim9execute.c"": {""insertions"": 79, ""deletions"": 16, ""lines"": 95}, ""src/vim9expr.c"": {""insertions"": 8, ""deletions"": 0, ""lines"": 8}}"
2022-09-04 12:45:15,c1eb131c9eb38e00e08109f50e3e5337c072b71e,Bram Moolenaar,3,1,4,2,"{""src/spellfile.c"": {""insertions"": 1, ""deletions"": 1, ""lines"": 2}, ""src/version.c"": {""insertions"": 2, ""deletions"": 0, ""lines"": 2}}"
2022-09-04 12:41:37,eb5adf19d15de4dd1d148954ac5345154f0fea60,Bram Moolenaar,3,1,4,2,"{""src/userfunc.c"": {""insertions"": 1, ""deletions"": 1, ""lines"": 2}, ""src/version.c"": {""insertions"": 2, ""deletions"": 0, ""lines"": 2}}"
2022-09-04 11:47:21,6b085b9d7367e077ca69f4f82ba0f92cc6b6e443,Yegappan Lakshmanan,14,27,41,8,"{""src/insexpand.c"": {""insertions"": 4, ""deletions"": 2, ""lines"": 6}, ""src/ops.c"": {""insertions"": 0, ""deletions"": 1, ""lines"": 1}, ""src/os_unix.c"": {""insertions"": 3, ""deletions"": 4, ""lines"": 7}, ""src/userfunc.c"": {""insertions"": 0, ""deletions"": 2, ""lines"": 2}, ""src/version.c"": {""insertions"": 2, ""deletions"": 0, ""lines"": 2}, ""src/vim9instr.c"": {""insertions"": 4, ""deletions"": 16, ""lines"": 20}, ""src/viminfo.c"": {""insertions"": 1, ""deletions"": 1, ""lines"": 2}, ""src/xxd/xxd.c"": {""insertions"": 0, ""deletions"": 1, ""lines"": 1}}"
2022-09-04 11:29:28,c8ac3a072f18d4b250e55e91f610fe517e218777,Bram Moolenaar,6,167,173,6,"{""src/evalfunc.c"": {""insertions"": 1, ""deletions"": 7, ""lines"": 8}, ""src/feature.h"": {""insertions"": 2, ""deletions"": 8, ""lines"": 10}, ""src/gui.c"": {""insertions"": 0, ""deletions"": 26, ""lines"": 26}, ""src/gui.h"": {""insertions"": 0, ""deletions"": 4, ""lines"": 4}, ""src/gui_motif.c"": {""insertions"": 0, ""deletions"": 117, ""lines"": 117}, ""src/version.c"": {""insertions"": 3, ""deletions"": 5, ""lines"": 8}}"
2022-09-04 10:55:19,3c7707680fea0881fe96c75f962af01edf810d5d,Bram Moolenaar,12,6,18,2,"{""src/spellfile.c"": {""insertions"": 10, ""deletions"": 6, ""lines"": 16}, ""src/version.c"": {""insertions"": 2, ""deletions"": 0, ""lines"": 2}}"
2022-09-04 10:42:22,a5348f241bbbb6d5db863d666fa9ca72fc95037a,Bram Moolenaar,5,4,9,3,"{""src/ex_eval.c"": {""insertions"": 1, ""deletions"": 1, ""lines"": 2}, ""src/version.c"": {""insertions"": 2, ""deletions"": 0, ""lines"": 2}, ""src/vim9execute.c"": {""insertions"": 2, ""deletions"": 3, ""lines"": 5}}"
2022-09-03 21:08:11,5fbbec180b623cd6ebfc9528be6fa70b4cf664d4,Bram Moolenaar,5,3,8,3,"{""src/testdir/runtest.vim"": {""insertions"": 2, ""deletions"": 2, ""lines"": 4}, ""src/testdir/shared.vim"": {""insertions"": 1, ""deletions"": 1, ""lines"": 2}, ""src/version.c"": {""insertions"": 2, ""deletions"": 0, ""lines"": 2}}"
2022-09-03 20:53:28,06fef1b2bdc07c6170b178e34b4712c21bd81a2e,Bram Moolenaar,3,1,4,2,"{""src/eval.c"": {""insertions"": 1, ""deletions"": 1, ""lines"": 2}, ""src/version.c"": {""insertions"": 2, ""deletions"": 0, ""lines"": 2}}"
2022-09-03 20:35:53,1d84f7608f1e41dad03b8cc7925895437775f7c0,Bram Moolenaar,632,158,790,19,"{""runtime/doc/eval.txt"": {""insertions"": 56, ""deletions"": 0, ""lines"": 56}, ""src/ex_cmdidxs.h"": {""insertions"": 24, ""deletions"": 24, ""lines"": 48}, ""src/ex_cmds.h"": {""insertions"": 3, ""deletions"": 0, ""lines"": 3}, ""src/proto/userfunc.pro"": {""insertions"": 1, ""deletions"": 0, ""lines"": 1}, ""src/proto/vim9cmds.pro"": {""insertions"": 1, ""deletions"": 0, ""lines"": 1}, ""src/proto/vim9expr.pro"": {""insertions"": 1, ""deletions"": 0, ""lines"": 1}, ""src/proto/vim9instr.pro"": {""insertions"": 2, ""deletions"": 1, ""lines"": 3}, ""src/structs.h"": {""insertions"": 10, ""deletions"": 1, ""lines"": 11}, ""src/testdir/test_user_func.vim"": {""insertions"": 32, ""deletions"": 0, ""lines"": 32}, ""src/testdir/test_vim9_disassemble.vim"": {""insertions"": 15, ""deletions"": 0, ""lines"": 15}, ""src/testdir/test_vim9_func.vim"": {""insertions"": 30, ""deletions"": 0, ""lines"": 30}, ""src/userfunc.c"": {""insertions"": 213, ""deletions"": 86, ""lines"": 299}, ""src/version.c"": {""insertions"": 2, ""deletions"": 0, ""lines"": 2}, ""src/vim9.h"": {""insertions"": 20, ""deletions"": 0, ""lines"": 20}, ""src/vim9cmds.c"": {""insertions"": 64, ""deletions"": 0, ""lines"": 64}, ""src/vim9compile.c"": {""insertions"": 6, ""deletions"": 1, ""lines"": 7}, ""src/vim9execute.c"": {""insertions"": 111, ""deletions"": 15, ""lines"": 126}, ""src/vim9expr.c"": {""insertions"": 5, ""deletions"": 14, ""lines"": 19}, ""src/vim9instr.c"": {""insertions"": 36, ""deletions"": 16, ""lines"": 52}}"
2022-09-03 12:58:47,06d32a0c177e4166ff0491668cd459464bc2ef45,Bram Moolenaar,9,5,14,3,"{""src/testdir/runtest.vim"": {""insertions"": 4, ""deletions"": 2, ""lines"": 6}, ""src/testdir/shared.vim"": {""insertions"": 3, ""deletions"": 3, ""lines"": 6}, ""src/version.c"": {""insertions"": 2, ""deletions"": 0, ""lines"": 2}}"
2022-09-03 11:59:19,89083466fa565bea22832687ec5fe89a70a3b8f7,Bram Moolenaar,6,0,6,2,"{""src/tag.c"": {""insertions"": 4, ""deletions"": 0, ""lines"": 4}, ""src/version.c"": {""insertions"": 2, ""deletions"": 0, ""lines"": 2}}"
2022-09-03 11:53:20,0a6bb59f6b198b351555dc0919816c9f0f1e3ed9,Bram Moolenaar,7,5,12,2,"{""src/spellfile.c"": {""insertions"": 5, ""deletions"": 5, ""lines"": 10}, ""src/version.c"": {""insertions"": 2, ""deletions"": 0, ""lines"": 2}}"
2022-09-03 11:09:07,6ac69ed9a23fcbccc54574ded1cbab5065e19c41,Bram Moolenaar,41,3,44,3,"{""src/eval.c"": {""insertions"": 17, ""deletions"": 3, ""lines"": 20}, ""src/testdir/test_vim9_import.vim"": {""insertions"": 22, ""deletions"": 0, ""lines"": 22}, ""src/version.c"": {""insertions"": 2, ""deletions"": 0, ""lines"": 2}}"
2022-09-03 09:59:32,91a874eb88eff2df9b8fdd64ccf98eed337823cf,Dominique Pelle,5,3,8,2,"{""src/testdir/test_terminal.vim"": {""insertions"": 3, ""deletions"": 3, ""lines"": 6}, ""src/version.c"": {""insertions"": 2, ""deletions"": 0, ""lines"": 2}}"
2022-09-03 09:52:24,c99e182e1fb54e39540d25d0ccd8dcdde25bb96c,Yegappan Lakshmanan,15,13,28,8,"{""src/evalvars.c"": {""insertions"": 0, ""deletions"": 2, ""lines"": 2}, ""src/float.c"": {""insertions"": 2, ""deletions"": 4, ""lines"": 6}, ""src/highlight.c"": {""insertions"": 1, ""deletions"": 1, ""lines"": 2}, ""src/mbyte.c"": {""insertions"": 0, ""deletions"": 1, ""lines"": 1}, ""src/ops.c"": {""insertions"": 2, ""deletions"": 2, ""lines"": 4}, ""src/tag.c"": {""insertions"": 6, ""deletions"": 1, ""lines"": 7}, ""src/version.c"": {""insertions"": 2, ""deletions"": 0, ""lines"": 2}, ""src/vim9compile.c"": {""insertions"": 2, ""deletions"": 2, ""lines"": 4}}"
2022-09-02 20:55:50,b18b49699776485150b71626069a40d12d2c5590,Bram Moolenaar,566,564,1130,37,"{""src/testdir/test_autocmd.vim"": {""insertions"": 1, ""deletions"": 1, ""lines"": 2}, ""src/testdir/test_eval_stuff.vim"": {""insertions"": 3, ""deletions"": 3, ""lines"": 6}, ""src/testdir/test_excmd.vim"": {""insertions"": 22, ""deletions"": 22, ""lines"": 44}, ""src/testdir/test_expand.vim"": {""insertions"": 14, ""deletions"": 14, ""lines"": 28}, ""src/testdir/test_file_perm.vim"": {""insertions"": 3, ""deletions"": 3, ""lines"": 6}, ""src/testdir/test_filechanged.vim"": {""insertions"": 4, ""deletions"": 4, ""lines"": 8}, ""src/testdir/test_fileformat.vim"": {""insertions"": 8, ""deletions"": 8, ""lines"": 16}, ""src/testdir/test_filetype.vim"": {""insertions"": 7, ""deletions"": 7, ""lines"": 14}, ""src/testdir/test_fold.vim"": {""insertions"": 6, ""deletions"": 6, ""lines"": 12}, ""src/testdir/test_functions.vim"": {""insertions"": 14, ""deletions"": 14, ""lines"": 28}, ""src/testdir/test_gf.vim"": {""insertions"": 11, ""deletions"": 11, ""lines"": 22}, ""src/testdir/test_gui.vim"": {""insertions"": 3, ""deletions"": 3, ""lines"": 6}, ""src/testdir/test_indent.vim"": {""insertions"": 3, ""deletions"": 3, ""lines"": 6}, ""src/testdir/test_ins_complete.vim"": {""insertions"": 3, ""deletions"": 3, ""lines"": 6}, ""src/testdir/test_mksession.vim"": {""insertions"": 3, ""deletions"": 3, ""lines"": 6}, ""src/testdir/test_modeline.vim"": {""insertions"": 3, ""deletions"": 3, ""lines"": 6}, ""src/testdir/test_normal.vim"": {""insertions"": 12, ""deletions"": 12, ""lines"": 24}, ""src/testdir/test_options.vim"": {""insertions"": 1, ""deletions"": 1, ""lines"": 2}, ""src/testdir/test_plus_arg_edit.vim"": {""insertions"": 7, ""deletions"": 7, ""lines"": 14}, ""src/testdir/test_popupwin.vim"": {""insertions"": 2, ""deletions"": 2, ""lines"": 4}, ""src/testdir/test_python2.vim"": {""insertions"": 25, ""deletions"": 25, ""lines"": 50}, ""src/testdir/test_python3.vim"": {""insertions"": 25, ""deletions"": 25, ""lines"": 50}, ""src/testdir/test_source.vim"": {""insertions"": 5, ""deletions"": 5, ""lines"": 10}, ""src/testdir/test_stat.vim"": {""insertions"": 1, ""deletions"": 1, ""lines"": 2}, ""src/testdir/test_substitute.vim"": {""insertions"": 2, ""deletions"": 2, ""lines"": 4}, ""src/testdir/test_tabpage.vim"": {""insertions"": 3, ""deletions"": 3, ""lines"": 6}, ""src/testdir/test_tagjump.vim"": {""insertions"": 78, ""deletions"": 78, ""lines"": 156}, ""src/testdir/test_terminal.vim"": {""insertions"": 11, ""deletions"": 11, ""lines"": 22}, ""src/testdir/test_terminal2.vim"": {""insertions"": 4, ""deletions"": 4, ""lines"": 8}, ""src/testdir/test_vim9_assign.vim"": {""insertions"": 1, ""deletions"": 1, ""lines"": 2}, ""src/testdir/test_vim9_cmd.vim"": {""insertions"": 13, ""deletions"": 13, ""lines"": 26}, ""src/testdir/test_vim9_import.vim"": {""insertions"": 6, ""deletions"": 6, ""lines"": 12}, ""src/testdir/test_vim9_script.vim"": {""insertions"": 16, ""deletions"": 16, ""lines"": 32}, ""src/testdir/test_visual.vim"": {""insertions"": 1, ""deletions"": 1, ""lines"": 2}, ""src/testdir/test_window_cmd.vim"": {""insertions"": 21, ""deletions"": 21, ""lines"": 42}, ""src/testdir/test_writefile.vim"": {""insertions"": 222, ""deletions"": 222, ""lines"": 444}, ""src/version.c"": {""insertions"": 2, ""deletions"": 0, ""lines"": 2}}"
2022-09-02 18:45:15,f5724376ab7362b5a98eaa8a331d663ef722c2a2,Bram Moolenaar,35,2,37,3,"{""src/filepath.c"": {""insertions"": 21, ""deletions"": 2, ""lines"": 23}, ""src/testdir/test_cmdline.vim"": {""insertions"": 12, ""deletions"": 0, ""lines"": 12}, ""src/version.c"": {""insertions"": 2, ""deletions"": 0, ""lines"": 2}}"
2022-09-02 16:12:07,956be4678fba2051a8d24c15cc5dc67fb89c515f,Yegappan Lakshmanan,35,2,37,3,"{""src/change.c"": {""insertions"": 2, ""deletions"": 2, ""lines"": 4}, ""src/testdir/test_listener.vim"": {""insertions"": 31, ""deletions"": 0, ""lines"": 31}, ""src/version.c"": {""insertions"": 2, ""deletions"": 0, ""lines"": 2}}"
2022-09-02 15:47:16,35d21c6830fc2d68aca838424a0e786821c5891c,Bram Moolenaar,16,1,17,3,"{""src/ex_docmd.c"": {""insertions"": 1, ""deletions"": 1, ""lines"": 2}, ""src/testdir/test_eval_stuff.vim"": {""insertions"": 13, ""deletions"": 0, ""lines"": 13}, ""src/version.c"": {""insertions"": 2, ""deletions"": 0, ""lines"": 2}}"
2022-09-02 14:15:27,8deb2b30c77035bb682ccf80b781455ac1d6038b,Yegappan Lakshmanan,115,193,308,17,"{""src/blob.c"": {""insertions"": 1, ""deletions"": 4, ""lines"": 5}, ""src/cmdexpand.c"": {""insertions"": 1, ""deletions"": 4, ""lines"": 5}, ""src/evalfunc.c"": {""insertions"": 9, ""deletions"": 26, ""lines"": 35}, ""src/popupwin.c"": {""insertions"": 1, ""deletions"": 3, ""lines"": 4}, ""src/sign.c"": {""insertions"": 1, ""deletions"": 12, ""lines"": 13}, ""src/strings.c"": {""insertions"": 3, ""deletions"": 19, ""lines"": 22}, ""src/testdir/test_assert.vim"": {""insertions"": 1, ""deletions"": 1, ""lines"": 2}, ""src/testdir/test_cmdline.vim"": {""insertions"": 1, ""deletions"": 1, ""lines"": 2}, ""src/testdir/test_functions.vim"": {""insertions"": 7, ""deletions"": 7, ""lines"": 14}, ""src/testdir/test_listdict.vim"": {""insertions"": 6, ""deletions"": 6, ""lines"": 12}, ""src/testdir/test_signs.vim"": {""insertions"": 1, ""deletions"": 1, ""lines"": 2}, ""src/testdir/test_tagjump.vim"": {""insertions"": 1, ""deletions"": 1, ""lines"": 2}, ""src/testdir/test_timers.vim"": {""insertions"": 2, ""deletions"": 2, ""lines"": 4}, ""src/testdir/test_vim9_builtin.vim"": {""insertions"": 2, ""deletions"": 2, ""lines"": 4}, ""src/testing.c"": {""insertions"": 71, ""deletions"": 89, ""lines"": 160}, ""src/time.c"": {""insertions"": 5, ""deletions"": 15, ""lines"": 20}, ""src/version.c"": {""insertions"": 2, ""deletions"": 0, ""lines"": 2}}"
2022-09-02 13:08:53,119167265ebc7eced210a7f8ed2f4b90378f98f1,Maxim Kim,44,9,53,3,"{""src/indent.c"": {""insertions"": 3, ""deletions"": 8, ""lines"": 11}, ""src/testdir/test_breakindent.vim"": {""insertions"": 39, ""deletions"": 1, ""lines"": 40}, ""src/version.c"": {""insertions"": 2, ""deletions"": 0, ""lines"": 2}}"
2022-09-02 12:26:29,cf2bb633978a3d2d5bba06611c95e15170662c15,Bram Moolenaar,30,4,34,5,"{""src/drawline.c"": {""insertions"": 6, ""deletions"": 1, ""lines"": 7}, ""src/testdir/dumps/{Test_prop_linebreak.dump => Test_prop_linebreak_1.dump}"": {""insertions"": 1, ""deletions"": 1, ""lines"": 2}, ""src/testdir/dumps/Test_prop_linebreak_2.dump"": {""insertions"": 10, ""deletions"": 0, ""lines"": 10}, ""src/testdir/test_textprop.vim"": {""insertions"": 11, ""deletions"": 2, ""lines"": 13}, ""src/version.c"": {""insertions"": 2, ""deletions"": 0, ""lines"": 2}}"
2022-09-02 11:16:21,a02a8a4d849906ae100f46f23642b5f7d1bd314e,Yasuhiro Matsumoto,41,9,50,4,"{""src/eval.c"": {""insertions"": 11, ""deletions"": 9, ""lines"": 20}, ""src/testdir/dumps/Test_echowin_eval.dump"": {""insertions"": 8, ""deletions"": 0, ""lines"": 8}, ""src/testdir/test_messages.vim"": {""insertions"": 20, ""deletions"": 0, ""lines"": 20}, ""src/version.c"": {""insertions"": 2, ""deletions"": 0, ""lines"": 2}}"
2022-09-02 10:25:37,6c667bdc9489963102bd6c46b1b73e4d43c034ce,thinca,9,1,10,3,"{""src/evalvars.c"": {""insertions"": 3, ""deletions"": 1, ""lines"": 4}, ""src/testdir/test_let.vim"": {""insertions"": 4, ""deletions"": 0, ""lines"": 4}, ""src/version.c"": {""insertions"": 2, ""deletions"": 0, ""lines"": 2}}"
2022-09-01 17:42:32,a906e8e1abf0a4c9a058ec5ee8a4c321a008cd41,Bram Moolenaar,4,2,6,2,"{""src/testdir/shared.vim"": {""insertions"": 2, ""deletions"": 2, ""lines"": 4}, ""src/version.c"": {""insertions"": 2, ""deletions"": 0, ""lines"": 2}}"
2022-09-01 16:26:17,68a635a80a4cccf5b4b7235d886159d52b08f04c,Bram Moolenaar,3,0,3,2,"{""src/version.c"": {""insertions"": 2, ""deletions"": 0, ""lines"": 2}, ""src/vim9instr.c"": {""insertions"": 1, ""deletions"": 0, ""lines"": 1}}"
2022-09-01 16:01:32,3b474dcd30ea188124f5ad766f5096f9a0cef895,Bram Moolenaar,9,3,12,4,"{""src/message.c"": {""insertions"": 5, ""deletions"": 1, ""lines"": 6}, ""src/testdir/dumps/Test_echowindow_2.dump"": {""insertions"": 1, ""deletions"": 1, ""lines"": 2}, ""src/testdir/dumps/Test_echowindow_4.dump"": {""insertions"": 1, ""deletions"": 1, ""lines"": 2}, ""src/version.c"": {""insertions"": 2, ""deletions"": 0, ""lines"": 2}}"
2022-09-01 15:43:17,b5b4f61cf192324379b6a8c4f7ed83a13f0e3bc6,Bram Moolenaar,24,12,36,5,"{""src/eval.c"": {""insertions"": 3, ""deletions"": 12, ""lines"": 15}, ""src/popupwin.c"": {""insertions"": 3, ""deletions"": 0, ""lines"": 3}, ""src/testdir/dumps/Test_echowindow_4.dump"": {""insertions"": 8, ""deletions"": 0, ""lines"": 8}, ""src/testdir/test_messages.vim"": {""insertions"": 8, ""deletions"": 0, ""lines"": 8}, ""src/version.c"": {""insertions"": 2, ""deletions"": 0, ""lines"": 2}}"
2022-09-01 15:00:53,7d7ad7b2e8c6403033fbdb083f092321c0ccbfaf,Bram Moolenaar,84,11,95,12,"{""src/channel.c"": {""insertions"": 1, ""deletions"": 5, ""lines"": 6}, ""src/ex_docmd.c"": {""insertions"": 11, ""deletions"": 2, ""lines"": 13}, ""src/popupwin.c"": {""insertions"": 25, ""deletions"": 0, ""lines"": 25}, ""src/proto/ex_docmd.pro"": {""insertions"": 1, ""deletions"": 0, ""lines"": 1}, ""src/proto/popupwin.pro"": {""insertions"": 2, ""deletions"": 0, ""lines"": 2}, ""src/testdir/test_vim9_disassemble.vim"": {""insertions"": 10, ""deletions"": 1, ""lines"": 11}, ""src/testdir/test_vim9_script.vim"": {""insertions"": 7, ""deletions"": 0, ""lines"": 7}, ""src/version.c"": {""insertions"": 2, ""deletions"": 0, ""lines"": 2}, ""src/vim9.h"": {""insertions"": 1, ""deletions"": 0, ""lines"": 1}, ""src/vim9cmds.c"": {""insertions"": 4, ""deletions"": 0, ""lines"": 4}, ""src/vim9compile.c"": {""insertions"": 6, ""deletions"": 3, ""lines"": 9}, ""src/vim9execute.c"": {""insertions"": 14, ""deletions"": 0, ""lines"": 14}}"
2022-09-01 14:01:25,be807d582499acbe314ead3891481cba6ca136df,Bram Moolenaar,60,3,63,4,"{""runtime/autoload/dist/ft.vim"": {""insertions"": 17, ""deletions"": 0, ""lines"": 17}, ""runtime/filetype.vim"": {""insertions"": 3, ""deletions"": 3, ""lines"": 6}, ""src/testdir/test_filetype.vim"": {""insertions"": 38, ""deletions"": 0, ""lines"": 38}, ""src/version.c"": {""insertions"": 2, ""deletions"": 0, ""lines"": 2}}"
2022-09-01 13:38:01,36eb14fa3e729434cbb6f9078b4b330ae4f864f9,Bram Moolenaar,16,10,26,2,"{""src/testdir/test_gui.vim"": {""insertions"": 14, ""deletions"": 10, ""lines"": 24}, ""src/version.c"": {""insertions"": 2, ""deletions"": 0, ""lines"": 2}}"
2022-09-01 12:20:16,df5320c439e9a7f7bf1ebff3cb455d45e223547a,K.Takata,50,7,57,3,"{""runtime/doc/term.txt"": {""insertions"": 12, ""deletions"": 0, ""lines"": 12}, ""src/os_win32.c"": {""insertions"": 36, ""deletions"": 7, ""lines"": 43}, ""src/version.c"": {""insertions"": 2, ""deletions"": 0, ""lines"": 2}}"
2022-09-01 11:58:52,d3de178e5352fedf0f30b979f46a2fcbca24ea40,zeertzjq,20,5,25,7,"{""runtime/doc/map.txt"": {""insertions"": 5, ""deletions"": 5, ""lines"": 10}, ""src/cmdexpand.c"": {""insertions"": 1, ""deletions"": 0, ""lines"": 1}, ""src/ex_docmd.c"": {""insertions"": 1, ""deletions"": 0, ""lines"": 1}, ""src/testdir/test_cmdline.vim"": {""insertions"": 4, ""deletions"": 0, ""lines"": 4}, ""src/testdir/test_usercommands.vim"": {""insertions"": 4, ""deletions"": 0, ""lines"": 4}, ""src/usercmd.c"": {""insertions"": 3, ""deletions"": 0, ""lines"": 3}, ""src/version.c"": {""insertions"": 2, ""deletions"": 0, ""lines"": 2}}"
2022-09-01 11:22:46,d83392a43a48c566c0f3b76382a3648584dae32b,Bram Moolenaar,63,68,131,22,"{""runtime/doc/vim9.txt"": {""insertions"": 1, ""deletions"": 1, ""lines"": 2}, ""src/errors.h"": {""insertions"": 4, ""deletions"": 0, ""lines"": 4}, ""src/evalfunc.c"": {""insertions"": 1, ""deletions"": 4, ""lines"": 5}, ""src/filepath.c"": {""insertions"": 10, ""deletions"": 9, ""lines"": 19}, ""src/insexpand.c"": {""insertions"": 2, ""deletions"": 7, ""lines"": 9}, ""src/list.c"": {""insertions"": 2, ""deletions"": 8, ""lines"": 10}, ""src/match.c"": {""insertions"": 1, ""deletions"": 4, ""lines"": 5}, ""src/mbyte.c"": {""insertions"": 1, ""deletions"": 6, ""lines"": 7}, ""src/proto/typval.pro"": {""insertions"": 1, ""deletions"": 0, ""lines"": 1}, ""src/sign.c"": {""insertions"": 2, ""deletions"": 8, ""lines"": 10}, ""src/terminal.c"": {""insertions"": 2, ""deletions"": 4, ""lines"": 6}, ""src/testdir/test_functions.vim"": {""insertions"": 6, ""deletions"": 3, ""lines"": 9}, ""src/testdir/test_ins_complete.vim"": {""insertions"": 3, ""deletions"": 3, ""lines"": 6}, ""src/testdir/test_match.vim"": {""insertions"": 1, ""deletions"": 1, ""lines"": 2}, ""src/testdir/test_method.vim"": {""insertions"": 1, ""deletions"": 1, ""lines"": 2}, ""src/testdir/test_signs.vim"": {""insertions"": 2, ""deletions"": 2, ""lines"": 4}, ""src/testdir/test_terminal.vim"": {""insertions"": 1, ""deletions"": 1, ""lines"": 2}, ""src/testdir/test_textprop.vim"": {""insertions"": 1, ""deletions"": 1, ""lines"": 2}, ""src/testdir/test_utf8.vim"": {""insertions"": 1, ""deletions"": 1, ""lines"": 2}, ""src/textprop.c"": {""insertions"": 1, ""deletions"": 4, ""lines"": 5}, ""src/typval.c"": {""insertions"": 17, ""deletions"": 0, ""lines"": 17}, ""src/version.c"": {""insertions"": 2, ""deletions"": 0, ""lines"": 2}}"
2022-09-01 10:31:45,e42c8dae32f3575557b83a371c4be66c09afbf7f,Yasuhiro Matsumoto,23,4,27,2,"{""src/os_win32.c"": {""insertions"": 21, ""deletions"": 4, ""lines"": 25}, ""src/version.c"": {""insertions"": 2, ""deletions"": 0, ""lines"": 2}}"
2022-08-31 20:17:10,5d09a401ec393dc930e1104ceb38eab34681de64,Bram Moolenaar,15,3,18,3,"{""src/highlight.c"": {""insertions"": 3, ""deletions"": 1, ""lines"": 4}, ""src/testdir/test_gui.vim"": {""insertions"": 10, ""deletions"": 2, ""lines"": 12}, ""src/version.c"": {""insertions"": 2, ""deletions"": 0, ""lines"": 2}}"
2022-08-31 16:49:14,21c3a80a7fd6b7fc250ce5dc287963511f54b86f,Bram Moolenaar,99,33,132,8,"{""runtime/doc/windows.txt"": {""insertions"": 12, ""deletions"": 1, ""lines"": 13}, ""src/ex_cmdidxs.h"": {""insertions"": 20, ""deletions"": 20, ""lines"": 40}, ""src/ex_cmds.h"": {""insertions"": 3, ""deletions"": 0, ""lines"": 3}, ""src/ex_docmd.c"": {""insertions"": 6, ""deletions"": 1, ""lines"": 7}, ""src/testdir/test_window_cmd.vim"": {""insertions"": 40, ""deletions"": 0, ""lines"": 40}, ""src/version.c"": {""insertions"": 2, ""deletions"": 0, ""lines"": 2}, ""src/vim.h"": {""insertions"": 9, ""deletions"": 8, ""lines"": 17}, ""src/window.c"": {""insertions"": 7, ""deletions"": 3, ""lines"": 10}}"
2022-08-31 15:40:17,92a3d20682d46359bb50a452b4f831659e799155,zeertzjq,33,7,40,3,"{""src/map.c"": {""insertions"": 4, ""deletions"": 1, ""lines"": 5}, ""src/testdir/test_map_functions.vim"": {""insertions"": 27, ""deletions"": 6, ""lines"": 33}, ""src/version.c"": {""insertions"": 2, ""deletions"": 0, ""lines"": 2}}"
2022-08-31 13:46:18,a2a8973e51a0052bb52e43a2b22e7ecdecc32003,Bram Moolenaar,46,404,450,32,"{""runtime/doc/options.txt"": {""insertions"": 5, ""deletions"": 16, ""lines"": 21}, ""src/drawscreen.c"": {""insertions"": 8, ""deletions"": 15, ""lines"": 23}, ""src/eval.c"": {""insertions"": 3, ""deletions"": 2, ""lines"": 5}, ""src/ex_cmds.c"": {""insertions"": 0, ""deletions"": 14, ""lines"": 14}, ""src/ex_docmd.c"": {""insertions"": 3, ""deletions"": 8, ""lines"": 11}, ""src/ex_getln.c"": {""insertions"": 0, ""deletions"": 28, ""lines"": 28}, ""src/getchar.c"": {""insertions"": 0, ""deletions"": 4, ""lines"": 4}, ""src/globals.h"": {""insertions"": 0, ""deletions"": 3, ""lines"": 3}, ""src/highlight.c"": {""insertions"": 0, ""deletions"": 1, ""lines"": 1}, ""src/memline.c"": {""insertions"": 0, ""deletions"": 1, ""lines"": 1}, ""src/message.c"": {""insertions"": 10, ""deletions"": 42, ""lines"": 52}, ""src/normal.c"": {""insertions"": 0, ""deletions"": 3, ""lines"": 3}, ""src/ops.c"": {""insertions"": 0, ""deletions"": 5, ""lines"": 5}, ""src/option.c"": {""insertions"": 1, ""deletions"": 1, ""lines"": 2}, ""src/popupwin.c"": {""insertions"": 1, ""deletions"": 11, ""lines"": 12}, ""src/proto/message.pro"": {""insertions"": 0, ""deletions"": 2, ""lines"": 2}, ""src/proto/popupwin.pro"": {""insertions"": 0, ""deletions"": 1, ""lines"": 1}, ""src/register.c"": {""insertions"": 0, ""deletions"": 17, ""lines"": 17}, ""src/screen.c"": {""insertions"": 2, ""deletions"": 2, ""lines"": 4}, ""src/testdir/dumps/Test_cmdheight_zero_1.dump"": {""insertions"": 0, ""deletions"": 6, ""lines"": 6}, ""src/testdir/dumps/Test_cmdheight_zero_2.dump"": {""insertions"": 0, ""deletions"": 6, ""lines"": 6}, ""src/testdir/dumps/Test_cmdheight_zero_3.dump"": {""insertions"": 0, ""deletions"": 6, ""lines"": 6}, ""src/testdir/dumps/Test_cmdheight_zero_4.dump"": {""insertions"": 0, ""deletions"": 6, ""lines"": 6}, ""src/testdir/dumps/Test_cmdheight_zero_5.dump"": {""insertions"": 0, ""deletions"": 6, ""lines"": 6}, ""src/testdir/dumps/Test_cmdheight_zero_6.dump"": {""insertions"": 0, ""deletions"": 6, ""lines"": 6}, ""src/testdir/dumps/Test_cmdheight_zero_7.dump"": {""insertions"": 0, ""deletions"": 6, ""lines"": 6}, ""src/testdir/dumps/Test_cmdheight_zero_8.dump"": {""insertions"": 0, ""deletions"": 6, ""lines"": 6}, ""src/testdir/gen_opt_test.vim"": {""insertions"": 1, ""deletions"": 1, ""lines"": 2}, ""src/testdir/test_messages.vim"": {""insertions"": 0, ""deletions"": 150, ""lines"": 150}, ""src/testdir/test_window_cmd.vim"": {""insertions"": 2, ""deletions"": 5, ""lines"": 7}, ""src/version.c"": {""insertions"": 2, ""deletions"": 0, ""lines"": 2}, ""src/window.c"": {""insertions"": 8, ""deletions"": 24, ""lines"": 32}}"
2022-08-31 11:01:54,a63ad78ed31e36dbdf3a9cd28071dcdbefce7d19,Bram Moolenaar,9,3,12,2,"{""src/gui_x11.c"": {""insertions"": 7, ""deletions"": 3, ""lines"": 10}, ""src/version.c"": {""insertions"": 2, ""deletions"": 0, ""lines"": 2}}"
2022-08-31 10:25:06,9ba6194d4cba60fec4ed10c33d2d4fbe6e38c696,Bram Moolenaar,44,11,55,5,"{""src/evalfunc.c"": {""insertions"": 8, ""deletions"": 2, ""lines"": 10}, ""src/evalwindow.c"": {""insertions"": 12, ""deletions"": 3, ""lines"": 15}, ""src/list.c"": {""insertions"": 12, ""deletions"": 4, ""lines"": 16}, ""src/search.c"": {""insertions"": 10, ""deletions"": 2, ""lines"": 12}, ""src/version.c"": {""insertions"": 2, ""deletions"": 0, ""lines"": 2}}"
2022-08-30 21:24:26,b22653a98ed9252b88455c55e15c888c66c97927,Bram Moolenaar,2,4,6,2,"{""src/drawscreen.c"": {""insertions"": 0, ""deletions"": 4, ""lines"": 4}, ""src/version.c"": {""insertions"": 2, ""deletions"": 0, ""lines"": 2}}"
2022-08-30 20:46:08,61abe7d8f827ec31f098e8abcdf58846b956ef16,Bram Moolenaar,175,173,348,38,"{""src/testdir/dumps/Test_diff_01.dump"": {""insertions"": 1, ""deletions"": 1, ""lines"": 2}, ""src/testdir/dumps/Test_diff_02.dump"": {""insertions"": 1, ""deletions"": 1, ""lines"": 2}, ""src/testdir/dumps/Test_diff_03.dump"": {""insertions"": 1, ""deletions"": 1, ""lines"": 2}, ""src/testdir/dumps/Test_diff_04.dump"": {""insertions"": 1, ""deletions"": 1, ""lines"": 2}, ""src/testdir/dumps/Test_diff_05.dump"": {""insertions"": 1, ""deletions"": 1, ""lines"": 2}, ""src/testdir/dumps/Test_diff_06.0.dump"": {""insertions"": 1, ""deletions"": 1, ""lines"": 2}, ""src/testdir/dumps/Test_diff_06.1.dump"": {""insertions"": 1, ""deletions"": 1, ""lines"": 2}, ""src/testdir/dumps/Test_diff_06.2.dump"": {""insertions"": 1, ""deletions"": 1, ""lines"": 2}, ""src/testdir/dumps/Test_diff_06.dump"": {""insertions"": 1, ""deletions"": 1, ""lines"": 2}, ""src/testdir/dumps/Test_diff_07.dump"": {""insertions"": 1, ""deletions"": 1, ""lines"": 2}, ""src/testdir/dumps/Test_diff_08.dump"": {""insertions"": 1, ""deletions"": 1, ""lines"": 2}, ""src/testdir/dumps/Test_diff_09.dump"": {""insertions"": 1, ""deletions"": 1, ""lines"": 2}, ""src/testdir/dumps/Test_diff_10.dump"": {""insertions"": 1, ""deletions"": 1, ""lines"": 2}, ""src/testdir/dumps/Test_diff_11.dump"": {""insertions"": 1, ""deletions"": 1, ""lines"": 2}, ""src/testdir/dumps/Test_diff_12.dump"": {""insertions"": 1, ""deletions"": 1, ""lines"": 2}, ""src/testdir/dumps/Test_diff_13.dump"": {""insertions"": 1, ""deletions"": 1, ""lines"": 2}, ""src/testdir/dumps/Test_diff_14.dump"": {""insertions"": 1, ""deletions"": 1, ""lines"": 2}, ""src/testdir/dumps/Test_diff_15.dump"": {""insertions"": 1, ""deletions"": 1, ""lines"": 2}, ""src/testdir/dumps/Test_diff_16.dump"": {""insertions"": 1, ""deletions"": 1, ""lines"": 2}, ""src/testdir/dumps/Test_diff_17.dump"": {""insertions"": 1, ""deletions"": 1, ""lines"": 2}, ""src/testdir/dumps/Test_diff_18.dump"": {""insertions"": 1, ""deletions"": 1, ""lines"": 2}, ""src/testdir/dumps/Test_diff_19.dump"": {""insertions"": 1, ""deletions"": 1, ""lines"": 2}, ""src/testdir/dumps/Test_diff_20.dump"": {""insertions"": 1, ""deletions"": 1, ""lines"": 2}, ""src/testdir/dumps/Test_wildmenu_pum_14.dump"": {""insertions"": 3, ""deletions"": 3, ""lines"": 6}, ""src/testdir/dumps/Test_wildmenu_pum_15.dump"": {""insertions"": 3, ""deletions"": 3, ""lines"": 6}, ""src/testdir/dumps/Test_wildmenu_pum_16.dump"": {""insertions"": 3, ""deletions"": 3, ""lines"": 6}, ""src/testdir/dumps/Test_wildmenu_pum_32.dump"": {""insertions"": 4, ""deletions"": 4, ""lines"": 8}, ""src/testdir/test_autocmd.vim"": {""insertions"": 8, ""deletions"": 8, ""lines"": 16}, ""src/testdir/test_buffer.vim"": {""insertions"": 3, ""deletions"": 3, ""lines"": 6}, ""src/testdir/test_changelist.vim"": {""insertions"": 10, ""deletions"": 10, ""lines"": 20}, ""src/testdir/test_clientserver.vim"": {""insertions"": 9, ""deletions"": 9, ""lines"": 18}, ""src/testdir/test_cmdline.vim"": {""insertions"": 51, ""deletions"": 51, ""lines"": 102}, ""src/testdir/test_cpoptions.vim"": {""insertions"": 7, ""deletions"": 7, ""lines"": 14}, ""src/testdir/test_delete.vim"": {""insertions"": 10, ""deletions"": 10, ""lines"": 20}, ""src/testdir/test_diffmode.vim"": {""insertions"": 10, ""deletions"": 10, ""lines"": 20}, ""src/testdir/test_edit.vim"": {""insertions"": 20, ""deletions"": 20, ""lines"": 40}, ""src/testdir/test_help_tagjump.vim"": {""insertions"": 9, ""deletions"": 9, ""lines"": 18}, ""src/version.c"": {""insertions"": 2, ""deletions"": 0, ""lines"": 2}}"
2022-08-30 19:26:34,9b03d3e75b4274493bbe76772d7b92238791964c,Bram Moolenaar,1326,17,1343,19,"{"".github/CODEOWNERS"": {""insertions"": 7, ""deletions"": 1, ""lines"": 8}, ""runtime/compiler/raco.vim"": {""insertions"": 14, ""deletions"": 0, ""lines"": 14}, ""runtime/compiler/racomake.vim"": {""insertions"": 14, ""deletions"": 0, ""lines"": 14}, ""runtime/compiler/racosetup.vim"": {""insertions"": 14, ""deletions"": 0, ""lines"": 14}, ""runtime/compiler/racotest.vim"": {""insertions"": 14, ""deletions"": 0, ""lines"": 14}, ""runtime/doc/eval.txt"": {""insertions"": 6, ""deletions"": 1, ""lines"": 7}, ""runtime/doc/syntax.txt"": {""insertions"": 7, ""deletions"": 1, ""lines"": 8}, ""runtime/doc/tags"": {""insertions"": 7, ""deletions"": 0, ""lines"": 7}, ""runtime/doc/todo.txt"": {""insertions"": 6, ""deletions"": 13, ""lines"": 19}, ""runtime/doc/vim9.txt"": {""insertions"": 1, ""deletions"": 1, ""lines"": 2}, ""runtime/ftplugin/gdscript.vim"": {""insertions"": 53, ""deletions"": 0, ""lines"": 53}, ""runtime/ftplugin/gdshader.vim"": {""insertions"": 12, ""deletions"": 0, ""lines"": 12}, ""runtime/ftplugin/racket.vim"": {""insertions"": 82, ""deletions"": 0, ""lines"": 82}, ""runtime/indent/gdscript.vim"": {""insertions"": 148, ""deletions"": 0, ""lines"": 148}, ""runtime/indent/racket.vim"": {""insertions"": 60, ""deletions"": 0, ""lines"": 60}, ""runtime/syntax/gdresource.vim"": {""insertions"": 64, ""deletions"": 0, ""lines"": 64}, ""runtime/syntax/gdscript.vim"": {""insertions"": 104, ""deletions"": 0, ""lines"": 104}, ""runtime/syntax/gdshader.vim"": {""insertions"": 57, ""deletions"": 0, ""lines"": 57}, ""runtime/syntax/racket.vim"": {""insertions"": 656, ""deletions"": 0, ""lines"": 656}}"
2022-08-30 18:48:24,04c4c5746e15884768d2cb41370c3276a196cd4c,Yegappan Lakshmanan,124,179,303,32,"{""src/channel.c"": {""insertions"": 3, ""deletions"": 8, ""lines"": 11}, ""src/dict.c"": {""insertions"": 2, ""deletions"": 4, ""lines"": 6}, ""src/errors.h"": {""insertions"": 2, ""deletions"": 0, ""lines"": 2}, ""src/evalfunc.c"": {""insertions"": 5, ""deletions"": 17, ""lines"": 22}, ""src/evalwindow.c"": {""insertions"": 32, ""deletions"": 40, ""lines"": 72}, ""src/list.c"": {""insertions"": 1, ""deletions"": 4, ""lines"": 5}, ""src/map.c"": {""insertions"": 1, ""deletions"": 4, ""lines"": 5}, ""src/popupwin.c"": {""insertions"": 3, ""deletions"": 12, ""lines"": 15}, ""src/proto/typval.pro"": {""insertions"": 1, ""deletions"": 0, ""lines"": 1}, ""src/search.c"": {""insertions"": 6, ""deletions"": 12, ""lines"": 18}, ""src/sign.c"": {""insertions"": 8, ""deletions"": 18, ""lines"": 26}, ""src/terminal.c"": {""insertions"": 1, ""deletions"": 4, ""lines"": 5}, ""src/testdir/test_channel.vim"": {""insertions"": 1, ""deletions"": 1, ""lines"": 2}, ""src/testdir/test_charsearch.vim"": {""insertions"": 1, ""deletions"": 1, ""lines"": 2}, ""src/testdir/test_expr.vim"": {""insertions"": 1, ""deletions"": 1, ""lines"": 2}, ""src/testdir/test_functions.vim"": {""insertions"": 1, ""deletions"": 1, ""lines"": 2}, ""src/testdir/test_listdict.vim"": {""insertions"": 1, ""deletions"": 1, ""lines"": 2}, ""src/testdir/test_map_functions.vim"": {""insertions"": 1, ""deletions"": 1, ""lines"": 2}, ""src/testdir/test_matchfuzzy.vim"": {""insertions"": 4, ""deletions"": 4, ""lines"": 8}, ""src/testdir/test_partial.vim"": {""insertions"": 1, ""deletions"": 1, ""lines"": 2}, ""src/testdir/test_popupwin.vim"": {""insertions"": 5, ""deletions"": 5, ""lines"": 10}, ""src/testdir/test_search_stat.vim"": {""insertions"": 1, ""deletions"": 1, ""lines"": 2}, ""src/testdir/test_signs.vim"": {""insertions"": 5, ""deletions"": 7, ""lines"": 12}, ""src/testdir/test_tagjump.vim"": {""insertions"": 1, ""deletions"": 1, ""lines"": 2}, ""src/testdir/test_terminal.vim"": {""insertions"": 1, ""deletions"": 1, ""lines"": 2}, ""src/testdir/test_textprop.vim"": {""insertions"": 4, ""deletions"": 4, ""lines"": 8}, ""src/testdir/test_timers.vim"": {""insertions"": 1, ""deletions"": 1, ""lines"": 2}, ""src/testdir/test_window_cmd.vim"": {""insertions"": 3, ""deletions"": 3, ""lines"": 6}, ""src/textprop.c"": {""insertions"": 4, ""deletions"": 16, ""lines"": 20}, ""src/time.c"": {""insertions"": 3, ""deletions"": 5, ""lines"": 8}, ""src/typval.c"": {""insertions"": 18, ""deletions"": 1, ""lines"": 19}, ""src/version.c"": {""insertions"": 2, ""deletions"": 0, ""lines"": 2}}"
2022-08-30 17:42:16,f240395fca63d4b330112a4b81e94b05b50de1aa,Dominique Pelle,3,1,4,2,"{""src/testdir/test_vim9_func.vim"": {""insertions"": 1, ""deletions"": 1, ""lines"": 2}, ""src/version.c"": {""insertions"": 2, ""deletions"": 0, ""lines"": 2}}"
2022-08-30 17:26:19,171a1607f4b0b3cdcbbe5e886da37a5d11f15684,Bram Moolenaar,3,1,4,2,"{""src/testdir/test_method.vim"": {""insertions"": 1, ""deletions"": 1, ""lines"": 2}, ""src/version.c"": {""insertions"": 2, ""deletions"": 0, ""lines"": 2}}"
2022-08-30 17:17:15,9c8f94636b3610b898ffbbd07f6b75866d16cbca,zeertzjq,26,4,30,3,"{""src/ex_cmds.c"": {""insertions"": 9, ""deletions"": 4, ""lines"": 13}, ""src/testdir/test_autocmd.vim"": {""insertions"": 15, ""deletions"": 0, ""lines"": 15}, ""src/version.c"": {""insertions"": 2, ""deletions"": 0, ""lines"": 2}}"
2022-08-30 16:45:33,3e518a8ec74065aedd67d352c93d6ae6be550316,Bram Moolenaar,65,24,89,7,"{""src/dict.c"": {""insertions"": 6, ""deletions"": 15, ""lines"": 21}, ""src/evalfunc.c"": {""insertions"": 6, ""deletions"": 4, ""lines"": 10}, ""src/list.c"": {""insertions"": 34, ""deletions"": 2, ""lines"": 36}, ""src/proto/list.pro"": {""insertions"": 1, ""deletions"": 0, ""lines"": 1}, ""src/testdir/test_listdict.vim"": {""insertions"": 10, ""deletions"": 1, ""lines"": 11}, ""src/testdir/test_vim9_builtin.vim"": {""insertions"": 6, ""deletions"": 2, ""lines"": 8}, ""src/version.c"": {""insertions"": 2, ""deletions"": 0, ""lines"": 2}}"
2022-08-30 15:40:45,f92cfb1acc3fef74eef0c83c1a35a2b6a9f93a9b,Bram Moolenaar,5,3,8,2,"{""src/testdir/test_method.vim"": {""insertions"": 3, ""deletions"": 3, ""lines"": 6}, ""src/version.c"": {""insertions"": 2, ""deletions"": 0, ""lines"": 2}}"
2022-08-30 14:44:22,24735f2a19c666f545330a267a32ae5df72db25c,Bram Moolenaar,5,2,7,3,"{""src/highlight.c"": {""insertions"": 1, ""deletions"": 0, ""lines"": 1}, ""src/message.c"": {""insertions"": 2, ""deletions"": 2, ""lines"": 4}, ""src/version.c"": {""insertions"": 2, ""deletions"": 0, ""lines"": 2}}"
2022-08-30 14:05:30,e27d6e6382795e86ea4dd3a86396350a4c29b6fb,Bram Moolenaar,8,232,240,4,"{""src/Makefile"": {""insertions"": 0, ""deletions"": 5, ""lines"": 5}, ""src/digraph.c"": {""insertions"": 6, ""deletions"": 224, ""lines"": 230}, ""src/feature.h"": {""insertions"": 0, ""deletions"": 3, ""lines"": 3}, ""src/version.c"": {""insertions"": 2, ""deletions"": 0, ""lines"": 2}}"
2022-08-30 13:34:52,976f859763b215050a03248dbc2bb62fa5d0d059,Bram Moolenaar,73,20,93,7,"{""src/dict.c"": {""insertions"": 21, ""deletions"": 18, ""lines"": 39}, ""src/evalfunc.c"": {""insertions"": 1, ""deletions"": 1, ""lines"": 2}, ""src/list.c"": {""insertions"": 32, ""deletions"": 0, ""lines"": 32}, ""src/proto/list.pro"": {""insertions"": 1, ""deletions"": 0, ""lines"": 1}, ""src/testdir/test_listdict.vim"": {""insertions"": 11, ""deletions"": 0, ""lines"": 11}, ""src/testdir/test_vim9_builtin.vim"": {""insertions"": 5, ""deletions"": 1, ""lines"": 6}, ""src/version.c"": {""insertions"": 2, ""deletions"": 0, ""lines"": 2}}"
2022-08-30 10:54:21,0e412be00f8290e0575c7f72ec080725631eff38,Shougo Matsushita,4,4,8,2,"{""src/version.c"": {""insertions"": 2, ""deletions"": 0, ""lines"": 2}, ""src/window.c"": {""insertions"": 2, ""deletions"": 4, ""lines"": 6}}"
2022-08-29 22:01:45,816736bcc74ddd058f68d565d9e2b2fca153c33a,Bram Moolenaar,8,6,14,2,"{""src/testdir/test_ins_complete.vim"": {""insertions"": 6, ""deletions"": 6, ""lines"": 12}, ""src/version.c"": {""insertions"": 2, ""deletions"": 0, ""lines"": 2}}"
2022-08-29 21:51:38,15cae5c9ca3d2dc0b2c9ac29d27c4ba765362ab5,Bram Moolenaar,32,29,61,2,"{""src/testdir/test_functions.vim"": {""insertions"": 30, ""deletions"": 29, ""lines"": 59}, ""src/version.c"": {""insertions"": 2, ""deletions"": 0, ""lines"": 2}}"
2022-08-29 21:31:20,3b0d70f4ff436cb144683dafd956e8a3ee485a90,Bram Moolenaar,532,531,1063,25,"{""src/testdir/test_autocmd.vim"": {""insertions"": 8, ""deletions"": 8, ""lines"": 16}, ""src/testdir/test_cd.vim"": {""insertions"": 13, ""deletions"": 13, ""lines"": 26}, ""src/testdir/test_channel.vim"": {""insertions"": 3, ""deletions"": 3, ""lines"": 6}, ""src/testdir/test_checkpath.vim"": {""insertions"": 37, ""deletions"": 37, ""lines"": 74}, ""src/testdir/test_cmdline.vim"": {""insertions"": 37, ""deletions"": 37, ""lines"": 74}, ""src/testdir/test_delete.vim"": {""insertions"": 54, ""deletions"": 54, ""lines"": 108}, ""src/testdir/test_edit.vim"": {""insertions"": 2, ""deletions"": 2, ""lines"": 4}, ""src/testdir/test_excmd.vim"": {""insertions"": 3, ""deletions"": 3, ""lines"": 6}, ""src/testdir/test_findfile.vim"": {""insertions"": 34, ""deletions"": 34, ""lines"": 68}, ""src/testdir/test_functions.vim"": {""insertions"": 100, ""deletions"": 101, ""lines"": 201}, ""src/testdir/test_getcwd.vim"": {""insertions"": 28, ""deletions"": 28, ""lines"": 56}, ""src/testdir/test_gui.vim"": {""insertions"": 12, ""deletions"": 12, ""lines"": 24}, ""src/testdir/test_help.vim"": {""insertions"": 24, ""deletions"": 24, ""lines"": 48}, ""src/testdir/test_ins_complete.vim"": {""insertions"": 11, ""deletions"": 11, ""lines"": 22}, ""src/testdir/test_packadd.vim"": {""insertions"": 6, ""deletions"": 6, ""lines"": 12}, ""src/testdir/test_quickfix.vim"": {""insertions"": 6, ""deletions"": 6, ""lines"": 12}, ""src/testdir/test_startup.vim"": {""insertions"": 10, ""deletions"": 10, ""lines"": 20}, ""src/testdir/test_terminal.vim"": {""insertions"": 4, ""deletions"": 4, ""lines"": 8}, ""src/testdir/test_vim9_disassemble.vim"": {""insertions"": 4, ""deletions"": 4, ""lines"": 8}, ""src/testdir/test_vim9_func.vim"": {""insertions"": 12, ""deletions"": 12, ""lines"": 24}, ""src/testdir/test_vim9_import.vim"": {""insertions"": 103, ""deletions"": 103, ""lines"": 206}, ""src/testdir/test_vim9_script.vim"": {""insertions"": 4, ""deletions"": 4, ""lines"": 8}, ""src/testdir/test_viminfo.vim"": {""insertions"": 4, ""deletions"": 4, ""lines"": 8}, ""src/testdir/test_writefile.vim"": {""insertions"": 11, ""deletions"": 11, ""lines"": 22}, ""src/version.c"": {""insertions"": 2, ""deletions"": 0, ""lines"": 2}}"
2022-08-29 19:45:16,4f1b083be43f351bc107541e7b0c9655a5d2c0bb,Bram Moolenaar,19,1,20,3,"{""src/quickfix.c"": {""insertions"": 1, ""deletions"": 1, ""lines"": 2}, ""src/testdir/test_quickfix.vim"": {""insertions"": 16, ""deletions"": 0, ""lines"": 16}, ""src/version.c"": {""insertions"": 2, ""deletions"": 0, ""lines"": 2}}"
2022-08-29 17:16:32,37fef16c225eabed28a3c7a0542d2eeef30d812b,Bram Moolenaar,114,31,145,14,"{""runtime/doc/eval.txt"": {""insertions"": 10, ""deletions"": 0, ""lines"": 10}, ""src/eval.c"": {""insertions"": 11, ""deletions"": 3, ""lines"": 14}, ""src/ex_cmdidxs.h"": {""insertions"": 23, ""deletions"": 23, ""lines"": 46}, ""src/ex_cmds.h"": {""insertions"": 3, ""deletions"": 0, ""lines"": 3}, ""src/ex_getln.c"": {""insertions"": 7, ""deletions"": 0, ""lines"": 7}, ""src/globals.h"": {""insertions"": 1, ""deletions"": 0, ""lines"": 1}, ""src/message.c"": {""insertions"": 5, ""deletions"": 3, ""lines"": 8}, ""src/popupwin.c"": {""insertions"": 2, ""deletions"": 1, ""lines"": 3}, ""src/structs.h"": {""insertions"": 1, ""deletions"": 1, ""lines"": 2}, ""src/testdir/dumps/Test_echowindow_1.dump"": {""insertions"": 8, ""deletions"": 0, ""lines"": 8}, ""src/testdir/dumps/Test_echowindow_2.dump"": {""insertions"": 8, ""deletions"": 0, ""lines"": 8}, ""src/testdir/dumps/Test_echowindow_3.dump"": {""insertions"": 8, ""deletions"": 0, ""lines"": 8}, ""src/testdir/test_messages.vim"": {""insertions"": 25, ""deletions"": 0, ""lines"": 25}, ""src/version.c"": {""insertions"": 2, ""deletions"": 0, ""lines"": 2}}"
2022-08-29 15:21:25,54acb90d9e672315e3bd13f8dc71f828df97c868,zeertzjq,56,60,116,4,"{""src/ex_getln.c"": {""insertions"": 40, ""deletions"": 58, ""lines"": 98}, ""src/proto/ex_getln.pro"": {""insertions"": 1, ""deletions"": 2, ""lines"": 3}, ""src/testdir/test_cmdline.vim"": {""insertions"": 13, ""deletions"": 0, ""lines"": 13}, ""src/version.c"": {""insertions"": 2, ""deletions"": 0, ""lines"": 2}}"
2022-08-29 14:28:53,d5c8f11905abc1bdf3b8864dbc40187855ed9374,Maxim Kim,7,1,8,3,"{""runtime/filetype.vim"": {""insertions"": 4, ""deletions"": 1, ""lines"": 5}, ""src/testdir/test_filetype.vim"": {""insertions"": 1, ""deletions"": 0, ""lines"": 1}, ""src/version.c"": {""insertions"": 2, ""deletions"": 0, ""lines"": 2}}"
2022-08-29 14:06:50,13608d851a0470ced30921428b3313c023d395d8,Bram Moolenaar,39,37,76,14,"{""src/drawscreen.c"": {""insertions"": 16, ""deletions"": 17, ""lines"": 33}, ""src/ex_cmds.c"": {""insertions"": 3, ""deletions"": 2, ""lines"": 5}, ""src/ex_cmds2.c"": {""insertions"": 1, ""deletions"": 1, ""lines"": 2}, ""src/ex_docmd.c"": {""insertions"": 2, ""deletions"": 2, ""lines"": 4}, ""src/ex_getln.c"": {""insertions"": 1, ""deletions"": 1, ""lines"": 2}, ""src/getchar.c"": {""insertions"": 1, ""deletions"": 1, ""lines"": 2}, ""src/if_cscope.c"": {""insertions"": 1, ""deletions"": 1, ""lines"": 2}, ""src/main.c"": {""insertions"": 2, ""deletions"": 2, ""lines"": 4}, ""src/memline.c"": {""insertions"": 1, ""deletions"": 1, ""lines"": 2}, ""src/message.c"": {""insertions"": 6, ""deletions"": 6, ""lines"": 12}, ""src/misc1.c"": {""insertions"": 1, ""deletions"": 1, ""lines"": 2}, ""src/option.c"": {""insertions"": 1, ""deletions"": 1, ""lines"": 2}, ""src/version.c"": {""insertions"": 2, ""deletions"": 0, ""lines"": 2}, ""src/viminfo.c"": {""insertions"": 1, ""deletions"": 1, ""lines"": 2}}"
2022-08-29 12:44:28,b13d3405fffae1115acc1433479b616f30e292e5,Bram Moolenaar,48,7,55,7,"{""src/drawscreen.c"": {""insertions"": 6, ""deletions"": 0, ""lines"": 6}, ""src/popupwin.c"": {""insertions"": 14, ""deletions"": 0, ""lines"": 14}, ""src/proto/popupwin.pro"": {""insertions"": 1, ""deletions"": 0, ""lines"": 1}, ""src/proto/screen.pro"": {""insertions"": 1, ""deletions"": 0, ""lines"": 1}, ""src/screen.c"": {""insertions"": 23, ""deletions"": 6, ""lines"": 29}, ""src/testdir/dumps/Test_popupwin_win_execute.dump"": {""insertions"": 1, ""deletions"": 1, ""lines"": 2}, ""src/version.c"": {""insertions"": 2, ""deletions"": 0, ""lines"": 2}}"
2022-08-29 11:41:06,f73e5ba56f4aca1cd6e38f1c8ea24e941bf6b33f,Bram Moolenaar,31,26,57,3,"{""src/drawscreen.c"": {""insertions"": 28, ""deletions"": 25, ""lines"": 53}, ""src/ex_getln.c"": {""insertions"": 1, ""deletions"": 1, ""lines"": 2}, ""src/version.c"": {""insertions"": 2, ""deletions"": 0, ""lines"": 2}}"
2022-08-29 11:23:39,309c4e0ed7dcf42011e29976a06e6335f5ae6d1c,Bram Moolenaar,6,2,8,3,"{""src/ex_cmds.c"": {""insertions"": 1, ""deletions"": 0, ""lines"": 1}, ""src/message.c"": {""insertions"": 3, ""deletions"": 2, ""lines"": 5}, ""src/version.c"": {""insertions"": 2, ""deletions"": 0, ""lines"": 2}}"
2022-08-29 10:57:30,bf26941f40923d331169a4ecb7341608f5d1ca38,Alessandro Pezzoni,10,0,10,3,"{""runtime/filetype.vim"": {""insertions"": 5, ""deletions"": 0, ""lines"": 5}, ""src/testdir/test_filetype.vim"": {""insertions"": 3, ""deletions"": 0, ""lines"": 3}, ""src/version.c"": {""insertions"": 2, ""deletions"": 0, ""lines"": 2}}"
2022-08-29 10:02:59,e7cda97b6b578b33a42de0d27ac2876337c641ca,Bram Moolenaar,92,90,182,5,"{""src/testdir/test_autochdir.vim"": {""insertions"": 4, ""deletions"": 4, ""lines"": 8}, ""src/testdir/test_autocmd.vim"": {""insertions"": 25, ""deletions"": 25, ""lines"": 50}, ""src/testdir/test_backup.vim"": {""insertions"": 3, ""deletions"": 3, ""lines"": 6}, ""src/testdir/test_buffer.vim"": {""insertions"": 58, ""deletions"": 58, ""lines"": 116}, ""src/version.c"": {""insertions"": 2, ""deletions"": 0, ""lines"": 2}}"
2022-08-28 23:08:39,98d1069a9cc6f1b439be154aeae0ed32a598e855,Bram Moolenaar,3,1,4,2,"{""src/normal.c"": {""insertions"": 1, ""deletions"": 1, ""lines"": 2}, ""src/version.c"": {""insertions"": 2, ""deletions"": 0, ""lines"": 2}}"
2022-08-28 22:36:52,926218b5dad0dcdc273ccd92436a72f038d222c4,Bram Moolenaar,5,2,7,2,"{""src/drawscreen.c"": {""insertions"": 3, ""deletions"": 2, ""lines"": 5}, ""src/version.c"": {""insertions"": 2, ""deletions"": 0, ""lines"": 2}}"
2022-08-28 21:46:21,b849c82851192cf14cd92b78d83d90ca432332ea,Bram Moolenaar,11,1,12,3,"{""src/message.c"": {""insertions"": 1, ""deletions"": 0, ""lines"": 1}, ""src/normal.c"": {""insertions"": 8, ""deletions"": 1, ""lines"": 9}, ""src/version.c"": {""insertions"": 2, ""deletions"": 0, ""lines"": 2}}"
2022-08-28 21:21:01,7a99da43d14671cc91a302bcfa34d37a35eaa28d,Bram Moolenaar,7,1,8,2,"{""src/drawscreen.c"": {""insertions"": 5, ""deletions"": 1, ""lines"": 6}, ""src/version.c"": {""insertions"": 2, ""deletions"": 0, ""lines"": 2}}"
2022-08-28 21:17:50,33a5dd8b237738c15cae87441d731ab899b4e846,Bram Moolenaar,18,0,18,4,"{""src/memline.c"": {""insertions"": 1, ""deletions"": 0, ""lines"": 1}, ""src/message.c"": {""insertions"": 14, ""deletions"": 0, ""lines"": 14}, ""src/proto/message.pro"": {""insertions"": 1, ""deletions"": 0, ""lines"": 1}, ""src/version.c"": {""insertions"": 2, ""deletions"": 0, ""lines"": 2}}"
2022-08-28 20:36:43,134b86553c12c46e0ae7d534f6fe65e8ba2d50bc,Bram Moolenaar,54,3,57,7,"{""src/eval.c"": {""insertions"": 11, ""deletions"": 0, ""lines"": 11}, ""src/ex_docmd.c"": {""insertions"": 8, ""deletions"": 3, ""lines"": 11}, ""src/testdir/dumps/Test_cmdheight_zero_6.dump"": {""insertions"": 6, ""deletions"": 0, ""lines"": 6}, ""src/testdir/dumps/Test_cmdheight_zero_7.dump"": {""insertions"": 6, ""deletions"": 0, ""lines"": 6}, ""src/testdir/dumps/Test_cmdheight_zero_8.dump"": {""insertions"": 6, ""deletions"": 0, ""lines"": 6}, ""src/testdir/test_messages.vim"": {""insertions"": 15, ""deletions"": 0, ""lines"": 15}, ""src/version.c"": {""insertions"": 2, ""deletions"": 0, ""lines"": 2}}"
2022-08-28 19:58:51,f2fb54f641aa0e8a64356e4d0053f89b52c78229,Bram Moolenaar,16,2,18,4,"{""src/message.c"": {""insertions"": 3, ""deletions"": 1, ""lines"": 4}, ""src/testdir/dumps/Test_cmdheight_zero_5.dump"": {""insertions"": 6, ""deletions"": 0, ""lines"": 6}, ""src/testdir/test_messages.vim"": {""insertions"": 5, ""deletions"": 1, ""lines"": 6}, ""src/version.c"": {""insertions"": 2, ""deletions"": 0, ""lines"": 2}}"
2022-08-28 18:41:36,533c306921a3ac46ab92f35dfc4ebd22b3da845d,Philip H,3,1,4,2,"{"".github/workflows/ci.yml"": {""insertions"": 1, ""deletions"": 1, ""lines"": 2}, ""src/version.c"": {""insertions"": 2, ""deletions"": 0, ""lines"": 2}}"
2022-08-28 18:16:15,670ab0334b536e12d84810de88e73b7bcb01346d,zeertzjq,40,1,41,5,"{""src/autocmd.c"": {""insertions"": 1, ""deletions"": 0, ""lines"": 1}, ""src/structs.h"": {""insertions"": 2, ""deletions"": 1, ""lines"": 3}, ""src/testdir/test_autocmd.vim"": {""insertions"": 33, ""deletions"": 0, ""lines"": 33}, ""src/version.c"": {""insertions"": 2, ""deletions"": 0, ""lines"": 2}, ""src/window.c"": {""insertions"": 2, ""deletions"": 0, ""lines"": 2}}"
2022-08-28 17:52:10,2f892d8663498c21296ad6661dac1bb8372cfd10,Yegappan Lakshmanan,187,20,207,7,"{""runtime/doc/builtin.txt"": {""insertions"": 29, ""deletions"": 11, ""lines"": 40}, ""src/scriptfile.c"": {""insertions"": 78, ""deletions"": 5, ""lines"": 83}, ""src/testdir/test_scriptnames.vim"": {""insertions"": 37, ""deletions"": 2, ""lines"": 39}, ""src/testdir/test_vim9_builtin.vim"": {""insertions"": 40, ""deletions"": 0, ""lines"": 40}, ""src/testdir/test_vim9_import.vim"": {""insertions"": 1, ""deletions"": 0, ""lines"": 1}, ""src/userfunc.c"": {""insertions"": 0, ""deletions"": 2, ""lines"": 2}, ""src/version.c"": {""insertions"": 2, ""deletions"": 0, ""lines"": 2}}"
2022-08-28 16:59:05,75e9a6693e8d0126b5fff42203bfba9428cd19ae,Philip H,3,0,3,2,"{"".github/workflows/coverity.yml"": {""insertions"": 1, ""deletions"": 0, ""lines"": 1}, ""src/version.c"": {""insertions"": 2, ""deletions"": 0, ""lines"": 2}}"
2022-08-28 16:53:23,878e1d25a0a5b03233bf6ad64073fcf576c2aea5,Bram Moolenaar,8,2,10,2,"{""src/message.c"": {""insertions"": 6, ""deletions"": 2, ""lines"": 8}, ""src/version.c"": {""insertions"": 2, ""deletions"": 0, ""lines"": 2}}"
2022-08-28 16:44:20,a85e4db9780a4cf7a72cbb98c7127922f668cdf6,Bram Moolenaar,40,38,78,2,"{""src/testdir/test_cpoptions.vim"": {""insertions"": 38, ""deletions"": 38, ""lines"": 76}, ""src/version.c"": {""insertions"": 2, ""deletions"": 0, ""lines"": 2}}"
2022-08-28 16:25:04,25f1e5556259d536c8608185145b0769262873ff,Yegappan Lakshmanan,8,8,16,4,"{""src/ex_getln.c"": {""insertions"": 2, ""deletions"": 4, ""lines"": 6}, ""src/testdir/test_cmdline.vim"": {""insertions"": 2, ""deletions"": 2, ""lines"": 4}, ""src/testdir/test_vim9_builtin.vim"": {""insertions"": 2, ""deletions"": 2, ""lines"": 4}, ""src/version.c"": {""insertions"": 2, ""deletions"": 0, ""lines"": 2}}"
2022-08-28 16:08:18,8934ec027da323aea95d4f6f6cf4967f054433b2,Wilhelm Payne,3,1,4,2,"{""src/message.c"": {""insertions"": 1, ""deletions"": 1, ""lines"": 2}, ""src/version.c"": {""insertions"": 2, ""deletions"": 0, ""lines"": 2}}"
2022-08-28 15:39:22,c8bf59e9b27f9d621818ffc61468abef45cedf37,Bram Moolenaar,25,9,34,5,"{""src/charset.c"": {""insertions"": 3, ""deletions"": 2, ""lines"": 5}, ""src/drawline.c"": {""insertions"": 4, ""deletions"": 2, ""lines"": 6}, ""src/testdir/dumps/Test_prop_right_align_twice_3.dump"": {""insertions"": 8, ""deletions"": 0, ""lines"": 8}, ""src/testdir/test_textprop.vim"": {""insertions"": 8, ""deletions"": 5, ""lines"": 13}, ""src/version.c"": {""insertions"": 2, ""deletions"": 0, ""lines"": 2}}"
2022-08-28 13:39:53,35a4fbc5d04820d9b08e7da2e295a7e8210e2e2c,Bram Moolenaar,39,3,42,5,"{""src/message.c"": {""insertions"": 10, ""deletions"": 2, ""lines"": 12}, ""src/popupwin.c"": {""insertions"": 1, ""deletions"": 1, ""lines"": 2}, ""src/testdir/dumps/Test_cmdheight_zero_4.dump"": {""insertions"": 6, ""deletions"": 0, ""lines"": 6}, ""src/testdir/test_messages.vim"": {""insertions"": 20, ""deletions"": 0, ""lines"": 20}, ""src/version.c"": {""insertions"": 2, ""deletions"": 0, ""lines"": 2}}"
2022-08-28 12:38:43,00d4ceeccafb36f1337d133489b3651c11e78c30,Bram Moolenaar,5,0,5,2,"{""src/testdir/test_gui.vim"": {""insertions"": 3, ""deletions"": 0, ""lines"": 3}, ""src/version.c"": {""insertions"": 2, ""deletions"": 0, ""lines"": 2}}"
2022-08-28 12:02:45,43568648dfefe5796dc3fe8fe711135eb20d9eb6,Bram Moolenaar,74,3,77,8,"{""src/popupwin.c"": {""insertions"": 20, ""deletions"": 3, ""lines"": 23}, ""src/proto/popupwin.pro"": {""insertions"": 1, ""deletions"": 0, ""lines"": 1}, ""src/testdir/dumps/Test_cmdheight_zero_1.dump"": {""insertions"": 6, ""deletions"": 0, ""lines"": 6}, ""src/testdir/dumps/Test_cmdheight_zero_2.dump"": {""insertions"": 6, ""deletions"": 0, ""lines"": 6}, ""src/testdir/dumps/Test_cmdheight_zero_3.dump"": {""insertions"": 6, ""deletions"": 0, ""lines"": 6}, ""src/testdir/test_messages.vim"": {""insertions"": 28, ""deletions"": 0, ""lines"": 28}, ""src/version.c"": {""insertions"": 2, ""deletions"": 0, ""lines"": 2}, ""src/window.c"": {""insertions"": 5, ""deletions"": 0, ""lines"": 5}}"
2022-08-28 11:06:21,b0509c542ed974cb388d49273d365ff2daf43159,Bram Moolenaar,10,0,10,3,"{""src/ex_getln.c"": {""insertions"": 3, ""deletions"": 0, ""lines"": 3}, ""src/testdir/test_messages.vim"": {""insertions"": 5, ""deletions"": 0, ""lines"": 5}, ""src/version.c"": {""insertions"": 2, ""deletions"": 0, ""lines"": 2}}"
2022-08-27 21:51:25,d1f8fd59074d9c8b4d00ccdea77726a9195e0be4,Bram Moolenaar,6,3,9,2,"{""src/testdir/test_messages.vim"": {""insertions"": 4, ""deletions"": 3, ""lines"": 7}, ""src/version.c"": {""insertions"": 2, ""deletions"": 0, ""lines"": 2}}"
2022-08-27 21:21:07,efdfb0c5eeedb625cdfa3f9fe6e480d18ea7c6cb,Bram Moolenaar,5,1,6,2,"{""src/testdir/test_messages.vim"": {""insertions"": 3, ""deletions"": 1, ""lines"": 4}, ""src/version.c"": {""insertions"": 2, ""deletions"": 0, ""lines"": 2}}"
2022-08-27 21:05:13,d54af2e550c6c34efbad748de36e42b318f39243,Bram Moolenaar,9,2,11,2,"{""src/message.c"": {""insertions"": 7, ""deletions"": 2, ""lines"": 9}, ""src/version.c"": {""insertions"": 2, ""deletions"": 0, ""lines"": 2}}"
2022-08-27 20:52:52,beedd0a266cfe524fe2a851caec8316f2e37885c,Bram Moolenaar,26,5,31,2,"{""src/message.c"": {""insertions"": 24, ""deletions"": 5, ""lines"": 29}, ""src/version.c"": {""insertions"": 2, ""deletions"": 0, ""lines"": 2}}"
2022-08-27 20:30:03,9198de3ae2bd20ac51d580c44f2b43c282c1e773,Bram Moolenaar,383,50,433,12,"{""runtime/doc/options.txt"": {""insertions"": 5, ""deletions"": 3, ""lines"": 8}, ""src/feature.h"": {""insertions"": 7, ""deletions"": 0, ""lines"": 7}, ""src/message.c"": {""insertions"": 196, ""deletions"": 24, ""lines"": 220}, ""src/popupwin.c"": {""insertions"": 123, ""deletions"": 13, ""lines"": 136}, ""src/proto/message.pro"": {""insertions"": 1, ""deletions"": 0, ""lines"": 1}, ""src/proto/popupwin.pro"": {""insertions"": 4, ""deletions"": 0, ""lines"": 4}, ""src/proto/time.pro"": {""insertions"": 1, ""deletions"": 0, ""lines"": 1}, ""src/screen.c"": {""insertions"": 2, ""deletions"": 2, ""lines"": 4}, ""src/structs.h"": {""insertions"": 2, ""deletions"": 0, ""lines"": 2}, ""src/testdir/test_messages.vim"": {""insertions"": 21, ""deletions"": 5, ""lines"": 26}, ""src/time.c"": {""insertions"": 19, ""deletions"": 3, ""lines"": 22}, ""src/version.c"": {""insertions"": 2, ""deletions"": 0, ""lines"": 2}}"
2022-08-27 20:24:26,aebc6ef7cdc5d4d0627a711ff66e6fe8d67f9d87,Yegappan Lakshmanan,7,99,106,8,"{""src/Makefile"": {""insertions"": 0, ""deletions"": 52, ""lines"": 52}, ""src/filepath.c"": {""insertions"": 0, ""deletions"": 2, ""lines"": 2}, ""src/install-sh"": {""insertions"": 1, ""deletions"": 1, ""lines"": 2}, ""src/optiondefs.h"": {""insertions"": 0, ""deletions"": 4, ""lines"": 4}, ""src/os_unix.c"": {""insertions"": 1, ""deletions"": 1, ""lines"": 2}, ""src/os_unix.h"": {""insertions"": 3, ""deletions"": 14, ""lines"": 17}, ""src/pty.c"": {""insertions"": 0, ""deletions"": 25, ""lines"": 25}, ""src/version.c"": {""insertions"": 2, ""deletions"": 0, ""lines"": 2}}"
2022-08-27 19:59:57,6d24a51b94beb1991cddce221f90b455e2d50db7,Yegappan Lakshmanan,37,10,47,3,"{""src/quickfix.c"": {""insertions"": 18, ""deletions"": 10, ""lines"": 28}, ""src/testdir/test_quickfix.vim"": {""insertions"": 17, ""deletions"": 0, ""lines"": 17}, ""src/version.c"": {""insertions"": 2, ""deletions"": 0, ""lines"": 2}}"
2022-08-27 11:22:25,07ea5f1509fe8dafe3262ed2702b4d0fc99e288b,Shougo Matsushita,134,11,145,8,"{""runtime/doc/builtin.txt"": {""insertions"": 21, ""deletions"": 6, ""lines"": 27}, ""runtime/doc/usr_41.txt"": {""insertions"": 1, ""deletions"": 0, ""lines"": 1}, ""src/evalfunc.c"": {""insertions"": 4, ""deletions"": 5, ""lines"": 9}, ""src/ex_getln.c"": {""insertions"": 58, ""deletions"": 0, ""lines"": 58}, ""src/proto/ex_getln.pro"": {""insertions"": 2, ""deletions"": 0, ""lines"": 2}, ""src/testdir/test_cmdline.vim"": {""insertions"": 40, ""deletions"": 0, ""lines"": 40}, ""src/testdir/test_vim9_builtin.vim"": {""insertions"": 6, ""deletions"": 0, ""lines"": 6}, ""src/version.c"": {""insertions"": 2, ""deletions"": 0, ""lines"": 2}}"
2022-08-26 21:36:41,5ff595d9db2d9a33aa10cc9f18f256826226862f,Bram Moolenaar,21,24,45,5,"{""src/cmdhist.c"": {""insertions"": 6, ""deletions"": 6, ""lines"": 12}, ""src/misc1.c"": {""insertions"": 8, ""deletions"": 12, ""lines"": 20}, ""src/structs.h"": {""insertions"": 2, ""deletions"": 0, ""lines"": 2}, ""src/syntax.c"": {""insertions"": 3, ""deletions"": 6, ""lines"": 9}, ""src/version.c"": {""insertions"": 2, ""deletions"": 0, ""lines"": 2}}"
2022-08-26 20:58:31,af9a6002e0761012cb7108cbfa179a880d3cb49b,bfredl,32,4,36,3,"{""src/syntax.c"": {""insertions"": 26, ""deletions"": 4, ""lines"": 30}, ""src/testdir/test_syntax.vim"": {""insertions"": 4, ""deletions"": 0, ""lines"": 4}, ""src/version.c"": {""insertions"": 2, ""deletions"": 0, ""lines"": 2}}"
2022-08-26 20:33:04,0f618386367ba9388e1f50bc665bc1add6c01567,Bram Moolenaar,22,4,26,3,"{""src/evalfunc.c"": {""insertions"": 2, ""deletions"": 1, ""lines"": 3}, ""src/regexp.c"": {""insertions"": 18, ""deletions"": 3, ""lines"": 21}, ""src/version.c"": {""insertions"": 2, ""deletions"": 0, ""lines"": 2}}"
2022-08-26 18:58:49,58dcbf1c6586d3873702e035b47829178a91250e,Bram Moolenaar,9,1,10,2,"{""src/cmdexpand.c"": {""insertions"": 7, ""deletions"": 1, ""lines"": 8}, ""src/version.c"": {""insertions"": 2, ""deletions"": 0, ""lines"": 2}}"
2022-08-26 17:01:12,7dd543246a4c21c4d5a4242a28076706f5abebd4,Bram Moolenaar,737,374,1111,31,"{""runtime/colors/blue.vim"": {""insertions"": 2, ""deletions"": 2, ""lines"": 4}, ""runtime/colors/darkblue.vim"": {""insertions"": 2, ""deletions"": 2, ""lines"": 4}, ""runtime/colors/delek.vim"": {""insertions"": 2, ""deletions"": 2, ""lines"": 4}, ""runtime/colors/desert.vim"": {""insertions"": 2, ""deletions"": 2, ""lines"": 4}, ""runtime/colors/elflord.vim"": {""insertions"": 2, ""deletions"": 2, ""lines"": 4}, ""runtime/colors/evening.vim"": {""insertions"": 2, ""deletions"": 2, ""lines"": 4}, ""runtime/colors/habamax.vim"": {""insertions"": 2, ""deletions"": 2, ""lines"": 4}, ""runtime/colors/industry.vim"": {""insertions"": 2, ""deletions"": 2, ""lines"": 4}, ""runtime/colors/koehler.vim"": {""insertions"": 2, ""deletions"": 2, ""lines"": 4}, ""runtime/colors/lunaperche.vim"": {""insertions"": 2, ""deletions"": 2, ""lines"": 4}, ""runtime/colors/morning.vim"": {""insertions"": 2, ""deletions"": 2, ""lines"": 4}, ""runtime/colors/murphy.vim"": {""insertions"": 2, ""deletions"": 2, ""lines"": 4}, ""runtime/colors/pablo.vim"": {""insertions"": 2, ""deletions"": 2, ""lines"": 4}, ""runtime/colors/peachpuff.vim"": {""insertions"": 2, ""deletions"": 2, ""lines"": 4}, ""runtime/colors/quiet.vim"": {""insertions"": 2, ""deletions"": 2, ""lines"": 4}, ""runtime/colors/ron.vim"": {""insertions"": 2, ""deletions"": 2, ""lines"": 4}, ""runtime/colors/shine.vim"": {""insertions"": 2, ""deletions"": 2, ""lines"": 4}, ""runtime/colors/slate.vim"": {""insertions"": 2, ""deletions"": 2, ""lines"": 4}, ""runtime/colors/torte.vim"": {""insertions"": 2, ""deletions"": 2, ""lines"": 4}, ""runtime/colors/zellner.vim"": {""insertions"": 2, ""deletions"": 2, ""lines"": 4}, ""runtime/doc/Makefile"": {""insertions"": 4, ""deletions"": 0, ""lines"": 4}, ""runtime/doc/ft_context.txt"": {""insertions"": 152, ""deletions"": 0, ""lines"": 152}, ""runtime/doc/ft_mp.txt"": {""insertions"": 151, ""deletions"": 0, ""lines"": 151}, ""runtime/doc/tags"": {""insertions"": 41, ""deletions"": 1, ""lines"": 42}, ""runtime/doc/term.txt"": {""insertions"": 1, ""deletions"": 1, ""lines"": 2}, ""runtime/doc/todo.txt"": {""insertions"": 6, ""deletions"": 0, ""lines"": 6}, ""runtime/doc/various.txt"": {""insertions"": 2, ""deletions"": 1, ""lines"": 3}, ""runtime/indent/context.vim"": {""insertions"": 51, ""deletions"": 22, ""lines"": 73}, ""runtime/indent/mf.vim"": {""insertions"": 1, ""deletions"": 1, ""lines"": 2}, ""runtime/indent/mp.vim"": {""insertions"": 254, ""deletions"": 294, ""lines"": 548}, ""src/po/it.po"": {""insertions"": 34, ""deletions"": 14, ""lines"": 48}}"
2022-08-26 16:53:44,2ee347fbc0619179fefb9933e9bb1165463507b3,Bram Moolenaar,20,153,173,7,"{""runtime/doc/builtin.txt"": {""insertions"": 3, ""deletions"": 2, ""lines"": 5}, ""runtime/doc/term.txt"": {""insertions"": 4, ""deletions"": 9, ""lines"": 13}, ""runtime/doc/various.txt"": {""insertions"": 2, ""deletions"": 2, ""lines"": 4}, ""src/evalfunc.c"": {""insertions"": 2, ""deletions"": 14, ""lines"": 16}, ""src/feature.h"": {""insertions"": 7, ""deletions"": 33, ""lines"": 40}, ""src/term.c"": {""insertions"": 0, ""deletions"": 85, ""lines"": 85}, ""src/version.c"": {""insertions"": 2, ""deletions"": 8, ""lines"": 10}}"
2022-08-26 15:58:51,5416232707349d5f24294178f47544f2024b73ed,Bram Moolenaar,19,122,141,14,"{""runtime/doc/options.txt"": {""insertions"": 5, ""deletions"": 7, ""lines"": 12}, ""runtime/doc/various.txt"": {""insertions"": 1, ""deletions"": 1, ""lines"": 2}, ""src/cmdexpand.c"": {""insertions"": 0, ""deletions"": 20, ""lines"": 20}, ""src/drawscreen.c"": {""insertions"": 1, ""deletions"": 8, ""lines"": 9}, ""src/evalfunc.c"": {""insertions"": 1, ""deletions"": 9, ""lines"": 10}, ""src/ex_getln.c"": {""insertions"": 6, ""deletions"": 48, ""lines"": 54}, ""src/feature.h"": {""insertions"": 1, ""deletions"": 7, ""lines"": 8}, ""src/globals.h"": {""insertions"": 2, ""deletions"": 4, ""lines"": 6}, ""src/highlight.c"": {""insertions"": 0, ""deletions"": 4, ""lines"": 4}, ""src/option.h"": {""insertions"": 0, ""deletions"": 2, ""lines"": 2}, ""src/optiondefs.h"": {""insertions"": 0, ""deletions"": 4, ""lines"": 4}, ""src/popupmenu.c"": {""insertions"": 0, ""deletions"": 2, ""lines"": 2}, ""src/screen.c"": {""insertions"": 0, ""deletions"": 2, ""lines"": 2}, ""src/version.c"": {""insertions"": 2, ""deletions"": 4, ""lines"": 6}}"
2022-08-26 15:41:14,074fbd413172edc6f4936296a28bf8fd5cdfa38b,Bram Moolenaar,17,57,74,11,"{""runtime/doc/options.txt"": {""insertions"": 0, ""deletions"": 6, ""lines"": 6}, ""runtime/doc/various.txt"": {""insertions"": 1, ""deletions"": 1, ""lines"": 2}, ""src/bufwrite.c"": {""insertions"": 0, ""deletions"": 2, ""lines"": 2}, ""src/evalfunc.c"": {""insertions"": 1, ""deletions"": 7, ""lines"": 8}, ""src/feature.h"": {""insertions"": 2, ""deletions"": 9, ""lines"": 11}, ""src/fileio.c"": {""insertions"": 3, ""deletions"": 3, ""lines"": 6}, ""src/filepath.c"": {""insertions"": 0, ""deletions"": 2, ""lines"": 2}, ""src/option.c"": {""insertions"": 8, ""deletions"": 10, ""lines"": 18}, ""src/option.h"": {""insertions"": 0, ""deletions"": 4, ""lines"": 4}, ""src/optiondefs.h"": {""insertions"": 0, ""deletions"": 9, ""lines"": 9}, ""src/version.c"": {""insertions"": 2, ""deletions"": 4, ""lines"": 6}}"
2022-08-26 14:48:55,c361842f1479a7f7f3e65bfb0e188f2e5d38336e,Philip H,2,6,8,2,"{"".github/workflows/coverity.yml"": {""insertions"": 0, ""deletions"": 6, ""lines"": 6}, ""src/version.c"": {""insertions"": 2, ""deletions"": 0, ""lines"": 2}}"
2022-08-26 14:34:52,93f72cc119c796f1ccb75468ef9e446cbfb41e9b,zeertzjq,76,31,107,4,"{""src/testdir/test_autocmd.vim"": {""insertions"": 37, ""deletions"": 18, ""lines"": 55}, ""src/testdir/test_bufline.vim"": {""insertions"": 20, ""deletions"": 0, ""lines"": 20}, ""src/testdir/test_functions.vim"": {""insertions"": 17, ""deletions"": 13, ""lines"": 30}, ""src/version.c"": {""insertions"": 2, ""deletions"": 0, ""lines"": 2}}"
2022-08-26 12:16:20,a9b5b85068b2fcb1c01ea20524e227bcad579ceb,Bram Moolenaar,14,2,16,3,"{""src/fileio.c"": {""insertions"": 1, ""deletions"": 1, ""lines"": 2}, ""src/testdir/test_autocmd.vim"": {""insertions"": 11, ""deletions"": 1, ""lines"": 12}, ""src/version.c"": {""insertions"": 2, ""deletions"": 0, ""lines"": 2}}"
2022-08-26 11:58:17,c312619f7c0cf590d96e0b2ed891d1f6c43d769b,Bram Moolenaar,42,19,61,3,"{""src/buffer.c"": {""insertions"": 33, ""deletions"": 19, ""lines"": 52}, ""src/testdir/test_functions.vim"": {""insertions"": 7, ""deletions"": 0, ""lines"": 7}, ""src/version.c"": {""insertions"": 2, ""deletions"": 0, ""lines"": 2}}"
2022-08-26 11:26:07,d55f9ef8b2f1e9f868ed1440fe859d1b18b1cfe8,Bram Moolenaar,20,10,30,3,"{""src/term.c"": {""insertions"": 2, ""deletions"": 1, ""lines"": 3}, ""src/testdir/test_termcodes.vim"": {""insertions"": 16, ""deletions"": 9, ""lines"": 25}, ""src/version.c"": {""insertions"": 2, ""deletions"": 0, ""lines"": 2}}"
2022-08-26 10:55:01,b1d2c8116cb5577961ea109651fb888b5e58265f,Bram Moolenaar,26,3,29,5,"{""src/buffer.c"": {""insertions"": 7, ""deletions"": 3, ""lines"": 10}, ""src/fileio.c"": {""insertions"": 4, ""deletions"": 0, ""lines"": 4}, ""src/testdir/test_autocmd.vim"": {""insertions"": 12, ""deletions"": 0, ""lines"": 12}, ""src/version.c"": {""insertions"": 2, ""deletions"": 0, ""lines"": 2}, ""src/vim.h"": {""insertions"": 1, ""deletions"": 0, ""lines"": 1}}"
2022-08-26 09:33:54,9b7d2a959646560f5770329f4428c4739eed4656,zeertzjq,5,3,8,4,"{""src/ex_getln.c"": {""insertions"": 1, ""deletions"": 1, ""lines"": 2}, ""src/gui_xim.c"": {""insertions"": 1, ""deletions"": 1, ""lines"": 2}, ""src/os_unix.c"": {""insertions"": 1, ""deletions"": 1, ""lines"": 2}, ""src/version.c"": {""insertions"": 2, ""deletions"": 0, ""lines"": 2}}"
2022-08-25 17:12:06,2bd9dbc19fc67395cfa1226dda7326071ab22464,Bram Moolenaar,19,131,150,9,"{""runtime/doc/editing.txt"": {""insertions"": 0, ""deletions"": 2, ""lines"": 2}, ""runtime/doc/options.txt"": {""insertions"": 1, ""deletions"": 3, ""lines"": 4}, ""runtime/doc/various.txt"": {""insertions"": 2, ""deletions"": 1, ""lines"": 3}, ""src/errors.h"": {""insertions"": 0, ""deletions"": 2, ""lines"": 2}, ""src/evalfunc.c"": {""insertions"": 1, ""deletions"": 7, ""lines"": 8}, ""src/feature.h"": {""insertions"": 1, ""deletions"": 7, ""lines"": 8}, ""src/findfile.c"": {""insertions"": 12, ""deletions"": 101, ""lines"": 113}, ""src/tag.c"": {""insertions"": 0, ""deletions"": 4, ""lines"": 4}, ""src/version.c"": {""insertions"": 2, ""deletions"": 4, ""lines"": 6}}"
2022-08-25 16:40:40,520f6ef60a59f7b5f3da9199999d13dbe817d3ce,Yegappan Lakshmanan,76,10,86,7,"{""runtime/doc/builtin.txt"": {""insertions"": 9, ""deletions"": 2, ""lines"": 11}, ""src/evalfunc.c"": {""insertions"": 1, ""deletions"": 1, ""lines"": 2}, ""src/scriptfile.c"": {""insertions"": 27, ""deletions"": 1, ""lines"": 28}, ""src/testdir/test_scriptnames.vim"": {""insertions"": 26, ""deletions"": 4, ""lines"": 30}, ""src/testdir/test_vim9_builtin.vim"": {""insertions"": 4, ""deletions"": 0, ""lines"": 4}, ""src/testdir/test_vim9_import.vim"": {""insertions"": 7, ""deletions"": 2, ""lines"": 9}, ""src/version.c"": {""insertions"": 2, ""deletions"": 0, ""lines"": 2}}"
2022-08-25 15:30:01,0166e398d11a09662d783fe5db62b414045880f8,Bram Moolenaar,2,2,4,2,"{""src/globals.h"": {""insertions"": 0, ""deletions"": 2, ""lines"": 2}, ""src/version.c"": {""insertions"": 2, ""deletions"": 0, ""lines"": 2}}"
2022-08-25 15:24:56,930830a68b6eb7ca630956330b48996e3ef8518f,Philip H,3,1,4,2,"{"".github/workflows/coverity.yml"": {""insertions"": 1, ""deletions"": 1, ""lines"": 2}, ""src/version.c"": {""insertions"": 2, ""deletions"": 0, ""lines"": 2}}"
2022-08-25 15:16:45,340dafd155222ac96304107542344faf3c56e12b,Bram Moolenaar,4,2,6,2,"{""src/buffer.c"": {""insertions"": 2, ""deletions"": 2, ""lines"": 4}, ""src/version.c"": {""insertions"": 2, ""deletions"": 0, ""lines"": 2}}"
2022-08-25 15:02:23,f80f40a55ccff0a4331c5fbd1ac446511f622ed0,Bram Moolenaar,20,157,177,25,"{""runtime/doc/builtin.txt"": {""insertions"": 2, ""deletions"": 3, ""lines"": 5}, ""runtime/doc/cmdline.txt"": {""insertions"": 0, ""deletions"": 3, ""lines"": 3}, ""runtime/doc/editing.txt"": {""insertions"": 0, ""deletions"": 4, ""lines"": 4}, ""runtime/doc/options.txt"": {""insertions"": 0, ""deletions"": 4, ""lines"": 4}, ""runtime/doc/tabpage.txt"": {""insertions"": 0, ""deletions"": 2, ""lines"": 2}, ""runtime/doc/windows.txt"": {""insertions"": 0, ""deletions"": 8, ""lines"": 8}, ""src/alloc.c"": {""insertions"": 2, ""deletions"": 4, ""lines"": 6}, ""src/buffer.c"": {""insertions"": 0, ""deletions"": 2, ""lines"": 2}, ""src/errors.h"": {""insertions"": 0, ""deletions"": 4, ""lines"": 4}, ""src/evalfunc.c"": {""insertions"": 1, ""deletions"": 7, ""lines"": 8}, ""src/ex_docmd.c"": {""insertions"": 1, ""deletions"": 16, ""lines"": 17}, ""src/feature.h"": {""insertions"": 5, ""deletions"": 13, ""lines"": 18}, ""src/filepath.c"": {""insertions"": 0, ""deletions"": 10, ""lines"": 10}, ""src/findfile.c"": {""insertions"": 0, ""deletions"": 10, ""lines"": 10}, ""src/misc2.c"": {""insertions"": 2, ""deletions"": 6, ""lines"": 8}, ""src/normal.c"": {""insertions"": 0, ""deletions"": 6, ""lines"": 6}, ""src/option.c"": {""insertions"": 1, ""deletions"": 13, ""lines"": 14}, ""src/option.h"": {""insertions"": 0, ""deletions"": 6, ""lines"": 6}, ""src/optiondefs.h"": {""insertions"": 1, ""deletions"": 13, ""lines"": 14}, ""src/optionstr.c"": {""insertions"": 0, ""deletions"": 2, ""lines"": 2}, ""src/register.c"": {""insertions"": 0, ""deletions"": 4, ""lines"": 4}, ""src/structs.h"": {""insertions"": 0, ""deletions"": 2, ""lines"": 2}, ""src/testdir/test_options.vim"": {""insertions"": 0, ""deletions"": 1, ""lines"": 1}, ""src/version.c"": {""insertions"": 2, ""deletions"": 4, ""lines"": 6}, ""src/window.c"": {""insertions"": 3, ""deletions"": 10, ""lines"": 13}}"
2022-08-25 14:21:24,b213703f358e1e10ba0affb3729c09ccb2c88ea3,Philip H,4,7,11,2,"{"".github/workflows/ci.yml"": {""insertions"": 2, ""deletions"": 7, ""lines"": 9}, ""src/version.c"": {""insertions"": 2, ""deletions"": 0, ""lines"": 2}}"
2022-08-25 14:11:15,6d4b2f54df5d533eb0794331f38445a6ca5d3a3f,Bram Moolenaar,27,117,144,15,"{""src/buffer.c"": {""insertions"": 14, ""deletions"": 39, ""lines"": 53}, ""src/bufwrite.c"": {""insertions"": 0, ""deletions"": 8, ""lines"": 8}, ""src/change.c"": {""insertions"": 1, ""deletions"": 5, ""lines"": 6}, ""src/drawscreen.c"": {""insertions"": 1, ""deletions"": 5, ""lines"": 6}, ""src/errors.h"": {""insertions"": 1, ""deletions"": 1, ""lines"": 2}, ""src/evalbuffer.c"": {""insertions"": 1, ""deletions"": 5, ""lines"": 6}, ""src/ex_cmds.c"": {""insertions"": 2, ""deletions"": 11, ""lines"": 13}, ""src/ex_cmds2.c"": {""insertions"": 0, ""deletions"": 2, ""lines"": 2}, ""src/ex_docmd.c"": {""insertions"": 0, ""deletions"": 2, ""lines"": 2}, ""src/fileio.c"": {""insertions"": 0, ""deletions"": 6, ""lines"": 6}, ""src/netbeans.c"": {""insertions"": 1, ""deletions"": 4, ""lines"": 5}, ""src/session.c"": {""insertions"": 3, ""deletions"": 14, ""lines"": 17}, ""src/version.c"": {""insertions"": 2, ""deletions"": 0, ""lines"": 2}, ""src/viminfo.c"": {""insertions"": 1, ""deletions"": 9, ""lines"": 10}, ""src/window.c"": {""insertions"": 0, ""deletions"": 6, ""lines"": 6}}"
2022-08-25 12:54:16,2e6dcbc4450c98bd12faace5d77a65f2afddae44,Bram Moolenaar,4,0,4,2,"{""src/buffer.c"": {""insertions"": 2, ""deletions"": 0, ""lines"": 2}, ""src/version.c"": {""insertions"": 2, ""deletions"": 0, ""lines"": 2}}"
2022-08-25 11:45:21,2eddbacd6dc17c84e4bdc41e60e81949a36bb973,Bram Moolenaar,16,2,18,4,"{""runtime/doc/builtin.txt"": {""insertions"": 4, ""deletions"": 2, ""lines"": 6}, ""src/buffer.c"": {""insertions"": 3, ""deletions"": 0, ""lines"": 3}, ""src/testdir/test_functions.vim"": {""insertions"": 7, ""deletions"": 0, ""lines"": 7}, ""src/version.c"": {""insertions"": 2, ""deletions"": 0, ""lines"": 2}}"
2022-08-24 19:07:22,d6c67629ed05aae436164eec474832daf8ba7420,Bram Moolenaar,24,0,24,3,"{""src/quickfix.c"": {""insertions"": 9, ""deletions"": 0, ""lines"": 9}, ""src/testdir/test_quickfix.vim"": {""insertions"": 13, ""deletions"": 0, ""lines"": 13}, ""src/version.c"": {""insertions"": 2, ""deletions"": 0, ""lines"": 2}}"
2022-08-24 18:27:45,80525751c5ce9ed82c41d83faf9ef38667bf61b1,Bram Moolenaar,71,52,123,3,"{""src/mouse.c"": {""insertions"": 55, ""deletions"": 52, ""lines"": 107}, ""src/testdir/test_tabline.vim"": {""insertions"": 14, ""deletions"": 0, ""lines"": 14}, ""src/version.c"": {""insertions"": 2, ""deletions"": 0, ""lines"": 2}}"
2022-08-24 17:30:14,fd999452adaf529a30d78844b5fbee355943da29,Bram Moolenaar,2071,98,2169,48,"{""runtime/autoload/python.vim"": {""insertions"": 26, ""deletions"": 14, ""lines"": 40}, ""runtime/doc/builtin.txt"": {""insertions"": 7, ""deletions"": 4, ""lines"": 11}, ""runtime/doc/indent.txt"": {""insertions"": 20, ""deletions"": 7, ""lines"": 27}, ""runtime/doc/tags"": {""insertions"": 5, ""deletions"": 0, ""lines"": 5}, ""runtime/doc/terminal.txt"": {""insertions"": 4, ""deletions"": 2, ""lines"": 6}, ""runtime/doc/textprop.txt"": {""insertions"": 7, ""deletions"": 2, ""lines"": 9}, ""runtime/doc/todo.txt"": {""insertions"": 3, ""deletions"": 3, ""lines"": 6}, ""runtime/doc/usr_41.txt"": {""insertions"": 1, ""deletions"": 1, ""lines"": 2}, ""runtime/doc/various.txt"": {""insertions"": 2, ""deletions"": 1, ""lines"": 3}, ""runtime/doc/vim9.txt"": {""insertions"": 1, ""deletions"": 1, ""lines"": 2}, ""runtime/doc/windows.txt"": {""insertions"": 2, ""deletions"": 0, ""lines"": 2}, ""runtime/indent/testdir/python.in"": {""insertions"": 18, ""deletions"": 0, ""lines"": 18}, ""runtime/indent/testdir/python.ok"": {""insertions"": 18, ""deletions"": 0, ""lines"": 18}, ""runtime/plugin/matchparen.vim"": {""insertions"": 2, ""deletions"": 3, ""lines"": 5}, ""runtime/syntax/plsql.vim"": {""insertions"": 56, ""deletions"": 31, ""lines"": 87}, ""runtime/syntax/shared/context-data-context.vim"": {""insertions"": 345, ""deletions"": 0, ""lines"": 345}, ""runtime/syntax/shared/context-data-interfaces.vim"": {""insertions"": 1183, ""deletions"": 0, ""lines"": 1183}, ""runtime/syntax/shared/context-data-metafun.vim"": {""insertions"": 117, ""deletions"": 0, ""lines"": 117}, ""runtime/syntax/shared/context-data-tex.vim"": {""insertions"": 225, ""deletions"": 0, ""lines"": 225}, ""src/INSTALLpc.txt"": {""insertions"": 1, ""deletions"": 1, ""lines"": 2}, ""src/po/ca.po"": {""insertions"": 1, ""deletions"": 1, ""lines"": 2}, ""src/po/da.po"": {""insertions"": 1, ""deletions"": 1, ""lines"": 2}, ""src/po/de.po"": {""insertions"": 1, ""deletions"": 1, ""lines"": 2}, ""src/po/eo.po"": {""insertions"": 1, ""deletions"": 1, ""lines"": 2}, ""src/po/es.po"": {""insertions"": 1, ""deletions"": 1, ""lines"": 2}, ""src/po/fi.po"": {""insertions"": 1, ""deletions"": 1, ""lines"": 2}, ""src/po/fr.po"": {""insertions"": 1, ""deletions"": 1, ""lines"": 2}, ""src/po/ga.po"": {""insertions"": 1, ""deletions"": 1, ""lines"": 2}, ""src/po/it.po"": {""insertions"": 1, ""deletions"": 1, ""lines"": 2}, ""src/po/ja.euc-jp.po"": {""insertions"": 1, ""deletions"": 1, ""lines"": 2}, ""src/po/ja.po"": {""insertions"": 1, ""deletions"": 1, ""lines"": 2}, ""src/po/ja.sjis.po"": {""insertions"": 1, ""deletions"": 1, ""lines"": 2}, ""src/po/ko.UTF-8.po"": {""insertions"": 1, ""deletions"": 1, ""lines"": 2}, ""src/po/ko.po"": {""insertions"": 1, ""deletions"": 1, ""lines"": 2}, ""src/po/nl.po"": {""insertions"": 1, ""deletions"": 1, ""lines"": 2}, ""src/po/pl.UTF-8.po"": {""insertions"": 1, ""deletions"": 1, ""lines"": 2}, ""src/po/pl.cp1250.po"": {""insertions"": 1, ""deletions"": 1, ""lines"": 2}, ""src/po/pl.po"": {""insertions"": 1, ""deletions"": 1, ""lines"": 2}, ""src/po/pt_BR.po"": {""insertions"": 1, ""deletions"": 1, ""lines"": 2}, ""src/po/ru.cp1251.po"": {""insertions"": 1, ""deletions"": 1, ""lines"": 2}, ""src/po/ru.po"": {""insertions"": 1, ""deletions"": 1, ""lines"": 2}, ""src/po/sr.po"": {""insertions"": 1, ""deletions"": 1, ""lines"": 2}, ""src/po/tr.po"": {""insertions"": 1, ""deletions"": 1, ""lines"": 2}, ""src/po/uk.cp1251.po"": {""insertions"": 1, ""deletions"": 1, ""lines"": 2}, ""src/po/uk.po"": {""insertions"": 1, ""deletions"": 1, ""lines"": 2}, ""src/po/zh_CN.UTF-8.po"": {""insertions"": 1, ""deletions"": 1, ""lines"": 2}, ""src/po/zh_CN.cp936.po"": {""insertions"": 1, ""deletions"": 1, ""lines"": 2}, ""src/po/zh_CN.po"": {""insertions"": 1, ""deletions"": 1, ""lines"": 2}}"
2022-08-24 17:08:00,44b9abb150afdca557d8ff5af112d654e0d19e84,K.Takata,5,13,18,2,"{""nsis/gvim.nsi"": {""insertions"": 3, ""deletions"": 13, ""lines"": 16}, ""src/version.c"": {""insertions"": 2, ""deletions"": 0, ""lines"": 2}}"
2022-08-24 16:46:12,7ea9fcb48dcdb07c9eb960ace3cc625fe7c685b2,Bram Moolenaar,7,0,7,2,"{""src/testdir/test_vim9_import.vim"": {""insertions"": 5, ""deletions"": 0, ""lines"": 5}, ""src/version.c"": {""insertions"": 2, ""deletions"": 0, ""lines"": 2}}"
2022-08-24 16:32:35,5214b294615718cc3f0d2248b76e9970b9fe9d45,Bram Moolenaar,4,2,6,2,"{""src/scriptfile.c"": {""insertions"": 2, ""deletions"": 2, ""lines"": 4}, ""src/version.c"": {""insertions"": 2, ""deletions"": 0, ""lines"": 2}}"
2022-08-24 16:05:56,0af2ecfe4474be3a83d75b1d636bfdf6b27bbc92,Bram Moolenaar,4,0,4,2,"{""src/scriptfile.c"": {""insertions"": 2, ""deletions"": 0, ""lines"": 2}, ""src/version.c"": {""insertions"": 2, ""deletions"": 0, ""lines"": 2}}"
2022-08-24 15:48:23,5fb3aabc2b0edd5573e107bb3bc103c348771f61,zeertzjq,5,3,8,2,"{""src/insexpand.c"": {""insertions"": 3, ""deletions"": 3, ""lines"": 6}, ""src/version.c"": {""insertions"": 2, ""deletions"": 0, ""lines"": 2}}"
2022-08-24 15:30:36,753885b6c5b9021184daa94d32fd8bf025f1b488,Bram Moolenaar,124,21,145,11,"{""runtime/doc/builtin.txt"": {""insertions"": 8, ""deletions"": 5, ""lines"": 13}, ""runtime/doc/repeat.txt"": {""insertions"": 4, ""deletions"": 0, ""lines"": 4}, ""src/eval.c"": {""insertions"": 1, ""deletions"": 0, ""lines"": 1}, ""src/evalvars.c"": {""insertions"": 1, ""deletions"": 0, ""lines"": 1}, ""src/proto/vim9script.pro"": {""insertions"": 1, ""deletions"": 0, ""lines"": 1}, ""src/scriptfile.c"": {""insertions"": 35, ""deletions"": 13, ""lines"": 48}, ""src/structs.h"": {""insertions"": 7, ""deletions"": 1, ""lines"": 8}, ""src/testdir/test_vim9_import.vim"": {""insertions"": 45, ""deletions"": 0, ""lines"": 45}, ""src/version.c"": {""insertions"": 2, ""deletions"": 0, ""lines"": 2}, ""src/vim9compile.c"": {""insertions"": 6, ""deletions"": 2, ""lines"": 8}, ""src/vim9script.c"": {""insertions"": 14, ""deletions"": 0, ""lines"": 14}}"
2022-08-24 11:24:37,f5240b96f721b08d703340ff0b2e67b79fb8b821,Bram Moolenaar,50,1,51,5,"{""src/testdir/dumps/Test_prop_text_change_arg_1.dump"": {""insertions"": 5, ""deletions"": 0, ""lines"": 5}, ""src/testdir/dumps/Test_prop_text_change_arg_2.dump"": {""insertions"": 5, ""deletions"": 0, ""lines"": 5}, ""src/testdir/test_textprop.vim"": {""insertions"": 36, ""deletions"": 0, ""lines"": 36}, ""src/textprop.c"": {""insertions"": 2, ""deletions"": 1, ""lines"": 3}, ""src/version.c"": {""insertions"": 2, ""deletions"": 0, ""lines"": 2}}"
2022-08-24 10:26:16,762df0477c32065498805e09c15adc468a6cc8ea,huang06,3,0,3,2,"{"".gitignore"": {""insertions"": 1, ""deletions"": 0, ""lines"": 1}, ""src/version.c"": {""insertions"": 2, ""deletions"": 0, ""lines"": 2}}"
2022-08-23 20:41:15,dde77a7c4d72622284dc5fb72557bde42c314fa6,Bram Moolenaar,3,1,4,2,"{""src/errors.h"": {""insertions"": 1, ""deletions"": 1, ""lines"": 2}, ""src/version.c"": {""insertions"": 2, ""deletions"": 0, ""lines"": 2}}"
2022-08-23 18:54:27,3a7ad904d27d904e57f7a22eb33872a587ae6673,Bram Moolenaar,9,0,9,2,"{""src/testdir/test_cmdwin.vim"": {""insertions"": 7, ""deletions"": 0, ""lines"": 7}, ""src/version.c"": {""insertions"": 2, ""deletions"": 0, ""lines"": 2}}"
2022-08-23 18:26:05,a247142ae45308087b25f91c8af48399c8ac2943,zeertzjq,9,18,27,2,"{""src/scriptfile.c"": {""insertions"": 7, ""deletions"": 18, ""lines"": 25}, ""src/version.c"": {""insertions"": 2, ""deletions"": 0, ""lines"": 2}}"
2022-08-23 17:39:37,f396ce83eebf6c61596184231d39ce4d41eeac04,Bram Moolenaar,403,189,592,15,"{""runtime/doc/textprop.txt"": {""insertions"": 12, ""deletions"": 4, ""lines"": 16}, ""src/charset.c"": {""insertions"": 48, ""deletions"": 45, ""lines"": 93}, ""src/drawline.c"": {""insertions"": 146, ""deletions"": 132, ""lines"": 278}, ""src/errors.h"": {""insertions"": 4, ""deletions"": 0, ""lines"": 4}, ""src/proto/drawline.pro"": {""insertions"": 1, ""deletions"": 0, ""lines"": 1}, ""src/proto/textprop.pro"": {""insertions"": 1, ""deletions"": 0, ""lines"": 1}, ""src/structs.h"": {""insertions"": 2, ""deletions"": 1, ""lines"": 3}, ""src/testdir/dumps/Test_prop_right_align_twice_2.dump"": {""insertions"": 3, ""deletions"": 3, ""lines"": 6}, ""src/testdir/dumps/Test_prop_text_with_padding_1.dump"": {""insertions"": 8, ""deletions"": 0, ""lines"": 8}, ""src/testdir/dumps/Test_prop_text_with_padding_2.dump"": {""insertions"": 8, ""deletions"": 0, ""lines"": 8}, ""src/testdir/dumps/Test_prop_text_with_padding_3.dump"": {""insertions"": 8, ""deletions"": 0, ""lines"": 8}, ""src/testdir/dumps/Test_prop_with_text_after_wraps_1.dump"": {""insertions"": 2, ""deletions"": 2, ""lines"": 4}, ""src/testdir/test_textprop.vim"": {""insertions"": 50, ""deletions"": 0, ""lines"": 50}, ""src/textprop.c"": {""insertions"": 108, ""deletions"": 2, ""lines"": 110}, ""src/version.c"": {""insertions"": 2, ""deletions"": 0, ""lines"": 2}}"
2022-08-22 15:35:45,adce965162dd89bf29ee0e5baf53652e7515762c,Bram Moolenaar,22,1,23,3,"{""src/tag.c"": {""insertions"": 8, ""deletions"": 1, ""lines"": 9}, ""src/testdir/test_tagfunc.vim"": {""insertions"": 12, ""deletions"": 0, ""lines"": 12}, ""src/version.c"": {""insertions"": 2, ""deletions"": 0, ""lines"": 2}}"
2022-08-22 14:19:16,471c0fa3eed4f6207d1cb7636970547bfd2eee26,Bram Moolenaar,51,40,91,13,"{""src/buffer.c"": {""insertions"": 11, ""deletions"": 12, ""lines"": 23}, ""src/change.c"": {""insertions"": 2, ""deletions"": 3, ""lines"": 5}, ""src/digraph.c"": {""insertions"": 1, ""deletions"": 1, ""lines"": 2}, ""src/drawscreen.c"": {""insertions"": 12, ""deletions"": 2, ""lines"": 14}, ""src/ex_docmd.c"": {""insertions"": 1, ""deletions"": 1, ""lines"": 2}, ""src/globals.h"": {""insertions"": 5, ""deletions"": 1, ""lines"": 6}, ""src/highlight.c"": {""insertions"": 9, ""deletions"": 9, ""lines"": 18}, ""src/main.c"": {""insertions"": 1, ""deletions"": 1, ""lines"": 2}, ""src/message.c"": {""insertions"": 2, ""deletions"": 3, ""lines"": 5}, ""src/misc1.c"": {""insertions"": 3, ""deletions"": 6, ""lines"": 9}, ""src/proto/drawscreen.pro"": {""insertions"": 1, ""deletions"": 0, ""lines"": 1}, ""src/screen.c"": {""insertions"": 1, ""deletions"": 1, ""lines"": 2}, ""src/version.c"": {""insertions"": 2, ""deletions"": 0, ""lines"": 2}}"
2022-08-22 12:15:13,f768c3d19c518822d89dec4cc3947ddeea249316,Yegappan Lakshmanan,70,8,78,8,"{""runtime/doc/builtin.txt"": {""insertions"": 13, ""deletions"": 0, ""lines"": 13}, ""runtime/doc/usr_41.txt"": {""insertions"": 9, ""deletions"": 7, ""lines"": 16}, ""src/evalfunc.c"": {""insertions"": 2, ""deletions"": 0, ""lines"": 2}, ""src/proto/scriptfile.pro"": {""insertions"": 1, ""deletions"": 0, ""lines"": 1}, ""src/scriptfile.c"": {""insertions"": 30, ""deletions"": 0, ""lines"": 30}, ""src/testdir/test_scriptnames.vim"": {""insertions"": 11, ""deletions"": 1, ""lines"": 12}, ""src/testdir/test_vim9_import.vim"": {""insertions"": 2, ""deletions"": 0, ""lines"": 2}, ""src/version.c"": {""insertions"": 2, ""deletions"": 0, ""lines"": 2}}"
2022-08-22 12:00:16,e89aeed43e6eca1bda5379cf9b437bce3bc56628,Bram Moolenaar,8,1,9,2,"{""src/drawline.c"": {""insertions"": 6, ""deletions"": 1, ""lines"": 7}, ""src/version.c"": {""insertions"": 2, ""deletions"": 0, ""lines"": 2}}"
2022-08-21 21:20:20,171c683237149262665135c7d5841a89bb156f53,Bram Moolenaar,6,2,8,2,"{""src/Makefile"": {""insertions"": 4, ""deletions"": 2, ""lines"": 6}, ""src/version.c"": {""insertions"": 2, ""deletions"": 0, ""lines"": 2}}"
2022-08-21 20:05:08,448f72a78aad3a86a066f269d7e4569679355c46,Bram Moolenaar,9,2,11,2,"{""src/Makefile"": {""insertions"": 7, ""deletions"": 2, ""lines"": 9}, ""src/version.c"": {""insertions"": 2, ""deletions"": 0, ""lines"": 2}}"
2022-08-21 19:33:47,6669de1b235843968e88844ca6d3c8dec4b01a9e,Bram Moolenaar,17,1,18,3,"{""src/spellfile.c"": {""insertions"": 3, ""deletions"": 1, ""lines"": 4}, ""src/testdir/test_spellfile.vim"": {""insertions"": 12, ""deletions"": 0, ""lines"": 12}, ""src/version.c"": {""insertions"": 2, ""deletions"": 0, ""lines"": 2}}"
2022-08-21 18:08:50,8884916043a4d517ff1cf3afb8c8a424a8ef3610,Bram Moolenaar,4,2,6,2,"{""src/ex_getln.c"": {""insertions"": 2, ""deletions"": 2, ""lines"": 4}, ""src/version.c"": {""insertions"": 2, ""deletions"": 0, ""lines"": 2}}"
2022-08-21 17:38:21,300175fd7f874be78826a00f5cb60a7ec2f20655,Bram Moolenaar,26,1,27,3,"{""src/ex_getln.c"": {""insertions"": 6, ""deletions"": 1, ""lines"": 7}, ""src/testdir/test_cmdline.vim"": {""insertions"": 18, ""deletions"": 0, ""lines"": 18}, ""src/version.c"": {""insertions"": 2, ""deletions"": 0, ""lines"": 2}}"
2022-08-21 16:24:00,e24a14118c29d910d3be59203332768b5fbd93e8,Evan Miller,4,0,4,2,"{""src/os_macosx.m"": {""insertions"": 2, ""deletions"": 0, ""lines"": 2}, ""src/version.c"": {""insertions"": 2, ""deletions"": 0, ""lines"": 2}}"
2022-08-21 13:33:57,b82a2ab8ad7af52a327cdba013ec433f7caf550d,zeertzjq,13,1,14,3,"{""src/cmdexpand.c"": {""insertions"": 1, ""deletions"": 1, ""lines"": 2}, ""src/testdir/test_cmdline.vim"": {""insertions"": 10, ""deletions"": 0, ""lines"": 10}, ""src/version.c"": {""insertions"": 2, ""deletions"": 0, ""lines"": 2}}"
2022-08-21 10:37:17,474ad390ccb8bbeb53848122829e04c52f0349ce,Bram Moolenaar,21,17,38,2,"{""src/terminal.c"": {""insertions"": 19, ""deletions"": 17, ""lines"": 36}, ""src/version.c"": {""insertions"": 2, ""deletions"": 0, ""lines"": 2}}"
2022-08-21 09:40:07,8d69637133e17370491b83da8657a15b991c2f76,Bram Moolenaar,16,3,19,4,"{""src/getchar.c"": {""insertions"": 7, ""deletions"": 0, ""lines"": 7}, ""src/globals.h"": {""insertions"": 4, ""deletions"": 0, ""lines"": 4}, ""src/normal.c"": {""insertions"": 3, ""deletions"": 3, ""lines"": 6}, ""src/version.c"": {""insertions"": 2, ""deletions"": 0, ""lines"": 2}}"
2022-08-20 19:54:51,a7704226a26b95b15bf87d3a3a5128e23e4aaa06,Ben Jackson,111,19,130,4,"{""src/errors.h"": {""insertions"": 6, ""deletions"": 2, ""lines"": 8}, ""src/testdir/test_textprop.vim"": {""insertions"": 38, ""deletions"": 7, ""lines"": 45}, ""src/textprop.c"": {""insertions"": 65, ""deletions"": 10, ""lines"": 75}, ""src/version.c"": {""insertions"": 2, ""deletions"": 0, ""lines"": 2}}"
2022-08-20 19:09:14,38ea5bda2b699d91e339fb116d96e3a4f2e69c89,Bram Moolenaar,6,4,10,2,"{""src/testdir/test_vim9_cmd.vim"": {""insertions"": 4, ""deletions"": 4, ""lines"": 8}, ""src/version.c"": {""insertions"": 2, ""deletions"": 0, ""lines"": 2}}"
2022-08-20 18:26:14,57e95179abdd851cb2d0c06d4f973575a768e3bb,Bram Moolenaar,12,6,18,3,"{""src/cmdexpand.c"": {""insertions"": 3, ""deletions"": 2, ""lines"": 5}, ""src/filepath.c"": {""insertions"": 7, ""deletions"": 4, ""lines"": 11}, ""src/version.c"": {""insertions"": 2, ""deletions"": 0, ""lines"": 2}}"
2022-08-20 13:51:17,2984ed31d92f7da19b3dc86b37764c55669dd7c2,Bram Moolenaar,26,15,41,7,"{""src/testdir/test_vim9_assign.vim"": {""insertions"": 3, ""deletions"": 3, ""lines"": 6}, ""src/testdir/test_vim9_disassemble.vim"": {""insertions"": 2, ""deletions"": 2, ""lines"": 4}, ""src/testdir/test_vim9_expr.vim"": {""insertions"": 4, ""deletions"": 3, ""lines"": 7}, ""src/testdir/test_vim9_func.vim"": {""insertions"": 5, ""deletions"": 5, ""lines"": 10}, ""src/testdir/test_vim9_script.vim"": {""insertions"": 2, ""deletions"": 2, ""lines"": 4}, ""src/version.c"": {""insertions"": 2, ""deletions"": 0, ""lines"": 2}, ""src/vim9expr.c"": {""insertions"": 8, ""deletions"": 0, ""lines"": 8}}"
2022-08-20 11:07:58,62e0e2e54b34b618500be4521ab1c33e1c378b42,Bram Moolenaar,18,13,31,5,"{""src/errors.h"": {""insertions"": 4, ""deletions"": 4, ""lines"": 8}, ""src/testdir/test_vim9_assign.vim"": {""insertions"": 1, ""deletions"": 1, ""lines"": 2}, ""src/testdir/test_vim9_func.vim"": {""insertions"": 3, ""deletions"": 3, ""lines"": 6}, ""src/version.c"": {""insertions"": 2, ""deletions"": 0, ""lines"": 2}, ""src/vim9type.c"": {""insertions"": 8, ""deletions"": 5, ""lines"": 13}}"
2022-08-19 16:15:35,e80086446cc20856ed8359bc8dc87c4d430da4c8,Bram Moolenaar,1340,2458,3798,35,"{""runtime/autoload/python.vim"": {""insertions"": 9, ""deletions"": 4, ""lines"": 13}, ""runtime/colors/blue.vim"": {""insertions"": 29, ""deletions"": 13, ""lines"": 42}, ""runtime/colors/darkblue.vim"": {""insertions"": 2, ""deletions"": 2, ""lines"": 4}, ""runtime/colors/delek.vim"": {""insertions"": 2, ""deletions"": 2, ""lines"": 4}, ""runtime/colors/desert.vim"": {""insertions"": 2, ""deletions"": 2, ""lines"": 4}, ""runtime/colors/elflord.vim"": {""insertions"": 2, ""deletions"": 2, ""lines"": 4}, ""runtime/colors/evening.vim"": {""insertions"": 2, ""deletions"": 2, ""lines"": 4}, ""runtime/colors/habamax.vim"": {""insertions"": 21, ""deletions"": 21, ""lines"": 42}, ""runtime/colors/industry.vim"": {""insertions"": 2, ""deletions"": 2, ""lines"": 4}, ""runtime/colors/koehler.vim"": {""insertions"": 2, ""deletions"": 2, ""lines"": 4}, ""runtime/colors/lunaperche.vim"": {""insertions"": 911, ""deletions"": 0, ""lines"": 911}, ""runtime/colors/morning.vim"": {""insertions"": 2, ""deletions"": 2, ""lines"": 4}, ""runtime/colors/murphy.vim"": {""insertions"": 2, ""deletions"": 2, ""lines"": 4}, ""runtime/colors/pablo.vim"": {""insertions"": 2, ""deletions"": 2, ""lines"": 4}, ""runtime/colors/peachpuff.vim"": {""insertions"": 2, ""deletions"": 2, ""lines"": 4}, ""runtime/colors/quiet.vim"": {""insertions"": 161, ""deletions"": 168, ""lines"": 329}, ""runtime/colors/ron.vim"": {""insertions"": 2, ""deletions"": 2, ""lines"": 4}, ""runtime/colors/shine.vim"": {""insertions"": 2, ""deletions"": 2, ""lines"": 4}, ""runtime/colors/slate.vim"": {""insertions"": 76, ""deletions"": 59, ""lines"": 135}, ""runtime/colors/tools/check_colors.vim"": {""insertions"": 18, ""deletions"": 4, ""lines"": 22}, ""runtime/colors/torte.vim"": {""insertions"": 2, ""deletions"": 2, ""lines"": 4}, ""runtime/colors/zellner.vim"": {""insertions"": 2, ""deletions"": 2, ""lines"": 4}, ""runtime/doc/builtin.txt"": {""insertions"": 5, ""deletions"": 2, ""lines"": 7}, ""runtime/doc/options.txt"": {""insertions"": 2, ""deletions"": 1, ""lines"": 3}, ""runtime/doc/syntax.txt"": {""insertions"": 1, ""deletions"": 0, ""lines"": 1}, ""runtime/doc/tags"": {""insertions"": 1, ""deletions"": 0, ""lines"": 1}, ""runtime/doc/todo.txt"": {""insertions"": 0, ""deletions"": 2, ""lines"": 2}, ""runtime/ftplugin/j.vim"": {""insertions"": 34, ""deletions"": 32, ""lines"": 66}, ""runtime/indent/testdir/html.in"": {""insertions"": 3, ""deletions"": 3, ""lines"": 6}, ""runtime/indent/testdir/html.ok"": {""insertions"": 3, ""deletions"": 3, ""lines"": 6}, ""runtime/indent/testdir/python.in"": {""insertions"": 11, ""deletions"": 3, ""lines"": 14}, ""runtime/indent/testdir/python.ok"": {""insertions"": 11, ""deletions"": 3, ""lines"": 14}, ""runtime/syntax/typescriptcommon.vim"": {""insertions"": 0, ""deletions"": 2099, ""lines"": 2099}, ""runtime/syntax/vim.vim"": {""insertions"": 8, ""deletions"": 8, ""lines"": 16}, ""src/INSTALLpc.txt"": {""insertions"": 6, ""deletions"": 3, ""lines"": 9}}"
2022-08-19 12:59:25,13ed494bb5edc5a02d0ed0feabddb68920f88570,Bram Moolenaar,35,10,45,4,"{""src/regexp_bt.c"": {""insertions"": 11, ""deletions"": 6, ""lines"": 17}, ""src/regexp_nfa.c"": {""insertions"": 10, ""deletions"": 4, ""lines"": 14}, ""src/testdir/test_regexp_latin.vim"": {""insertions"": 12, ""deletions"": 0, ""lines"": 12}, ""src/version.c"": {""insertions"": 2, ""deletions"": 0, ""lines"": 2}}"
2022-08-19 12:17:21,213e70e284b0975dd34525e94e59e26811097c72,Bram Moolenaar,8,2,10,2,"{""src/message.c"": {""insertions"": 6, ""deletions"": 2, ""lines"": 8}, ""src/version.c"": {""insertions"": 2, ""deletions"": 0, ""lines"": 2}}"
2022-08-18 14:22:09,9e043181ad51536f23d069e719d6f6b96c4c0ec0,Bram Moolenaar,3,0,3,2,"{""src/testdir/test_vim9_builtin.vim"": {""insertions"": 1, ""deletions"": 0, ""lines"": 1}, ""src/version.c"": {""insertions"": 2, ""deletions"": 0, ""lines"": 2}}"
2022-08-18 12:28:31,91c7cbfe31bbef57d5fcf7d76989fc159f73ef15,Bram Moolenaar,77,59,136,5,"{""src/eval.c"": {""insertions"": 60, ""deletions"": 42, ""lines"": 102}, ""src/proto/eval.pro"": {""insertions"": 2, ""deletions"": 2, ""lines"": 4}, ""src/testdir/test_vim9_script.vim"": {""insertions"": 13, ""deletions"": 0, ""lines"": 13}, ""src/userfunc.c"": {""insertions"": 0, ""deletions"": 15, ""lines"": 15}, ""src/version.c"": {""insertions"": 2, ""deletions"": 0, ""lines"": 2}}"
2022-08-17 14:55:51,4875d6ab068f09df88d24d81de40dcd8d56e243d,Bram Moolenaar,25,4,29,3,"{""src/testdir/test_vim9_script.vim"": {""insertions"": 13, ""deletions"": 0, ""lines"": 13}, ""src/version.c"": {""insertions"": 2, ""deletions"": 0, ""lines"": 2}, ""src/vim9compile.c"": {""insertions"": 10, ""deletions"": 4, ""lines"": 14}}"
2022-08-17 11:09:45,5fd6ab820b4a0aaa5c6020852f39d118375fab49,zeertzjq,3,1,4,2,"{""src/testdir/test_diffmode.vim"": {""insertions"": 1, ""deletions"": 1, ""lines"": 2}, ""src/version.c"": {""insertions"": 2, ""deletions"": 0, ""lines"": 2}}"
2022-08-16 19:24:29,887748742deae3d6de7aa0fdbb042afe1ccf5e7a,Bram Moolenaar,15,60,75,16,"{""runtime/doc/motion.txt"": {""insertions"": 1, ""deletions"": 2, ""lines"": 3}, ""runtime/doc/various.txt"": {""insertions"": 1, ""deletions"": 1, ""lines"": 2}, ""src/buffer.c"": {""insertions"": 0, ""deletions"": 2, ""lines"": 2}, ""src/evalfunc.c"": {""insertions"": 1, ""deletions"": 7, ""lines"": 8}, ""src/feature.h"": {""insertions"": 1, ""deletions"": 7, ""lines"": 8}, ""src/misc2.c"": {""insertions"": 0, ""deletions"": 2, ""lines"": 2}, ""src/normal.c"": {""insertions"": 2, ""deletions"": 8, ""lines"": 10}, ""src/option.c"": {""insertions"": 0, ""deletions"": 4, ""lines"": 4}, ""src/option.h"": {""insertions"": 0, ""deletions"": 4, ""lines"": 4}, ""src/optiondefs.h"": {""insertions"": 2, ""deletions"": 10, ""lines"": 12}, ""src/optionstr.c"": {""insertions"": 0, ""deletions"": 2, ""lines"": 2}, ""src/scriptfile.c"": {""insertions"": 3, ""deletions"": 1, ""lines"": 4}, ""src/structs.h"": {""insertions"": 0, ""deletions"": 2, ""lines"": 2}, ""src/testdir/test_textobjects.vim"": {""insertions"": 0, ""deletions"": 1, ""lines"": 1}, ""src/textobject.c"": {""insertions"": 2, ""deletions"": 3, ""lines"": 5}, ""src/version.c"": {""insertions"": 2, ""deletions"": 4, ""lines"": 6}}"
2022-08-16 18:34:44,1889f499a4f248cd84e0e0bf6d0d820016774494,Bram Moolenaar,19,2,21,3,"{""src/testdir/test_vim9_func.vim"": {""insertions"": 12, ""deletions"": 0, ""lines"": 12}, ""src/version.c"": {""insertions"": 2, ""deletions"": 0, ""lines"": 2}, ""src/vim9compile.c"": {""insertions"": 5, ""deletions"": 2, ""lines"": 7}}"
2022-08-16 16:50:38,f6d39c31d2177549a986d170e192d8351bd571e2,Bram Moolenaar,29,9,38,4,"{""src/globals.h"": {""insertions"": 2, ""deletions"": 1, ""lines"": 3}, ""src/mbyte.c"": {""insertions"": 13, ""deletions"": 8, ""lines"": 21}, ""src/testdir/test_eval_stuff.vim"": {""insertions"": 12, ""deletions"": 0, ""lines"": 12}, ""src/version.c"": {""insertions"": 2, ""deletions"": 0, ""lines"": 2}}"
2022-08-16 15:09:59,948a3894d98f5e2a6e7fc57189fe9c2a5919eebf,Kota Kato,45,4,49,4,"{""src/testdir/test_vim9_func.vim"": {""insertions"": 39, ""deletions"": 0, ""lines"": 39}, ""src/userfunc.c"": {""insertions"": 2, ""deletions"": 1, ""lines"": 3}, ""src/version.c"": {""insertions"": 2, ""deletions"": 0, ""lines"": 2}, ""src/vim9expr.c"": {""insertions"": 2, ""deletions"": 3, ""lines"": 5}}"
2022-08-16 13:51:53,e98c88c44c308edaea5994b8ad4363e65030968c,Bram Moolenaar,13,2,15,4,"{""src/edit.c"": {""insertions"": 2, ""deletions"": 1, ""lines"": 3}, ""src/proto/edit.pro"": {""insertions"": 1, ""deletions"": 1, ""lines"": 2}, ""src/testdir/test_cmdwin.vim"": {""insertions"": 8, ""deletions"": 0, ""lines"": 8}, ""src/version.c"": {""insertions"": 2, ""deletions"": 0, ""lines"": 2}}"
2022-08-15 17:51:32,e1f3fd1d02e3f5fe6d2b6d82687c6846b8e500f8,Bram Moolenaar,3015,1203,4218,24,"{""Filelist"": {""insertions"": 2, ""deletions"": 0, ""lines"": 2}, ""runtime/autoload/context.vim"": {""insertions"": 89, ""deletions"": 178, ""lines"": 267}, ""runtime/autoload/typeset.vim"": {""insertions"": 233, ""deletions"": 0, ""lines"": 233}, ""runtime/compiler/context.vim"": {""insertions"": 37, ""deletions"": 43, ""lines"": 80}, ""runtime/doc/eval.txt"": {""insertions"": 1, ""deletions"": 0, ""lines"": 1}, ""runtime/doc/motion.txt"": {""insertions"": 2, ""deletions"": 1, ""lines"": 3}, ""runtime/doc/options.txt"": {""insertions"": 5, ""deletions"": 4, ""lines"": 9}, ""runtime/doc/tags"": {""insertions"": 2, ""deletions"": 0, ""lines"": 2}, ""runtime/doc/textprop.txt"": {""insertions"": 9, ""deletions"": 4, ""lines"": 13}, ""runtime/doc/todo.txt"": {""insertions"": 14, ""deletions"": 19, ""lines"": 33}, ""runtime/doc/vim9.txt"": {""insertions"": 6, ""deletions"": 0, ""lines"": 6}, ""runtime/ftplugin/context.vim"": {""insertions"": 95, ""deletions"": 97, ""lines"": 192}, ""runtime/ftplugin/elixir.vim"": {""insertions"": 19, ""deletions"": 1, ""lines"": 20}, ""runtime/ftplugin/mf.vim"": {""insertions"": 68, ""deletions"": 56, ""lines"": 124}, ""runtime/ftplugin/mp.vim"": {""insertions"": 78, ""deletions"": 69, ""lines"": 147}, ""runtime/syntax/README.txt"": {""insertions"": 3, ""deletions"": 0, ""lines"": 3}, ""runtime/syntax/context.vim"": {""insertions"": 95, ""deletions"": 92, ""lines"": 187}, ""runtime/syntax/mf.vim"": {""insertions"": 56, ""deletions"": 43, ""lines"": 99}, ""runtime/syntax/mp.vim"": {""insertions"": 94, ""deletions"": 590, ""lines"": 684}, ""runtime/syntax/shared/README.txt"": {""insertions"": 2, ""deletions"": 0, ""lines"": 2}, ""runtime/syntax/shared/typescriptcommon.vim"": {""insertions"": 2099, ""deletions"": 0, ""lines"": 2099}, ""runtime/syntax/swayconfig.vim"": {""insertions"": 4, ""deletions"": 4, ""lines"": 8}, ""runtime/syntax/typescript.vim"": {""insertions"": 1, ""deletions"": 1, ""lines"": 2}, ""runtime/syntax/typescriptreact.vim"": {""insertions"": 1, ""deletions"": 1, ""lines"": 2}}"
2022-08-15 16:53:55,5a4fff4d948cd12a5cf5f637ad2c561815a77d8e,zeertzjq,32,5,37,3,"{""src/scriptfile.c"": {""insertions"": 4, ""deletions"": 4, ""lines"": 8}, ""src/testdir/test_expand_func.vim"": {""insertions"": 26, ""deletions"": 1, ""lines"": 27}, ""src/version.c"": {""insertions"": 2, ""deletions"": 0, ""lines"": 2}}"
2022-08-15 16:28:27,cce293f87beb57a75ff738fade7fafadbc4a78a9,Bram Moolenaar,5,3,8,2,"{""src/testdir/test_undo.vim"": {""insertions"": 3, ""deletions"": 3, ""lines"": 6}, ""src/version.c"": {""insertions"": 2, ""deletions"": 0, ""lines"": 2}}"
2022-08-15 15:29:37,8a77d208ff580b231ffacf4202dc3a6ce171087f,Bram Moolenaar,4,1,5,2,"{""src/indent.c"": {""insertions"": 2, ""deletions"": 1, ""lines"": 3}, ""src/version.c"": {""insertions"": 2, ""deletions"": 0, ""lines"": 2}}"
2022-08-15 14:55:10,d8d4cfcb393123fa19640be0806091d47935407f,Bram Moolenaar,58,11,69,12,"{""src/testdir/dumps/Test_prop_insert_start_incl_1.dump"": {""insertions"": 2, ""deletions"": 2, ""lines"": 4}, ""src/testdir/dumps/Test_prop_insert_start_incl_2.dump"": {""insertions"": 2, ""deletions"": 2, ""lines"": 4}, ""src/testdir/dumps/Test_prop_insert_start_incl_3.dump"": {""insertions"": 2, ""deletions"": 2, ""lines"": 4}, ""src/testdir/dumps/Test_prop_insert_start_incl_4.dump"": {""insertions"": 2, ""deletions"": 2, ""lines"": 4}, ""src/testdir/dumps/Test_prop_insert_start_incl_5.dump"": {""insertions"": 2, ""deletions"": 2, ""lines"": 4}, ""src/testdir/dumps/Test_prop_insert_start_incl_6.dump"": {""insertions"": 8, ""deletions"": 0, ""lines"": 8}, ""src/testdir/dumps/Test_prop_insert_start_incl_7.dump"": {""insertions"": 8, ""deletions"": 0, ""lines"": 8}, ""src/testdir/dumps/Test_prop_insert_start_incl_8.dump"": {""insertions"": 8, ""deletions"": 0, ""lines"": 8}, ""src/testdir/test_textprop.vim"": {""insertions"": 12, ""deletions"": 1, ""lines"": 13}, ""src/textprop.c"": {""insertions"": 9, ""deletions"": 0, ""lines"": 9}, ""src/version.c"": {""insertions"": 2, ""deletions"": 0, ""lines"": 2}, ""src/vim.h"": {""insertions"": 1, ""deletions"": 0, ""lines"": 1}}"
2022-08-14 21:23:02,249e1b903a9c0460d618f6dcc59aeb8c03b24b20,Bram Moolenaar,18,6,24,3,"{""src/testdir/test_assert.vim"": {""insertions"": 4, ""deletions"": 0, ""lines"": 4}, ""src/testing.c"": {""insertions"": 12, ""deletions"": 6, ""lines"": 18}, ""src/version.c"": {""insertions"": 2, ""deletions"": 0, ""lines"": 2}}"
2022-08-14 20:46:07,dbdd16b62560413abcc3c8e893cc3010ccf31666,Bram Moolenaar,17,2,19,3,"{""src/testdir/test_vim9_cmd.vim"": {""insertions"": 9, ""deletions"": 2, ""lines"": 11}, ""src/version.c"": {""insertions"": 2, ""deletions"": 0, ""lines"": 2}, ""src/vim9cmds.c"": {""insertions"": 6, ""deletions"": 0, ""lines"": 6}}"
2022-08-14 20:28:32,d1d8f6bacb489036d0fd479c9dd3c0102c988889,Bram Moolenaar,18,2,20,3,"{""src/testdir/test_vim9_cmd.vim"": {""insertions"": 9, ""deletions"": 0, ""lines"": 9}, ""src/version.c"": {""insertions"": 2, ""deletions"": 0, ""lines"": 2}, ""src/vim9cmds.c"": {""insertions"": 7, ""deletions"": 2, ""lines"": 9}}"
2022-08-14 18:37:36,c3a483fc3c65f649f9985bb88792a465ea18b0a2,Bram Moolenaar,83,11,94,7,"{""src/charset.c"": {""insertions"": 5, ""deletions"": 0, ""lines"": 5}, ""src/drawline.c"": {""insertions"": 22, ""deletions"": 11, ""lines"": 33}, ""src/testdir/dumps/Test_prop_insert_list_mode_1.dump"": {""insertions"": 8, ""deletions"": 0, ""lines"": 8}, ""src/testdir/dumps/Test_prop_insert_list_mode_2.dump"": {""insertions"": 8, ""deletions"": 0, ""lines"": 8}, ""src/testdir/dumps/Test_prop_insert_list_mode_3.dump"": {""insertions"": 8, ""deletions"": 0, ""lines"": 8}, ""src/testdir/test_textprop.vim"": {""insertions"": 30, ""deletions"": 0, ""lines"": 30}, ""src/version.c"": {""insertions"": 2, ""deletions"": 0, ""lines"": 2}}"
2022-08-14 15:50:42,677a39fdf6a61d77ae5d14faeb498f94fd8742ff,Bram Moolenaar,7,1,8,2,"{""src/drawline.c"": {""insertions"": 5, ""deletions"": 1, ""lines"": 6}, ""src/version.c"": {""insertions"": 2, ""deletions"": 0, ""lines"": 2}}"
2022-08-14 15:36:38,9e7e28fc4c32337f2153b94fb08140f47e46e35d,Bram Moolenaar,51,6,57,5,"{""src/drawline.c"": {""insertions"": 13, ""deletions"": 6, ""lines"": 19}, ""src/testdir/dumps/Test_prop_with_text_override_1.dump"": {""insertions"": 6, ""deletions"": 0, ""lines"": 6}, ""src/testdir/dumps/Test_prop_with_text_override_2.dump"": {""insertions"": 6, ""deletions"": 0, ""lines"": 6}, ""src/testdir/test_textprop.vim"": {""insertions"": 24, ""deletions"": 0, ""lines"": 24}, ""src/version.c"": {""insertions"": 2, ""deletions"": 0, ""lines"": 2}}"
2022-08-14 13:49:50,28c162f6f1f525882a9a60f10ab4836dee7eb59f,zeertzjq,10,2,12,3,"{""src/message.c"": {""insertions"": 2, ""deletions"": 1, ""lines"": 3}, ""src/testdir/test_options.vim"": {""insertions"": 6, ""deletions"": 1, ""lines"": 7}, ""src/version.c"": {""insertions"": 2, ""deletions"": 0, ""lines"": 2}}"
2022-08-14 13:17:45,a4d158b3c839e96ed98ff87c7b7124ff4518c4ff,Bram Moolenaar,382,378,760,64,"{""src/buffer.c"": {""insertions"": 1, ""deletions"": 1, ""lines"": 2}, ""src/change.c"": {""insertions"": 10, ""deletions"": 10, ""lines"": 20}, ""src/channel.c"": {""insertions"": 1, ""deletions"": 1, ""lines"": 2}, ""src/clipboard.c"": {""insertions"": 2, ""deletions"": 2, ""lines"": 4}, ""src/cmdexpand.c"": {""insertions"": 1, ""deletions"": 1, ""lines"": 2}, ""src/debugger.c"": {""insertions"": 1, ""deletions"": 1, ""lines"": 2}, ""src/diff.c"": {""insertions"": 4, ""deletions"": 4, ""lines"": 8}, ""src/digraph.c"": {""insertions"": 4, ""deletions"": 2, ""lines"": 6}, ""src/drawscreen.c"": {""insertions"": 56, ""deletions"": 55, ""lines"": 111}, ""src/edit.c"": {""insertions"": 3, ""deletions"": 3, ""lines"": 6}, ""src/evalvars.c"": {""insertions"": 1, ""deletions"": 1, ""lines"": 2}, ""src/ex_cmds.c"": {""insertions"": 5, ""deletions"": 5, ""lines"": 10}, ""src/ex_docmd.c"": {""insertions"": 9, ""deletions"": 9, ""lines"": 18}, ""src/ex_getln.c"": {""insertions"": 9, ""deletions"": 9, ""lines"": 18}, ""src/fileio.c"": {""insertions"": 1, ""deletions"": 1, ""lines"": 2}, ""src/fold.c"": {""insertions"": 3, ""deletions"": 3, ""lines"": 6}, ""src/getchar.c"": {""insertions"": 1, ""deletions"": 1, ""lines"": 2}, ""src/gui.c"": {""insertions"": 3, ""deletions"": 3, ""lines"": 6}, ""src/gui_haiku.cc"": {""insertions"": 1, ""deletions"": 1, ""lines"": 2}, ""src/highlight.c"": {""insertions"": 12, ""deletions"": 12, ""lines"": 24}, ""src/if_lua.c"": {""insertions"": 5, ""deletions"": 5, ""lines"": 10}, ""src/if_mzsch.c"": {""insertions"": 5, ""deletions"": 5, ""lines"": 10}, ""src/if_perl.xs"": {""insertions"": 5, ""deletions"": 5, ""lines"": 10}, ""src/if_py_both.h"": {""insertions"": 5, ""deletions"": 5, ""lines"": 10}, ""src/if_ruby.c"": {""insertions"": 6, ""deletions"": 6, ""lines"": 12}, ""src/if_tcl.c"": {""insertions"": 5, ""deletions"": 5, ""lines"": 10}, ""src/indent.c"": {""insertions"": 3, ""deletions"": 3, ""lines"": 6}, ""src/main.c"": {""insertions"": 3, ""deletions"": 3, ""lines"": 6}, ""src/match.c"": {""insertions"": 5, ""deletions"": 5, ""lines"": 10}, ""src/memline.c"": {""insertions"": 3, ""deletions"": 5, ""lines"": 8}, ""src/menu.c"": {""insertions"": 1, ""deletions"": 1, ""lines"": 2}, ""src/message.c"": {""insertions"": 4, ""deletions"": 4, ""lines"": 8}, ""src/misc1.c"": {""insertions"": 3, ""deletions"": 3, ""lines"": 6}, ""src/misc2.c"": {""insertions"": 1, ""deletions"": 1, ""lines"": 2}, ""src/mouse.c"": {""insertions"": 9, ""deletions"": 9, ""lines"": 18}, ""src/move.c"": {""insertions"": 16, ""deletions"": 15, ""lines"": 31}, ""src/netbeans.c"": {""insertions"": 7, ""deletions"": 7, ""lines"": 14}, ""src/normal.c"": {""insertions"": 19, ""deletions"": 19, ""lines"": 38}, ""src/ops.c"": {""insertions"": 5, ""deletions"": 5, ""lines"": 10}, ""src/option.c"": {""insertions"": 11, ""deletions"": 11, ""lines"": 22}, ""src/optionstr.c"": {""insertions"": 6, ""deletions"": 6, ""lines"": 12}, ""src/os_unix.c"": {""insertions"": 1, ""deletions"": 1, ""lines"": 2}, ""src/os_win32.c"": {""insertions"": 2, ""deletions"": 2, ""lines"": 4}, ""src/popupmenu.c"": {""insertions"": 3, ""deletions"": 3, ""lines"": 6}, ""src/popupwin.c"": {""insertions"": 16, ""deletions"": 16, ""lines"": 32}, ""src/quickfix.c"": {""insertions"": 4, ""deletions"": 4, ""lines"": 8}, ""src/register.c"": {""insertions"": 2, ""deletions"": 2, ""lines"": 4}, ""src/screen.c"": {""insertions"": 4, ""deletions"": 4, ""lines"": 8}, ""src/search.c"": {""insertions"": 6, ""deletions"": 6, ""lines"": 12}, ""src/sign.c"": {""insertions"": 5, ""deletions"": 5, ""lines"": 10}, ""src/spell.c"": {""insertions"": 2, ""deletions"": 2, ""lines"": 4}, ""src/spellfile.c"": {""insertions"": 2, ""deletions"": 2, ""lines"": 4}, ""src/structs.h"": {""insertions"": 1, ""deletions"": 1, ""lines"": 2}, ""src/syntax.c"": {""insertions"": 8, ""deletions"": 8, ""lines"": 16}, ""src/tag.c"": {""insertions"": 1, ""deletions"": 1, ""lines"": 2}, ""src/term.c"": {""insertions"": 10, ""deletions"": 10, ""lines"": 20}, ""src/terminal.c"": {""insertions"": 14, ""deletions"": 14, ""lines"": 28}, ""src/textformat.c"": {""insertions"": 3, ""deletions"": 3, ""lines"": 6}, ""src/textobject.c"": {""insertions"": 6, ""deletions"": 6, ""lines"": 12}, ""src/textprop.c"": {""insertions"": 4, ""deletions"": 4, ""lines"": 8}, ""src/undo.c"": {""insertions"": 1, ""deletions"": 1, ""lines"": 2}, ""src/version.c"": {""insertions"": 2, ""deletions"": 0, ""lines"": 2}, ""src/vim.h"": {""insertions"": 10, ""deletions"": 10, ""lines"": 20}, ""src/window.c"": {""insertions"": 20, ""deletions"": 20, ""lines"": 40}}"
2022-08-14 12:28:55,28c9f895716cfa8f1220bc41b72a534c0e10cabe,Bram Moolenaar,83,2,85,10,"{""src/charset.c"": {""insertions"": 4, ""deletions"": 1, ""lines"": 5}, ""src/structs.h"": {""insertions"": 3, ""deletions"": 0, ""lines"": 3}, ""src/testdir/dumps/Test_prop_insert_start_incl_1.dump"": {""insertions"": 8, ""deletions"": 0, ""lines"": 8}, ""src/testdir/dumps/Test_prop_insert_start_incl_2.dump"": {""insertions"": 8, ""deletions"": 0, ""lines"": 8}, ""src/testdir/dumps/Test_prop_insert_start_incl_3.dump"": {""insertions"": 8, ""deletions"": 0, ""lines"": 8}, ""src/testdir/dumps/Test_prop_insert_start_incl_4.dump"": {""insertions"": 8, ""deletions"": 0, ""lines"": 8}, ""src/testdir/dumps/Test_prop_insert_start_incl_5.dump"": {""insertions"": 8, ""deletions"": 0, ""lines"": 8}, ""src/testdir/test_textprop.vim"": {""insertions"": 31, ""deletions"": 0, ""lines"": 31}, ""src/textprop.c"": {""insertions"": 3, ""deletions"": 1, ""lines"": 4}, ""src/version.c"": {""insertions"": 2, ""deletions"": 0, ""lines"": 2}}"
2022-08-14 11:07:11,63acae13f57c5ad4c8ec3146d0c458550b9e984e,Yegappan Lakshmanan,43,3,46,5,"{""src/evalfunc.c"": {""insertions"": 6, ""deletions"": 1, ""lines"": 7}, ""src/testdir/test_blob.vim"": {""insertions"": 1, ""deletions"": 0, ""lines"": 1}, ""src/testdir/test_listdict.vim"": {""insertions"": 6, ""deletions"": 0, ""lines"": 6}, ""src/testdir/test_vim9_builtin.vim"": {""insertions"": 28, ""deletions"": 2, ""lines"": 30}, ""src/version.c"": {""insertions"": 2, ""deletions"": 0, ""lines"": 2}}"
2022-08-13 20:37:29,c9b6570fab46bf2c246a954cfb8c0d95fe2746b3,Bram Moolenaar,41,39,80,2,"{""src/highlight.c"": {""insertions"": 39, ""deletions"": 39, ""lines"": 78}, ""src/version.c"": {""insertions"": 2, ""deletions"": 0, ""lines"": 2}}"
2022-08-13 20:35:13,3fbf6cd355de2212e9227f57d545592aae3f688f,Yegappan Lakshmanan,109,79,188,4,"{""runtime/doc/builtin.txt"": {""insertions"": 17, ""deletions"": 14, ""lines"": 31}, ""src/evalfunc.c"": {""insertions"": 81, ""deletions"": 63, ""lines"": 144}, ""src/testdir/test_vim9_builtin.vim"": {""insertions"": 9, ""deletions"": 2, ""lines"": 11}, ""src/version.c"": {""insertions"": 2, ""deletions"": 0, ""lines"": 2}}"
2022-08-13 19:17:34,9113c2cd19c72c0973ee5dc095a0a7f03f2af344,Bram Moolenaar,11,7,18,5,"{""src/drawline.c"": {""insertions"": 3, ""deletions"": 2, ""lines"": 5}, ""src/testdir/dumps/Test_prop_with_text_after_nowrap_2.dump"": {""insertions"": 2, ""deletions"": 2, ""lines"": 4}, ""src/testdir/dumps/Test_prop_with_text_after_nowrap_3.dump"": {""insertions"": 2, ""deletions"": 2, ""lines"": 4}, ""src/testdir/test_textprop.vim"": {""insertions"": 2, ""deletions"": 1, ""lines"": 3}, ""src/version.c"": {""insertions"": 2, ""deletions"": 0, ""lines"": 2}}"
2022-08-13 18:35:05,8f369fb1ab7debeeda0fec69c379c528d162d9c5,Bram Moolenaar,44,7,51,6,"{""src/testdir/dumps/Test_prop_with_text_after_nowrap_1.dump"": {""insertions"": 3, ""deletions"": 1, ""lines"": 4}, ""src/testdir/dumps/Test_prop_with_text_after_nowrap_2.dump"": {""insertions"": 3, ""deletions"": 1, ""lines"": 4}, ""src/testdir/dumps/Test_prop_with_text_after_nowrap_3.dump"": {""insertions"": 12, ""deletions"": 0, ""lines"": 12}, ""src/testdir/test_textprop.vim"": {""insertions"": 9, ""deletions"": 3, ""lines"": 12}, ""src/textprop.c"": {""insertions"": 15, ""deletions"": 2, ""lines"": 17}, ""src/version.c"": {""insertions"": 2, ""deletions"": 0, ""lines"": 2}}"
2022-08-13 15:41:19,f0ccfa474a5c4940d03bfc6084e896dc8ac2d791,Bram Moolenaar,53,2,55,5,"{""src/charset.c"": {""insertions"": 12, ""deletions"": 2, ""lines"": 14}, ""src/testdir/dumps/Test_prop_right_align_twice_1.dump"": {""insertions"": 8, ""deletions"": 0, ""lines"": 8}, ""src/testdir/dumps/Test_prop_right_align_twice_2.dump"": {""insertions"": 8, ""deletions"": 0, ""lines"": 8}, ""src/testdir/test_textprop.vim"": {""insertions"": 23, ""deletions"": 0, ""lines"": 23}, ""src/version.c"": {""insertions"": 2, ""deletions"": 0, ""lines"": 2}}"
2022-08-13 13:09:44,cfeb8a584be11758cf71ae02f6c937b06d6bb66f,Bram Moolenaar,30,0,30,3,"{""src/buffer.c"": {""insertions"": 8, ""deletions"": 0, ""lines"": 8}, ""src/testdir/test_visual.vim"": {""insertions"": 20, ""deletions"": 0, ""lines"": 20}, ""src/version.c"": {""insertions"": 2, ""deletions"": 0, ""lines"": 2}}"
2022-08-13 12:21:31,6a76e84f555da6d9ee57db80143e1e5eb85535ff,Emilia Zapata,6,0,6,3,"{""runtime/filetype.vim"": {""insertions"": 3, ""deletions"": 0, ""lines"": 3}, ""src/testdir/test_filetype.vim"": {""insertions"": 1, ""deletions"": 0, ""lines"": 1}, ""src/version.c"": {""insertions"": 2, ""deletions"": 0, ""lines"": 2}}"
2022-08-13 12:09:20,b218655d5a485f5b193fb18d7240837d42b89812,Yegappan Lakshmanan,265,3,268,7,"{""runtime/doc/builtin.txt"": {""insertions"": 47, ""deletions"": 1, ""lines"": 48}, ""runtime/doc/usr_41.txt"": {""insertions"": 4, ""deletions"": 2, ""lines"": 6}, ""src/evalfunc.c"": {""insertions"": 134, ""deletions"": 0, ""lines"": 134}, ""src/testdir/test_blob.vim"": {""insertions"": 26, ""deletions"": 0, ""lines"": 26}, ""src/testdir/test_listdict.vim"": {""insertions"": 45, ""deletions"": 0, ""lines"": 45}, ""src/testdir/test_vim9_builtin.vim"": {""insertions"": 7, ""deletions"": 0, ""lines"": 7}, ""src/version.c"": {""insertions"": 2, ""deletions"": 0, ""lines"": 2}}"
2022-08-12 20:57:13,9032b9ceb6073288d75386dbcbd9d1982fa24080,Bram Moolenaar,4,1,5,3,"{""runtime/filetype.vim"": {""insertions"": 1, ""deletions"": 0, ""lines"": 1}, ""src/testdir/test_filetype.vim"": {""insertions"": 1, ""deletions"": 1, ""lines"": 2}, ""src/version.c"": {""insertions"": 2, ""deletions"": 0, ""lines"": 2}}"
2022-08-12 12:05:49,326c5d36e7cb8526330565109c17b4a13ff790ae,Bram Moolenaar,77,0,77,8,"{""src/change.c"": {""insertions"": 1, ""deletions"": 0, ""lines"": 1}, ""src/move.c"": {""insertions"": 16, ""deletions"": 0, ""lines"": 16}, ""src/proto/move.pro"": {""insertions"": 1, ""deletions"": 0, ""lines"": 1}, ""src/testdir/dumps/Test_prop_with_text_cursormoved_1.dump"": {""insertions"": 8, ""deletions"": 0, ""lines"": 8}, ""src/testdir/dumps/Test_prop_with_text_cursormoved_2.dump"": {""insertions"": 8, ""deletions"": 0, ""lines"": 8}, ""src/testdir/test_textprop.vim"": {""insertions"": 39, ""deletions"": 0, ""lines"": 39}, ""src/textprop.c"": {""insertions"": 2, ""deletions"": 0, ""lines"": 2}, ""src/version.c"": {""insertions"": 2, ""deletions"": 0, ""lines"": 2}}"
2022-08-11 16:24:50,e38fc86180fd3f6b372648eea6adc3f623fea302,Bram Moolenaar,123,41,164,9,"{""src/drawline.c"": {""insertions"": 49, ""deletions"": 41, ""lines"": 90}, ""src/testdir/dumps/Test_prop_inserts_text_hi_1.dump"": {""insertions"": 6, ""deletions"": 0, ""lines"": 6}, ""src/testdir/dumps/Test_prop_inserts_text_hi_2.dump"": {""insertions"": 6, ""deletions"": 0, ""lines"": 6}, ""src/testdir/dumps/Test_prop_inserts_text_hi_3.dump"": {""insertions"": 6, ""deletions"": 0, ""lines"": 6}, ""src/testdir/dumps/Test_prop_inserts_text_hi_4.dump"": {""insertions"": 6, ""deletions"": 0, ""lines"": 6}, ""src/testdir/dumps/Test_prop_inserts_text_hi_5.dump"": {""insertions"": 6, ""deletions"": 0, ""lines"": 6}, ""src/testdir/dumps/Test_prop_inserts_text_hi_6.dump"": {""insertions"": 6, ""deletions"": 0, ""lines"": 6}, ""src/testdir/test_textprop.vim"": {""insertions"": 36, ""deletions"": 0, ""lines"": 36}, ""src/version.c"": {""insertions"": 2, ""deletions"": 0, ""lines"": 2}}"
2022-08-11 14:52:14,fdc5d17d58cc9c9edc9fb2816e1afaabc531bf1e,Bram Moolenaar,7,1,8,2,"{""src/drawscreen.c"": {""insertions"": 5, ""deletions"": 1, ""lines"": 6}, ""src/version.c"": {""insertions"": 2, ""deletions"": 0, ""lines"": 2}}"
2022-08-11 13:13:37,d4cf9fc53e0b1d36e84d28ecd5595a6f102f325e,Bram Moolenaar,26,1,27,5,"{""src/testdir/dumps/Test_changing_cmdheight_5.dump"": {""insertions"": 8, ""deletions"": 0, ""lines"": 8}, ""src/testdir/test_cmdline.vim"": {""insertions"": 5, ""deletions"": 0, ""lines"": 5}, ""src/testdir/test_messages.vim"": {""insertions"": 5, ""deletions"": 1, ""lines"": 6}, ""src/version.c"": {""insertions"": 2, ""deletions"": 0, ""lines"": 2}, ""src/window.c"": {""insertions"": 6, ""deletions"": 0, ""lines"": 6}}"
2022-08-11 12:17:30,f797e309caff48f7a56c73b16e62ff67c4dcbdd6,Bram Moolenaar,78,2,80,7,"{""src/testdir/dumps/Test_changing_cmdheight_1.dump"": {""insertions"": 8, ""deletions"": 0, ""lines"": 8}, ""src/testdir/dumps/Test_changing_cmdheight_2.dump"": {""insertions"": 8, ""deletions"": 0, ""lines"": 8}, ""src/testdir/dumps/Test_changing_cmdheight_3.dump"": {""insertions"": 8, ""deletions"": 0, ""lines"": 8}, ""src/testdir/dumps/Test_changing_cmdheight_4.dump"": {""insertions"": 8, ""deletions"": 0, ""lines"": 8}, ""src/testdir/test_cmdline.vim"": {""insertions"": 29, ""deletions"": 0, ""lines"": 29}, ""src/version.c"": {""insertions"": 2, ""deletions"": 0, ""lines"": 2}, ""src/window.c"": {""insertions"": 15, ""deletions"": 2, ""lines"": 17}}"
2022-08-10 19:50:23,87f3a2ca3d0ffbfa7389bbb89add4d8d3fca6fbb,Bram Moolenaar,5,1,6,3,"{""src/drawline.c"": {""insertions"": 2, ""deletions"": 1, ""lines"": 3}, ""src/highlight.c"": {""insertions"": 1, ""deletions"": 0, ""lines"": 1}, ""src/version.c"": {""insertions"": 2, ""deletions"": 0, ""lines"": 2}}"
2022-08-10 18:50:47,82b14c143aa1e70d55509cc9fa408828e90c93de,Bram Moolenaar,11,0,11,4,"{""src/errors.h"": {""insertions"": 2, ""deletions"": 0, ""lines"": 2}, ""src/testdir/test_textprop.vim"": {""insertions"": 2, ""deletions"": 0, ""lines"": 2}, ""src/textprop.c"": {""insertions"": 5, ""deletions"": 0, ""lines"": 5}, ""src/version.c"": {""insertions"": 2, ""deletions"": 0, ""lines"": 2}}"
2022-08-10 16:23:12,96bde99bf890acd9952863a02c1d15edca2000e1,Bram Moolenaar,22,2,24,3,"{""src/testdir/test_window_cmd.vim"": {""insertions"": 20, ""deletions"": 0, ""lines"": 20}, ""src/version.c"": {""insertions"": 2, ""deletions"": 0, ""lines"": 2}, ""src/window.c"": {""insertions"": 0, ""deletions"": 2, ""lines"": 2}}"
2022-08-10 15:49:02,3331dd03515655ec6b9c1bd374db6e8c27acb27a,Bram Moolenaar,15,8,23,9,"{""src/drawline.c"": {""insertions"": 2, ""deletions"": 1, ""lines"": 3}, ""src/testdir/dumps/Test_prop_inserts_text_1.dump"": {""insertions"": 1, ""deletions"": 1, ""lines"": 2}, ""src/testdir/dumps/Test_prop_inserts_text_2.dump"": {""insertions"": 1, ""deletions"": 1, ""lines"": 2}, ""src/testdir/dumps/Test_prop_inserts_text_3.dump"": {""insertions"": 1, ""deletions"": 1, ""lines"": 2}, ""src/testdir/dumps/Test_prop_inserts_text_4.dump"": {""insertions"": 1, ""deletions"": 1, ""lines"": 2}, ""src/testdir/dumps/Test_prop_inserts_text_5.dump"": {""insertions"": 1, ""deletions"": 1, ""lines"": 2}, ""src/testdir/dumps/Test_prop_inserts_text_6.dump"": {""insertions"": 1, ""deletions"": 1, ""lines"": 2}, ""src/testdir/test_textprop.vim"": {""insertions"": 5, ""deletions"": 1, ""lines"": 6}, ""src/version.c"": {""insertions"": 2, ""deletions"": 0, ""lines"": 2}}"
2022-08-10 15:00:33,952c9b02f8a7c2386b66ed643eef0acd35e842ae,Bram Moolenaar,61,10,71,4,"{""src/drawline.c"": {""insertions"": 27, ""deletions"": 10, ""lines"": 37}, ""src/testdir/dumps/Test_prop_at_same_pos.dump"": {""insertions"": 5, ""deletions"": 0, ""lines"": 5}, ""src/testdir/test_textprop.vim"": {""insertions"": 27, ""deletions"": 0, ""lines"": 27}, ""src/version.c"": {""insertions"": 2, ""deletions"": 0, ""lines"": 2}}"
2022-08-10 12:39:35,1d8844aa59416dd306912b5563b8e928dfd387ba,Bram Moolenaar,27,0,27,4,"{""src/drawline.c"": {""insertions"": 1, ""deletions"": 0, ""lines"": 1}, ""src/testdir/dumps/Test_prop_with_wrap_1.dump"": {""insertions"": 6, ""deletions"": 0, ""lines"": 6}, ""src/testdir/test_textprop.vim"": {""insertions"": 18, ""deletions"": 0, ""lines"": 18}, ""src/version.c"": {""insertions"": 2, ""deletions"": 0, ""lines"": 2}}"
2022-08-10 12:12:03,52de3a8d3943520bbd4e5e40a4c43fcc7182dac0,Bram Moolenaar,40,3,43,5,"{""src/drawline.c"": {""insertions"": 6, ""deletions"": 3, ""lines"": 9}, ""src/testdir/dumps/Test_prop_with_linebreak_1.dump"": {""insertions"": 6, ""deletions"": 0, ""lines"": 6}, ""src/testdir/dumps/Test_prop_with_linebreak_2.dump"": {""insertions"": 6, ""deletions"": 0, ""lines"": 6}, ""src/testdir/test_textprop.vim"": {""insertions"": 20, ""deletions"": 0, ""lines"": 20}, ""src/version.c"": {""insertions"": 2, ""deletions"": 0, ""lines"": 2}}"
2022-08-10 10:48:10,3a9687fb2749cb3da6e3bbf60cb9eaa81f7889ae,smjonas,6,0,6,3,"{""runtime/filetype.vim"": {""insertions"": 3, ""deletions"": 0, ""lines"": 3}, ""src/testdir/test_filetype.vim"": {""insertions"": 1, ""deletions"": 0, ""lines"": 1}, ""src/version.c"": {""insertions"": 2, ""deletions"": 0, ""lines"": 2}}"
2022-08-09 20:37:55,e5a0e8c1d781aa3781b4f6167fc2cba1193213f1,Bram Moolenaar,33,30,63,3,"{""src/memline.c"": {""insertions"": 22, ""deletions"": 23, ""lines"": 45}, ""src/testdir/test_textprop.vim"": {""insertions"": 9, ""deletions"": 7, ""lines"": 16}, ""src/version.c"": {""insertions"": 2, ""deletions"": 0, ""lines"": 2}}"
2022-08-09 18:30:19,ef257e7bd1850f34dd54382222b0e7537cf234bf,Bram Moolenaar,2,2,4,2,"{""src/testdir/test_textprop.vim"": {""insertions"": 0, ""deletions"": 2, ""lines"": 2}, ""src/version.c"": {""insertions"": 2, ""deletions"": 0, ""lines"": 2}}"
2022-08-09 17:25:23,49a90792d950c51608d0459ef8699fe921070718,Bram Moolenaar,121,13,134,10,"{""src/charset.c"": {""insertions"": 41, ""deletions"": 10, ""lines"": 51}, ""src/misc1.c"": {""insertions"": 11, ""deletions"": 3, ""lines"": 14}, ""src/proto/charset.pro"": {""insertions"": 1, ""deletions"": 0, ""lines"": 1}, ""src/testdir/dumps/Test_prop_with_text_empty_line_1.dump"": {""insertions"": 8, ""deletions"": 0, ""lines"": 8}, ""src/testdir/dumps/Test_prop_with_text_empty_line_2.dump"": {""insertions"": 8, ""deletions"": 0, ""lines"": 8}, ""src/testdir/dumps/Test_prop_with_text_empty_line_3.dump"": {""insertions"": 8, ""deletions"": 0, ""lines"": 8}, ""src/testdir/dumps/Test_prop_with_text_empty_line_4.dump"": {""insertions"": 8, ""deletions"": 0, ""lines"": 8}, ""src/testdir/dumps/Test_prop_with_text_empty_line_5.dump"": {""insertions"": 8, ""deletions"": 0, ""lines"": 8}, ""src/testdir/test_textprop.vim"": {""insertions"": 26, ""deletions"": 0, ""lines"": 26}, ""src/version.c"": {""insertions"": 2, ""deletions"": 0, ""lines"": 2}}"
2022-08-09 15:55:41,e428fa04a758cc87ea580c856a796e58e407504b,Bram Moolenaar,141,7,148,13,"{""src/charset.c"": {""insertions"": 17, ""deletions"": 7, ""lines"": 24}, ""src/testdir/dumps/Test_prop_before_tab_01.dump"": {""insertions"": 8, ""deletions"": 0, ""lines"": 8}, ""src/testdir/dumps/Test_prop_before_tab_02.dump"": {""insertions"": 8, ""deletions"": 0, ""lines"": 8}, ""src/testdir/dumps/Test_prop_before_tab_03.dump"": {""insertions"": 8, ""deletions"": 0, ""lines"": 8}, ""src/testdir/dumps/Test_prop_before_tab_04.dump"": {""insertions"": 8, ""deletions"": 0, ""lines"": 8}, ""src/testdir/dumps/Test_prop_before_tab_05.dump"": {""insertions"": 8, ""deletions"": 0, ""lines"": 8}, ""src/testdir/dumps/Test_prop_before_tab_06.dump"": {""insertions"": 8, ""deletions"": 0, ""lines"": 8}, ""src/testdir/dumps/Test_prop_before_tab_07.dump"": {""insertions"": 8, ""deletions"": 0, ""lines"": 8}, ""src/testdir/dumps/Test_prop_before_tab_08.dump"": {""insertions"": 8, ""deletions"": 0, ""lines"": 8}, ""src/testdir/dumps/Test_prop_before_tab_09.dump"": {""insertions"": 8, ""deletions"": 0, ""lines"": 8}, ""src/testdir/dumps/Test_prop_before_tab_10.dump"": {""insertions"": 8, ""deletions"": 0, ""lines"": 8}, ""src/testdir/test_textprop.vim"": {""insertions"": 42, ""deletions"": 0, ""lines"": 42}, ""src/version.c"": {""insertions"": 2, ""deletions"": 0, ""lines"": 2}}"
2022-08-09 13:19:40,8f49e690dc7b6ed521fb11431e2a406d01c4de3a,Bram Moolenaar,39,1,40,3,"{""src/mouse.c"": {""insertions"": 2, ""deletions"": 1, ""lines"": 3}, ""src/testdir/test_virtualedit.vim"": {""insertions"": 35, ""deletions"": 0, ""lines"": 35}, ""src/version.c"": {""insertions"": 2, ""deletions"": 0, ""lines"": 2}}"
2022-08-09 11:53:14,8ca29b6a3599b82b8822b7697cad63d0244c2d59,zeertzjq,42,44,86,6,"{""src/mbyte.c"": {""insertions"": 3, ""deletions"": 25, ""lines"": 28}, ""src/optionstr.c"": {""insertions"": 1, ""deletions"": 17, ""lines"": 18}, ""src/proto/screen.pro"": {""insertions"": 1, ""deletions"": 0, ""lines"": 1}, ""src/screen.c"": {""insertions"": 25, ""deletions"": 0, ""lines"": 25}, ""src/testdir/test_options.vim"": {""insertions"": 10, ""deletions"": 2, ""lines"": 12}, ""src/version.c"": {""insertions"": 2, ""deletions"": 0, ""lines"": 2}}"
2022-08-09 11:25:10,afa23d1b99692e3c726eb694933ab348b442a1e4,Christian Brabandt,36,1,37,4,"{""src/drawline.c"": {""insertions"": 3, ""deletions"": 1, ""lines"": 4}, ""src/testdir/dumps/Test_spell_2.dump"": {""insertions"": 8, ""deletions"": 0, ""lines"": 8}, ""src/testdir/test_spell.vim"": {""insertions"": 23, ""deletions"": 0, ""lines"": 23}, ""src/version.c"": {""insertions"": 2, ""deletions"": 0, ""lines"": 2}}"
2022-08-08 20:43:11,ad6d9cc679259936b7c8453f17c0ec9d7ab7dcd0,Bram Moolenaar,9,1,10,3,"{""src/testdir/test_vim9_func.vim"": {""insertions"": 4, ""deletions"": 0, ""lines"": 4}, ""src/version.c"": {""insertions"": 2, ""deletions"": 0, ""lines"": 2}, ""src/vim9compile.c"": {""insertions"": 3, ""deletions"": 1, ""lines"": 4}}"
2022-08-08 17:12:30,e6a3d81e053d150b6db4d7e04dbe401cb0161151,Bram Moolenaar,6,1,7,2,"{""src/testdir/test_textprop.vim"": {""insertions"": 4, ""deletions"": 1, ""lines"": 5}, ""src/version.c"": {""insertions"": 2, ""deletions"": 0, ""lines"": 2}}"
2022-08-08 16:08:05,1024690c015921b0a458172bc368133f63af1b89,Bram Moolenaar,15,1,16,3,"{""src/testdir/test_textprop.vim"": {""insertions"": 12, ""deletions"": 0, ""lines"": 12}, ""src/textprop.c"": {""insertions"": 1, ""deletions"": 1, ""lines"": 2}, ""src/version.c"": {""insertions"": 2, ""deletions"": 0, ""lines"": 2}}"
2022-08-08 15:03:06,6e5c61119a07b513a99baa9618e8182a74fd7e24,Bram Moolenaar,6,1,7,2,"{""src/drawline.c"": {""insertions"": 4, ""deletions"": 1, ""lines"": 5}, ""src/version.c"": {""insertions"": 2, ""deletions"": 0, ""lines"": 2}}"
2022-08-08 14:49:18,113d9dec9958debbae2b611c98aed2f6f23c8502,Bram Moolenaar,12,6,18,7,"{""src/change.c"": {""insertions"": 1, ""deletions"": 1, ""lines"": 2}, ""src/if_lua.c"": {""insertions"": 2, ""deletions"": 1, ""lines"": 3}, ""src/if_tcl.c"": {""insertions"": 4, ""deletions"": 2, ""lines"": 6}, ""src/popupwin.c"": {""insertions"": 1, ""deletions"": 1, ""lines"": 2}, ""src/textformat.c"": {""insertions"": 1, ""deletions"": 1, ""lines"": 2}, ""src/version.c"": {""insertions"": 2, ""deletions"": 0, ""lines"": 2}, ""src/vim.h"": {""insertions"": 1, ""deletions"": 0, ""lines"": 1}}"
2022-08-08 14:42:38,48c3f4e0bff7efd289a7001b68c777b6f89a7057,Bram Moolenaar,513,212,725,19,"{"".github/CODEOWNERS"": {""insertions"": 2, ""deletions"": 0, ""lines"": 2}, ""runtime/autoload/dist/ft.vim"": {""insertions"": 9, ""deletions"": 2, ""lines"": 11}, ""runtime/autoload/python.vim"": {""insertions"": 39, ""deletions"": 32, ""lines"": 71}, ""runtime/doc/help.txt"": {""insertions"": 1, ""deletions"": 0, ""lines"": 1}, ""runtime/doc/options.txt"": {""insertions"": 32, ""deletions"": 5, ""lines"": 37}, ""runtime/doc/tags"": {""insertions"": 2, ""deletions"": 0, ""lines"": 2}, ""runtime/doc/terminal.txt"": {""insertions"": 30, ""deletions"": 0, ""lines"": 30}, ""runtime/doc/todo.txt"": {""insertions"": 4, ""deletions"": 27, ""lines"": 31}, ""runtime/doc/usr_41.txt"": {""insertions"": 5, ""deletions"": 4, ""lines"": 9}, ""runtime/doc/vim9.txt"": {""insertions"": 1, ""deletions"": 1, ""lines"": 2}, ""runtime/ftplugin/abaqus.vim"": {""insertions"": 25, ""deletions"": 23, ""lines"": 48}, ""runtime/ftplugin/php.vim"": {""insertions"": 109, ""deletions"": 42, ""lines"": 151}, ""runtime/ftplugin/vim.vim"": {""insertions"": 2, ""deletions"": 2, ""lines"": 4}, ""runtime/indent/lisp.vim"": {""insertions"": 2, ""deletions"": 2, ""lines"": 4}, ""runtime/indent/systemverilog.vim"": {""insertions"": 111, ""deletions"": 65, ""lines"": 176}, ""runtime/indent/testdir/python.in"": {""insertions"": 68, ""deletions"": 0, ""lines"": 68}, ""runtime/indent/testdir/python.ok"": {""insertions"": 68, ""deletions"": 0, ""lines"": 68}, ""runtime/pack/dist/opt/matchit/doc/matchit.txt"": {""insertions"": 0, ""deletions"": 3, ""lines"": 3}, ""runtime/syntax/abaqus.vim"": {""insertions"": 3, ""deletions"": 4, ""lines"": 7}}"
2022-08-08 13:59:47,cf85d97bafdcc7837a77ab79cc04da189fa3dd0c,Bram Moolenaar,31,4,35,3,"{""src/testdir/test_textprop.vim"": {""insertions"": 29, ""deletions"": 0, ""lines"": 29}, ""src/textprop.c"": {""insertions"": 0, ""deletions"": 4, ""lines"": 4}, ""src/version.c"": {""insertions"": 2, ""deletions"": 0, ""lines"": 2}}"
2022-08-08 10:07:47,25463610dfc7a4984f70b030463fb98b09772ad9,Bram Moolenaar,48,8,56,9,"{""src/charset.c"": {""insertions"": 6, ""deletions"": 2, ""lines"": 8}, ""src/testdir/dumps/Test_prop_inserts_text_1.dump"": {""insertions"": 2, ""deletions"": 0, ""lines"": 2}, ""src/testdir/dumps/Test_prop_inserts_text_2.dump"": {""insertions"": 2, ""deletions"": 0, ""lines"": 2}, ""src/testdir/dumps/Test_prop_inserts_text_3.dump"": {""insertions"": 2, ""deletions"": 0, ""lines"": 2}, ""src/testdir/dumps/Test_prop_inserts_text_4.dump"": {""insertions"": 4, ""deletions"": 2, ""lines"": 6}, ""src/testdir/dumps/Test_prop_inserts_text_5.dump"": {""insertions"": 8, ""deletions"": 0, ""lines"": 8}, ""src/testdir/dumps/Test_prop_inserts_text_6.dump"": {""insertions"": 8, ""deletions"": 0, ""lines"": 8}, ""src/testdir/test_textprop.vim"": {""insertions"": 14, ""deletions"": 4, ""lines"": 18}, ""src/version.c"": {""insertions"": 2, ""deletions"": 0, ""lines"": 2}}"
2022-08-07 21:04:56,38ea2733b4dd8e9bfc4a5bb5c11cb661bf000c4e,Bram Moolenaar,5,6,11,2,"{""src/textprop.c"": {""insertions"": 3, ""deletions"": 6, ""lines"": 9}, ""src/version.c"": {""insertions"": 2, ""deletions"": 0, ""lines"": 2}}"
2022-08-07 20:48:37,50652b0c5cfc9d48d3561772420e1f01f878f033,Bram Moolenaar,24,6,30,2,"{""src/memline.c"": {""insertions"": 22, ""deletions"": 6, ""lines"": 28}, ""src/version.c"": {""insertions"": 2, ""deletions"": 0, ""lines"": 2}}"
2022-08-07 17:20:08,e44336b00a6c51bef904450a8012e4982e38ba2d,Bram Moolenaar,84,35,119,3,"{""src/structs.h"": {""insertions"": 1, ""deletions"": 0, ""lines"": 1}, ""src/textprop.c"": {""insertions"": 81, ""deletions"": 35, ""lines"": 116}, ""src/version.c"": {""insertions"": 2, ""deletions"": 0, ""lines"": 2}}"
2022-08-07 17:09:10,c390cc13e55b25d85a0684aa1becde881ef8ab19,Bram Moolenaar,7,3,10,2,"{""src/register.c"": {""insertions"": 5, ""deletions"": 3, ""lines"": 8}, ""src/version.c"": {""insertions"": 2, ""deletions"": 0, ""lines"": 2}}"
2022-08-07 13:55:14,ecb00c7b613b92ffb628a5a7f303ba06780288ad,Bram Moolenaar,34,1,35,3,"{""src/register.c"": {""insertions"": 2, ""deletions"": 1, ""lines"": 3}, ""src/testdir/test_textprop.vim"": {""insertions"": 30, ""deletions"": 0, ""lines"": 30}, ""src/version.c"": {""insertions"": 2, ""deletions"": 0, ""lines"": 2}}"
2022-08-07 10:53:40,73c3842fa54aa99e59b897b6ff1e69e800fe9cd3,Bram Moolenaar,8,2,10,4,"{""src/drawline.c"": {""insertions"": 3, ""deletions"": 0, ""lines"": 3}, ""src/testdir/dumps/Test_prop_with_text_after_1.dump"": {""insertions"": 1, ""deletions"": 1, ""lines"": 2}, ""src/testdir/test_textprop.vim"": {""insertions"": 2, ""deletions"": 1, ""lines"": 3}, ""src/version.c"": {""insertions"": 2, ""deletions"": 0, ""lines"": 2}}"
2022-08-06 21:38:02,bf9158408a9d27932b8678f824cf1fe32d3cd920,Bram Moolenaar,3,1,4,2,"{""src/drawline.c"": {""insertions"": 1, ""deletions"": 1, ""lines"": 2}, ""src/version.c"": {""insertions"": 2, ""deletions"": 0, ""lines"": 2}}"
2022-08-06 21:23:40,83bf11a1ffc5a7bc4a5ba81747df606d69c1465a,Bram Moolenaar,3,1,4,2,"{""src/drawline.c"": {""insertions"": 1, ""deletions"": 1, ""lines"": 2}, ""src/version.c"": {""insertions"": 2, ""deletions"": 0, ""lines"": 2}}"
2022-08-06 21:13:03,da70cf30ef9c03e5645de0df6f7d44ffb6b31f58,Bram Moolenaar,8,0,8,3,"{""src/ex_docmd.c"": {""insertions"": 2, ""deletions"": 0, ""lines"": 2}, ""src/version.c"": {""insertions"": 2, ""deletions"": 0, ""lines"": 2}, ""src/vim9script.c"": {""insertions"": 4, ""deletions"": 0, ""lines"": 4}}"
2022-08-06 21:03:20,48ca24d913105a14cf6d723d45f6b39e7b7b7b77,Bram Moolenaar,76,4,80,5,"{""src/drawline.c"": {""insertions"": 25, ""deletions"": 4, ""lines"": 29}, ""src/testdir/dumps/Test_prop_with_text_below_nowrap_1.dump"": {""insertions"": 8, ""deletions"": 0, ""lines"": 8}, ""src/testdir/dumps/Test_prop_with_text_below_nowrap_2.dump"": {""insertions"": 8, ""deletions"": 0, ""lines"": 8}, ""src/testdir/test_textprop.vim"": {""insertions"": 33, ""deletions"": 0, ""lines"": 33}, ""src/version.c"": {""insertions"": 2, ""deletions"": 0, ""lines"": 2}}"
2022-08-06 20:03:53,cba6952e3499f85545c274873c67bb843d3f3518,Bram Moolenaar,46,3,49,5,"{""src/charset.c"": {""insertions"": 6, ""deletions"": 2, ""lines"": 8}, ""src/drawline.c"": {""insertions"": 1, ""deletions"": 1, ""lines"": 2}, ""src/testdir/dumps/Test_prop_with_text_after_below_trunc_1.dump"": {""insertions"": 8, ""deletions"": 0, ""lines"": 8}, ""src/testdir/test_textprop.vim"": {""insertions"": 29, ""deletions"": 0, ""lines"": 29}, ""src/version.c"": {""insertions"": 2, ""deletions"": 0, ""lines"": 2}}"
2022-08-06 17:12:06,3f74c0ab32de7ed17dd16d9b06f5455a0bb1c297,Bram Moolenaar,24,14,38,6,"{""src/errors.h"": {""insertions"": 2, ""deletions"": 2, ""lines"": 4}, ""src/eval.c"": {""insertions"": 0, ""deletions"": 5, ""lines"": 5}, ""src/ex_docmd.c"": {""insertions"": 8, ""deletions"": 2, ""lines"": 10}, ""src/testdir/test_vim9_script.vim"": {""insertions"": 5, ""deletions"": 1, ""lines"": 6}, ""src/version.c"": {""insertions"": 2, ""deletions"": 0, ""lines"": 2}, ""src/vim9script.c"": {""insertions"": 7, ""deletions"": 4, ""lines"": 11}}"
2022-08-06 16:38:53,db9b96d84491131460e5876fe21b9bbc58c73ed7,Bram Moolenaar,24,14,38,5,"{""src/drawline.c"": {""insertions"": 12, ""deletions"": 11, ""lines"": 23}, ""src/testdir/dumps/Test_prop_with_text_after_nowrap_1.dump"": {""insertions"": 3, ""deletions"": 1, ""lines"": 4}, ""src/testdir/dumps/Test_prop_with_text_after_nowrap_2.dump"": {""insertions"": 3, ""deletions"": 1, ""lines"": 4}, ""src/testdir/test_textprop.vim"": {""insertions"": 4, ""deletions"": 1, ""lines"": 5}, ""src/version.c"": {""insertions"": 2, ""deletions"": 0, ""lines"": 2}}"
2022-08-06 16:10:57,7d0f7e9524975ebcc3c7d98b5507de1b7df74370,Bram Moolenaar,96,11,107,9,"{""src/ops.c"": {""insertions"": 1, ""deletions"": 1, ""lines"": 2}, ""src/testdir/dumps/Test_prop_with_text_after_join_split_1.dump"": {""insertions"": 8, ""deletions"": 0, ""lines"": 8}, ""src/testdir/dumps/Test_prop_with_text_after_join_split_2.dump"": {""insertions"": 8, ""deletions"": 0, ""lines"": 8}, ""src/testdir/dumps/Test_prop_with_text_after_join_split_3.dump"": {""insertions"": 8, ""deletions"": 0, ""lines"": 8}, ""src/testdir/dumps/Test_prop_with_text_after_join_split_4.dump"": {""insertions"": 8, ""deletions"": 0, ""lines"": 8}, ""src/testdir/dumps/Test_prop_with_text_after_join_split_5.dump"": {""insertions"": 8, ""deletions"": 0, ""lines"": 8}, ""src/testdir/test_textprop.vim"": {""insertions"": 35, ""deletions"": 0, ""lines"": 35}, ""src/textprop.c"": {""insertions"": 18, ""deletions"": 10, ""lines"": 28}, ""src/version.c"": {""insertions"": 2, ""deletions"": 0, ""lines"": 2}}"
2022-08-06 14:59:06,1306b36a7b63c33b8948a78c71feb087cf83a39d,Bram Moolenaar,489,448,937,4,"{""src/drawline.c"": {""insertions"": 476, ""deletions"": 448, ""lines"": 924}, ""src/testdir/dumps/Test_prop_with_text_after_nowrap_2.dump"": {""insertions"": 8, ""deletions"": 0, ""lines"": 8}, ""src/testdir/test_textprop.vim"": {""insertions"": 3, ""deletions"": 0, ""lines"": 3}, ""src/version.c"": {""insertions"": 2, ""deletions"": 0, ""lines"": 2}}"
2022-08-06 13:21:52,e2086350d3043fe4e7fece3754d454249459d5c4,Bram Moolenaar,3,1,4,2,"{""src/drawline.c"": {""insertions"": 1, ""deletions"": 1, ""lines"": 2}, ""src/version.c"": {""insertions"": 2, ""deletions"": 0, ""lines"": 2}}"
2022-08-06 12:48:20,4d91d347e65a5621621ea1e3c97dce2c677ed71d,Bram Moolenaar,468,341,809,7,"{""src/drawline.c"": {""insertions"": 403, ""deletions"": 337, ""lines"": 740}, ""src/misc1.c"": {""insertions"": 10, ""deletions"": 4, ""lines"": 14}, ""src/proto/textprop.pro"": {""insertions"": 1, ""deletions"": 0, ""lines"": 1}, ""src/testdir/dumps/Test_prop_with_text_after_nowrap_1.dump"": {""insertions"": 8, ""deletions"": 0, ""lines"": 8}, ""src/testdir/test_textprop.vim"": {""insertions"": 21, ""deletions"": 0, ""lines"": 21}, ""src/textprop.c"": {""insertions"": 23, ""deletions"": 0, ""lines"": 23}, ""src/version.c"": {""insertions"": 2, ""deletions"": 0, ""lines"": 2}}"
2022-08-06 10:35:28,25f40af9d2f04d18c8a276249f2794e83aa5c290,Bram Moolenaar,13,4,17,5,"{""src/errors.h"": {""insertions"": 2, ""deletions"": 2, ""lines"": 4}, ""src/eval.c"": {""insertions"": 5, ""deletions"": 0, ""lines"": 5}, ""src/testdir/test_vim9_expr.vim"": {""insertions"": 2, ""deletions"": 0, ""lines"": 2}, ""src/version.c"": {""insertions"": 2, ""deletions"": 0, ""lines"": 2}, ""src/vim9script.c"": {""insertions"": 2, ""deletions"": 2, ""lines"": 4}}"
2022-08-06 09:28:19,5ac4b1a24e3ba52698a0d24b22cdd2e1c7895417,Bram Moolenaar,12,9,21,2,"{""src/testdir/test_cmdline.vim"": {""insertions"": 10, ""deletions"": 9, ""lines"": 19}, ""src/version.c"": {""insertions"": 2, ""deletions"": 0, ""lines"": 2}}"
2022-08-05 20:39:30,3ec3b8e92da8299bcbfd851fa76fccf5403e4097,Bram Moolenaar,16,2,18,3,"{""src/drawline.c"": {""insertions"": 13, ""deletions"": 2, ""lines"": 15}, ""src/testdir/test_textprop.vim"": {""insertions"": 1, ""deletions"": 0, ""lines"": 1}, ""src/version.c"": {""insertions"": 2, ""deletions"": 0, ""lines"": 2}}"
2022-08-05 19:25:50,50e75fe8d8c8ab262ab5b11d1498e5628044e07c,Bram Moolenaar,7,2,9,4,"{""src/charset.c"": {""insertions"": 1, ""deletions"": 1, ""lines"": 2}, ""src/testdir/dumps/Test_prop_with_text_after_1.dump"": {""insertions"": 2, ""deletions"": 0, ""lines"": 2}, ""src/testdir/test_textprop.vim"": {""insertions"": 2, ""deletions"": 1, ""lines"": 3}, ""src/version.c"": {""insertions"": 2, ""deletions"": 0, ""lines"": 2}}"
2022-08-05 19:03:55,4d2031fdbe833431269a960dd2f0287dbcaa92f9,Bram Moolenaar,12,5,17,2,"{""src/drawline.c"": {""insertions"": 10, ""deletions"": 5, ""lines"": 15}, ""src/version.c"": {""insertions"": 2, ""deletions"": 0, ""lines"": 2}}"
2022-08-05 18:46:48,213bbaf15afc628e5f83d1ae6526631ca8292292,Bram Moolenaar,132,12,144,5,"{""src/ex_cmds.c"": {""insertions"": 64, ""deletions"": 2, ""lines"": 66}, ""src/proto/textprop.pro"": {""insertions"": 1, ""deletions"": 0, ""lines"": 1}, ""src/testdir/test_textprop.vim"": {""insertions"": 42, ""deletions"": 9, ""lines"": 51}, ""src/textprop.c"": {""insertions"": 23, ""deletions"": 1, ""lines"": 24}, ""src/version.c"": {""insertions"": 2, ""deletions"": 0, ""lines"": 2}}"
2022-08-05 16:05:04,f4ba8bc47eb3c6b5899ef31d083b9b8f0d4ca456,Bram Moolenaar,65,2,67,7,"{""runtime/doc/textprop.txt"": {""insertions"": 2, ""deletions"": 0, ""lines"": 2}, ""src/structs.h"": {""insertions"": 1, ""deletions"": 0, ""lines"": 1}, ""src/testdir/dumps/Test_textprop_hl_override_1.dump"": {""insertions"": 8, ""deletions"": 0, ""lines"": 8}, ""src/testdir/dumps/Test_textprop_hl_override_2.dump"": {""insertions"": 8, ""deletions"": 0, ""lines"": 8}, ""src/testdir/test_textprop.vim"": {""insertions"": 32, ""deletions"": 0, ""lines"": 32}, ""src/textprop.c"": {""insertions"": 12, ""deletions"": 2, ""lines"": 14}, ""src/version.c"": {""insertions"": 2, ""deletions"": 0, ""lines"": 2}}"
2022-08-05 12:07:23,afd2aa79eda3fe69f2e7c87d0b9b4bca874f386a,Bram Moolenaar,26,3,29,7,"{""src/charset.c"": {""insertions"": 1, ""deletions"": 1, ""lines"": 2}, ""src/testdir/dumps/Test_prop_inserts_text_1.dump"": {""insertions"": 1, ""deletions"": 1, ""lines"": 2}, ""src/testdir/dumps/Test_prop_inserts_text_2.dump"": {""insertions"": 1, ""deletions"": 1, ""lines"": 2}, ""src/testdir/dumps/Test_prop_inserts_text_3.dump"": {""insertions"": 6, ""deletions"": 0, ""lines"": 6}, ""src/testdir/dumps/Test_prop_inserts_text_4.dump"": {""insertions"": 6, ""deletions"": 0, ""lines"": 6}, ""src/testdir/test_textprop.vim"": {""insertions"": 9, ""deletions"": 0, ""lines"": 9}, ""src/version.c"": {""insertions"": 2, ""deletions"": 0, ""lines"": 2}}"
2022-08-05 10:45:17,2f83cc4cfa56750c91eb6daa8fde319bca032d18,Bram Moolenaar,34,26,60,2,"{""src/charset.c"": {""insertions"": 32, ""deletions"": 26, ""lines"": 58}, ""src/version.c"": {""insertions"": 2, ""deletions"": 0, ""lines"": 2}}"
2022-08-05 09:52:30,206fce307b265f7f6c6290b623a80c1d846dd131,zeertzjq,31,6,37,3,"{""runtime/delmenu.vim"": {""insertions"": 25, ""deletions"": 0, ""lines"": 25}, ""src/testdir/test_menu.vim"": {""insertions"": 4, ""deletions"": 6, ""lines"": 10}, ""src/version.c"": {""insertions"": 2, ""deletions"": 0, ""lines"": 2}}"
2022-08-04 17:50:14,3d3f6ac09859905405f35f50b2b7c57ccf40fb47,Kota Kato,43,0,43,3,"{""src/evalfunc.c"": {""insertions"": 5, ""deletions"": 0, ""lines"": 5}, ""src/testdir/test_vim9_cmd.vim"": {""insertions"": 36, ""deletions"": 0, ""lines"": 36}, ""src/version.c"": {""insertions"": 2, ""deletions"": 0, ""lines"": 2}}"
2022-08-04 14:03:48,398649ee44edeb309c77361de697320378104b70,Bram Moolenaar,236,30,266,12,"{""src/charset.c"": {""insertions"": 61, ""deletions"": 15, ""lines"": 76}, ""src/drawline.c"": {""insertions"": 52, ""deletions"": 15, ""lines"": 67}, ""src/proto/charset.pro"": {""insertions"": 1, ""deletions"": 0, ""lines"": 1}, ""src/structs.h"": {""insertions"": 2, ""deletions"": 0, ""lines"": 2}, ""src/testdir/dumps/Test_prop_with_text_after_trunc_1.dump"": {""insertions"": 9, ""deletions"": 0, ""lines"": 9}, ""src/testdir/dumps/Test_prop_with_text_after_trunc_2.dump"": {""insertions"": 9, ""deletions"": 0, ""lines"": 9}, ""src/testdir/dumps/Test_prop_with_text_after_trunc_3.dump"": {""insertions"": 9, ""deletions"": 0, ""lines"": 9}, ""src/testdir/dumps/Test_prop_with_text_after_trunc_4.dump"": {""insertions"": 9, ""deletions"": 0, ""lines"": 9}, ""src/testdir/dumps/Test_prop_with_text_after_trunc_5.dump"": {""insertions"": 9, ""deletions"": 0, ""lines"": 9}, ""src/testdir/dumps/Test_prop_with_text_after_wraps_1.dump"": {""insertions"": 9, ""deletions"": 0, ""lines"": 9}, ""src/testdir/test_textprop.vim"": {""insertions"": 64, ""deletions"": 0, ""lines"": 64}, ""src/version.c"": {""insertions"": 2, ""deletions"": 0, ""lines"": 2}}"
2022-08-04 12:01:48,bc49c5f48f89c2d6f4d88ee77f44a11d68293be3,Bram Moolenaar,27,3,30,5,"{""src/charset.c"": {""insertions"": 15, ""deletions"": 2, ""lines"": 17}, ""src/proto/charset.pro"": {""insertions"": 1, ""deletions"": 0, ""lines"": 1}, ""src/spell.c"": {""insertions"": 1, ""deletions"": 1, ""lines"": 2}, ""src/testdir/test_spellfile.vim"": {""insertions"": 8, ""deletions"": 0, ""lines"": 8}, ""src/version.c"": {""insertions"": 2, ""deletions"": 0, ""lines"": 2}}"
2022-08-03 15:13:27,db7a88db8b52508d3df6d5947f7c4f3ef05d5f62,James McCoy,4,0,4,2,"{""src/testdir/test_debugger.vim"": {""insertions"": 2, ""deletions"": 0, ""lines"": 2}, ""src/version.c"": {""insertions"": 2, ""deletions"": 0, ""lines"": 2}}"
2022-08-03 14:48:33,d6212b80d6d49d4d890c3141b7c6b83f899333b0,Bram Moolenaar,8,3,11,2,"{""src/mouse.c"": {""insertions"": 6, ""deletions"": 3, ""lines"": 9}, ""src/version.c"": {""insertions"": 2, ""deletions"": 0, ""lines"": 2}}"
2022-08-02 11:15:51,0b0ccbbfb014e1c9682b86a7a41ff2837b0b8047,zeertzjq,7,4,11,2,"{""src/version.c"": {""insertions"": 2, ""deletions"": 0, ""lines"": 2}, ""src/window.c"": {""insertions"": 5, ""deletions"": 4, ""lines"": 9}}"
2022-08-02 10:48:53,f05a1e59a3df759667f2082cf42368945c57e389,Bram Moolenaar,20,1,21,3,"{""src/testdir/runtest.vim"": {""insertions"": 1, ""deletions"": 1, ""lines"": 2}, ""src/testdir/test_textprop.vim"": {""insertions"": 17, ""deletions"": 0, ""lines"": 17}, ""src/version.c"": {""insertions"": 2, ""deletions"": 0, ""lines"": 2}}"
2022-08-01 21:18:50,e175dc6911948bcd0c854876b534fee62fb95b9f,Bram Moolenaar,53,14,67,6,"{""src/ops.c"": {""insertions"": 2, ""deletions"": 2, ""lines"": 4}, ""src/proto/textprop.pro"": {""insertions"": 2, ""deletions"": 2, ""lines"": 4}, ""src/testdir/dumps/Test_prop_with_text_after_joined_1.dump"": {""insertions"": 6, ""deletions"": 0, ""lines"": 6}, ""src/testdir/test_textprop.vim"": {""insertions"": 26, ""deletions"": 0, ""lines"": 26}, ""src/textprop.c"": {""insertions"": 15, ""deletions"": 10, ""lines"": 25}, ""src/version.c"": {""insertions"": 2, ""deletions"": 0, ""lines"": 2}}"
2022-08-01 15:51:02,09ff4b54fb86a64390ba9c609853c6410ea6197c,Bram Moolenaar,20,13,33,7,"{""src/charset.c"": {""insertions"": 4, ""deletions"": 4, ""lines"": 8}, ""src/drawline.c"": {""insertions"": 3, ""deletions"": 4, ""lines"": 7}, ""src/testdir/dumps/Test_prop_inserts_text_1.dump"": {""insertions"": 1, ""deletions"": 1, ""lines"": 2}, ""src/testdir/dumps/Test_prop_inserts_text_2.dump"": {""insertions"": 1, ""deletions"": 1, ""lines"": 2}, ""src/testdir/dumps/Test_prop_with_text_after_1.dump"": {""insertions"": 2, ""deletions"": 2, ""lines"": 4}, ""src/testdir/test_textprop.vim"": {""insertions"": 7, ""deletions"": 1, ""lines"": 8}, ""src/version.c"": {""insertions"": 2, ""deletions"": 0, ""lines"": 2}}"
2022-08-01 15:11:06,783ef7214b6a33300bd83f616c1ead587370ce49,Bram Moolenaar,13,3,16,4,"{""runtime/doc/textprop.txt"": {""insertions"": 2, ""deletions"": 0, ""lines"": 2}, ""src/testdir/test_textprop.vim"": {""insertions"": 2, ""deletions"": 2, ""lines"": 4}, ""src/textprop.c"": {""insertions"": 7, ""deletions"": 1, ""lines"": 8}, ""src/version.c"": {""insertions"": 2, ""deletions"": 0, ""lines"": 2}}"
2022-08-01 14:52:55,1f4ee19eefecd8f70b7cbe8ee9db8ace6352e23e,Bram Moolenaar,29,13,42,6,"{""src/drawline.c"": {""insertions"": 0, ""deletions"": 7, ""lines"": 7}, ""src/edit.c"": {""insertions"": 7, ""deletions"": 2, ""lines"": 9}, ""src/testdir/dumps/Test_prop_inserts_text_1.dump"": {""insertions"": 2, ""deletions"": 2, ""lines"": 4}, ""src/testdir/dumps/Test_prop_inserts_text_2.dump"": {""insertions"": 2, ""deletions"": 2, ""lines"": 4}, ""src/testdir/test_textprop.vim"": {""insertions"": 16, ""deletions"": 0, ""lines"": 16}, ""src/version.c"": {""insertions"": 2, ""deletions"": 0, ""lines"": 2}}"
2022-08-01 14:09:53,05a8061eecd9969ee6cde008f54ded77462b649e,Bram Moolenaar,1284,59,1343,24,"{"".github/CODEOWNERS"": {""insertions"": 3, ""deletions"": 0, ""lines"": 3}, ""runtime/colors/blue.vim"": {""insertions"": 2, ""deletions"": 2, ""lines"": 4}, ""runtime/colors/darkblue.vim"": {""insertions"": 2, ""deletions"": 2, ""lines"": 4}, ""runtime/colors/delek.vim"": {""insertions"": 2, ""deletions"": 2, ""lines"": 4}, ""runtime/colors/desert.vim"": {""insertions"": 4, ""deletions"": 4, ""lines"": 8}, ""runtime/colors/elflord.vim"": {""insertions"": 2, ""deletions"": 2, ""lines"": 4}, ""runtime/colors/evening.vim"": {""insertions"": 2, ""deletions"": 2, ""lines"": 4}, ""runtime/colors/habamax.vim"": {""insertions"": 519, ""deletions"": 0, ""lines"": 519}, ""runtime/colors/industry.vim"": {""insertions"": 2, ""deletions"": 2, ""lines"": 4}, ""runtime/colors/koehler.vim"": {""insertions"": 2, ""deletions"": 2, ""lines"": 4}, ""runtime/colors/morning.vim"": {""insertions"": 2, ""deletions"": 2, ""lines"": 4}, ""runtime/colors/murphy.vim"": {""insertions"": 2, ""deletions"": 2, ""lines"": 4}, ""runtime/colors/pablo.vim"": {""insertions"": 2, ""deletions"": 2, ""lines"": 4}, ""runtime/colors/peachpuff.vim"": {""insertions"": 2, ""deletions"": 2, ""lines"": 4}, ""runtime/colors/quiet.vim"": {""insertions"": 707, ""deletions"": 0, ""lines"": 707}, ""runtime/colors/ron.vim"": {""insertions"": 2, ""deletions"": 2, ""lines"": 4}, ""runtime/colors/shine.vim"": {""insertions"": 2, ""deletions"": 2, ""lines"": 4}, ""runtime/colors/slate.vim"": {""insertions"": 2, ""deletions"": 2, ""lines"": 4}, ""runtime/colors/torte.vim"": {""insertions"": 2, ""deletions"": 2, ""lines"": 4}, ""runtime/colors/zellner.vim"": {""insertions"": 2, ""deletions"": 2, ""lines"": 4}, ""runtime/doc/eval.txt"": {""insertions"": 1, ""deletions"": 1, ""lines"": 2}, ""runtime/doc/tags"": {""insertions"": 0, ""deletions"": 6, ""lines"": 6}, ""runtime/doc/todo.txt"": {""insertions"": 17, ""deletions"": 15, ""lines"": 32}, ""runtime/doc/vim9.txt"": {""insertions"": 1, ""deletions"": 1, ""lines"": 2}}"
2022-08-01 13:00:31,ab146dac6b4148e770eb2bf61c72ef62d3ecfc65,Mike Williams,3,1,4,2,"{""src/quickfix.c"": {""insertions"": 1, ""deletions"": 1, ""lines"": 2}, ""src/version.c"": {""insertions"": 2, ""deletions"": 0, ""lines"": 2}}"
2022-08-01 11:06:40,3f79b61288bf528b9a848af9e4c849c35c1df0bf,Bram Moolenaar,6,7,13,2,"{""src/charset.c"": {""insertions"": 4, ""deletions"": 7, ""lines"": 11}, ""src/version.c"": {""insertions"": 2, ""deletions"": 0, ""lines"": 2}}"
2022-08-01 10:49:45,e95f22f63a1871b91e5508088e5ae4905ce28cd7,zeertzjq,2,2,4,2,"{""src/map.c"": {""insertions"": 0, ""deletions"": 2, ""lines"": 2}, ""src/version.c"": {""insertions"": 2, ""deletions"": 0, ""lines"": 2}}"
2022-08-01 10:38:17,95fca12b0e8a351ce4416417323db24c63eb940a,John Drouhard,27,2,29,3,"{""src/findfile.c"": {""insertions"": 1, ""deletions"": 1, ""lines"": 2}, ""src/testdir/test_gf.vim"": {""insertions"": 24, ""deletions"": 1, ""lines"": 25}, ""src/version.c"": {""insertions"": 2, ""deletions"": 0, ""lines"": 2}}"
2022-08-01 10:17:40,84b247fab70e9b76539c2a0e24556e7c66126974,Bram Moolenaar,10,3,13,4,"{""src/charset.c"": {""insertions"": 1, ""deletions"": 0, ""lines"": 1}, ""src/testdir/dumps/Test_prop_with_text_after_1.dump"": {""insertions"": 3, ""deletions"": 3, ""lines"": 6}, ""src/testdir/test_textprop.vim"": {""insertions"": 4, ""deletions"": 0, ""lines"": 4}, ""src/version.c"": {""insertions"": 2, ""deletions"": 0, ""lines"": 2}}"
2022-07-31 17:34:32,101d57b34b72f4fbc7df1b6edfd64c64a6be14fc,zeertzjq,252,260,512,8,"{""src/arglist.c"": {""insertions"": 19, ""deletions"": 20, ""lines"": 39}, ""src/diff.c"": {""insertions"": 24, ""deletions"": 22, ""lines"": 46}, ""src/edit.c"": {""insertions"": 43, ""deletions"": 42, ""lines"": 85}, ""src/help.c"": {""insertions"": 30, ""deletions"": 30, ""lines"": 60}, ""src/normal.c"": {""insertions"": 34, ""deletions"": 34, ""lines"": 68}, ""src/syntax.c"": {""insertions"": 36, ""deletions"": 44, ""lines"": 80}, ""src/version.c"": {""insertions"": 2, ""deletions"": 0, ""lines"": 2}, ""src/window.c"": {""insertions"": 64, ""deletions"": 68, ""lines"": 132}}"
2022-07-31 17:03:57,c146d974f13450453a7c1f5ab10b105c515f0ccb,Bram Moolenaar,4,0,4,2,"{""src/charset.c"": {""insertions"": 2, ""deletions"": 0, ""lines"": 2}, ""src/version.c"": {""insertions"": 2, ""deletions"": 0, ""lines"": 2}}"
2022-07-31 17:00:10,be33e5e4a979811df84e19995b94655128f31046,Bram Moolenaar,3,1,4,2,"{""src/charset.c"": {""insertions"": 1, ""deletions"": 1, ""lines"": 2}, ""src/version.c"": {""insertions"": 2, ""deletions"": 0, ""lines"": 2}}"
2022-07-31 16:12:43,b7963df98f9dbbb824713acad2f47c9989fcf8f3,Bram Moolenaar,246,48,294,8,"{""runtime/doc/textprop.txt"": {""insertions"": 27, ""deletions"": 5, ""lines"": 32}, ""src/charset.c"": {""insertions"": 15, ""deletions"": 5, ""lines"": 20}, ""src/drawline.c"": {""insertions"": 91, ""deletions"": 15, ""lines"": 106}, ""src/structs.h"": {""insertions"": 9, ""deletions"": 1, ""lines"": 10}, ""src/testdir/dumps/Test_prop_with_text_after_1.dump"": {""insertions"": 6, ""deletions"": 0, ""lines"": 6}, ""src/testdir/test_textprop.vim"": {""insertions"": 20, ""deletions"": 0, ""lines"": 20}, ""src/textprop.c"": {""insertions"": 76, ""deletions"": 22, ""lines"": 98}, ""src/version.c"": {""insertions"": 2, ""deletions"": 0, ""lines"": 2}}"
2022-07-31 11:26:05,6b568b1cc75e6c4d4a3ec95d7867c7a22e98eba1,Anton Sharonov,5,2,7,2,"{""src/gui_w32.c"": {""insertions"": 3, ""deletions"": 2, ""lines"": 5}, ""src/version.c"": {""insertions"": 2, ""deletions"": 0, ""lines"": 2}}"
2022-07-31 10:50:42,dbdcc799109f0893856f07e03214206723cfdcf6,K.Takata,12,2,14,2,"{""src/bufwrite.c"": {""insertions"": 10, ""deletions"": 2, ""lines"": 12}, ""src/version.c"": {""insertions"": 2, ""deletions"": 0, ""lines"": 2}}"
2022-07-31 10:37:20,750209459c9e54030409afe8f4ad59570600b5c4,zeertzjq,19,8,27,6,"{""runtime/doc/options.txt"": {""insertions"": 1, ""deletions"": 1, ""lines"": 2}, ""src/globals.h"": {""insertions"": 1, ""deletions"": 1, ""lines"": 2}, ""src/register.c"": {""insertions"": 1, ""deletions"": 1, ""lines"": 2}, ""src/testdir/test_ins_complete.vim"": {""insertions"": 1, ""deletions"": 1, ""lines"": 2}, ""src/testdir/test_messages.vim"": {""insertions"": 13, ""deletions"": 4, ""lines"": 17}, ""src/version.c"": {""insertions"": 2, ""deletions"": 0, ""lines"": 2}}"
2022-07-30 21:17:18,3a4cd39d476474e20e88ebf120ca6070cc0d0072,Bram Moolenaar,51,3,54,3,"{""src/testdir/test_textprop.vim"": {""insertions"": 19, ""deletions"": 0, ""lines"": 19}, ""src/textprop.c"": {""insertions"": 30, ""deletions"": 3, ""lines"": 33}, ""src/version.c"": {""insertions"": 2, ""deletions"": 0, ""lines"": 2}}"
2022-07-30 20:33:46,711483cd1381a4ed848d783ae0a6792d5b04447b,Bram Moolenaar,14,1,15,5,"{""src/drawline.c"": {""insertions"": 2, ""deletions"": 0, ""lines"": 2}, ""src/testdir/dumps/{Test_prop_inserts_text.dump => Test_prop_inserts_text_1.dump}"": {""insertions"": 0, ""deletions"": 0, ""lines"": 0}, ""src/testdir/dumps/Test_prop_inserts_text_2.dump"": {""insertions"": 6, ""deletions"": 0, ""lines"": 6}, ""src/testdir/test_textprop.vim"": {""insertions"": 4, ""deletions"": 1, ""lines"": 5}, ""src/version.c"": {""insertions"": 2, ""deletions"": 0, ""lines"": 2}}"
2022-07-30 18:10:06,6747cf1671bd41cddee77c65b3f9a70509f968db,Bram Moolenaar,18,3,21,4,"{""src/ex_getln.c"": {""insertions"": 11, ""deletions"": 2, ""lines"": 13}, ""src/globals.h"": {""insertions"": 3, ""deletions"": 0, ""lines"": 3}, ""src/version.c"": {""insertions"": 2, ""deletions"": 0, ""lines"": 2}, ""src/window.c"": {""insertions"": 2, ""deletions"": 1, ""lines"": 3}}"
2022-07-30 15:54:05,f39cfb72629f3e7fefaf578a3faa2619cd0654f8,Shougo Matsushita,154,30,184,16,"{""runtime/doc/options.txt"": {""insertions"": 11, ""deletions"": 4, ""lines"": 15}, ""src/drawscreen.c"": {""insertions"": 10, ""deletions"": 7, ""lines"": 17}, ""src/ex_cmds.c"": {""insertions"": 13, ""deletions"": 0, ""lines"": 13}, ""src/ex_getln.c"": {""insertions"": 16, ""deletions"": 0, ""lines"": 16}, ""src/getchar.c"": {""insertions"": 4, ""deletions"": 0, ""lines"": 4}, ""src/message.c"": {""insertions"": 4, ""deletions"": 4, ""lines"": 8}, ""src/normal.c"": {""insertions"": 3, ""deletions"": 0, ""lines"": 3}, ""src/ops.c"": {""insertions"": 5, ""deletions"": 0, ""lines"": 5}, ""src/option.c"": {""insertions"": 1, ""deletions"": 1, ""lines"": 2}, ""src/register.c"": {""insertions"": 17, ""deletions"": 0, ""lines"": 17}, ""src/screen.c"": {""insertions"": 1, ""deletions"": 1, ""lines"": 2}, ""src/testdir/gen_opt_test.vim"": {""insertions"": 1, ""deletions"": 1, ""lines"": 2}, ""src/testdir/test_messages.vim"": {""insertions"": 47, ""deletions"": 0, ""lines"": 47}, ""src/testdir/test_window_cmd.vim"": {""insertions"": 5, ""deletions"": 2, ""lines"": 7}, ""src/version.c"": {""insertions"": 2, ""deletions"": 0, ""lines"": 2}, ""src/window.c"": {""insertions"": 14, ""deletions"": 10, ""lines"": 24}}"
2022-07-30 14:43:59,d90f91fe3075bb51668ed926182b2163da9df001,K.Takata,30,12,42,3,"{""src/evalfunc.c"": {""insertions"": 19, ""deletions"": 12, ""lines"": 31}, ""src/testdir/test_expr.vim"": {""insertions"": 9, ""deletions"": 0, ""lines"": 9}, ""src/version.c"": {""insertions"": 2, ""deletions"": 0, ""lines"": 2}}"
2022-07-30 14:35:12,0f823c360947779d9de6048c6bce51c670a06eb6,Bram Moolenaar,17,5,22,2,"{""src/testdir/test_shortpathname.vim"": {""insertions"": 15, ""deletions"": 5, ""lines"": 20}, ""src/version.c"": {""insertions"": 2, ""deletions"": 0, ""lines"": 2}}"
2022-07-30 13:56:17,de78632c41d870d5254e9ccd285f53674b955f4e,Bram Moolenaar,11,3,14,4,"{""runtime/doc/builtin.txt"": {""insertions"": 1, ""deletions"": 0, ""lines"": 1}, ""src/evalfunc.c"": {""insertions"": 5, ""deletions"": 2, ""lines"": 7}, ""src/testdir/test_syn_attr.vim"": {""insertions"": 3, ""deletions"": 1, ""lines"": 4}, ""src/version.c"": {""insertions"": 2, ""deletions"": 0, ""lines"": 2}}"
2022-07-30 11:03:16,ddab3ce3457aadffb16ce0127f67a99966a065a8,Carlo Teubner,45,10,55,4,"{""runtime/doc/doctags.c"": {""insertions"": 22, ""deletions"": 10, ""lines"": 32}, ""src/help.c"": {""insertions"": 14, ""deletions"": 0, ""lines"": 14}, ""src/testdir/test_help.vim"": {""insertions"": 7, ""deletions"": 0, ""lines"": 7}, ""src/version.c"": {""insertions"": 2, ""deletions"": 0, ""lines"": 2}}"
2022-07-30 10:39:57,1eead4cf1daf87ee41aeb4de3b3e38708417f9d5,Bram Moolenaar,16,4,20,3,"{""src/spellsuggest.c"": {""insertions"": 6, ""deletions"": 4, ""lines"": 10}, ""src/testdir/test_spell_utf8.vim"": {""insertions"": 8, ""deletions"": 0, ""lines"": 8}, ""src/version.c"": {""insertions"": 2, ""deletions"": 0, ""lines"": 2}}"
2022-07-30 10:00:50,5f6cae8b8a49c435556e32f84d067cd0b4d28e4c,Bram Moolenaar,8,4,12,3,"{""src/auto/configure"": {""insertions"": 4, ""deletions"": 2, ""lines"": 6}, ""src/configure.ac"": {""insertions"": 2, ""deletions"": 2, ""lines"": 4}, ""src/version.c"": {""insertions"": 2, ""deletions"": 0, ""lines"": 2}}"
2022-07-29 20:36:21,2ecbe53f452e92e941aff623f6a0b72f80e43d07,Bram Moolenaar,1032,704,1736,35,"{""CONTRIBUTING.md"": {""insertions"": 0, ""deletions"": 3, ""lines"": 3}, ""README.md"": {""insertions"": 2, ""deletions"": 5, ""lines"": 7}, ""runtime/doc/builtin.txt"": {""insertions"": 3, ""deletions"": 3, ""lines"": 6}, ""runtime/doc/change.txt"": {""insertions"": 2, ""deletions"": 0, ""lines"": 2}, ""runtime/doc/channel.txt"": {""insertions"": 1, ""deletions"": 0, ""lines"": 1}, ""runtime/doc/cmdline.txt"": {""insertions"": 2, ""deletions"": 0, ""lines"": 2}, ""runtime/doc/eval.txt"": {""insertions"": 3, ""deletions"": 3, ""lines"": 6}, ""runtime/doc/pattern.txt"": {""insertions"": 1, ""deletions"": 1, ""lines"": 2}, ""runtime/doc/popup.txt"": {""insertions"": 1, ""deletions"": 1, ""lines"": 2}, ""runtime/doc/spell.txt"": {""insertions"": 1, ""deletions"": 1, ""lines"": 2}, ""runtime/doc/tags"": {""insertions"": 22, ""deletions"": 0, ""lines"": 22}, ""runtime/doc/testing.txt"": {""insertions"": 1, ""deletions"": 0, ""lines"": 1}, ""runtime/doc/textprop.txt"": {""insertions"": 2, ""deletions"": 1, ""lines"": 3}, ""runtime/doc/todo.txt"": {""insertions"": 13, ""deletions"": 4, ""lines"": 17}, ""runtime/doc/vim9.txt"": {""insertions"": 10, ""deletions"": 3, ""lines"": 13}, ""runtime/ftplugin/debchangelog.vim"": {""insertions"": 56, ""deletions"": 45, ""lines"": 101}, ""runtime/ftplugin/desktop.vim"": {""insertions"": 13, ""deletions"": 0, ""lines"": 13}, ""runtime/ftplugin/swayconfig.vim"": {""insertions"": 16, ""deletions"": 0, ""lines"": 16}, ""runtime/indent/html.vim"": {""insertions"": 1, ""deletions"": 1, ""lines"": 2}, ""runtime/indent/javascript.vim"": {""insertions"": 6, ""deletions"": 0, ""lines"": 6}, ""runtime/lang/Makefile"": {""insertions"": 17, ""deletions"": 2, ""lines"": 19}, ""runtime/lang/menu_chinese_gb.936.vim"": {""insertions"": 400, ""deletions"": 282, ""lines"": 682}, ""runtime/lang/menu_hu_hu.iso_8859-2.vim"": {""insertions"": 3, ""deletions"": 19, ""lines"": 22}, ""runtime/lang/menu_sk_sk.iso_8859-2.vim"": {""insertions"": 1, ""deletions"": 1, ""lines"": 2}, ""runtime/lang/menu_zh_cn.utf-8.vim"": {""insertions"": 24, ""deletions"": 19, ""lines"": 43}, ""runtime/syntax/autohotkey.vim"": {""insertions"": 10, ""deletions"": 7, ""lines"": 17}, ""runtime/syntax/debchangelog.vim"": {""insertions"": 6, ""deletions"": 6, ""lines"": 12}, ""runtime/syntax/debsources.vim"": {""insertions"": 6, ""deletions"": 6, ""lines"": 12}, ""runtime/syntax/i3config.vim"": {""insertions"": 9, ""deletions"": 3, ""lines"": 12}, ""runtime/syntax/python.vim"": {""insertions"": 8, ""deletions"": 2, ""lines"": 10}, ""runtime/syntax/swayconfig.vim"": {""insertions"": 92, ""deletions"": 0, ""lines"": 92}, ""runtime/tutor/tutor.zh_cn.utf-8"": {""insertions"": 1, ""deletions"": 1, ""lines"": 2}, ""src/po/Makefile"": {""insertions"": 3, ""deletions"": 1, ""lines"": 4}, ""src/po/ru.cp1251.po"": {""insertions"": 148, ""deletions"": 142, ""lines"": 290}, ""src/po/ru.po"": {""insertions"": 148, ""deletions"": 142, ""lines"": 290}}"
2022-07-29 18:50:41,72981ac94ff7aeaa596d535448ee0bef46050acf,Bram Moolenaar,3,4,7,2,"{""src/userfunc.c"": {""insertions"": 1, ""deletions"": 4, ""lines"": 5}, ""src/version.c"": {""insertions"": 2, ""deletions"": 0, ""lines"": 2}}"
2022-07-29 17:32:20,cb36c2a3cdd5610487dd830d430bf022f288328d,Bram Moolenaar,4,6,10,2,"{""src/testdir/test_regexp_utf8.vim"": {""insertions"": 2, ""deletions"": 6, ""lines"": 8}, ""src/version.c"": {""insertions"": 2, ""deletions"": 0, ""lines"": 2}}"
2022-07-29 15:22:25,f50940531dd57135fe60aa393ac9d3281f352d88,Bram Moolenaar,22,1,23,3,"{""src/regexp.c"": {""insertions"": 5, ""deletions"": 1, ""lines"": 6}, ""src/testdir/test_regexp_utf8.vim"": {""insertions"": 15, ""deletions"": 0, ""lines"": 15}, ""src/version.c"": {""insertions"": 2, ""deletions"": 0, ""lines"": 2}}"
2022-07-29 14:28:27,1e56bda9048a9625bce6e660938c834c5c15b07d,Bram Moolenaar,19,0,19,3,"{""src/testdir/test_eval_stuff.vim"": {""insertions"": 5, ""deletions"": 0, ""lines"": 5}, ""src/typval.c"": {""insertions"": 12, ""deletions"": 0, ""lines"": 12}, ""src/version.c"": {""insertions"": 2, ""deletions"": 0, ""lines"": 2}}"
2022-07-28 21:39:54,efffa5360ebb2b6919c5eb1998c5df4c8849a407,Bram Moolenaar,92,63,155,3,"{""src/auto/configure"": {""insertions"": 50, ""deletions"": 35, ""lines"": 85}, ""src/configure.ac"": {""insertions"": 40, ""deletions"": 28, ""lines"": 68}, ""src/version.c"": {""insertions"": 2, ""deletions"": 0, ""lines"": 2}}"
2022-07-28 20:51:37,a6f9e300161f4cb54713da22f65b261595e8e614,Bram Moolenaar,11,1,12,3,"{""src/insexpand.c"": {""insertions"": 1, ""deletions"": 1, ""lines"": 2}, ""src/testdir/test_ins_complete.vim"": {""insertions"": 8, ""deletions"": 0, ""lines"": 8}, ""src/version.c"": {""insertions"": 2, ""deletions"": 0, ""lines"": 2}}"
2022-07-28 17:44:27,4e677b9c40ccbc5f090971b31dc2fe07bf05541d,Bram Moolenaar,22,3,25,3,"{""src/diff.c"": {""insertions"": 6, ""deletions"": 3, ""lines"": 9}, ""src/testdir/test_diffmode.vim"": {""insertions"": 14, ""deletions"": 0, ""lines"": 14}, ""src/version.c"": {""insertions"": 2, ""deletions"": 0, ""lines"": 2}}"
2022-07-28 11:54:08,cb5ed4d6252a7c76c2f85ae95cb1e4e2bccc41fc,Bram Moolenaar,6,1,7,2,"{""src/os_unix.c"": {""insertions"": 4, ""deletions"": 1, ""lines"": 5}, ""src/version.c"": {""insertions"": 2, ""deletions"": 0, ""lines"": 2}}"
2022-07-28 11:34:09,46af7bc08debbf408d025680eeef136fb3b528ef,zeertzjq,55,6,61,5,"{""src/ex_getln.c"": {""insertions"": 2, ""deletions"": 1, ""lines"": 3}, ""src/message.c"": {""insertions"": 40, ""deletions"": 4, ""lines"": 44}, ""src/proto/message.pro"": {""insertions"": 1, ""deletions"": 0, ""lines"": 1}, ""src/testdir/test_messages.vim"": {""insertions"": 10, ""deletions"": 1, ""lines"": 11}, ""src/version.c"": {""insertions"": 2, ""deletions"": 0, ""lines"": 2}}"
2022-07-28 11:09:04,5748b7f2c8a8e8e6d12b3e2531df5c0261fd8f3b,Bram Moolenaar,26,7,33,3,"{""src/auto/configure"": {""insertions"": 12, ""deletions"": 3, ""lines"": 15}, ""src/configure.ac"": {""insertions"": 12, ""deletions"": 4, ""lines"": 16}, ""src/version.c"": {""insertions"": 2, ""deletions"": 0, ""lines"": 2}}"
2022-07-28 10:56:01,5f30e26f6946f0d0396499f91fbcfaa9d1f8acf7,Bram Moolenaar,35,7,42,3,"{""src/quickfix.c"": {""insertions"": 25, ""deletions"": 7, ""lines"": 32}, ""src/testdir/test_quickfix.vim"": {""insertions"": 8, ""deletions"": 0, ""lines"": 8}, ""src/version.c"": {""insertions"": 2, ""deletions"": 0, ""lines"": 2}}"
2022-07-27 17:26:03,f6782732ab4acd02211923fbdccb457dacaf277e,zeertzjq,14,35,49,4,"{""src/option.c"": {""insertions"": 1, ""deletions"": 7, ""lines"": 8}, ""src/optionstr.c"": {""insertions"": 10, ""deletions"": 27, ""lines"": 37}, ""src/proto/optionstr.pro"": {""insertions"": 1, ""deletions"": 1, ""lines"": 2}, ""src/version.c"": {""insertions"": 2, ""deletions"": 0, ""lines"": 2}}"
2022-07-27 14:48:45,122dea70073d140aa89212d344c3f62bd3b5b3fa,zeertzjq,7,4,11,3,"{""src/buffer.c"": {""insertions"": 2, ""deletions"": 2, ""lines"": 4}, ""src/cindent.c"": {""insertions"": 3, ""deletions"": 2, ""lines"": 5}, ""src/version.c"": {""insertions"": 2, ""deletions"": 0, ""lines"": 2}}"
2022-07-27 14:23:35,3d6ee8bda0550a01346f5992bbce09c0eb6d7569,Bram Moolenaar,26,6,32,3,"{""src/testdir/test_autocmd.vim"": {""insertions"": 11, ""deletions"": 0, ""lines"": 11}, ""src/version.c"": {""insertions"": 2, ""deletions"": 0, ""lines"": 2}, ""src/window.c"": {""insertions"": 13, ""deletions"": 6, ""lines"": 19}}"
2022-07-27 14:07:06,7abd1c6d8e777bde1700633bafc1a40be9e9c1aa,James Eapen,10,3,13,3,"{""runtime/filetype.vim"": {""insertions"": 7, ""deletions"": 3, ""lines"": 10}, ""src/testdir/test_filetype.vim"": {""insertions"": 1, ""deletions"": 0, ""lines"": 1}, ""src/version.c"": {""insertions"": 2, ""deletions"": 0, ""lines"": 2}}"
2022-07-27 13:40:00,61021aa318ca4c4a6b0182ee93388b2e9b5eefba,Shougo Matsushita,18,1,19,4,"{""runtime/doc/eval.txt"": {""insertions"": 2, ""deletions"": 0, ""lines"": 2}, ""src/evalvars.c"": {""insertions"": 1, ""deletions"": 1, ""lines"": 2}, ""src/testdir/test_ins_complete.vim"": {""insertions"": 13, ""deletions"": 0, ""lines"": 13}, ""src/version.c"": {""insertions"": 2, ""deletions"": 0, ""lines"": 2}}"
2022-07-27 12:18:14,34d1773bd4a1880616c5d7ef3a26f7bd69527589,Bram Moolenaar,3,1,4,2,"{""src/errors.h"": {""insertions"": 1, ""deletions"": 1, ""lines"": 2}, ""src/version.c"": {""insertions"": 2, ""deletions"": 0, ""lines"": 2}}"
2022-07-27 11:30:13,28f84e17b068daca2635692d279930dcb7a150d0,Bram Moolenaar,23,0,23,5,"{""src/evalvars.c"": {""insertions"": 5, ""deletions"": 0, ""lines"": 5}, ""src/option.c"": {""insertions"": 14, ""deletions"": 0, ""lines"": 14}, ""src/proto/option.pro"": {""insertions"": 1, ""deletions"": 0, ""lines"": 1}, ""src/testdir/test_vim9_builtin.vim"": {""insertions"": 1, ""deletions"": 0, ""lines"": 1}, ""src/version.c"": {""insertions"": 2, ""deletions"": 0, ""lines"": 2}}"
2022-07-26 21:01:36,7db3a8e3298bf7c7c3f74cc9c1add04f29e78d2d,Yegappan Lakshmanan,16,2,18,3,"{""src/cmdexpand.c"": {""insertions"": 4, ""deletions"": 2, ""lines"": 6}, ""src/testdir/test_cmdline.vim"": {""insertions"": 10, ""deletions"": 0, ""lines"": 10}, ""src/version.c"": {""insertions"": 2, ""deletions"": 0, ""lines"": 2}}"
2022-07-26 20:42:03,30e212dac1d29536883c36918a465a38d81d6413,Gregory Anders,28,1,29,3,"{""runtime/autoload/dist/ft.vim"": {""insertions"": 1, ""deletions"": 1, ""lines"": 2}, ""src/testdir/test_filetype.vim"": {""insertions"": 25, ""deletions"": 0, ""lines"": 25}, ""src/version.c"": {""insertions"": 2, ""deletions"": 0, ""lines"": 2}}"
2022-07-26 20:26:18,3f0266739db7d27cb7f03f9d131114fb0af3df71,Anton Sharonov,90,10,100,2,"{""src/gui_w32.c"": {""insertions"": 88, ""deletions"": 10, ""lines"": 98}, ""src/version.c"": {""insertions"": 2, ""deletions"": 0, ""lines"": 2}}"
2022-07-26 19:42:25,6791adca53981666f0cf23e264e102b795224044,zeertzjq,25,0,25,3,"{""src/ex_getln.c"": {""insertions"": 7, ""deletions"": 0, ""lines"": 7}, ""src/testdir/test_cmdline.vim"": {""insertions"": 16, ""deletions"": 0, ""lines"": 16}, ""src/version.c"": {""insertions"": 2, ""deletions"": 0, ""lines"": 2}}"
2022-07-26 18:44:56,1f0dc5e84f5cc530c0fb9d0789e3d42d644429d7,ii14,23,0,23,3,"{""src/ex_cmds.c"": {""insertions"": 5, ""deletions"": 0, ""lines"": 5}, ""src/testdir/test_excmd.vim"": {""insertions"": 16, ""deletions"": 0, ""lines"": 16}, ""src/version.c"": {""insertions"": 2, ""deletions"": 0, ""lines"": 2}}"
2022-07-26 18:18:28,15b87b6610bfce0c6296bbbad019c944f88a74ca,Bram Moolenaar,5,3,8,3,"{""runtime/filetype.vim"": {""insertions"": 2, ""deletions"": 2, ""lines"": 4}, ""src/testdir/test_filetype.vim"": {""insertions"": 1, ""deletions"": 1, ""lines"": 2}, ""src/version.c"": {""insertions"": 2, ""deletions"": 0, ""lines"": 2}}"
2022-07-26 17:12:38,c9e8fd6fc7d2027d0645b376d95a6ed51098036c,zeertzjq,107,91,198,4,"{""src/ex_getln.c"": {""insertions"": 1, ""deletions"": 0, ""lines"": 1}, ""src/testdir/test_autocmd.vim"": {""insertions"": 104, ""deletions"": 0, ""lines"": 104}, ""src/testdir/test_edit.vim"": {""insertions"": 0, ""deletions"": 91, ""lines"": 91}, ""src/version.c"": {""insertions"": 2, ""deletions"": 0, ""lines"": 2}}"
2022-07-26 16:48:13,3cfae39b087c2724991d385e5e8ee7d011aa8e99,zeertzjq,33,3,36,4,"{""src/ex_getln.c"": {""insertions"": 2, ""deletions"": 3, ""lines"": 5}, ""src/testdir/test_ex_mode.vim"": {""insertions"": 1, ""deletions"": 0, ""lines"": 1}, ""src/testdir/test_global.vim"": {""insertions"": 28, ""deletions"": 0, ""lines"": 28}, ""src/version.c"": {""insertions"": 2, ""deletions"": 0, ""lines"": 2}}"
2022-07-26 16:23:47,c2842adfb2ca0637f13e2793fefa18e7818684f9,Bram Moolenaar,23,1,24,3,"{""src/testdir/test_cmdline.vim"": {""insertions"": 10, ""deletions"": 0, ""lines"": 10}, ""src/usercmd.c"": {""insertions"": 11, ""deletions"": 1, ""lines"": 12}, ""src/version.c"": {""insertions"": 2, ""deletions"": 0, ""lines"": 2}}"
2022-07-26 15:03:42,0494789ecee9e2a973f48426f7a69fb96378fa8a,Mike Williams,4,2,6,3,"{""src/charset.c"": {""insertions"": 1, ""deletions"": 1, ""lines"": 2}, ""src/drawline.c"": {""insertions"": 1, ""deletions"": 1, ""lines"": 2}, ""src/version.c"": {""insertions"": 2, ""deletions"": 0, ""lines"": 2}}"
2022-07-26 14:10:56,6809ff978a5c5b798952db9fa663df9e1776f3ff,Bram Moolenaar,35,1,36,3,"{""src/testdir/test_vim9_script.vim"": {""insertions"": 24, ""deletions"": 0, ""lines"": 24}, ""src/version.c"": {""insertions"": 2, ""deletions"": 0, ""lines"": 2}, ""src/vim9compile.c"": {""insertions"": 9, ""deletions"": 1, ""lines"": 10}}"
2022-07-26 13:44:36,559f230fd618e51d7986d87217ff38a2eac73cef,Ernie Rael,45,1,46,4,"{""src/register.c"": {""insertions"": 4, ""deletions"": 1, ""lines"": 5}, ""src/testdir/check.vim"": {""insertions"": 9, ""deletions"": 0, ""lines"": 9}, ""src/testdir/test_registers.vim"": {""insertions"": 30, ""deletions"": 0, ""lines"": 30}, ""src/version.c"": {""insertions"": 2, ""deletions"": 0, ""lines"": 2}}"
2022-07-26 12:47:13,b03950fafa07e8b8d975eeb345ad08b8b62e67ce,Bram Moolenaar,39,4,43,4,"{""src/testdir/dumps/Test_autocmd_nested_switch.dump"": {""insertions"": 10, ""deletions"": 0, ""lines"": 10}, ""src/testdir/test_autocmd.vim"": {""insertions"": 21, ""deletions"": 1, ""lines"": 22}, ""src/version.c"": {""insertions"": 2, ""deletions"": 0, ""lines"": 2}, ""src/window.c"": {""insertions"": 6, ""deletions"": 3, ""lines"": 9}}"
2022-07-26 11:24:41,92a1678d488b7d023ddf2cd493a6ee0d7fcf1928,zeertzjq,23,2,25,3,"{""src/popupmenu.c"": {""insertions"": 2, ""deletions"": 2, ""lines"": 4}, ""src/testdir/test_popup.vim"": {""insertions"": 19, ""deletions"": 0, ""lines"": 19}, ""src/version.c"": {""insertions"": 2, ""deletions"": 0, ""lines"": 2}}"
2022-07-26 10:42:34,be3dbda871ffd1b61f52b9519c23772f62381c67,Bram Moolenaar,4,2,6,2,"{""src/drawline.c"": {""insertions"": 2, ""deletions"": 2, ""lines"": 4}, ""src/version.c"": {""insertions"": 2, ""deletions"": 0, ""lines"": 2}}"
2022-07-26 10:20:48,34a1f779791fd4137547fa72addeb147b7704604,Bram Moolenaar,9,3,12,3,"{""src/charset.c"": {""insertions"": 3, ""deletions"": 0, ""lines"": 3}, ""src/structs.h"": {""insertions"": 4, ""deletions"": 3, ""lines"": 7}, ""src/version.c"": {""insertions"": 2, ""deletions"": 0, ""lines"": 2}}"
2022-07-25 20:40:06,1b67f07f7626b87d9ce3e16815970988983a2ddc,Martin Tournoij,8,3,11,3,"{""runtime/filetype.vim"": {""insertions"": 1, ""deletions"": 1, ""lines"": 2}, ""src/testdir/test_filetype.vim"": {""insertions"": 5, ""deletions"": 2, ""lines"": 7}, ""src/version.c"": {""insertions"": 2, ""deletions"": 0, ""lines"": 2}}"
2022-07-25 20:15:45,6d023f98dfbad6215a4e94ed7df28f8972b3ff9d,Bram Moolenaar,3,1,4,2,"{""src/drawline.c"": {""insertions"": 1, ""deletions"": 1, ""lines"": 2}, ""src/version.c"": {""insertions"": 2, ""deletions"": 0, ""lines"": 2}}"
2022-07-25 18:50:57,ecdc82e74e6a7e73d9067ece1d5eac33abfde5ed,zeertzjq,6,2,8,3,"{""src/message.c"": {""insertions"": 2, ""deletions"": 1, ""lines"": 3}, ""src/testdir/test_messages.vim"": {""insertions"": 2, ""deletions"": 1, ""lines"": 3}, ""src/version.c"": {""insertions"": 2, ""deletions"": 0, ""lines"": 2}}"
2022-07-25 18:42:02,4dc513a22c017b3061287deac74fa55f70a3214c,zeertzjq,12,11,23,2,"{""src/screen.c"": {""insertions"": 10, ""deletions"": 11, ""lines"": 21}, ""src/version.c"": {""insertions"": 2, ""deletions"": 0, ""lines"": 2}}"
2022-07-25 18:07:04,0c740e745a5f8702fd87689615a9684664e40764,Bram Moolenaar,5,0,5,2,"{""src/buffer.c"": {""insertions"": 3, ""deletions"": 0, ""lines"": 3}, ""src/version.c"": {""insertions"": 2, ""deletions"": 0, ""lines"": 2}}"
2022-07-25 17:35:15,fe3fb6e1e6c90e9bada05518a13a72b3fc2f6a98,Bram Moolenaar,7,1,8,2,"{""src/charset.c"": {""insertions"": 5, ""deletions"": 1, ""lines"": 6}, ""src/version.c"": {""insertions"": 2, ""deletions"": 0, ""lines"": 2}}"
2022-07-25 17:13:54,7f9969c559b51446632ac7e8f76cde07e7d0078d,Bram Moolenaar,658,261,919,25,"{""runtime/doc/textprop.txt"": {""insertions"": 19, ""deletions"": 1, ""lines"": 20}, ""src/beval.c"": {""insertions"": 1, ""deletions"": 1, ""lines"": 2}, ""src/charset.c"": {""insertions"": 225, ""deletions"": 82, ""lines"": 307}, ""src/drawline.c"": {""insertions"": 55, ""deletions"": 15, ""lines"": 70}, ""src/edit.c"": {""insertions"": 32, ""deletions"": 19, ""lines"": 51}, ""src/errors.h"": {""insertions"": 4, ""deletions"": 0, ""lines"": 4}, ""src/evalfunc.c"": {""insertions"": 1, ""deletions"": 1, ""lines"": 2}, ""src/getchar.c"": {""insertions"": 15, ""deletions"": 9, ""lines"": 24}, ""src/indent.c"": {""insertions"": 48, ""deletions"": 32, ""lines"": 80}, ""src/misc1.c"": {""insertions"": 16, ""deletions"": 14, ""lines"": 30}, ""src/misc2.c"": {""insertions"": 11, ""deletions"": 8, ""lines"": 19}, ""src/mouse.c"": {""insertions"": 11, ""deletions"": 9, ""lines"": 20}, ""src/ops.c"": {""insertions"": 55, ""deletions"": 31, ""lines"": 86}, ""src/popupwin.c"": {""insertions"": 1, ""deletions"": 1, ""lines"": 2}, ""src/proto/charset.pro"": {""insertions"": 6, ""deletions"": 4, ""lines"": 10}, ""src/proto/textprop.pro"": {""insertions"": 1, ""deletions"": 1, ""lines"": 2}, ""src/regexp.c"": {""insertions"": 1, ""deletions"": 1, ""lines"": 2}, ""src/regexp_bt.c"": {""insertions"": 3, ""deletions"": 1, ""lines"": 4}, ""src/regexp_nfa.c"": {""insertions"": 3, ""deletions"": 1, ""lines"": 4}, ""src/register.c"": {""insertions"": 20, ""deletions"": 6, ""lines"": 26}, ""src/structs.h"": {""insertions"": 19, ""deletions"": 2, ""lines"": 21}, ""src/testdir/dumps/Test_prop_inserts_text.dump"": {""insertions"": 6, ""deletions"": 0, ""lines"": 6}, ""src/testdir/test_textprop.vim"": {""insertions"": 23, ""deletions"": 0, ""lines"": 23}, ""src/textprop.c"": {""insertions"": 80, ""deletions"": 22, ""lines"": 102}, ""src/version.c"": {""insertions"": 2, ""deletions"": 0, ""lines"": 2}}"
2022-07-25 14:42:07,b529cfbd04c02e31cfa88f2c8d88b5ff532d4f7d,Bram Moolenaar,879,460,1339,28,"{"".github/CODEOWNERS"": {""insertions"": 7, ""deletions"": 0, ""lines"": 7}, ""runtime/autoload/bitbake.vim"": {""insertions"": 95, ""deletions"": 0, ""lines"": 95}, ""runtime/autoload/python.vim"": {""insertions"": 228, ""deletions"": 0, ""lines"": 228}, ""runtime/doc/autocmd.txt"": {""insertions"": 1, ""deletions"": 1, ""lines"": 2}, ""runtime/doc/builtin.txt"": {""insertions"": 10, ""deletions"": 6, ""lines"": 16}, ""runtime/doc/ft_sql.txt"": {""insertions"": 4, ""deletions"": 4, ""lines"": 8}, ""runtime/doc/gui_x11.txt"": {""insertions"": 1, ""deletions"": 1, ""lines"": 2}, ""runtime/doc/insert.txt"": {""insertions"": 9, ""deletions"": 9, ""lines"": 18}, ""runtime/doc/map.txt"": {""insertions"": 13, ""deletions"": 10, ""lines"": 23}, ""runtime/doc/options.txt"": {""insertions"": 1, ""deletions"": 1, ""lines"": 2}, ""runtime/doc/pi_netrw.txt"": {""insertions"": 1, ""deletions"": 1, ""lines"": 2}, ""runtime/doc/repeat.txt"": {""insertions"": 1, ""deletions"": 1, ""lines"": 2}, ""runtime/doc/tags"": {""insertions"": 1, ""deletions"": 0, ""lines"": 1}, ""runtime/doc/todo.txt"": {""insertions"": 19, ""deletions"": 3, ""lines"": 22}, ""runtime/doc/undo.txt"": {""insertions"": 5, ""deletions"": 5, ""lines"": 10}, ""runtime/ftplugin/bitbake.vim"": {""insertions"": 16, ""deletions"": 0, ""lines"": 16}, ""runtime/ftplugin/expect.vim"": {""insertions"": 24, ""deletions"": 0, ""lines"": 24}, ""runtime/ftplugin/html.vim"": {""insertions"": 31, ""deletions"": 29, ""lines"": 60}, ""runtime/indent/bitbake.vim"": {""insertions"": 22, ""deletions"": 0, ""lines"": 22}, ""runtime/indent/expect.vim"": {""insertions"": 11, ""deletions"": 0, ""lines"": 11}, ""runtime/indent/python.vim"": {""insertions"": 4, ""deletions"": 199, ""lines"": 203}, ""runtime/indent/testdir/bitbake.in"": {""insertions"": 19, ""deletions"": 0, ""lines"": 19}, ""runtime/indent/testdir/bitbake.ok"": {""insertions"": 19, ""deletions"": 0, ""lines"": 19}, ""runtime/pack/dist/opt/shellmenu/plugin/shellmenu.vim"": {""insertions"": 83, ""deletions"": 83, ""lines"": 166}, ""runtime/synmenu.vim"": {""insertions"": 4, ""deletions"": 0, ""lines"": 4}, ""runtime/syntax/bitbake.vim"": {""insertions"": 126, ""deletions"": 0, ""lines"": 126}, ""runtime/syntax/html.vim"": {""insertions"": 118, ""deletions"": 101, ""lines"": 219}, ""runtime/syntax/make.vim"": {""insertions"": 6, ""deletions"": 6, ""lines"": 12}}"
2022-07-25 11:28:09,cd6ad6439da2ee2d1a8a6934c9d69e9c2664ba55,zeertzjq,6,3,9,2,"{""src/evalvars.c"": {""insertions"": 4, ""deletions"": 3, ""lines"": 7}, ""src/version.c"": {""insertions"": 2, ""deletions"": 0, ""lines"": 2}}"
2022-07-24 19:48:00,509695c1c3f5c94bf4b1de5dd0fc11202804f638,Richard Purdie,34,17,51,3,"{""src/auto/configure"": {""insertions"": 20, ""deletions"": 13, ""lines"": 33}, ""src/configure.ac"": {""insertions"": 12, ""deletions"": 4, ""lines"": 16}, ""src/version.c"": {""insertions"": 2, ""deletions"": 0, ""lines"": 2}}"
2022-07-24 19:08:01,c963ec31a0c293d629e40cb082d4bfb1651def49,Bram Moolenaar,20,0,20,4,"{""src/errors.h"": {""insertions"": 4, ""deletions"": 0, ""lines"": 4}, ""src/normal.c"": {""insertions"": 5, ""deletions"": 0, ""lines"": 5}, ""src/testdir/test_cmdwin.vim"": {""insertions"": 9, ""deletions"": 0, ""lines"": 9}, ""src/version.c"": {""insertions"": 2, ""deletions"": 0, ""lines"": 2}}"
2022-07-23 08:52:04,d61efa50f8f5b9d9dcbc136705cc33874f0fdcb3,Bram Moolenaar,193,202,395,24,"{""src/autocmd.c"": {""insertions"": 9, ""deletions"": 12, ""lines"": 21}, ""src/change.c"": {""insertions"": 5, ""deletions"": 5, ""lines"": 10}, ""src/dict.c"": {""insertions"": 9, ""deletions"": 9, ""lines"": 18}, ""src/evalbuffer.c"": {""insertions"": 3, ""deletions"": 3, ""lines"": 6}, ""src/evalfunc.c"": {""insertions"": 5, ""deletions"": 6, ""lines"": 11}, ""src/evalwindow.c"": {""insertions"": 10, ""deletions"": 10, ""lines"": 20}, ""src/fileio.c"": {""insertions"": 2, ""deletions"": 2, ""lines"": 4}, ""src/filepath.c"": {""insertions"": 1, ""deletions"": 1, ""lines"": 2}, ""src/gui_w32.c"": {""insertions"": 2, ""deletions"": 2, ""lines"": 4}, ""src/highlight.c"": {""insertions"": 4, ""deletions"": 5, ""lines"": 9}, ""src/insexpand.c"": {""insertions"": 14, ""deletions"": 18, ""lines"": 32}, ""src/map.c"": {""insertions"": 15, ""deletions"": 15, ""lines"": 30}, ""src/match.c"": {""insertions"": 6, ""deletions"": 7, ""lines"": 13}, ""src/popupwin.c"": {""insertions"": 26, ""deletions"": 27, ""lines"": 53}, ""src/proto/dict.pro"": {""insertions"": 5, ""deletions"": 5, ""lines"": 10}, ""src/quickfix.c"": {""insertions"": 14, ""deletions"": 14, ""lines"": 28}, ""src/search.c"": {""insertions"": 3, ""deletions"": 2, ""lines"": 5}, ""src/sign.c"": {""insertions"": 9, ""deletions"": 9, ""lines"": 18}, ""src/tag.c"": {""insertions"": 4, ""deletions"": 5, ""lines"": 9}, ""src/terminal.c"": {""insertions"": 7, ""deletions"": 7, ""lines"": 14}, ""src/testing.c"": {""insertions"": 21, ""deletions"": 21, ""lines"": 42}, ""src/textprop.c"": {""insertions"": 16, ""deletions"": 16, ""lines"": 32}, ""src/time.c"": {""insertions"": 1, ""deletions"": 1, ""lines"": 2}, ""src/version.c"": {""insertions"": 2, ""deletions"": 0, ""lines"": 2}}"
2022-07-23 08:22:47,5ac50de83f1b4136f903c51a1d4e7d84a26c2271,Bram Moolenaar,4,2,6,2,"{""src/gui_w32.c"": {""insertions"": 2, ""deletions"": 2, ""lines"": 4}, ""src/version.c"": {""insertions"": 2, ""deletions"": 0, ""lines"": 2}}"
2022-07-23 08:06:48,5fa9f23a63651a8abdb074b4fc2ec9b1adc6b089,Bram Moolenaar,57,10,67,5,"{""src/autocmd.c"": {""insertions"": 5, ""deletions"": 1, ""lines"": 6}, ""src/proto/window.pro"": {""insertions"": 1, ""deletions"": 0, ""lines"": 1}, ""src/testdir/test_autocmd.vim"": {""insertions"": 19, ""deletions"": 0, ""lines"": 19}, ""src/version.c"": {""insertions"": 2, ""deletions"": 0, ""lines"": 2}, ""src/window.c"": {""insertions"": 30, ""deletions"": 9, ""lines"": 39}}"
2022-07-23 05:53:08,b9e717367c395490149495cf375911b5d9de889e,Bram Moolenaar,10,0,10,3,"{""src/insexpand.c"": {""insertions"": 1, ""deletions"": 0, ""lines"": 1}, ""src/testdir/test_ins_complete.vim"": {""insertions"": 7, ""deletions"": 0, ""lines"": 7}, ""src/version.c"": {""insertions"": 2, ""deletions"": 0, ""lines"": 2}}"
2022-07-23 05:25:29,bb404f5ad5ec909318bc24e5b82e4ed7b87ba8f4,zeertzjq,50,36,86,10,"{""src/getchar.c"": {""insertions"": 1, ""deletions"": 1, ""lines"": 2}, ""src/testdir/Make_all.mak"": {""insertions"": 2, ""deletions"": 1, ""lines"": 3}, ""src/testdir/test_alot.vim"": {""insertions"": 0, ""deletions"": 1, ""lines"": 1}, ""src/testdir/{test_feedkeys.vim => test_input.vim}"": {""insertions"": 25, ""deletions"": 1, ""lines"": 26}, ""src/testdir/test_options.vim"": {""insertions"": 9, ""deletions"": 1, ""lines"": 10}, ""src/testdir/test_statusline.vim"": {""insertions"": 9, ""deletions"": 6, ""lines"": 15}, ""src/testdir/test_termcodes.vim"": {""insertions"": 0, ""deletions"": 23, ""lines"": 23}, ""src/testdir/test_timers.vim"": {""insertions"": 1, ""deletions"": 1, ""lines"": 2}, ""src/version.c"": {""insertions"": 2, ""deletions"": 0, ""lines"": 2}, ""src/vim.h"": {""insertions"": 1, ""deletions"": 1, ""lines"": 2}}"
2022-07-23 04:04:16,81a3ff97e2012bdafc3ece796289f2e11e2754f3,Yegappan Lakshmanan,148,0,148,7,"{""runtime/doc/testing.txt"": {""insertions"": 10, ""deletions"": 0, ""lines"": 10}, ""src/errors.h"": {""insertions"": 2, ""deletions"": 0, ""lines"": 2}, ""src/gui_w32.c"": {""insertions"": 39, ""deletions"": 0, ""lines"": 39}, ""src/proto/gui_w32.pro"": {""insertions"": 1, ""deletions"": 0, ""lines"": 1}, ""src/testdir/test_gui.vim"": {""insertions"": 84, ""deletions"": 0, ""lines"": 84}, ""src/testing.c"": {""insertions"": 10, ""deletions"": 0, ""lines"": 10}, ""src/version.c"": {""insertions"": 2, ""deletions"": 0, ""lines"": 2}}"
2022-07-18 19:48:50,5154a8880034b7bb94186d37bcecc6ee1a96f732,Bram Moolenaar,4,1,5,3,"{""src/evalfunc.c"": {""insertions"": 1, ""deletions"": 1, ""lines"": 2}, ""src/testdir/test_expr.vim"": {""insertions"": 1, ""deletions"": 0, ""lines"": 1}, ""src/version.c"": {""insertions"": 2, ""deletions"": 0, ""lines"": 2}}"
2022-07-18 16:49:03,bd683e3a79d73e608fec0df7cee1109a27f2e70a,Bram Moolenaar,15,0,15,3,"{""src/testdir/test_vim9_func.vim"": {""insertions"": 12, ""deletions"": 0, ""lines"": 12}, ""src/version.c"": {""insertions"": 2, ""deletions"": 0, ""lines"": 2}, ""src/vim9execute.c"": {""insertions"": 1, ""deletions"": 0, ""lines"": 1}}"
2022-07-16 16:46:47,fa49eb482729a5fe7da9c9a5ed8d14f68afa55c7,Gregory Anders,63,2,65,4,"{""runtime/autoload/dist/ft.vim"": {""insertions"": 4, ""deletions"": 2, ""lines"": 6}, ""runtime/filetype.vim"": {""insertions"": 3, ""deletions"": 0, ""lines"": 3}, ""src/testdir/test_filetype.vim"": {""insertions"": 54, ""deletions"": 0, ""lines"": 54}, ""src/version.c"": {""insertions"": 2, ""deletions"": 0, ""lines"": 2}}"
2022-07-15 19:45:20,c7bd2f08e531f08723cdc677212a3633d11c9a97,Bram Moolenaar,3,1,4,2,"{""src/insexpand.c"": {""insertions"": 1, ""deletions"": 1, ""lines"": 2}, ""src/version.c"": {""insertions"": 2, ""deletions"": 0, ""lines"": 2}}"
2022-07-14 16:40:49,3a393790a4fd7a5edcafbb55cd79438b6e641714,Dominique Pelle,9,3,12,2,"{""src/testdir/test_regexp_latin.vim"": {""insertions"": 7, ""deletions"": 3, ""lines"": 10}, ""src/version.c"": {""insertions"": 2, ""deletions"": 0, ""lines"": 2}}"
2022-07-14 16:25:14,2ebcc35826bc2deb04e5fc6d73332f55783e7f52,K.Takata,17,5,22,3,"{""src/spellfile.c"": {""insertions"": 5, ""deletions"": 5, ""lines"": 10}, ""src/testdir/test_spell.vim"": {""insertions"": 10, ""deletions"": 0, ""lines"": 10}, ""src/version.c"": {""insertions"": 2, ""deletions"": 0, ""lines"": 2}}"
2022-07-14 16:06:12,f754fe6a3d5384b5146c38a32db6da9d46e00c40,zeertzjq,27,0,27,3,"{""src/ex_getln.c"": {""insertions"": 2, ""deletions"": 0, ""lines"": 2}, ""src/testdir/test_ex_mode.vim"": {""insertions"": 23, ""deletions"": 0, ""lines"": 23}, ""src/version.c"": {""insertions"": 2, ""deletions"": 0, ""lines"": 2}}"
2022-07-12 16:34:31,b26592a84c8f578c8fbe83cf02ebb47453de1683,Bram Moolenaar,3,2,5,2,"{""src/gui.c"": {""insertions"": 1, ""deletions"": 2, ""lines"": 3}, ""src/version.c"": {""insertions"": 2, ""deletions"": 0, ""lines"": 2}}"
2022-07-09 19:27:07,99af91e5820c78a196c9272cd8ce5aa5be7bf374,Leandro Lourenci,10,0,10,3,"{""runtime/filetype.vim"": {""insertions"": 6, ""deletions"": 0, ""lines"": 6}, ""src/testdir/test_filetype.vim"": {""insertions"": 2, ""deletions"": 0, ""lines"": 2}, ""src/version.c"": {""insertions"": 2, ""deletions"": 0, ""lines"": 2}}"
2022-07-09 03:56:24,b90818867c089d4987f1a48ee3666674826d6f4b,Bram Moolenaar,142,43,185,6,"{""src/drawline.c"": {""insertions"": 18, ""deletions"": 11, ""lines"": 29}, ""src/globals.h"": {""insertions"": 4, ""deletions"": 2, ""lines"": 6}, ""src/mouse.c"": {""insertions"": 50, ""deletions"": 19, ""lines"": 69}, ""src/screen.c"": {""insertions"": 48, ""deletions"": 11, ""lines"": 59}, ""src/testdir/test_conceal.vim"": {""insertions"": 20, ""deletions"": 0, ""lines"": 20}, ""src/version.c"": {""insertions"": 2, ""deletions"": 0, ""lines"": 2}}"
2022-07-07 21:31:59,fee0c4aa99eb0a7a801dade758ce5e04b48c15d1,Bram Moolenaar,15320,10221,25541,4,"{""runtime/doc/gui_x11.txt"": {""insertions"": 3, ""deletions"": 0, ""lines"": 3}, ""runtime/doc/todo.txt"": {""insertions"": 7, ""deletions"": 5, ""lines"": 12}, ""src/po/ru.cp1251.po"": {""insertions"": 7655, ""deletions"": 5108, ""lines"": 12763}, ""src/po/ru.po"": {""insertions"": 7655, ""deletions"": 5108, ""lines"": 12763}}"
2022-07-07 21:20:31,32acf1f1a72ebb9d8942b9c9d80023bf1bb668ea,Bram Moolenaar,27,5,32,4,"{""src/ex_cmds.c"": {""insertions"": 10, ""deletions"": 1, ""lines"": 11}, ""src/regexp.c"": {""insertions"": 4, ""deletions"": 4, ""lines"": 8}, ""src/testdir/test_regexp_latin.vim"": {""insertions"": 11, ""deletions"": 0, ""lines"": 11}, ""src/version.c"": {""insertions"": 2, ""deletions"": 0, ""lines"": 2}}"
2022-07-07 18:59:49,baefde14550231f6468ac2ed2ed495bc381c0c92,Bram Moolenaar,14,1,15,3,"{""src/insexpand.c"": {""insertions"": 2, ""deletions"": 1, ""lines"": 3}, ""src/testdir/test_ins_complete.vim"": {""insertions"": 10, ""deletions"": 0, ""lines"": 10}, ""src/version.c"": {""insertions"": 2, ""deletions"": 0, ""lines"": 2}}"
2022-07-07 18:42:04,caea66442d86e7bbba3bf3dc202c3c0d549b9853,Bram Moolenaar,84,28,112,3,"{""src/insexpand.c"": {""insertions"": 66, ""deletions"": 28, ""lines"": 94}, ""src/testdir/test_ins_complete.vim"": {""insertions"": 16, ""deletions"": 0, ""lines"": 16}, ""src/version.c"": {""insertions"": 2, ""deletions"": 0, ""lines"": 2}}"
2022-07-06 12:31:28,b8329db36a886355e6e9cb9986a3668fef78c438,Bram Moolenaar,9,6,15,6,"{""src/ex_docmd.c"": {""insertions"": 1, ""deletions"": 1, ""lines"": 2}, ""src/getchar.c"": {""insertions"": 3, ""deletions"": 2, ""lines"": 5}, ""src/message.c"": {""insertions"": 2, ""deletions"": 1, ""lines"": 3}, ""src/search.c"": {""insertions"": 0, ""deletions"": 1, ""lines"": 1}, ""src/textformat.c"": {""insertions"": 1, ""deletions"": 1, ""lines"": 2}, ""src/version.c"": {""insertions"": 2, ""deletions"": 0, ""lines"": 2}}"
2022-07-06 12:18:11,5ed11535e0695163cec71033b98bb97356cf0113,Bram Moolenaar,506,336,842,14,"{""runtime/doc/builtin.txt"": {""insertions"": 4, ""deletions"": 0, ""lines"": 4}, ""runtime/doc/intro.txt"": {""insertions"": 3, ""deletions"": 2, ""lines"": 5}, ""runtime/doc/map.txt"": {""insertions"": 7, ""deletions"": 5, ""lines"": 12}, ""runtime/doc/options.txt"": {""insertions"": 1, ""deletions"": 1, ""lines"": 2}, ""runtime/doc/tags"": {""insertions"": 2, ""deletions"": 0, ""lines"": 2}, ""runtime/doc/term.txt"": {""insertions"": 7, ""deletions"": 4, ""lines"": 11}, ""runtime/doc/todo.txt"": {""insertions"": 6, ""deletions"": 5, ""lines"": 11}, ""runtime/doc/vim9.txt"": {""insertions"": 62, ""deletions"": 23, ""lines"": 85}, ""runtime/filetype.vim"": {""insertions"": 1, ""deletions"": 1, ""lines"": 2}, ""runtime/ftplugin/vim.vim"": {""insertions"": 6, ""deletions"": 1, ""lines"": 7}, ""runtime/lang/menu_zh_cn.utf-8.vim"": {""insertions"": 395, ""deletions"": 282, ""lines"": 677}, ""runtime/syntax/fetchmail.vim"": {""insertions"": 2, ""deletions"": 2, ""lines"": 4}, ""runtime/syntax/sh.vim"": {""insertions"": 4, ""deletions"": 4, ""lines"": 8}, ""runtime/syntax/vim.vim"": {""insertions"": 6, ""deletions"": 6, ""lines"": 12}}"
2022-07-06 11:57:31,cf34434b5e840dda4a21cd9c0bee24e3e43a674d,zeertzjq,39,2,41,2,"{""src/testdir/test_normal.vim"": {""insertions"": 37, ""deletions"": 2, ""lines"": 39}, ""src/version.c"": {""insertions"": 2, ""deletions"": 0, ""lines"": 2}}"
2022-07-05 20:56:39,324478037923feef1eb8a771648e38ade9e5e05a,Bram Moolenaar,6,0,6,2,"{""runtime/autoload/dist/script.vim"": {""insertions"": 4, ""deletions"": 0, ""lines"": 4}, ""src/version.c"": {""insertions"": 2, ""deletions"": 0, ""lines"": 2}}"
2022-07-05 17:42:56,704988f0c3598c1b0cc47f3b46f1f1229312f2bc,smjonas,8,5,13,3,"{""runtime/filetype.vim"": {""insertions"": 2, ""deletions"": 2, ""lines"": 4}, ""src/testdir/test_filetype.vim"": {""insertions"": 4, ""deletions"": 3, ""lines"": 7}, ""src/version.c"": {""insertions"": 2, ""deletions"": 0, ""lines"": 2}}"
2022-07-04 20:03:36,b67f0c8e495cfbfc09d6c7ff670b8162faf07b01,Bram Moolenaar,66,61,127,6,"{""src/mbyte.c"": {""insertions"": 4, ""deletions"": 4, ""lines"": 8}, ""src/option.c"": {""insertions"": 6, ""deletions"": 6, ""lines"": 12}, ""src/optionstr.c"": {""insertions"": 21, ""deletions"": 34, ""lines"": 55}, ""src/proto/screen.pro"": {""insertions"": 1, ""deletions"": 1, ""lines"": 2}, ""src/screen.c"": {""insertions"": 32, ""deletions"": 16, ""lines"": 48}, ""src/version.c"": {""insertions"": 2, ""deletions"": 0, ""lines"": 2}}"
2022-07-04 18:58:17,4c99e622ddd1cc0527262fda3b93e8e70f017371,Bram Moolenaar,4,0,4,2,"{""src/gui_gtk_x11.c"": {""insertions"": 2, ""deletions"": 0, ""lines"": 2}, ""src/version.c"": {""insertions"": 2, ""deletions"": 0, ""lines"": 2}}"
2022-07-04 17:05:51,5ed26faace574f6b36744f9e17075d7e806aa877,Bram Moolenaar,12,8,20,2,"{""src/optionstr.c"": {""insertions"": 10, ""deletions"": 8, ""lines"": 18}, ""src/version.c"": {""insertions"": 2, ""deletions"": 0, ""lines"": 2}}"
2022-07-04 16:46:22,510f03738dfcadfe2099c5b6a58cb75f64dbaa82,Bram Moolenaar,4,2,6,2,"{""src/terminal.c"": {""insertions"": 2, ""deletions"": 2, ""lines"": 4}, ""src/version.c"": {""insertions"": 2, ""deletions"": 0, ""lines"": 2}}"
2022-07-04 16:34:33,96ba25ac01279f73c0ecb5d4aa4ff37aa359e5eb,Bram Moolenaar,276,143,419,19,"{""runtime/doc/options.txt"": {""insertions"": 23, ""deletions"": 21, ""lines"": 44}, ""src/drawline.c"": {""insertions"": 6, ""deletions"": 6, ""lines"": 12}, ""src/drawscreen.c"": {""insertions"": 20, ""deletions"": 14, ""lines"": 34}, ""src/globals.h"": {""insertions"": 0, ""deletions"": 11, ""lines"": 11}, ""src/mbyte.c"": {""insertions"": 22, ""deletions"": 16, ""lines"": 38}, ""src/mouse.c"": {""insertions"": 1, ""deletions"": 1, ""lines"": 2}, ""src/option.c"": {""insertions"": 40, ""deletions"": 20, ""lines"": 60}, ""src/option.h"": {""insertions"": 1, ""deletions"": 0, ""lines"": 1}, ""src/optiondefs.h"": {""insertions"": 2, ""deletions"": 1, ""lines"": 3}, ""src/optionstr.c"": {""insertions"": 25, ""deletions"": 3, ""lines"": 28}, ""src/proto/screen.pro"": {""insertions"": 2, ""deletions"": 2, ""lines"": 4}, ""src/screen.c"": {""insertions"": 58, ""deletions"": 47, ""lines"": 105}, ""src/structs.h"": {""insertions"": 19, ""deletions"": 0, ""lines"": 19}, ""src/testdir/dumps/Test_display_fillchars_1.dump"": {""insertions"": 12, ""deletions"": 0, ""lines"": 12}, ""src/testdir/dumps/Test_display_fillchars_2.dump"": {""insertions"": 12, ""deletions"": 0, ""lines"": 12}, ""src/testdir/runtest.vim"": {""insertions"": 1, ""deletions"": 1, ""lines"": 2}, ""src/testdir/screendump.vim"": {""insertions"": 2, ""deletions"": 0, ""lines"": 2}, ""src/testdir/test_display.vim"": {""insertions"": 28, ""deletions"": 0, ""lines"": 28}, ""src/version.c"": {""insertions"": 2, ""deletions"": 0, ""lines"": 2}}"
2022-07-04 12:37:07,54e5fed6d27b747ff152cdb6edfb72ff60e70939,Bram Moolenaar,17,2,19,3,"{""src/spell.c"": {""insertions"": 3, ""deletions"": 2, ""lines"": 5}, ""src/testdir/test_spell.vim"": {""insertions"": 12, ""deletions"": 0, ""lines"": 12}, ""src/version.c"": {""insertions"": 2, ""deletions"": 0, ""lines"": 2}}"
2022-07-04 10:03:07,288ed23e3929ff55a8ae30db0ba3f57b6f119dc8,zeertzjq,11,7,18,3,"{""src/testdir/test_spell.vim"": {""insertions"": 6, ""deletions"": 3, ""lines"": 9}, ""src/testdir/test_spell_utf8.vim"": {""insertions"": 3, ""deletions"": 4, ""lines"": 7}, ""src/version.c"": {""insertions"": 2, ""deletions"": 0, ""lines"": 2}}"
2022-07-04 09:47:31,4dd9252d6f0e93c9118c808bd47f407d581947a8,Anton Sharonov,28,0,28,2,"{""src/gui_gtk_x11.c"": {""insertions"": 26, ""deletions"": 0, ""lines"": 26}, ""src/version.c"": {""insertions"": 2, ""deletions"": 0, ""lines"": 2}}"
2022-07-03 13:21:09,7fe956d17650b231f173868531bc7466010687f0,Bram Moolenaar,36,0,36,5,"{""src/drawline.c"": {""insertions"": 4, ""deletions"": 0, ""lines"": 4}, ""src/testdir/dumps/Test_quickfix_cwindow_3.dump"": {""insertions"": 12, ""deletions"": 0, ""lines"": 12}, ""src/testdir/dumps/Test_quickfix_cwindow_4.dump"": {""insertions"": 12, ""deletions"": 0, ""lines"": 12}, ""src/testdir/test_quickfix.vim"": {""insertions"": 6, ""deletions"": 0, ""lines"": 6}, ""src/version.c"": {""insertions"": 2, ""deletions"": 0, ""lines"": 2}}"
2022-07-03 12:16:09,9359e8a6d99fe2abfcbb9603339f1740d8870cc6,zeertzjq,44,12,56,4,"{""runtime/doc/map.txt"": {""insertions"": 4, ""deletions"": 4, ""lines"": 8}, ""src/testdir/test_usercommands.vim"": {""insertions"": 23, ""deletions"": 6, ""lines"": 29}, ""src/usercmd.c"": {""insertions"": 15, ""deletions"": 2, ""lines"": 17}, ""src/version.c"": {""insertions"": 2, ""deletions"": 0, ""lines"": 2}}"
2022-07-02 19:48:01,22e7e867e224596bd758260e4278ce6239c35ba5,Bram Moolenaar,3,1,4,2,"{""src/testdir/test_matchfuzzy.vim"": {""insertions"": 1, ""deletions"": 1, ""lines"": 2}, ""src/version.c"": {""insertions"": 2, ""deletions"": 0, ""lines"": 2}}"
2022-07-02 16:58:23,daaca8a1281ee610a308cd6209f81a06b3ae3a14,Bram Moolenaar,4,3,7,4,"{""Filelist"": {""insertions"": 1, ""deletions"": 0, ""lines"": 1}, ""Makefile"": {""insertions"": 1, ""deletions"": 3, ""lines"": 4}, ""runtime/bitmaps/vim.ico"": {""insertions"": 0, ""deletions"": 0, ""lines"": 0}, ""src/version.c"": {""insertions"": 2, ""deletions"": 0, ""lines"": 2}}"
2022-07-02 16:36:31,022f9ef16c955d6b5fca0f53b79899c56a3966c5,Bram Moolenaar,37,21,58,3,"{""src/filepath.c"": {""insertions"": 20, ""deletions"": 20, ""lines"": 40}, ""src/misc1.c"": {""insertions"": 15, ""deletions"": 1, ""lines"": 16}, ""src/version.c"": {""insertions"": 2, ""deletions"": 0, ""lines"": 2}}"
2022-07-02 15:29:34,2d2950198231a31bf87c1cd4322099cc36b0bb93,Bram Moolenaar,364,377,741,6,"{""src/testdir/Make_all.mak"": {""insertions"": 2, ""deletions"": 0, ""lines"": 2}, ""src/testdir/test_cmdline.vim"": {""insertions"": 0, ""deletions"": 276, ""lines"": 276}, ""src/testdir/test_cmdwin.vim"": {""insertions"": 360, ""deletions"": 0, ""lines"": 360}, ""src/testdir/test_ins_complete.vim"": {""insertions"": 0, ""deletions"": 95, ""lines"": 95}, ""src/testdir/test_normal.vim"": {""insertions"": 0, ""deletions"": 6, ""lines"": 6}, ""src/version.c"": {""insertions"": 2, ""deletions"": 0, ""lines"": 2}}"
2022-07-02 14:10:00,c5274dd12224421f2430b30c53b881b9403d649e,Bram Moolenaar,24,2,26,2,"{""src/diff.c"": {""insertions"": 22, ""deletions"": 2, ""lines"": 24}, ""src/version.c"": {""insertions"": 2, ""deletions"": 0, ""lines"": 2}}"
2022-07-02 12:43:21,c6fdb15d423df22e1776844811d082322475e48a,Bram Moolenaar,14,2,16,3,"{""src/ex_docmd.c"": {""insertions"": 4, ""deletions"": 2, ""lines"": 6}, ""src/testdir/test_cmdline.vim"": {""insertions"": 8, ""deletions"": 0, ""lines"": 8}, ""src/version.c"": {""insertions"": 2, ""deletions"": 0, ""lines"": 2}}"
2022-07-02 11:08:16,af043e12d9e5869c597de40b9a2517ae97ac72e7,Bram Moolenaar,4,1,5,2,"{""src/getchar.c"": {""insertions"": 2, ""deletions"": 1, ""lines"": 3}, ""src/version.c"": {""insertions"": 2, ""deletions"": 0, ""lines"": 2}}"
2022-07-02 10:40:40,f2ce76a8c0290af35e434e38cfe889ed0fec4c6a,Bram Moolenaar,37,13,50,3,"{""src/auto/configure"": {""insertions"": 27, ""deletions"": 9, ""lines"": 36}, ""src/configure.ac"": {""insertions"": 8, ""deletions"": 4, ""lines"": 12}, ""src/version.c"": {""insertions"": 2, ""deletions"": 0, ""lines"": 2}}"
2022-07-01 21:44:19,95afae6d1760b2efcc4968dbd3784799d24e9fdf,Bram Moolenaar,8,1,9,2,"{""src/testdir/test_spell_utf8.vim"": {""insertions"": 6, ""deletions"": 1, ""lines"": 7}, ""src/version.c"": {""insertions"": 2, ""deletions"": 0, ""lines"": 2}}"
2022-07-01 21:26:20,5e59ea54c0c37c2f84770f068d95280069828774,Bram Moolenaar,36,2,38,3,"{""src/spellfile.c"": {""insertions"": 19, ""deletions"": 2, ""lines"": 21}, ""src/testdir/test_spell.vim"": {""insertions"": 15, ""deletions"": 0, ""lines"": 15}, ""src/version.c"": {""insertions"": 2, ""deletions"": 0, ""lines"": 2}}"
2022-07-01 18:58:30,f12129f1714f7d2301935bb21d896609bdac221c,Bram Moolenaar,22,2,24,3,"{""src/insexpand.c"": {""insertions"": 12, ""deletions"": 2, ""lines"": 14}, ""src/testdir/test_ins_complete.vim"": {""insertions"": 8, ""deletions"": 0, ""lines"": 8}, ""src/version.c"": {""insertions"": 2, ""deletions"": 0, ""lines"": 2}}"
2022-07-01 18:11:23,eb273cd7b036c35ae9070bd6352101914f273e71,zeertzjq,6,3,9,2,"{""src/testdir/test_timers.vim"": {""insertions"": 4, ""deletions"": 3, ""lines"": 7}, ""src/version.c"": {""insertions"": 2, ""deletions"": 0, ""lines"": 2}}"
2022-07-01 17:45:04,0d878b95d8f9ece2fdba81050f5caba224540f9c,Bram Moolenaar,869,294,1163,20,"{"".github/CODEOWNERS"": {""insertions"": 3, ""deletions"": 0, ""lines"": 3}, ""Filelist"": {""insertions"": 1, ""deletions"": 1, ""lines"": 2}, ""README.md"": {""insertions"": 1, ""deletions"": 1, ""lines"": 2}, ""runtime/autoload/freebasic.vim"": {""insertions"": 3, ""deletions"": 4, ""lines"": 7}, ""runtime/doc/filetype.txt"": {""insertions"": 19, ""deletions"": 0, ""lines"": 19}, ""runtime/doc/quickfix.txt"": {""insertions"": 3, ""deletions"": 0, ""lines"": 3}, ""runtime/doc/syntax.txt"": {""insertions"": 15, ""deletions"": 0, ""lines"": 15}, ""runtime/doc/tags"": {""insertions"": 17, ""deletions"": 0, ""lines"": 17}, ""runtime/doc/todo.txt"": {""insertions"": 10, ""deletions"": 12, ""lines"": 22}, ""runtime/doc/xxd.man"": {""insertions"": 15, ""deletions"": 11, ""lines"": 26}, ""runtime/ftplugin/basic.vim"": {""insertions"": 7, ""deletions"": 6, ""lines"": 13}, ""runtime/ftplugin/fetchmail.vim"": {""insertions"": 6, ""deletions"": 9, ""lines"": 15}, ""runtime/ftplugin/freebasic.vim"": {""insertions"": 24, ""deletions"": 8, ""lines"": 32}, ""runtime/ftplugin/vue.vim"": {""insertions"": 24, ""deletions"": 0, ""lines"": 24}, ""runtime/pack/dist/opt/cfilter/plugin/cfilter.vim"": {""insertions"": 65, ""deletions"": 55, ""lines"": 120}, ""runtime/spell/sr/README_sr.txt"": {""insertions"": 14, ""deletions"": 0, ""lines"": 14}, ""runtime/spell/sr/convert.vim"": {""insertions"": 30, ""deletions"": 0, ""lines"": 30}, ""runtime/syntax/basic.vim"": {""insertions"": 2, ""deletions"": 2, ""lines"": 4}, ""runtime/syntax/fetchmail.vim"": {""insertions"": 59, ""deletions"": 51, ""lines"": 110}, ""runtime/syntax/freebasic.vim"": {""insertions"": 551, ""deletions"": 134, ""lines"": 685}}"
2022-07-01 15:35:45,27efc62f5d86afcb2ecb7565587fe8dea4b036fe,Bram Moolenaar,13,0,13,3,"{""src/term.c"": {""insertions"": 1, ""deletions"": 0, ""lines"": 1}, ""src/testdir/test_mapping.vim"": {""insertions"": 10, ""deletions"": 0, ""lines"": 10}, ""src/version.c"": {""insertions"": 2, ""deletions"": 0, ""lines"": 2}}"
2022-07-01 14:26:15,3d51ce18ab1be4f9f6061568a4e7fabf00b21794,Bram Moolenaar,16,0,16,3,"{""src/testdir/test_visual.vim"": {""insertions"": 12, ""deletions"": 0, ""lines"": 12}, ""src/version.c"": {""insertions"": 2, ""deletions"": 0, ""lines"": 2}, ""src/window.c"": {""insertions"": 2, ""deletions"": 0, ""lines"": 2}}"
2022-07-01 12:15:35,c2a79b87fc31080ba24394c0b30bab45f1bea852,Bram Moolenaar,17,18,35,3,"{""src/indent.c"": {""insertions"": 14, ""deletions"": 6, ""lines"": 20}, ""src/testdir/test_breakindent.vim"": {""insertions"": 1, ""deletions"": 12, ""lines"": 13}, ""src/version.c"": {""insertions"": 2, ""deletions"": 0, ""lines"": 2}}"
2022-07-01 11:13:15,79ae152697ed0dfa578cfac305d05021dec2a6bc,zeertzjq,5,3,8,3,"{""src/alloc.c"": {""insertions"": 1, ""deletions"": 0, ""lines"": 1}, ""src/menu.c"": {""insertions"": 2, ""deletions"": 3, ""lines"": 5}, ""src/version.c"": {""insertions"": 2, ""deletions"": 0, ""lines"": 2}}"
2022-06-30 21:28:08,9610f94510220c783328e1857af87a6ae7bc20b4,Bram Moolenaar,5,0,5,2,"{""src/testing.c"": {""insertions"": 3, ""deletions"": 0, ""lines"": 3}, ""src/version.c"": {""insertions"": 2, ""deletions"": 0, ""lines"": 2}}"
2022-06-30 21:13:59,fa4873ccfc10e0f278dc46f39d00136fab059b19,Bram Moolenaar,119,33,152,15,"{""runtime/doc/testing.txt"": {""insertions"": 5, ""deletions"": 1, ""lines"": 6}, ""src/change.c"": {""insertions"": 5, ""deletions"": 1, ""lines"": 6}, ""src/cindent.c"": {""insertions"": 13, ""deletions"": 7, ""lines"": 20}, ""src/edit.c"": {""insertions"": 2, ""deletions"": 2, ""lines"": 4}, ""src/globals.h"": {""insertions"": 1, ""deletions"": 0, ""lines"": 1}, ""src/memline.c"": {""insertions"": 37, ""deletions"": 6, ""lines"": 43}, ""src/netbeans.c"": {""insertions"": 5, ""deletions"": 3, ""lines"": 8}, ""src/normal.c"": {""insertions"": 2, ""deletions"": 0, ""lines"": 2}, ""src/ops.c"": {""insertions"": 6, ""deletions"": 0, ""lines"": 6}, ""src/structs.h"": {""insertions"": 5, ""deletions"": 4, ""lines"": 9}, ""src/testdir/runtest.vim"": {""insertions"": 5, ""deletions"": 1, ""lines"": 6}, ""src/testdir/test_breakindent.vim"": {""insertions"": 15, ""deletions"": 4, ""lines"": 19}, ""src/testdir/test_edit.vim"": {""insertions"": 3, ""deletions"": 0, ""lines"": 3}, ""src/textprop.c"": {""insertions"": 13, ""deletions"": 4, ""lines"": 17}, ""src/version.c"": {""insertions"": 2, ""deletions"": 0, ""lines"": 2}}"
2022-06-30 15:25:21,cdbfc6dbab1d63aa56af316d6b13e37939e7f7a8,Bram Moolenaar,82,4,86,5,"{""runtime/autoload/dist/ft.vim"": {""insertions"": 22, ""deletions"": 1, ""lines"": 23}, ""runtime/doc/filetype.txt"": {""insertions"": 1, ""deletions"": 0, ""lines"": 1}, ""runtime/filetype.vim"": {""insertions"": 2, ""deletions"": 2, ""lines"": 4}, ""src/testdir/test_filetype.vim"": {""insertions"": 55, ""deletions"": 1, ""lines"": 56}, ""src/version.c"": {""insertions"": 2, ""deletions"": 0, ""lines"": 2}}"
2022-06-30 11:30:19,d25f003342aca9889067f2e839963dfeccf1fe05,Bram Moolenaar,16,0,16,3,"{""src/register.c"": {""insertions"": 2, ""deletions"": 0, ""lines"": 2}, ""src/testdir/test_put.vim"": {""insertions"": 12, ""deletions"": 0, ""lines"": 12}, ""src/version.c"": {""insertions"": 2, ""deletions"": 0, ""lines"": 2}}"
2022-06-30 10:03:39,b0375d466e5ca57dca71995c342870b3226d8115,Bram Moolenaar,8,1,9,2,"{""src/testdir/test_functions.vim"": {""insertions"": 3, ""deletions"": 0, ""lines"": 3}, ""src/version.c"": {""insertions"": 5, ""deletions"": 1, ""lines"": 6}}"
2022-06-29 20:16:58,083692d598139228e101b8c521aaef7bcf256e9a,Bram Moolenaar,17,2,19,3,"{""src/message.c"": {""insertions"": 2, ""deletions"": 2, ""lines"": 4}, ""src/testdir/test_menu.vim"": {""insertions"": 13, ""deletions"": 0, ""lines"": 13}, ""src/version.c"": {""insertions"": 2, ""deletions"": 0, ""lines"": 2}}"
2022-06-29 19:24:49,83e11800cc3775de3135ac7d823137c8c1e87fa1,David Gow,79,6,85,4,"{""runtime/doc/xxd.1"": {""insertions"": 4, ""deletions"": 0, ""lines"": 4}, ""src/testdir/test_xxd.vim"": {""insertions"": 47, ""deletions"": 0, ""lines"": 47}, ""src/version.c"": {""insertions"": 2, ""deletions"": 0, ""lines"": 2}, ""src/xxd/xxd.c"": {""insertions"": 26, ""deletions"": 6, ""lines"": 32}}"
2022-06-29 17:39:11,84f546363068e4ddfe14a8a2a2322bb8d3a25417,Bram Moolenaar,137,35,172,16,"{""runtime/doc/options.txt"": {""insertions"": 4, ""deletions"": 1, ""lines"": 5}, ""runtime/doc/syntax.txt"": {""insertions"": 18, ""deletions"": 2, ""lines"": 20}, ""runtime/doc/term.txt"": {""insertions"": 5, ""deletions"": 2, ""lines"": 7}, ""src/evalfunc.c"": {""insertions"": 19, ""deletions"": 6, ""lines"": 25}, ""src/gui.c"": {""insertions"": 2, ""deletions"": 0, ""lines"": 2}, ""src/hardcopy.c"": {""insertions"": 1, ""deletions"": 0, ""lines"": 1}, ""src/highlight.c"": {""insertions"": 23, ""deletions"": 10, ""lines"": 33}, ""src/optiondefs.h"": {""insertions"": 4, ""deletions"": 1, ""lines"": 5}, ""src/screen.c"": {""insertions"": 17, ""deletions"": 5, ""lines"": 22}, ""src/term.c"": {""insertions"": 4, ""deletions"": 0, ""lines"": 4}, ""src/termdefs.h"": {""insertions"": 6, ""deletions"": 0, ""lines"": 6}, ""src/testdir/test_highlight.vim"": {""insertions"": 6, ""deletions"": 4, ""lines"": 10}, ""src/testdir/test_options.vim"": {""insertions"": 12, ""deletions"": 0, ""lines"": 12}, ""src/testdir/test_syn_attr.vim"": {""insertions"": 7, ""deletions"": 0, ""lines"": 7}, ""src/version.c"": {""insertions"": 2, ""deletions"": 0, ""lines"": 2}, ""src/vim.h"": {""insertions"": 7, ""deletions"": 4, ""lines"": 11}}"
2022-06-29 13:39:12,8b5901e2f9466eb6f38f5b251e871f609f65e252,Bram Moolenaar,90,22,112,5,"{""runtime/autoload/dist/ft.vim"": {""insertions"": 42, ""deletions"": 12, ""lines"": 54}, ""runtime/doc/filetype.txt"": {""insertions"": 1, ""deletions"": 0, ""lines"": 1}, ""runtime/filetype.vim"": {""insertions"": 4, ""deletions"": 9, ""lines"": 13}, ""src/testdir/test_filetype.vim"": {""insertions"": 41, ""deletions"": 1, ""lines"": 42}, ""src/version.c"": {""insertions"": 2, ""deletions"": 0, ""lines"": 2}}"
2022-06-29 12:48:49,040674129f3382822eeb7b590380efa5228124a8,Hugo Osvaldo Barrera,6,0,6,3,"{""runtime/filetype.vim"": {""insertions"": 3, ""deletions"": 0, ""lines"": 3}, ""src/testdir/test_filetype.vim"": {""insertions"": 1, ""deletions"": 0, ""lines"": 1}, ""src/version.c"": {""insertions"": 2, ""deletions"": 0, ""lines"": 2}}"
2022-06-29 12:18:27,d14bb1aef9a142f403aa16298c23db2751de9391,Matvey Tarasov,10,16,26,2,"{""src/version.c"": {""insertions"": 2, ""deletions"": 0, ""lines"": 2}, ""src/vim9execute.c"": {""insertions"": 8, ""deletions"": 16, ""lines"": 24}}"
2022-06-29 11:55:36,ee47eaceaa148e07b566ff420f9a3c2edde2fa34,Yegappan Lakshmanan,40,20,60,16,"{""src/crypt.c"": {""insertions"": 7, ""deletions"": 3, ""lines"": 10}, ""src/evalvars.c"": {""insertions"": 1, ""deletions"": 1, ""lines"": 2}, ""src/gui.c"": {""insertions"": 3, ""deletions"": 2, ""lines"": 5}, ""src/highlight.c"": {""insertions"": 1, ""deletions"": 1, ""lines"": 2}, ""src/proto/crypt.pro"": {""insertions"": 0, ""deletions"": 3, ""lines"": 3}, ""src/proto/evalvars.pro"": {""insertions"": 0, ""deletions"": 1, ""lines"": 1}, ""src/proto/gui.pro"": {""insertions"": 0, ""deletions"": 2, ""lines"": 2}, ""src/proto/highlight.pro"": {""insertions"": 0, ""deletions"": 1, ""lines"": 1}, ""src/proto/scriptfile.pro"": {""insertions"": 0, ""deletions"": 1, ""lines"": 1}, ""src/proto/userfunc.pro"": {""insertions"": 0, ""deletions"": 1, ""lines"": 1}, ""src/scriptfile.c"": {""insertions"": 1, ""deletions"": 1, ""lines"": 2}, ""src/testdir/test_fold.vim"": {""insertions"": 2, ""deletions"": 0, ""lines"": 2}, ""src/testdir/test_quickfix.vim"": {""insertions"": 5, ""deletions"": 2, ""lines"": 7}, ""src/testdir/test_vim9_builtin.vim"": {""insertions"": 16, ""deletions"": 0, ""lines"": 16}, ""src/userfunc.c"": {""insertions"": 2, ""deletions"": 1, ""lines"": 3}, ""src/version.c"": {""insertions"": 2, ""deletions"": 0, ""lines"": 2}}"
2022-06-29 09:37:40,c207fd2535717030d78f9b92839e5f2ac004cc78,zeertzjq,45,43,88,5,"{""src/buffer.c"": {""insertions"": 2, ""deletions"": 2, ""lines"": 4}, ""src/evalfunc.c"": {""insertions"": 0, ""deletions"": 35, ""lines"": 35}, ""src/map.c"": {""insertions"": 39, ""deletions"": 5, ""lines"": 44}, ""src/proto/map.pro"": {""insertions"": 2, ""deletions"": 1, ""lines"": 3}, ""src/version.c"": {""insertions"": 2, ""deletions"": 0, ""lines"": 2}}"
2022-06-28 19:07:42,75417d960bd17a5b701cfb625b8864dacaf0cc39,Bram Moolenaar,2,288,290,2,"{"".travis.yml"": {""insertions"": 0, ""deletions"": 288, ""lines"": 288}, ""src/version.c"": {""insertions"": 2, ""deletions"": 0, ""lines"": 2}}"
2022-06-28 12:44:46,eb49041875118be5fe60f07750c7c86cb26dccef,Bram Moolenaar,256,10578,10834,174,"{""Filelist"": {""insertions"": 0, ""deletions"": 1, ""lines"": 1}, ""Makefile"": {""insertions"": 5, ""deletions"": 5, ""lines"": 10}, ""README.md"": {""insertions"": 1, ""deletions"": 1, ""lines"": 2}, ""README.txt"": {""insertions"": 1, ""deletions"": 1, ""lines"": 2}, ""READMEdir/Contents"": {""insertions"": 5, ""deletions"": 5, ""lines"": 10}, ""READMEdir/README_ami.txt"": {""insertions"": 3, ""deletions"": 3, ""lines"": 6}, ""READMEdir/README_amibin.txt"": {""insertions"": 2, ""deletions"": 2, ""lines"": 4}, ""READMEdir/README_amisrc.txt"": {""insertions"": 2, ""deletions"": 2, ""lines"": 4}, ""READMEdir/README_bindos.txt"": {""insertions"": 7, ""deletions"": 7, ""lines"": 14}, ""READMEdir/README_dos.txt"": {""insertions"": 18, ""deletions"": 18, ""lines"": 36}, ""READMEdir/README_extra.txt"": {""insertions"": 1, ""deletions"": 1, ""lines"": 2}, ""READMEdir/README_haiku.txt"": {""insertions"": 1, ""deletions"": 1, ""lines"": 2}, ""READMEdir/README_mac.txt"": {""insertions"": 1, ""deletions"": 1, ""lines"": 2}, ""READMEdir/README_ole.txt"": {""insertions"": 1, ""deletions"": 1, ""lines"": 2}, ""READMEdir/README_os2.txt"": {""insertions"": 1, ""deletions"": 1, ""lines"": 2}, ""READMEdir/README_os390.txt"": {""insertions"": 1, ""deletions"": 1, ""lines"": 2}, ""READMEdir/README_src.txt"": {""insertions"": 2, ""deletions"": 2, ""lines"": 4}, ""READMEdir/README_srcdos.txt"": {""insertions"": 2, ""deletions"": 2, ""lines"": 4}, ""READMEdir/README_unix.txt"": {""insertions"": 1, ""deletions"": 1, ""lines"": 2}, ""READMEdir/README_vms.txt"": {""insertions"": 1, ""deletions"": 1, ""lines"": 2}, ""READMEdir/README_w32s.txt"": {""insertions"": 1, ""deletions"": 1, ""lines"": 2}, ""nsis/gvim_version.nsh"": {""insertions"": 2, ""deletions"": 2, ""lines"": 4}, ""runtime/bitmaps/vim.ico"": {""insertions"": 0, ""deletions"": 0, ""lines"": 0}, ""runtime/doc/arabic.txt"": {""insertions"": 1, ""deletions"": 1, ""lines"": 2}, ""runtime/doc/autocmd.txt"": {""insertions"": 1, ""deletions"": 1, ""lines"": 2}, ""runtime/doc/builtin.txt"": {""insertions"": 2, ""deletions"": 2, ""lines"": 4}, ""runtime/doc/change.txt"": {""insertions"": 1, ""deletions"": 1, ""lines"": 2}, ""runtime/doc/channel.txt"": {""insertions"": 1, ""deletions"": 1, ""lines"": 2}, ""runtime/doc/cmdline.txt"": {""insertions"": 1, ""deletions"": 1, ""lines"": 2}, ""runtime/doc/debug.txt"": {""insertions"": 1, ""deletions"": 1, ""lines"": 2}, ""runtime/doc/debugger.txt"": {""insertions"": 1, ""deletions"": 1, ""lines"": 2}, ""runtime/doc/develop.txt"": {""insertions"": 1, ""deletions"": 1, ""lines"": 2}, ""runtime/doc/diff.txt"": {""insertions"": 1, ""deletions"": 1, ""lines"": 2}, ""runtime/doc/digraph.txt"": {""insertions"": 1, ""deletions"": 1, ""lines"": 2}, ""runtime/doc/editing.txt"": {""insertions"": 1, ""deletions"": 1, ""lines"": 2}, ""runtime/doc/eval.txt"": {""insertions"": 1, ""deletions"": 1, ""lines"": 2}, ""runtime/doc/farsi.txt"": {""insertions"": 1, ""deletions"": 1, ""lines"": 2}, ""runtime/doc/filetype.txt"": {""insertions"": 1, ""deletions"": 1, ""lines"": 2}, ""runtime/doc/fold.txt"": {""insertions"": 1, ""deletions"": 1, ""lines"": 2}, ""runtime/doc/ft_ada.txt"": {""insertions"": 1, ""deletions"": 1, ""lines"": 2}, ""runtime/doc/ft_rust.txt"": {""insertions"": 1, ""deletions"": 1, ""lines"": 2}, ""runtime/doc/ft_sql.txt"": {""insertions"": 1, ""deletions"": 1, ""lines"": 2}, ""runtime/doc/gui.txt"": {""insertions"": 1, ""deletions"": 1, ""lines"": 2}, ""runtime/doc/gui_w32.txt"": {""insertions"": 1, ""deletions"": 1, ""lines"": 2}, ""runtime/doc/gui_x11.txt"": {""insertions"": 1, ""deletions"": 1, ""lines"": 2}, ""runtime/doc/hangulin.txt"": {""insertions"": 1, ""deletions"": 1, ""lines"": 2}, ""runtime/doc/hebrew.txt"": {""insertions"": 1, ""deletions"": 1, ""lines"": 2}, ""runtime/doc/help.txt"": {""insertions"": 1, ""deletions"": 1, ""lines"": 2}, ""runtime/doc/helphelp.txt"": {""insertions"": 1, ""deletions"": 1, ""lines"": 2}, ""runtime/doc/howto.txt"": {""insertions"": 1, ""deletions"": 1, ""lines"": 2}, ""runtime/doc/if_cscop.txt"": {""insertions"": 1, ""deletions"": 1, ""lines"": 2}, ""runtime/doc/if_lua.txt"": {""insertions"": 1, ""deletions"": 1, ""lines"": 2}, ""runtime/doc/if_mzsch.txt"": {""insertions"": 1, ""deletions"": 1, ""lines"": 2}, ""runtime/doc/if_ole.txt"": {""insertions"": 1, ""deletions"": 1, ""lines"": 2}, ""runtime/doc/if_perl.txt"": {""insertions"": 1, ""deletions"": 1, ""lines"": 2}, ""runtime/doc/if_pyth.txt"": {""insertions"": 1, ""deletions"": 1, ""lines"": 2}, ""runtime/doc/if_ruby.txt"": {""insertions"": 1, ""deletions"": 1, ""lines"": 2}, ""runtime/doc/if_sniff.txt"": {""insertions"": 1, ""deletions"": 1, ""lines"": 2}, ""runtime/doc/if_tcl.txt"": {""insertions"": 1, ""deletions"": 1, ""lines"": 2}, ""runtime/doc/indent.txt"": {""insertions"": 1, ""deletions"": 1, ""lines"": 2}, ""runtime/doc/index.txt"": {""insertions"": 1, ""deletions"": 1, ""lines"": 2}, ""runtime/doc/insert.txt"": {""insertions"": 1, ""deletions"": 1, ""lines"": 2}, ""runtime/doc/intro.txt"": {""insertions"": 1, ""deletions"": 1, ""lines"": 2}, ""runtime/doc/map.txt"": {""insertions"": 1, ""deletions"": 1, ""lines"": 2}, ""runtime/doc/mbyte.txt"": {""insertions"": 1, ""deletions"": 1, ""lines"": 2}, ""runtime/doc/message.txt"": {""insertions"": 1, ""deletions"": 1, ""lines"": 2}, ""runtime/doc/mlang.txt"": {""insertions"": 1, ""deletions"": 1, ""lines"": 2}, ""runtime/doc/motion.txt"": {""insertions"": 1, ""deletions"": 1, ""lines"": 2}, ""runtime/doc/netbeans.txt"": {""insertions"": 1, ""deletions"": 1, ""lines"": 2}, ""runtime/doc/options.txt"": {""insertions"": 1, ""deletions"": 1, ""lines"": 2}, ""runtime/doc/os_390.txt"": {""insertions"": 1, ""deletions"": 1, ""lines"": 2}, ""runtime/doc/os_amiga.txt"": {""insertions"": 1, ""deletions"": 1, ""lines"": 2}, ""runtime/doc/os_beos.txt"": {""insertions"": 1, ""deletions"": 1, ""lines"": 2}, ""runtime/doc/os_dos.txt"": {""insertions"": 1, ""deletions"": 1, ""lines"": 2}, ""runtime/doc/os_haiku.txt"": {""insertions"": 1, ""deletions"": 1, ""lines"": 2}, ""runtime/doc/os_mac.txt"": {""insertions"": 1, ""deletions"": 1, ""lines"": 2}, ""runtime/doc/os_mint.txt"": {""insertions"": 1, ""deletions"": 1, ""lines"": 2}, ""runtime/doc/os_msdos.txt"": {""insertions"": 1, ""deletions"": 1, ""lines"": 2}, ""runtime/doc/os_os2.txt"": {""insertions"": 1, ""deletions"": 1, ""lines"": 2}, ""runtime/doc/os_qnx.txt"": {""insertions"": 1, ""deletions"": 1, ""lines"": 2}, ""runtime/doc/os_risc.txt"": {""insertions"": 1, ""deletions"": 1, ""lines"": 2}, ""runtime/doc/os_unix.txt"": {""insertions"": 1, ""deletions"": 1, ""lines"": 2}, ""runtime/doc/os_vms.txt"": {""insertions"": 1, ""deletions"": 1, ""lines"": 2}, ""runtime/doc/os_win32.txt"": {""insertions"": 1, ""deletions"": 1, ""lines"": 2}, ""runtime/doc/pattern.txt"": {""insertions"": 1, ""deletions"": 1, ""lines"": 2}, ""runtime/doc/pi_getscript.txt"": {""insertions"": 1, ""deletions"": 1, ""lines"": 2}, ""runtime/doc/pi_gzip.txt"": {""insertions"": 1, ""deletions"": 1, ""lines"": 2}, ""runtime/doc/pi_netrw.txt"": {""insertions"": 1, ""deletions"": 1, ""lines"": 2}, ""runtime/doc/pi_paren.txt"": {""insertions"": 1, ""deletions"": 1, ""lines"": 2}, ""runtime/doc/pi_spec.txt"": {""insertions"": 1, ""deletions"": 1, ""lines"": 2}, ""runtime/doc/pi_tar.txt"": {""insertions"": 1, ""deletions"": 1, ""lines"": 2}, ""runtime/doc/pi_vimball.txt"": {""insertions"": 1, ""deletions"": 1, ""lines"": 2}, ""runtime/doc/pi_zip.txt"": {""insertions"": 1, ""deletions"": 1, ""lines"": 2}, ""runtime/doc/popup.txt"": {""insertions"": 1, ""deletions"": 1, ""lines"": 2}, ""runtime/doc/print.txt"": {""insertions"": 1, ""deletions"": 1, ""lines"": 2}, ""runtime/doc/quickfix.txt"": {""insertions"": 1, ""deletions"": 1, ""lines"": 2}, ""runtime/doc/quickref.txt"": {""insertions"": 1, ""deletions"": 1, ""lines"": 2}, ""runtime/doc/quotes.txt"": {""insertions"": 1, ""deletions"": 1, ""lines"": 2}, ""runtime/doc/recover.txt"": {""insertions"": 1, ""deletions"": 1, ""lines"": 2}, ""runtime/doc/remote.txt"": {""insertions"": 1, ""deletions"": 1, ""lines"": 2}, ""runtime/doc/repeat.txt"": {""insertions"": 1, ""deletions"": 1, ""lines"": 2}, ""runtime/doc/rileft.txt"": {""insertions"": 1, ""deletions"": 1, ""lines"": 2}, ""runtime/doc/russian.txt"": {""insertions"": 1, ""deletions"": 1, ""lines"": 2}, ""runtime/doc/scroll.txt"": {""insertions"": 1, ""deletions"": 1, ""lines"": 2}, ""runtime/doc/sign.txt"": {""insertions"": 1, ""deletions"": 1, ""lines"": 2}, ""runtime/doc/spell.txt"": {""insertions"": 1, ""deletions"": 1, ""lines"": 2}, ""runtime/doc/sponsor.txt"": {""insertions"": 1, ""deletions"": 1, ""lines"": 2}, ""runtime/doc/starting.txt"": {""insertions"": 1, ""deletions"": 1, ""lines"": 2}, ""runtime/doc/syntax.txt"": {""insertions"": 1, ""deletions"": 1, ""lines"": 2}, ""runtime/doc/tabpage.txt"": {""insertions"": 1, ""deletions"": 1, ""lines"": 2}, ""runtime/doc/tagsrch.txt"": {""insertions"": 1, ""deletions"": 1, ""lines"": 2}, ""runtime/doc/term.txt"": {""insertions"": 1, ""deletions"": 1, ""lines"": 2}, ""runtime/doc/terminal.txt"": {""insertions"": 1, ""deletions"": 1, ""lines"": 2}, ""runtime/doc/testing.txt"": {""insertions"": 1, ""deletions"": 1, ""lines"": 2}, ""runtime/doc/textprop.txt"": {""insertions"": 1, ""deletions"": 1, ""lines"": 2}, ""runtime/doc/tips.txt"": {""insertions"": 1, ""deletions"": 1, ""lines"": 2}, ""runtime/doc/todo.txt"": {""insertions"": 1, ""deletions"": 1, ""lines"": 2}, ""runtime/doc/uganda.txt"": {""insertions"": 1, ""deletions"": 1, ""lines"": 2}, ""runtime/doc/undo.txt"": {""insertions"": 1, ""deletions"": 1, ""lines"": 2}, ""runtime/doc/usr_01.txt"": {""insertions"": 1, ""deletions"": 1, ""lines"": 2}, ""runtime/doc/usr_02.txt"": {""insertions"": 1, ""deletions"": 1, ""lines"": 2}, ""runtime/doc/usr_03.txt"": {""insertions"": 1, ""deletions"": 1, ""lines"": 2}, ""runtime/doc/usr_04.txt"": {""insertions"": 1, ""deletions"": 1, ""lines"": 2}, ""runtime/doc/usr_05.txt"": {""insertions"": 1, ""deletions"": 1, ""lines"": 2}, ""runtime/doc/usr_06.txt"": {""insertions"": 1, ""deletions"": 1, ""lines"": 2}, ""runtime/doc/usr_07.txt"": {""insertions"": 1, ""deletions"": 1, ""lines"": 2}, ""runtime/doc/usr_08.txt"": {""insertions"": 1, ""deletions"": 1, ""lines"": 2}, ""runtime/doc/usr_09.txt"": {""insertions"": 1, ""deletions"": 1, ""lines"": 2}, ""runtime/doc/usr_10.txt"": {""insertions"": 1, ""deletions"": 1, ""lines"": 2}, ""runtime/doc/usr_11.txt"": {""insertions"": 1, ""deletions"": 1, ""lines"": 2}, ""runtime/doc/usr_12.txt"": {""insertions"": 1, ""deletions"": 1, ""lines"": 2}, ""runtime/doc/usr_20.txt"": {""insertions"": 1, ""deletions"": 1, ""lines"": 2}, ""runtime/doc/usr_21.txt"": {""insertions"": 1, ""deletions"": 1, ""lines"": 2}, ""runtime/doc/usr_22.txt"": {""insertions"": 1, ""deletions"": 1, ""lines"": 2}, ""runtime/doc/usr_23.txt"": {""insertions"": 1, ""deletions"": 1, ""lines"": 2}, ""runtime/doc/usr_24.txt"": {""insertions"": 1, ""deletions"": 1, ""lines"": 2}, ""runtime/doc/usr_25.txt"": {""insertions"": 1, ""deletions"": 1, ""lines"": 2}, ""runtime/doc/usr_26.txt"": {""insertions"": 1, ""deletions"": 1, ""lines"": 2}, ""runtime/doc/usr_27.txt"": {""insertions"": 1, ""deletions"": 1, ""lines"": 2}, ""runtime/doc/usr_28.txt"": {""insertions"": 1, ""deletions"": 1, ""lines"": 2}, ""runtime/doc/usr_29.txt"": {""insertions"": 1, ""deletions"": 1, ""lines"": 2}, ""runtime/doc/usr_30.txt"": {""insertions"": 1, ""deletions"": 1, ""lines"": 2}, ""runtime/doc/usr_31.txt"": {""insertions"": 1, ""deletions"": 1, ""lines"": 2}, ""runtime/doc/usr_32.txt"": {""insertions"": 1, ""deletions"": 1, ""lines"": 2}, ""runtime/doc/usr_40.txt"": {""insertions"": 1, ""deletions"": 1, ""lines"": 2}, ""runtime/doc/usr_41.txt"": {""insertions"": 1, ""deletions"": 1, ""lines"": 2}, ""runtime/doc/usr_42.txt"": {""insertions"": 1, ""deletions"": 1, ""lines"": 2}, ""runtime/doc/usr_43.txt"": {""insertions"": 1, ""deletions"": 1, ""lines"": 2}, ""runtime/doc/usr_44.txt"": {""insertions"": 1, ""deletions"": 1, ""lines"": 2}, ""runtime/doc/usr_45.txt"": {""insertions"": 1, ""deletions"": 1, ""lines"": 2}, ""runtime/doc/usr_50.txt"": {""insertions"": 1, ""deletions"": 1, ""lines"": 2}, ""runtime/doc/usr_51.txt"": {""insertions"": 1, ""deletions"": 1, ""lines"": 2}, ""runtime/doc/usr_52.txt"": {""insertions"": 1, ""deletions"": 1, ""lines"": 2}, ""runtime/doc/usr_90.txt"": {""insertions"": 1, ""deletions"": 1, ""lines"": 2}, ""runtime/doc/usr_toc.txt"": {""insertions"": 1, ""deletions"": 1, ""lines"": 2}, ""runtime/doc/various.txt"": {""insertions"": 1, ""deletions"": 1, ""lines"": 2}, ""runtime/doc/version4.txt"": {""insertions"": 1, ""deletions"": 1, ""lines"": 2}, ""runtime/doc/version5.txt"": {""insertions"": 1, ""deletions"": 1, ""lines"": 2}, ""runtime/doc/version6.txt"": {""insertions"": 1, ""deletions"": 1, ""lines"": 2}, ""runtime/doc/version7.txt"": {""insertions"": 1, ""deletions"": 1, ""lines"": 2}, ""runtime/doc/version8.txt"": {""insertions"": 1, ""deletions"": 1, ""lines"": 2}, ""runtime/doc/version9.txt"": {""insertions"": 27, ""deletions"": 6, ""lines"": 33}, ""runtime/doc/vi_diff.txt"": {""insertions"": 1, ""deletions"": 1, ""lines"": 2}, ""runtime/doc/vim9.txt"": {""insertions"": 1, ""deletions"": 1, ""lines"": 2}, ""runtime/doc/visual.txt"": {""insertions"": 1, ""deletions"": 1, ""lines"": 2}, ""runtime/doc/windows.txt"": {""insertions"": 1, ""deletions"": 1, ""lines"": 2}, ""runtime/doc/workshop.txt"": {""insertions"": 1, ""deletions"": 1, ""lines"": 2}, ""runtime/spell/sr/README_sr.txt"": {""insertions"": 15, ""deletions"": 13, ""lines"": 28}, ""src/GvimExt/GvimExt.reg"": {""insertions"": 2, ""deletions"": 2, ""lines"": 4}, ""src/Makefile"": {""insertions"": 2, ""deletions"": 2, ""lines"": 4}, ""src/README.md"": {""insertions"": 1, ""deletions"": 1, ""lines"": 2}, ""src/version.c"": {""insertions"": 0, ""deletions"": 10344, ""lines"": 10344}, ""src/version.h"": {""insertions"": 5, ""deletions"": 5, ""lines"": 10}, ""src/vim.manifest"": {""insertions"": 1, ""deletions"": 1, ""lines"": 2}}"
2022-06-27 22:13:04,c19f1a3488c1bb6fe5707dc6338b13cb9f598670,Bram Moolenaar,6,4,10,2,"{""runtime/makemenu.vim"": {""insertions"": 4, ""deletions"": 4, ""lines"": 8}, ""src/version.c"": {""insertions"": 2, ""deletions"": 0, ""lines"": 2}}"
2022-06-27 21:52:43,d21e5bde7c74eab8b10fddc30d12a313c7e7dcd0,Bram Moolenaar,512,360,872,18,"{""src/Makefile"": {""insertions"": 494, ""deletions"": 343, ""lines"": 837}, ""src/gui_w32.c"": {""insertions"": 2, ""deletions"": 0, ""lines"": 2}, ""src/os_mswin.c"": {""insertions"": 1, ""deletions"": 0, ""lines"": 1}, ""src/proto/buffer.pro"": {""insertions"": 1, ""deletions"": 1, ""lines"": 2}, ""src/proto/cmdexpand.pro"": {""insertions"": 4, ""deletions"": 4, ""lines"": 8}, ""src/proto/getchar.pro"": {""insertions"": 1, ""deletions"": 1, ""lines"": 2}, ""src/proto/gui_x11.pro"": {""insertions"": 0, ""deletions"": 1, ""lines"": 1}, ""src/proto/help.pro"": {""insertions"": 0, ""deletions"": 1, ""lines"": 1}, ""src/proto/if_tcl.pro"": {""insertions"": 1, ""deletions"": 1, ""lines"": 2}, ""src/proto/mbyte.pro"": {""insertions"": 1, ""deletions"": 1, ""lines"": 2}, ""src/proto/option.pro"": {""insertions"": 1, ""deletions"": 1, ""lines"": 2}, ""src/proto/os_mswin.pro"": {""insertions"": 1, ""deletions"": 1, ""lines"": 2}, ""src/proto/screen.pro"": {""insertions"": 1, ""deletions"": 1, ""lines"": 2}, ""src/proto/syntax.pro"": {""insertions"": 0, ""deletions"": 1, ""lines"": 1}, ""src/proto/textformat.pro"": {""insertions"": 1, ""deletions"": 1, ""lines"": 2}, ""src/proto/textobject.pro"": {""insertions"": 0, ""deletions"": 1, ""lines"": 1}, ""src/proto/time.pro"": {""insertions"": 1, ""deletions"": 1, ""lines"": 2}, ""src/version.c"": {""insertions"": 2, ""deletions"": 0, ""lines"": 2}}"
2022-06-27 21:17:37,944cc9ceba8868acd238264d4a3894803c566b37,Bram Moolenaar,6,3,9,4,"{""src/misc1.c"": {""insertions"": 2, ""deletions"": 1, ""lines"": 3}, ""src/screen.c"": {""insertions"": 1, ""deletions"": 1, ""lines"": 2}, ""src/version.c"": {""insertions"": 2, ""deletions"": 0, ""lines"": 2}, ""src/vim.h"": {""insertions"": 1, ""deletions"": 1, ""lines"": 2}}"
2022-06-27 21:16:08,069a7d561bbe7e3b9bf132f71b7121c59f99e8f1,Bram Moolenaar,179,111,290,5,"{"".github/CODEOWNERS"": {""insertions"": 90, ""deletions"": 1, ""lines"": 91}, ""runtime/doc/builtin.txt"": {""insertions"": 4, ""deletions"": 4, ""lines"": 8}, ""runtime/doc/options.txt"": {""insertions"": 4, ""deletions"": 3, ""lines"": 7}, ""runtime/doc/todo.txt"": {""insertions"": 34, ""deletions"": 102, ""lines"": 136}, ""runtime/doc/version9.txt"": {""insertions"": 47, ""deletions"": 1, ""lines"": 48}}"
2022-06-27 19:15:10,79481367a457951aabd9501b510fd7e3eb29c3d8,Bram Moolenaar,46,19,65,3,"{""src/eval.c"": {""insertions"": 25, ""deletions"": 19, ""lines"": 44}, ""src/testdir/test_vimscript.vim"": {""insertions"": 19, ""deletions"": 0, ""lines"": 19}, ""src/version.c"": {""insertions"": 2, ""deletions"": 0, ""lines"": 2}}"
2022-06-27 12:59:00,fee511c1d39ecd155e27545cf70aeaa99d31b215,Zdenek Dohnal,8,1,9,2,"{""src/if_python3.c"": {""insertions"": 6, ""deletions"": 1, ""lines"": 7}, ""src/version.c"": {""insertions"": 2, ""deletions"": 0, ""lines"": 2}}"
2022-06-27 10:45:52,1ae8c262df7083dfb4b41485508951c50eccc84c,Bram Moolenaar,20,5,25,3,"{""src/evalfunc.c"": {""insertions"": 9, ""deletions"": 5, ""lines"": 14}, ""src/testdir/test_getvar.vim"": {""insertions"": 9, ""deletions"": 0, ""lines"": 9}, ""src/version.c"": {""insertions"": 2, ""deletions"": 0, ""lines"": 2}}"
2022-06-26 17:17:50,f65cc665fa751bad3ffe75f58ce1251d6695949f,Bram Moolenaar,4,1,5,2,"{""src/testdir/test_diffmode.vim"": {""insertions"": 2, ""deletions"": 1, ""lines"": 3}, ""src/version.c"": {""insertions"": 2, ""deletions"": 0, ""lines"": 2}}"
2022-06-26 17:01:00,507618702e0b04d37028a5bdf7d0d1b09555e19a,Bram Moolenaar,4,0,4,2,"{""src/testdir/test_vim9_import.vim"": {""insertions"": 2, ""deletions"": 0, ""lines"": 2}, ""src/version.c"": {""insertions"": 2, ""deletions"": 0, ""lines"": 2}}"
2022-06-26 15:53:34,c101abff4c6756db4f5e740fde289decb9452efa,Bram Moolenaar,16,2,18,3,"{""src/diff.c"": {""insertions"": 2, ""deletions"": 2, ""lines"": 4}, ""src/testdir/test_diffmode.vim"": {""insertions"": 12, ""deletions"": 0, ""lines"": 12}, ""src/version.c"": {""insertions"": 2, ""deletions"": 0, ""lines"": 2}}"
2022-06-26 13:04:07,cd38bb4d83c942c4bad596835c6766cbf32e5195,Bram Moolenaar,22,2,24,3,"{""src/diff.c"": {""insertions"": 8, ""deletions"": 2, ""lines"": 10}, ""src/testdir/test_diffmode.vim"": {""insertions"": 12, ""deletions"": 0, ""lines"": 12}, ""src/version.c"": {""insertions"": 2, ""deletions"": 0, ""lines"": 2}}"
2022-06-26 11:59:02,0971c7a4e537ea120a6bb2195960be8d0815e97b,Bram Moolenaar,3,1,4,2,"{""src/edit.c"": {""insertions"": 1, ""deletions"": 1, ""lines"": 2}, ""src/version.c"": {""insertions"": 2, ""deletions"": 0, ""lines"": 2}}"
2022-06-26 11:21:15,8a3b805c6c9cae341d560df9c3567ebbe42a7404,Bram Moolenaar,689,697,1386,30,"{""runtime/doc/builtin.txt"": {""insertions"": 4, ""deletions"": 3, ""lines"": 7}, ""runtime/doc/channel.txt"": {""insertions"": 1, ""deletions"": 32, ""lines"": 33}, ""runtime/doc/cmdline.txt"": {""insertions"": 2, ""deletions"": 2, ""lines"": 4}, ""runtime/doc/editing.txt"": {""insertions"": 1, ""deletions"": 1, ""lines"": 2}, ""runtime/doc/eval.txt"": {""insertions"": 3, ""deletions"": 3, ""lines"": 6}, ""runtime/doc/filetype.txt"": {""insertions"": 1, ""deletions"": 1, ""lines"": 2}, ""runtime/doc/if_pyth.txt"": {""insertions"": 5, ""deletions"": 5, ""lines"": 10}, ""runtime/doc/indent.txt"": {""insertions"": 1, ""deletions"": 1, ""lines"": 2}, ""runtime/doc/map.txt"": {""insertions"": 5, ""deletions"": 4, ""lines"": 9}, ""runtime/doc/message.txt"": {""insertions"": 79, ""deletions"": 79, ""lines"": 158}, ""runtime/doc/options.txt"": {""insertions"": 8, ""deletions"": 8, ""lines"": 16}, ""runtime/doc/quickref.txt"": {""insertions"": 1, ""deletions"": 1, ""lines"": 2}, ""runtime/doc/starting.txt"": {""insertions"": 1, ""deletions"": 1, ""lines"": 2}, ""runtime/doc/tabpage.txt"": {""insertions"": 1, ""deletions"": 1, ""lines"": 2}, ""runtime/doc/tags"": {""insertions"": 1, ""deletions"": 0, ""lines"": 1}, ""runtime/doc/terminal.txt"": {""insertions"": 8, ""deletions"": 5, ""lines"": 13}, ""runtime/doc/testing.txt"": {""insertions"": 3, ""deletions"": 3, ""lines"": 6}, ""runtime/doc/todo.txt"": {""insertions"": 3, ""deletions"": 3, ""lines"": 6}, ""runtime/doc/usr_41.txt"": {""insertions"": 4, ""deletions"": 4, ""lines"": 8}, ""runtime/doc/usr_50.txt"": {""insertions"": 2, ""deletions"": 2, ""lines"": 4}, ""runtime/doc/usr_51.txt"": {""insertions"": 2, ""deletions"": 2, ""lines"": 4}, ""runtime/doc/usr_toc.txt"": {""insertions"": 1, ""deletions"": 1, ""lines"": 2}, ""runtime/doc/various.txt"": {""insertions"": 2, ""deletions"": 1, ""lines"": 3}, ""runtime/doc/version8.txt"": {""insertions"": 1, ""deletions"": 1, ""lines"": 2}, ""runtime/doc/version9.txt"": {""insertions"": 27, ""deletions"": 8, ""lines"": 35}, ""runtime/doc/vim9.txt"": {""insertions"": 5, ""deletions"": 5, ""lines"": 10}, ""runtime/syntax/doxygen.vim"": {""insertions"": 1, ""deletions"": 1, ""lines"": 2}, ""src/po/zh_CN.UTF-8.po"": {""insertions"": 172, ""deletions"": 173, ""lines"": 345}, ""src/po/zh_CN.cp936.po"": {""insertions"": 172, ""deletions"": 173, ""lines"": 345}, ""src/po/zh_CN.po"": {""insertions"": 172, ""deletions"": 173, ""lines"": 345}}"
2022-06-26 10:17:10,0fbc9260a75dfc4d86f20e7c0eb76878f513a212,Bram Moolenaar,5,1,6,2,"{""src/message.c"": {""insertions"": 3, ""deletions"": 1, ""lines"": 4}, ""src/version.c"": {""insertions"": 2, ""deletions"": 0, ""lines"": 2}}"
2022-06-25 18:54:09,e178af5a586ea023622d460779fdcabbbfac0908,Bram Moolenaar,8,0,8,2,"{""src/term.c"": {""insertions"": 6, ""deletions"": 0, ""lines"": 6}, ""src/version.c"": {""insertions"": 2, ""deletions"": 0, ""lines"": 2}}"
2022-06-25 17:01:32,e1dc76fbf333243ecfdfc3c0a81ea9984913b4f5,Bram Moolenaar,24032,12858,36890,17,"{""runtime/doc/builtin.txt"": {""insertions"": 7, ""deletions"": 5, ""lines"": 12}, ""runtime/doc/tags"": {""insertions"": 2, ""deletions"": 0, ""lines"": 2}, ""runtime/doc/todo.txt"": {""insertions"": 12, ""deletions"": 4, ""lines"": 16}, ""runtime/doc/various.txt"": {""insertions"": 5, ""deletions"": 2, ""lines"": 7}, ""runtime/doc/version7.txt"": {""insertions"": 1, ""deletions"": 1, ""lines"": 2}, ""runtime/doc/version8.txt"": {""insertions"": 1, ""deletions"": 1, ""lines"": 2}, ""runtime/doc/version9.txt"": {""insertions"": 310, ""deletions"": 124, ""lines"": 434}, ""runtime/gvim.desktop"": {""insertions"": 4, ""deletions"": 1, ""lines"": 5}, ""runtime/pack/dist/opt/termdebug/plugin/termdebug.vim"": {""insertions"": 2, ""deletions"": 1, ""lines"": 3}, ""runtime/vim.desktop"": {""insertions"": 4, ""deletions"": 1, ""lines"": 5}, ""src/po/README.txt"": {""insertions"": 3, ""deletions"": 0, ""lines"": 3}, ""src/po/cs.cp1250.po"": {""insertions"": 1, ""deletions"": 1, ""lines"": 2}, ""src/po/gvim.desktop.in"": {""insertions"": 0, ""deletions"": 1, ""lines"": 1}, ""src/po/vim.desktop.in"": {""insertions"": 0, ""deletions"": 1, ""lines"": 1}, ""src/po/zh_CN.UTF-8.po"": {""insertions"": 7894, ""deletions"": 4239, ""lines"": 12133}, ""src/po/zh_CN.cp936.po"": {""insertions"": 7893, ""deletions"": 4238, ""lines"": 12131}, ""src/po/zh_CN.po"": {""insertions"": 7893, ""deletions"": 4238, ""lines"": 12131}}"
2022-06-25 12:48:25,7bb6d56cfc8ac82dea323f6799a773d7fa3286a8,Bram Moolenaar,11,19,30,2,"{""src/gui_w32.c"": {""insertions"": 9, ""deletions"": 19, ""lines"": 28}, ""src/version.c"": {""insertions"": 2, ""deletions"": 0, ""lines"": 2}}"
2022-06-25 11:13:28,61e3784819d3776ec6fb40d97a12a1bb659e8143,Bram Moolenaar,7,16,23,2,"{""src/testdir/test_signals.vim"": {""insertions"": 5, ""deletions"": 16, ""lines"": 21}, ""src/version.c"": {""insertions"": 2, ""deletions"": 0, ""lines"": 2}}"
2022-06-24 19:18:09,4e0fc8956649d3208aeaa1642c5efc44e385d77a,LemonBoy,21,9,30,2,"{""src/gui_w32.c"": {""insertions"": 19, ""deletions"": 9, ""lines"": 28}, ""src/version.c"": {""insertions"": 2, ""deletions"": 0, ""lines"": 2}}"
2022-06-24 19:11:59,e9b74c03618e2dcd01cd71f8d62d620fbce884fa,Bram Moolenaar,6,0,6,2,"{""src/testdir/test_search.vim"": {""insertions"": 4, ""deletions"": 0, ""lines"": 4}, ""src/version.c"": {""insertions"": 2, ""deletions"": 0, ""lines"": 2}}"
2022-06-24 11:38:57,a315ce1f326b836167ca8b1037dafd93eb8d4d4e,Bram Moolenaar,101,1,102,5,"{""src/move.c"": {""insertions"": 6, ""deletions"": 1, ""lines"": 7}, ""src/testdir/dumps/Test_diff_scroll_1.dump"": {""insertions"": 12, ""deletions"": 0, ""lines"": 12}, ""src/testdir/dumps/Test_diff_scroll_2.dump"": {""insertions"": 12, ""deletions"": 0, ""lines"": 12}, ""src/testdir/test_diffmode.vim"": {""insertions"": 69, ""deletions"": 0, ""lines"": 69}, ""src/version.c"": {""insertions"": 2, ""deletions"": 0, ""lines"": 2}}"
2022-06-24 10:48:03,a57b553b432855667c9f26edfad95ccfdd24a6b7,Bram Moolenaar,204,115,319,48,"{""runtime/doc/channel.txt"": {""insertions"": 4, ""deletions"": 2, ""lines"": 6}, ""runtime/doc/options.txt"": {""insertions"": 3, ""deletions"": 3, ""lines"": 6}, ""runtime/doc/todo.txt"": {""insertions"": 2, ""deletions"": 1, ""lines"": 3}, ""runtime/doc/usr_40.txt"": {""insertions"": 2, ""deletions"": 2, ""lines"": 4}, ""runtime/doc/version9.txt"": {""insertions"": 93, ""deletions"": 20, ""lines"": 113}, ""runtime/indent/testdir/vim.in"": {""insertions"": 6, ""deletions"": 0, ""lines"": 6}, ""runtime/indent/testdir/vim.ok"": {""insertions"": 6, ""deletions"": 0, ""lines"": 6}, ""runtime/indent/vim.vim"": {""insertions"": 10, ""deletions"": 3, ""lines"": 13}, ""runtime/spell/main.aap"": {""insertions"": 0, ""deletions"": 6, ""lines"": 6}, ""src/po/af.po"": {""insertions"": 2, ""deletions"": 2, ""lines"": 4}, ""src/po/ca.po"": {""insertions"": 2, ""deletions"": 2, ""lines"": 4}, ""src/po/cs.cp1250.po"": {""insertions"": 2, ""deletions"": 2, ""lines"": 4}, ""src/po/cs.po"": {""insertions"": 2, ""deletions"": 2, ""lines"": 4}, ""src/po/da.po"": {""insertions"": 2, ""deletions"": 2, ""lines"": 4}, ""src/po/de.po"": {""insertions"": 2, ""deletions"": 2, ""lines"": 4}, ""src/po/eo.po"": {""insertions"": 2, ""deletions"": 2, ""lines"": 4}, ""src/po/es.po"": {""insertions"": 2, ""deletions"": 2, ""lines"": 4}, ""src/po/fi.po"": {""insertions"": 2, ""deletions"": 2, ""lines"": 4}, ""src/po/fr.po"": {""insertions"": 2, ""deletions"": 2, ""lines"": 4}, ""src/po/ga.po"": {""insertions"": 2, ""deletions"": 2, ""lines"": 4}, ""src/po/it.po"": {""insertions"": 2, ""deletions"": 2, ""lines"": 4}, ""src/po/ja.euc-jp.po"": {""insertions"": 2, ""deletions"": 2, ""lines"": 4}, ""src/po/ja.po"": {""insertions"": 2, ""deletions"": 2, ""lines"": 4}, ""src/po/ja.sjis.po"": {""insertions"": 2, ""deletions"": 2, ""lines"": 4}, ""src/po/ko.UTF-8.po"": {""insertions"": 2, ""deletions"": 2, ""lines"": 4}, ""src/po/ko.po"": {""insertions"": 2, ""deletions"": 2, ""lines"": 4}, ""src/po/nb.po"": {""insertions"": 2, ""deletions"": 2, ""lines"": 4}, ""src/po/nl.po"": {""insertions"": 2, ""deletions"": 2, ""lines"": 4}, ""src/po/no.po"": {""insertions"": 2, ""deletions"": 2, ""lines"": 4}, ""src/po/pl.UTF-8.po"": {""insertions"": 2, ""deletions"": 2, ""lines"": 4}, ""src/po/pl.cp1250.po"": {""insertions"": 2, ""deletions"": 2, ""lines"": 4}, ""src/po/pl.po"": {""insertions"": 2, ""deletions"": 2, ""lines"": 4}, ""src/po/pt_BR.po"": {""insertions"": 2, ""deletions"": 2, ""lines"": 4}, ""src/po/ru.cp1251.po"": {""insertions"": 2, ""deletions"": 2, ""lines"": 4}, ""src/po/ru.po"": {""insertions"": 2, ""deletions"": 2, ""lines"": 4}, ""src/po/sk.cp1250.po"": {""insertions"": 2, ""deletions"": 2, ""lines"": 4}, ""src/po/sk.po"": {""insertions"": 2, ""deletions"": 2, ""lines"": 4}, ""src/po/sr.po"": {""insertions"": 2, ""deletions"": 2, ""lines"": 4}, ""src/po/sv.po"": {""insertions"": 2, ""deletions"": 2, ""lines"": 4}, ""src/po/tr.po"": {""insertions"": 2, ""deletions"": 2, ""lines"": 4}, ""src/po/uk.cp1251.po"": {""insertions"": 2, ""deletions"": 2, ""lines"": 4}, ""src/po/uk.po"": {""insertions"": 2, ""deletions"": 2, ""lines"": 4}, ""src/po/vi.po"": {""insertions"": 2, ""deletions"": 2, ""lines"": 4}, ""src/po/zh_CN.UTF-8.po"": {""insertions"": 2, ""deletions"": 2, ""lines"": 4}, ""src/po/zh_CN.cp936.po"": {""insertions"": 2, ""deletions"": 2, ""lines"": 4}, ""src/po/zh_CN.po"": {""insertions"": 2, ""deletions"": 2, ""lines"": 4}, ""src/po/zh_TW.UTF-8.po"": {""insertions"": 2, ""deletions"": 2, ""lines"": 4}, ""src/po/zh_TW.po"": {""insertions"": 2, ""deletions"": 2, ""lines"": 4}}"
2022-06-23 19:46:27,abd56da30bae4a5c6c20b9363ccae12f7b126026,Bram Moolenaar,17,9,26,7,"{""Filelist"": {""insertions"": 1, ""deletions"": 0, ""lines"": 1}, ""src/Makefile"": {""insertions"": 0, ""deletions"": 1, ""lines"": 1}, ""src/if_tcl.c"": {""insertions"": 9, ""deletions"": 3, ""lines"": 12}, ""src/os_unix.c"": {""insertions"": 2, ""deletions"": 1, ""lines"": 3}, ""src/regexp.c"": {""insertions"": 1, ""deletions"": 1, ""lines"": 2}, ""src/testdir/test_gui.vim"": {""insertions"": 0, ""deletions"": 2, ""lines"": 2}, ""src/version.c"": {""insertions"": 4, ""deletions"": 1, ""lines"": 5}}"
2022-06-23 14:54:09,1b096b0d4a52cacf5ac782c7fa0d02cf0ef22fc4,towrang,3,0,3,2,"{""src/Makefile"": {""insertions"": 1, ""deletions"": 0, ""lines"": 1}, ""src/version.c"": {""insertions"": 2, ""deletions"": 0, ""lines"": 2}}"
2022-06-23 12:04:20,8cc5b559f70041361612b8a6a87922503b33baa6,Bram Moolenaar,179,339,518,15,"{""runtime/doc/options.txt"": {""insertions"": 7, ""deletions"": 3, ""lines"": 10}, ""runtime/doc/todo.txt"": {""insertions"": 8, ""deletions"": 8, ""lines"": 16}, ""runtime/doc/usr_40.txt"": {""insertions"": 12, ""deletions"": 1, ""lines"": 13}, ""runtime/doc/usr_41.txt"": {""insertions"": 12, ""deletions"": 8, ""lines"": 20}, ""runtime/doc/usr_50.txt"": {""insertions"": 7, ""deletions"": 20, ""lines"": 27}, ""runtime/doc/usr_toc.txt"": {""insertions"": 3, ""deletions"": 3, ""lines"": 6}, ""runtime/doc/version9.txt"": {""insertions"": 64, ""deletions"": 20, ""lines"": 84}, ""runtime/doc/vim9.txt"": {""insertions"": 1, ""deletions"": 8, ""lines"": 9}, ""runtime/lang/README.txt"": {""insertions"": 3, ""deletions"": 0, ""lines"": 3}, ""runtime/pack/dist/opt/termdebug/plugin/termdebug.vim"": {""insertions"": 3, ""deletions"": 3, ""lines"": 6}, ""runtime/spell/sr/README_sr.txt"": {""insertions"": 43, ""deletions"": 0, ""lines"": 43}, ""runtime/spell/sr/main.aap"": {""insertions"": 6, ""deletions"": 125, ""lines"": 131}, ""runtime/spell/sr/sr_RS.diff"": {""insertions"": 0, ""deletions"": 68, ""lines"": 68}, ""runtime/spell/sr/sr_RS@latin.diff"": {""insertions"": 0, ""deletions"": 66, ""lines"": 66}, ""runtime/syntax/doxygen.vim"": {""insertions"": 10, ""deletions"": 6, ""lines"": 16}}"
2022-06-23 11:04:46,180246cfd1a5842c538fa8a4a0b520f1d95c90c7,zeertzjq,12,5,17,3,"{""src/evalfunc.c"": {""insertions"": 3, ""deletions"": 0, ""lines"": 3}, ""src/testdir/test_syntax.vim"": {""insertions"": 7, ""deletions"": 5, ""lines"": 12}, ""src/version.c"": {""insertions"": 2, ""deletions"": 0, ""lines"": 2}}"
2022-06-22 18:59:28,8eba2bd291b347e3008aa9e565652d51ad638cfa,Bram Moolenaar,18,3,21,3,"{""src/indent.c"": {""insertions"": 5, ""deletions"": 2, ""lines"": 7}, ""src/testdir/test_lispwords.vim"": {""insertions"": 11, ""deletions"": 1, ""lines"": 12}, ""src/version.c"": {""insertions"": 2, ""deletions"": 0, ""lines"": 2}}"
2022-06-22 18:08:38,f7c7c3fad6d2135d558f3b36d0d1a943118aeb5e,Bram Moolenaar,14,1,15,3,"{""src/ex_docmd.c"": {""insertions"": 4, ""deletions"": 1, ""lines"": 5}, ""src/testdir/test_cmdline.vim"": {""insertions"": 8, ""deletions"": 0, ""lines"": 8}, ""src/version.c"": {""insertions"": 2, ""deletions"": 0, ""lines"": 2}}"
2022-06-22 17:14:29,6689df024bce4309ec5884e445738fe07ee4ffcc,Bram Moolenaar,6,0,6,2,"{""src/ex_getln.c"": {""insertions"": 4, ""deletions"": 0, ""lines"": 4}, ""src/version.c"": {""insertions"": 2, ""deletions"": 0, ""lines"": 2}}"
2022-06-22 12:51:54,6046aded8da002b08d380db29de2ba0268b6616e,Bram Moolenaar,10,2,12,3,"{""src/ex_getln.c"": {""insertions"": 3, ""deletions"": 2, ""lines"": 5}, ""src/testdir/test_cmdline.vim"": {""insertions"": 5, ""deletions"": 0, ""lines"": 5}, ""src/version.c"": {""insertions"": 2, ""deletions"": 0, ""lines"": 2}}"
2022-06-21 21:35:40,12a49408b3d60a55b1e098f97d3f1127a75fb3bf,Bram Moolenaar,3,0,3,2,"{""src/testdir/test_search.vim"": {""insertions"": 1, ""deletions"": 0, ""lines"": 1}, ""src/version.c"": {""insertions"": 2, ""deletions"": 0, ""lines"": 2}}"
2022-06-21 21:15:25,44ddf19ec0ff59c969658ec7d9ed42070c59c51b,Bram Moolenaar,77,23,100,7,"{""src/alloc.c"": {""insertions"": 3, ""deletions"": 0, ""lines"": 3}, ""src/errors.h"": {""insertions"": 4, ""deletions"": 0, ""lines"": 4}, ""src/ex_cmds.c"": {""insertions"": 6, ""deletions"": 4, ""lines"": 10}, ""src/proto/regexp.pro"": {""insertions"": 1, ""deletions"": 0, ""lines"": 1}, ""src/regexp.c"": {""insertions"": 50, ""deletions"": 18, ""lines"": 68}, ""src/testdir/test_substitute.vim"": {""insertions"": 11, ""deletions"": 1, ""lines"": 12}, ""src/version.c"": {""insertions"": 2, ""deletions"": 0, ""lines"": 2}}"
2022-06-21 17:34:42,cf801d4b95180ddaee1bf633ef482232625dd80b,Bram Moolenaar,12,3,15,4,"{""src/testdir/check.vim"": {""insertions"": 8, ""deletions"": 0, ""lines"": 8}, ""src/testdir/test_channel.vim"": {""insertions"": 1, ""deletions"": 3, ""lines"": 4}, ""src/testdir/test_exit.vim"": {""insertions"": 1, ""deletions"": 0, ""lines"": 1}, ""src/version.c"": {""insertions"": 2, ""deletions"": 0, ""lines"": 2}}"
2022-06-21 17:10:39,c856ceb300ff8871ed546e36638f1a28531c379c,Bram Moolenaar,7,0,7,2,"{""src/screen.c"": {""insertions"": 5, ""deletions"": 0, ""lines"": 5}, ""src/version.c"": {""insertions"": 2, ""deletions"": 0, ""lines"": 2}}"
2022-06-21 16:40:47,37bb3b111d08ce420e3cfd6ea3da3ed7428fbed1,Bram Moolenaar,45,33,78,5,"{""src/testdir/test_channel.vim"": {""insertions"": 26, ""deletions"": 16, ""lines"": 42}, ""src/testdir/test_cscope.vim"": {""insertions"": 7, ""deletions"": 4, ""lines"": 11}, ""src/testdir/test_iminsert.vim"": {""insertions"": 1, ""deletions"": 3, ""lines"": 4}, ""src/testdir/test_popup.vim"": {""insertions"": 9, ""deletions"": 10, ""lines"": 19}, ""src/version.c"": {""insertions"": 2, ""deletions"": 0, ""lines"": 2}}"
2022-06-21 13:38:40,fa04eae5a5b9394079bde2d37ce6f9f8a5567d48,Bram Moolenaar,7,3,10,2,"{""src/testdir/test_startup.vim"": {""insertions"": 5, ""deletions"": 3, ""lines"": 8}, ""src/version.c"": {""insertions"": 2, ""deletions"": 0, ""lines"": 2}}"
2022-06-20 12:38:33,155f2d1451949d1124bfd6ba9c55be6bd74bab75,Bram Moolenaar,24,23,47,6,"{""src/os_unix.c"": {""insertions"": 14, ""deletions"": 15, ""lines"": 29}, ""src/os_win32.c"": {""insertions"": 4, ""deletions"": 4, ""lines"": 8}, ""src/proto/os_unix.pro"": {""insertions"": 1, ""deletions"": 1, ""lines"": 2}, ""src/proto/os_win32.pro"": {""insertions"": 1, ""deletions"": 1, ""lines"": 2}, ""src/regexp.c"": {""insertions"": 2, ""deletions"": 2, ""lines"": 4}, ""src/version.c"": {""insertions"": 2, ""deletions"": 0, ""lines"": 2}}"
2022-06-20 11:39:39,73171ba4344e17484699d11c65d57fb1f4de572a,Bram Moolenaar,4,0,4,2,"{""src/testdir/test_search.vim"": {""insertions"": 2, ""deletions"": 0, ""lines"": 2}, ""src/version.c"": {""insertions"": 2, ""deletions"": 0, ""lines"": 2}}"
2022-06-20 11:01:10,300d71881957f8e60e48eda19002ce5e25fd9c06,Bram Moolenaar,3,4,7,2,"{""src/os_unix.h"": {""insertions"": 1, ""deletions"": 4, ""lines"": 5}, ""src/version.c"": {""insertions"": 2, ""deletions"": 0, ""lines"": 2}}"
2022-06-20 10:38:17,8088ae95bbed2085c5fb196850c4e4b8df55c989,Bram Moolenaar,11,8,19,6,"{""src/filepath.c"": {""insertions"": 2, ""deletions"": 2, ""lines"": 4}, ""src/job.c"": {""insertions"": 2, ""deletions"": 1, ""lines"": 3}, ""src/mark.c"": {""insertions"": 1, ""deletions"": 1, ""lines"": 2}, ""src/move.c"": {""insertions"": 3, ""deletions"": 3, ""lines"": 6}, ""src/popupwin.c"": {""insertions"": 1, ""deletions"": 1, ""lines"": 2}, ""src/version.c"": {""insertions"": 2, ""deletions"": 0, ""lines"": 2}}"
2022-06-20 10:23:01,509ce0383105d5b516ef2d489adb7c554d3c8f81,Bram Moolenaar,8,0,8,4,"{""src/os_unix.c"": {""insertions"": 2, ""deletions"": 0, ""lines"": 2}, ""src/regexp_bt.c"": {""insertions"": 2, ""deletions"": 0, ""lines"": 2}, ""src/regexp_nfa.c"": {""insertions"": 2, ""deletions"": 0, ""lines"": 2}, ""src/version.c"": {""insertions"": 2, ""deletions"": 0, ""lines"": 2}}"
2022-06-20 10:17:32,d799daa660b8821943cbe1682f00da9e812dd48c,Bram Moolenaar,4672,326,4998,15,"{""runtime/autoload/dist/man.vim"": {""insertions"": 196, ""deletions"": 0, ""lines"": 196}, ""runtime/doc/builtin.txt"": {""insertions"": 2, ""deletions"": 4, ""lines"": 6}, ""runtime/doc/eval.txt"": {""insertions"": 2, ""deletions"": 2, ""lines"": 4}, ""runtime/doc/map.txt"": {""insertions"": 2, ""deletions"": 10, ""lines"": 12}, ""runtime/doc/repeat.txt"": {""insertions"": 2, ""deletions"": 2, ""lines"": 4}, ""runtime/doc/tags"": {""insertions"": 2, ""deletions"": 0, ""lines"": 2}, ""runtime/doc/todo.txt"": {""insertions"": 21, ""deletions"": 36, ""lines"": 57}, ""runtime/doc/version9.txt"": {""insertions"": 4362, ""deletions"": 8, ""lines"": 4370}, ""runtime/doc/visual.txt"": {""insertions"": 8, ""deletions"": 1, ""lines"": 9}, ""runtime/ftplugin/man.vim"": {""insertions"": 9, ""deletions"": 194, ""lines"": 203}, ""runtime/indent/confini.vim"": {""insertions"": 0, ""deletions"": 10, ""lines"": 10}, ""runtime/indent/systemd.vim"": {""insertions"": 0, ""deletions"": 10, ""lines"": 10}, ""runtime/indent/yaml.vim"": {""insertions"": 20, ""deletions"": 20, ""lines"": 40}, ""runtime/lang/menu_it_it.latin1.vim"": {""insertions"": 45, ""deletions"": 28, ""lines"": 73}, ""runtime/syntax/vim.vim"": {""insertions"": 1, ""deletions"": 1, ""lines"": 2}}"
2022-06-19 19:13:56,e366ed4f2c6fa8cb663f1b9599b39d57ddbd8a2a,Bram Moolenaar,11,3,14,4,"{""src/testdir/shared.vim"": {""insertions"": 6, ""deletions"": 0, ""lines"": 6}, ""src/testdir/test_debugger.vim"": {""insertions"": 2, ""deletions"": 2, ""lines"": 4}, ""src/testdir/test_search.vim"": {""insertions"": 1, ""deletions"": 1, ""lines"": 2}, ""src/version.c"": {""insertions"": 2, ""deletions"": 0, ""lines"": 2}}"
2022-06-19 17:02:05,0f0d3a7fb6473760b6f6679e3c8a81376220c869,Bram Moolenaar,28,26,54,3,"{""src/auto/configure"": {""insertions"": 13, ""deletions"": 13, ""lines"": 26}, ""src/configure.ac"": {""insertions"": 13, ""deletions"": 13, ""lines"": 26}, ""src/version.c"": {""insertions"": 2, ""deletions"": 0, ""lines"": 2}}"
2022-06-19 16:45:28,3efd65c55710cbd2db7569096554bc92f4a66a43,Bram Moolenaar,7,5,12,2,"{""src/term.c"": {""insertions"": 5, ""deletions"": 5, ""lines"": 10}, ""src/version.c"": {""insertions"": 2, ""deletions"": 0, ""lines"": 2}}"
2022-06-19 16:22:49,1f68d992cd2fd7f484fbdc14eb8a9feefe59bec8,Bram Moolenaar,2,2,4,2,"{""src/os_macosx.m"": {""insertions"": 0, ""deletions"": 2, ""lines"": 2}, ""src/version.c"": {""insertions"": 2, ""deletions"": 0, ""lines"": 2}}"
2022-06-19 16:16:18,c829faa8211df52997c0b9ee49cdea0c8786b177,James McCoy,15,5,20,2,"{""src/testdir/test_mksession.vim"": {""insertions"": 13, ""deletions"": 5, ""lines"": 18}, ""src/version.c"": {""insertions"": 2, ""deletions"": 0, ""lines"": 2}}"
2022-06-19 16:05:47,e530395c2cd261d598094dc9ea785e90a753c5f1,Bram Moolenaar,60,23,83,5,"{""src/auto/configure"": {""insertions"": 4, ""deletions"": 2, ""lines"": 6}, ""src/configure.ac"": {""insertions"": 22, ""deletions"": 20, ""lines"": 42}, ""src/testdir/test_hlsearch.vim"": {""insertions"": 1, ""deletions"": 1, ""lines"": 2}, ""src/testdir/test_search.vim"": {""insertions"": 31, ""deletions"": 0, ""lines"": 31}, ""src/version.c"": {""insertions"": 2, ""deletions"": 0, ""lines"": 2}}"
2022-06-19 14:22:36,c5382b667ac4b69ddff5b5bc562386843bc9c07b,Bram Moolenaar,9,7,16,2,"{""src/testdir/test_edit.vim"": {""insertions"": 7, ""deletions"": 7, ""lines"": 14}, ""src/version.c"": {""insertions"": 2, ""deletions"": 0, ""lines"": 2}}"
2022-06-19 13:36:35,1f30caff8b63beda75a5dcd15ffe3e9e818ed483,Bram Moolenaar,6,4,10,4,"{""src/os_unix.c"": {""insertions"": 0, ""deletions"": 1, ""lines"": 1}, ""src/os_win32.c"": {""insertions"": 3, ""deletions"": 3, ""lines"": 6}, ""src/regexp.c"": {""insertions"": 1, ""deletions"": 0, ""lines"": 1}, ""src/version.c"": {""insertions"": 2, ""deletions"": 0, ""lines"": 2}}"
2022-06-19 11:27:45,6f0cf62df97ee7c9d26b550adaf469be7fe1e09a,Bram Moolenaar,11,3,14,4,"{""src/drawscreen.c"": {""insertions"": 2, ""deletions"": 0, ""lines"": 2}, ""src/globals.h"": {""insertions"": 4, ""deletions"": 0, ""lines"": 4}, ""src/syntax.c"": {""insertions"": 3, ""deletions"": 3, ""lines"": 6}, ""src/version.c"": {""insertions"": 2, ""deletions"": 0, ""lines"": 2}}"
2022-06-19 10:45:46,cdc6a43559d5b880f81efceb849f40c20af1ada1,zeertzjq,5,5,10,3,"{""src/testdir/test_channel.vim"": {""insertions"": 2, ""deletions"": 3, ""lines"": 5}, ""src/testdir/test_hlsearch.vim"": {""insertions"": 1, ""deletions"": 2, ""lines"": 3}, ""src/version.c"": {""insertions"": 2, ""deletions"": 0, ""lines"": 2}}"
2022-06-18 18:48:14,d6211a52ab9f53b82f884561ed43d2fe4d24ff7d,Bram Moolenaar,19,3,22,3,"{""src/ex_docmd.c"": {""insertions"": 4, ""deletions"": 3, ""lines"": 7}, ""src/testdir/test_substitute.vim"": {""insertions"": 13, ""deletions"": 0, ""lines"": 13}, ""src/version.c"": {""insertions"": 2, ""deletions"": 0, ""lines"": 2}}"
2022-06-18 15:48:36,09f68a5e7817cbb40854ee6b8ae3db21d5365346,Yasuhiro Matsumoto,5,3,8,4,"{""src/map.c"": {""insertions"": 1, ""deletions"": 1, ""lines"": 2}, ""src/os_win32.c"": {""insertions"": 1, ""deletions"": 1, ""lines"": 2}, ""src/proto/os_win32.pro"": {""insertions"": 1, ""deletions"": 1, ""lines"": 2}, ""src/version.c"": {""insertions"": 2, ""deletions"": 0, ""lines"": 2}}"
2022-06-18 15:05:32,620aa8eb5b1468d086253f8aa787a33a86033100,Bram Moolenaar,5,5,10,2,"{""src/testdir/test_syntax.vim"": {""insertions"": 3, ""deletions"": 5, ""lines"": 8}, ""src/version.c"": {""insertions"": 2, ""deletions"": 0, ""lines"": 2}}"
2022-06-18 13:09:08,156d3911952d73b03d7420dc3540215247db0fe8,Bram Moolenaar,14,1,15,3,"{""src/spellsuggest.c"": {""insertions"": 2, ""deletions"": 1, ""lines"": 3}, ""src/testdir/test_spell.vim"": {""insertions"": 10, ""deletions"": 0, ""lines"": 10}, ""src/version.c"": {""insertions"": 2, ""deletions"": 0, ""lines"": 2}}"
2022-06-18 11:51:11,0e8e938d497260dd57be67b4966cb27a5f72376f,Bram Moolenaar,14,0,14,3,"{""src/indent.c"": {""insertions"": 2, ""deletions"": 0, ""lines"": 2}, ""src/testdir/test_indent.vim"": {""insertions"": 10, ""deletions"": 0, ""lines"": 10}, ""src/version.c"": {""insertions"": 2, ""deletions"": 0, ""lines"": 2}}"
2022-06-18 10:54:47,8d6420631c2bd73dbc1939c4bf04ab7bb39cc263,Bram Moolenaar,9,4,13,2,"{""src/testdir/test_interrupt.vim"": {""insertions"": 7, ""deletions"": 4, ""lines"": 11}, ""src/version.c"": {""insertions"": 2, ""deletions"": 0, ""lines"": 2}}"
2022-06-18 10:22:40,2f074f4685897ab7212e25931eeeb0212292829f,Bram Moolenaar,8,0,8,2,"{""src/textobject.c"": {""insertions"": 6, ""deletions"": 0, ""lines"": 6}, ""src/version.c"": {""insertions"": 2, ""deletions"": 0, ""lines"": 2}}"
2022-06-17 20:27:38,2ff7e7e16db4791ec3fe45766120552ece42e8a6,Philip H,4,2,6,2,"{"".github/workflows/ci.yml"": {""insertions"": 2, ""deletions"": 2, ""lines"": 4}, ""src/version.c"": {""insertions"": 2, ""deletions"": 0, ""lines"": 2}}"
2022-06-17 19:05:40,f9f2a330b961fe1623d428b61afdc52f0af0a666,K.Takata,68,39,107,3,"{""runtime/pack/dist/opt/editexisting/plugin/editexisting.vim"": {""insertions"": 27, ""deletions"": 23, ""lines"": 50}, ""src/os_mswin.c"": {""insertions"": 39, ""deletions"": 16, ""lines"": 55}, ""src/version.c"": {""insertions"": 2, ""deletions"": 0, ""lines"": 2}}"
2022-06-17 18:23:34,7d149f899d423b7bf2b90d7b11ebe3e560c462b9,Bram Moolenaar,22,8,30,3,"{""src/testdir/test_lua.vim"": {""insertions"": 11, ""deletions"": 0, ""lines"": 11}, ""src/userfunc.c"": {""insertions"": 9, ""deletions"": 8, ""lines"": 17}, ""src/version.c"": {""insertions"": 2, ""deletions"": 0, ""lines"": 2}}"
2022-06-17 17:30:03,47f1a55849a73cefe738a246798221e45448546a,Kazuyuki Miyagi,14,3,17,4,"{""runtime/doc/builtin.txt"": {""insertions"": 2, ""deletions"": 2, ""lines"": 4}, ""src/search.c"": {""insertions"": 2, ""deletions"": 1, ""lines"": 3}, ""src/testdir/test_matchfuzzy.vim"": {""insertions"": 8, ""deletions"": 0, ""lines"": 8}, ""src/version.c"": {""insertions"": 2, ""deletions"": 0, ""lines"": 2}}"
2022-06-17 14:42:40,d592deb336523a5448779ee3d4bba80334cff1f7,Bram Moolenaar,747,619,1366,35,"{"".github/CODEOWNERS"": {""insertions"": 3, ""deletions"": 0, ""lines"": 3}, ""runtime/compiler/icon.vim"": {""insertions"": 33, ""deletions"": 0, ""lines"": 33}, ""runtime/doc/builtin.txt"": {""insertions"": 44, ""deletions"": 6, ""lines"": 50}, ""runtime/doc/channel.txt"": {""insertions"": 3, ""deletions"": 3, ""lines"": 6}, ""runtime/doc/cmdline.txt"": {""insertions"": 3, ""deletions"": 3, ""lines"": 6}, ""runtime/doc/eval.txt"": {""insertions"": 2, ""deletions"": 2, ""lines"": 4}, ""runtime/doc/filetype.txt"": {""insertions"": 3, ""deletions"": 3, ""lines"": 6}, ""runtime/doc/map.txt"": {""insertions"": 9, ""deletions"": 3, ""lines"": 12}, ""runtime/doc/pi_netrw.txt"": {""insertions"": 3, ""deletions"": 3, ""lines"": 6}, ""runtime/doc/popup.txt"": {""insertions"": 62, ""deletions"": 66, ""lines"": 128}, ""runtime/doc/todo.txt"": {""insertions"": 4, ""deletions"": 8, ""lines"": 12}, ""runtime/doc/undo.txt"": {""insertions"": 1, ""deletions"": 1, ""lines"": 2}, ""runtime/doc/usr_52.txt"": {""insertions"": 1, ""deletions"": 1, ""lines"": 2}, ""runtime/doc/version5.txt"": {""insertions"": 2, ""deletions"": 2, ""lines"": 4}, ""runtime/ftplugin/icon.vim"": {""insertions"": 36, ""deletions"": 0, ""lines"": 36}, ""runtime/indent/dtd.vim"": {""insertions"": 6, ""deletions"": 0, ""lines"": 6}, ""runtime/indent/julia.vim"": {""insertions"": 7, ""deletions"": 1, ""lines"": 8}, ""runtime/indent/perl.vim"": {""insertions"": 162, ""deletions"": 88, ""lines"": 250}, ""runtime/plugin/manpager.vim"": {""insertions"": 21, ""deletions"": 8, ""lines"": 29}, ""runtime/syntax/coco.vim"": {""insertions"": 2, ""deletions"": 1, ""lines"": 3}, ""runtime/syntax/dirpager.vim"": {""insertions"": 1, ""deletions"": 1, ""lines"": 2}, ""runtime/syntax/dts.vim"": {""insertions"": 2, ""deletions"": 1, ""lines"": 3}, ""runtime/syntax/icon.vim"": {""insertions"": 174, ""deletions"": 162, ""lines"": 336}, ""runtime/syntax/initng.vim"": {""insertions"": 0, ""deletions"": 1, ""lines"": 1}, ""runtime/syntax/ipfilter.vim"": {""insertions"": 2, ""deletions"": 1, ""lines"": 3}, ""runtime/syntax/mupad.vim"": {""insertions"": 1, ""deletions"": 0, ""lines"": 1}, ""runtime/syntax/perl.vim"": {""insertions"": 12, ""deletions"": 5, ""lines"": 17}, ""runtime/syntax/pod.vim"": {""insertions"": 1, ""deletions"": 1, ""lines"": 2}, ""runtime/syntax/sendpr.vim"": {""insertions"": 3, ""deletions"": 1, ""lines"": 4}, ""runtime/syntax/tar.vim"": {""insertions"": 2, ""deletions"": 0, ""lines"": 2}, ""runtime/syntax/trustees.vim"": {""insertions"": 3, ""deletions"": 1, ""lines"": 4}, ""runtime/syntax/vim.vim"": {""insertions"": 5, ""deletions"": 5, ""lines"": 10}, ""src/po/ca.po"": {""insertions"": 108, ""deletions"": 240, ""lines"": 348}, ""src/po/cleanup.vim"": {""insertions"": 3, ""deletions"": 0, ""lines"": 3}, ""src/po/it.po"": {""insertions"": 23, ""deletions"": 1, ""lines"": 24}}"
2022-06-17 14:17:10,616592e0816d2d9f893fcd95e3e1e0fbc5893168,Bram Moolenaar,80,37,117,7,"{""src/os_unix.c"": {""insertions"": 6, ""deletions"": 4, ""lines"": 10}, ""src/proto/os_unix.pro"": {""insertions"": 1, ""deletions"": 1, ""lines"": 2}, ""src/regexp.c"": {""insertions"": 1, ""deletions"": 1, ""lines"": 2}, ""src/regexp_bt.c"": {""insertions"": 31, ""deletions"": 8, ""lines"": 39}, ""src/regexp_nfa.c"": {""insertions"": 27, ""deletions"": 21, ""lines"": 48}, ""src/testdir/test_search.vim"": {""insertions"": 12, ""deletions"": 2, ""lines"": 14}, ""src/version.c"": {""insertions"": 2, ""deletions"": 0, ""lines"": 2}}"
2022-06-16 20:20:48,5ea38d1e7fd597ffde13b292d43e12747f20e97f,Bram Moolenaar,42,11,53,4,"{""src/evalfunc.c"": {""insertions"": 7, ""deletions"": 3, ""lines"": 10}, ""src/search.c"": {""insertions"": 8, ""deletions"": 7, ""lines"": 15}, ""src/testdir/test_search.vim"": {""insertions"": 25, ""deletions"": 1, ""lines"": 26}, ""src/version.c"": {""insertions"": 2, ""deletions"": 0, ""lines"": 2}}"
2022-06-16 17:47:20,c72e31dfcc013ae840cd7f8899f2430b7f6812c9,Bram Moolenaar,22,1,23,4,"{""src/gui.c"": {""insertions"": 5, ""deletions"": 0, ""lines"": 5}, ""src/os_unix.c"": {""insertions"": 14, ""deletions"": 1, ""lines"": 15}, ""src/proto/os_unix.pro"": {""insertions"": 1, ""deletions"": 0, ""lines"": 1}, ""src/version.c"": {""insertions"": 2, ""deletions"": 0, ""lines"": 2}}"
2022-06-16 15:36:43,a272624c763fea9f98510bbc5b1f2b65a309c765,Bram Moolenaar,7,1,8,2,"{""src/testdir/test_gui.vim"": {""insertions"": 5, ""deletions"": 1, ""lines"": 6}, ""src/version.c"": {""insertions"": 2, ""deletions"": 0, ""lines"": 2}}"
2022-06-16 13:45:41,de8be2beaeb99961247766a9b8181429be1617d6,Bram Moolenaar,21,3,24,2,"{""src/testdir/test_gui.vim"": {""insertions"": 19, ""deletions"": 3, ""lines"": 22}, ""src/version.c"": {""insertions"": 2, ""deletions"": 0, ""lines"": 2}}"
2022-06-16 12:27:18,bf6614643f656d38d220c04befdcb1d35774853a,Bram Moolenaar,7,0,7,3,"{""runtime/autoload/dist/script.vim"": {""insertions"": 4, ""deletions"": 0, ""lines"": 4}, ""src/testdir/test_filetype.vim"": {""insertions"": 1, ""deletions"": 0, ""lines"": 1}, ""src/version.c"": {""insertions"": 2, ""deletions"": 0, ""lines"": 2}}"
2022-06-16 12:04:45,7a1d32809bb5c1527314000983e75125d79192e0,Bram Moolenaar,28,3,31,5,"{""src/main.c"": {""insertions"": 1, ""deletions"": 1, ""lines"": 2}, ""src/normal.c"": {""insertions"": 3, ""deletions"": 0, ""lines"": 3}, ""src/testdir/dumps/Test_mode_updated_1.dump"": {""insertions"": 5, ""deletions"": 0, ""lines"": 5}, ""src/testdir/test_normal.vim"": {""insertions"": 17, ""deletions"": 2, ""lines"": 19}, ""src/version.c"": {""insertions"": 2, ""deletions"": 0, ""lines"": 2}}"
2022-06-16 11:10:48,308660bd263367a4f1a75498cbd2e29cade47f4d,Bram Moolenaar,20,16,36,3,"{""src/indent.c"": {""insertions"": 16, ""deletions"": 8, ""lines"": 24}, ""src/testdir/test_retab.vim"": {""insertions"": 2, ""deletions"": 8, ""lines"": 10}, ""src/version.c"": {""insertions"": 2, ""deletions"": 0, ""lines"": 2}}"
2022-06-16 10:42:09,93a1096fe48e12095544924adb267e3b8a16b221,Bram Moolenaar,40,38,78,17,"{""src/channel.c"": {""insertions"": 1, ""deletions"": 1, ""lines"": 2}, ""src/cmdexpand.c"": {""insertions"": 1, ""deletions"": 1, ""lines"": 2}, ""src/evalbuffer.c"": {""insertions"": 1, ""deletions"": 1, ""lines"": 2}, ""src/evalfunc.c"": {""insertions"": 12, ""deletions"": 12, ""lines"": 24}, ""src/evalwindow.c"": {""insertions"": 5, ""deletions"": 5, ""lines"": 10}, ""src/insexpand.c"": {""insertions"": 1, ""deletions"": 1, ""lines"": 2}, ""src/job.c"": {""insertions"": 1, ""deletions"": 1, ""lines"": 2}, ""src/list.c"": {""insertions"": 1, ""deletions"": 1, ""lines"": 2}, ""src/map.c"": {""insertions"": 2, ""deletions"": 2, ""lines"": 4}, ""src/menu.c"": {""insertions"": 1, ""deletions"": 1, ""lines"": 2}, ""src/mouse.c"": {""insertions"": 1, ""deletions"": 1, ""lines"": 2}, ""src/move.c"": {""insertions"": 1, ""deletions"": 1, ""lines"": 2}, ""src/sign.c"": {""insertions"": 6, ""deletions"": 6, ""lines"": 12}, ""src/term.c"": {""insertions"": 1, ""deletions"": 1, ""lines"": 2}, ""src/textprop.c"": {""insertions"": 1, ""deletions"": 1, ""lines"": 2}, ""src/time.c"": {""insertions"": 2, ""deletions"": 2, ""lines"": 4}, ""src/version.c"": {""insertions"": 2, ""deletions"": 0, ""lines"": 2}}"
2022-06-16 10:14:55,44068e97dbd8fc8ebd93113e436a1e37a6bff52c,zeertzjq,37,25,62,7,"{""src/digraph.c"": {""insertions"": 2, ""deletions"": 2, ""lines"": 4}, ""src/ex_getln.c"": {""insertions"": 2, ""deletions"": 2, ""lines"": 4}, ""src/map.c"": {""insertions"": 22, ""deletions"": 17, ""lines"": 39}, ""src/netbeans.c"": {""insertions"": 1, ""deletions"": 1, ""lines"": 2}, ""src/proto/map.pro"": {""insertions"": 1, ""deletions"": 1, ""lines"": 2}, ""src/version.c"": {""insertions"": 2, ""deletions"": 0, ""lines"": 2}, ""src/vim.h"": {""insertions"": 7, ""deletions"": 2, ""lines"": 9}}"
2022-06-15 21:11:45,83497f875881973df772cc4cc593766345df6c4a,Bram Moolenaar,8,9,17,2,"{""src/testdir/test_retab.vim"": {""insertions"": 6, ""deletions"": 9, ""lines"": 15}, ""src/version.c"": {""insertions"": 2, ""deletions"": 0, ""lines"": 2}}"
2022-06-15 20:28:55,b31cb04771234556374cda45ce19dabd4a2a7fc7,Bram Moolenaar,8,1,9,2,"{""src/testdir/test_retab.vim"": {""insertions"": 6, ""deletions"": 1, ""lines"": 7}, ""src/version.c"": {""insertions"": 2, ""deletions"": 0, ""lines"": 2}}"
2022-06-15 20:08:09,34f99584c73f91bcc8ca5236557a2a09335e1e43,Bram Moolenaar,7,0,7,3,"{""src/indent.c"": {""insertions"": 2, ""deletions"": 0, ""lines"": 2}, ""src/testdir/test_retab.vim"": {""insertions"": 3, ""deletions"": 0, ""lines"": 3}, ""src/version.c"": {""insertions"": 2, ""deletions"": 0, ""lines"": 2}}"
2022-06-15 19:49:35,8bea171f154845046239c61bdef50a8e0f12f643,Bram Moolenaar,31,12,43,5,"{""src/indent.c"": {""insertions"": 4, ""deletions"": 2, ""lines"": 6}, ""src/testdir/runtest.vim"": {""insertions"": 2, ""deletions"": 2, ""lines"": 4}, ""src/testdir/test_retab.vim"": {""insertions"": 22, ""deletions"": 8, ""lines"": 30}, ""src/testing.c"": {""insertions"": 1, ""deletions"": 0, ""lines"": 1}, ""src/version.c"": {""insertions"": 2, ""deletions"": 0, ""lines"": 2}}"
2022-06-15 17:31:45,cf65d88ff844f042337dfd043e6e98f3b9270577,Yegappan Lakshmanan,9,4,13,3,"{""src/INSTALLpc.txt"": {""insertions"": 3, ""deletions"": 2, ""lines"": 5}, ""src/Make_cyg_ming.mak"": {""insertions"": 4, ""deletions"": 2, ""lines"": 6}, ""src/version.c"": {""insertions"": 2, ""deletions"": 0, ""lines"": 2}}"
2022-06-15 17:08:42,dad5d2f87b867dab48ac265e3d978d86f0541493,Bram Moolenaar,5,0,5,2,"{""src/testdir/test_memory_usage.vim"": {""insertions"": 3, ""deletions"": 0, ""lines"": 3}, ""src/version.c"": {""insertions"": 2, ""deletions"": 0, ""lines"": 2}}"
2022-06-15 16:52:44,62eb239c1c19ff3e08e492ecf01b1246082a03ac,Bram Moolenaar,7,1,8,2,"{""src/testdir/test_terminal.vim"": {""insertions"": 5, ""deletions"": 1, ""lines"": 6}, ""src/version.c"": {""insertions"": 2, ""deletions"": 0, ""lines"": 2}}"
2022-06-15 15:57:44,fc9f0fd6d18c03d6420f84ebb374a373c830fbad,Bram Moolenaar,57,17,74,2,"{""src/testdir/test_spell.vim"": {""insertions"": 55, ""deletions"": 17, ""lines"": 72}, ""src/version.c"": {""insertions"": 2, ""deletions"": 0, ""lines"": 2}}"
2022-06-15 11:12:44,74ac29cecd56457ee93f3f71b31b7a2e6d9712d6,Bram Moolenaar,5,2,7,2,"{""src/message.c"": {""insertions"": 3, ""deletions"": 2, ""lines"": 5}, ""src/version.c"": {""insertions"": 2, ""deletions"": 0, ""lines"": 2}}"
2022-06-14 20:22:12,377d92a912d4d11a336322a6eeff128cf8ebb5fa,Bram Moolenaar,3,1,4,2,"{""src/testdir/test_terminal.vim"": {""insertions"": 1, ""deletions"": 1, ""lines"": 2}, ""src/version.c"": {""insertions"": 2, ""deletions"": 0, ""lines"": 2}}"
2022-06-14 18:52:16,99f4b6e0824b339510aaaa0bb81c50f5866f6be1,Bram Moolenaar,5,3,8,2,"{""src/testdir/test_terminal.vim"": {""insertions"": 3, ""deletions"": 3, ""lines"": 6}, ""src/version.c"": {""insertions"": 2, ""deletions"": 0, ""lines"": 2}}"
2022-06-14 16:41:28,8c1b8cb2e0b52d0853f85c2096a2f22dbc57a788,Bram Moolenaar,2839,1511,4350,42,"{"".github/CODEOWNERS"": {""insertions"": 17, ""deletions"": 0, ""lines"": 17}, ""runtime/colors/blue.vim"": {""insertions"": 166, ""deletions"": 51, ""lines"": 217}, ""runtime/colors/darkblue.vim"": {""insertions"": 166, ""deletions"": 169, ""lines"": 335}, ""runtime/colors/delek.vim"": {""insertions"": 129, ""deletions"": 61, ""lines"": 190}, ""runtime/colors/desert.vim"": {""insertions"": 115, ""deletions"": 54, ""lines"": 169}, ""runtime/colors/elflord.vim"": {""insertions"": 105, ""deletions"": 33, ""lines"": 138}, ""runtime/colors/evening.vim"": {""insertions"": 218, ""deletions"": 154, ""lines"": 372}, ""runtime/colors/industry.vim"": {""insertions"": 104, ""deletions"": 35, ""lines"": 139}, ""runtime/colors/koehler.vim"": {""insertions"": 107, ""deletions"": 43, ""lines"": 150}, ""runtime/colors/morning.vim"": {""insertions"": 129, ""deletions"": 64, ""lines"": 193}, ""runtime/colors/murphy.vim"": {""insertions"": 99, ""deletions"": 41, ""lines"": 140}, ""runtime/colors/pablo.vim"": {""insertions"": 101, ""deletions"": 30, ""lines"": 131}, ""runtime/colors/peachpuff.vim"": {""insertions"": 144, ""deletions"": 75, ""lines"": 219}, ""runtime/colors/ron.vim"": {""insertions"": 71, ""deletions"": 7, ""lines"": 78}, ""runtime/colors/shine.vim"": {""insertions"": 134, ""deletions"": 75, ""lines"": 209}, ""runtime/colors/slate.vim"": {""insertions"": 102, ""deletions"": 42, ""lines"": 144}, ""runtime/colors/torte.vim"": {""insertions"": 102, ""deletions"": 45, ""lines"": 147}, ""runtime/colors/zellner.vim"": {""insertions"": 111, ""deletions"": 45, ""lines"": 156}, ""runtime/compiler/perl.vim"": {""insertions"": 11, ""deletions"": 7, ""lines"": 18}, ""runtime/compiler/perlcritic.vim"": {""insertions"": 27, ""deletions"": 0, ""lines"": 27}, ""runtime/compiler/podchecker.vim"": {""insertions"": 28, ""deletions"": 0, ""lines"": 28}, ""runtime/doc/starting.txt"": {""insertions"": 2, ""deletions"": 2, ""lines"": 4}, ""runtime/doc/tags"": {""insertions"": 1, ""deletions"": 0, ""lines"": 1}, ""runtime/doc/todo.txt"": {""insertions"": 5, ""deletions"": 3, ""lines"": 8}, ""runtime/ftplugin/m3build.vim"": {""insertions"": 4, ""deletions"": 5, ""lines"": 9}, ""runtime/ftplugin/m3quake.vim"": {""insertions"": 6, ""deletions"": 4, ""lines"": 10}, ""runtime/ftplugin/modula3.vim"": {""insertions"": 11, ""deletions"": 7, ""lines"": 18}, ""runtime/ftplugin/perl.vim"": {""insertions"": 40, ""deletions"": 20, ""lines"": 60}, ""runtime/ftplugin/pod.vim"": {""insertions"": 71, ""deletions"": 0, ""lines"": 71}, ""runtime/ftplugin/tap.vim"": {""insertions"": 27, ""deletions"": 0, ""lines"": 27}, ""runtime/ftplugin/tt2html.vim"": {""insertions"": 5, ""deletions"": 3, ""lines"": 8}, ""runtime/ftplugin/xs.vim"": {""insertions"": 4, ""deletions"": 3, ""lines"": 7}, ""runtime/indent/perl.vim"": {""insertions"": 91, ""deletions"": 162, ""lines"": 253}, ""runtime/syntax/mason.vim"": {""insertions"": 9, ""deletions"": 7, ""lines"": 16}, ""runtime/syntax/perl.vim"": {""insertions"": 243, ""deletions"": 170, ""lines"": 413}, ""runtime/syntax/pod.vim"": {""insertions"": 93, ""deletions"": 46, ""lines"": 139}, ""runtime/syntax/tap.vim"": {""insertions"": 6, ""deletions"": 17, ""lines"": 23}, ""runtime/syntax/tt2.vim"": {""insertions"": 8, ""deletions"": 9, ""lines"": 17}, ""runtime/syntax/tt2html.vim"": {""insertions"": 5, ""deletions"": 3, ""lines"": 8}, ""runtime/syntax/tt2js.vim"": {""insertions"": 5, ""deletions"": 3, ""lines"": 8}, ""runtime/syntax/vim.vim"": {""insertions"": 9, ""deletions"": 11, ""lines"": 20}, ""runtime/syntax/xs.vim"": {""insertions"": 8, ""deletions"": 5, ""lines"": 13}}"
2022-06-14 16:13:59,217ea51ee4c4cb6cf690eb0da70cc4c81291aa2e,Bram Moolenaar,6,2,8,3,"{""src/testdir/runtest.vim"": {""insertions"": 1, ""deletions"": 2, ""lines"": 3}, ""src/testdir/test_ex_mode.vim"": {""insertions"": 3, ""deletions"": 0, ""lines"": 3}, ""src/version.c"": {""insertions"": 2, ""deletions"": 0, ""lines"": 2}}"
2022-06-14 15:06:07,6ce1b59228b94f4a5b076af75b091e14483c1392,Bram Moolenaar,5,1,6,2,"{""src/ex_docmd.c"": {""insertions"": 3, ""deletions"": 1, ""lines"": 4}, ""src/version.c"": {""insertions"": 2, ""deletions"": 0, ""lines"": 2}}"
2022-06-14 14:43:18,48ce135e6d45e6c10ed0c0fc4cb8433bf647672a,Bram Moolenaar,18,11,29,2,"{""src/ex_docmd.c"": {""insertions"": 16, ""deletions"": 11, ""lines"": 27}, ""src/version.c"": {""insertions"": 2, ""deletions"": 0, ""lines"": 2}}"
2022-06-14 14:00:28,e564c7009dfb065fb5261e548b15f83d32f735c9,Bram Moolenaar,6,0,6,2,"{""src/testdir/test_terminal.vim"": {""insertions"": 4, ""deletions"": 0, ""lines"": 4}, ""src/version.c"": {""insertions"": 2, ""deletions"": 0, ""lines"": 2}}"
2022-06-14 12:58:29,831d6d4c02ca629e7e7a28537fd9048351e5db5c,K.Takata,4,8,12,4,"{""Filelist"": {""insertions"": 0, ""deletions"": 1, ""lines"": 1}, ""Makefile"": {""insertions"": 2, ""deletions"": 3, ""lines"": 5}, ""src/version.c"": {""insertions"": 2, ""deletions"": 0, ""lines"": 2}, ""src/vim.def"": {""insertions"": 0, ""deletions"": 4, ""lines"": 4}}"
2022-06-14 12:42:26,ca195cc84fb3f5e497cdbc5f1f53dc1d7efedf48,Yegappan Lakshmanan,14,6,20,5,"{""src/autocmd.c"": {""insertions"": 2, ""deletions"": 2, ""lines"": 4}, ""src/dict.c"": {""insertions"": 3, ""deletions"": 2, ""lines"": 5}, ""src/evalfunc.c"": {""insertions"": 4, ""deletions"": 1, ""lines"": 5}, ""src/list.c"": {""insertions"": 3, ""deletions"": 1, ""lines"": 4}, ""src/version.c"": {""insertions"": 2, ""deletions"": 0, ""lines"": 2}}"
2022-06-14 12:30:35,cd7496382efc9e6748326c6cda7f01003fa07063,zeertzjq,11,11,22,5,"{""src/ex_docmd.c"": {""insertions"": 6, ""deletions"": 7, ""lines"": 13}, ""src/ex_getln.c"": {""insertions"": 0, ""deletions"": 1, ""lines"": 1}, ""src/globals.h"": {""insertions"": 1, ""deletions"": 1, ""lines"": 2}, ""src/structs.h"": {""insertions"": 2, ""deletions"": 2, ""lines"": 4}, ""src/version.c"": {""insertions"": 2, ""deletions"": 0, ""lines"": 2}}"
2022-06-14 11:30:25,1630bd980a1f7f62adc6f73cb20be66a3c382225,Yegappan Lakshmanan,56,1,57,4,"{""src/GvimExt/Make_ming.mak"": {""insertions"": 2, ""deletions"": 0, ""lines"": 2}, ""src/INSTALLpc.txt"": {""insertions"": 23, ""deletions"": 0, ""lines"": 23}, ""src/Make_cyg_ming.mak"": {""insertions"": 29, ""deletions"": 1, ""lines"": 30}, ""src/version.c"": {""insertions"": 2, ""deletions"": 0, ""lines"": 2}}"
2022-06-14 10:35:21,361f9d2da4eee27797deaa3283c5054106324b09,Philip H,13,3,16,2,"{"".github/workflows/ci.yml"": {""insertions"": 11, ""deletions"": 3, ""lines"": 14}, ""src/version.c"": {""insertions"": 2, ""deletions"": 0, ""lines"": 2}}"
2022-06-13 21:34:14,819ab82f7ee505d6fc4c6dc408e4b27c0fbe4a97,Bram Moolenaar,5,3,8,2,"{""src/os_mswin.c"": {""insertions"": 3, ""deletions"": 3, ""lines"": 6}, ""src/version.c"": {""insertions"": 2, ""deletions"": 0, ""lines"": 2}}"
2022-06-13 20:42:45,2d12c25a1b73fb6991006fd970b3132ab8ee8b62,Bram Moolenaar,111,18,129,15,"{""runtime/doc/starting.txt"": {""insertions"": 7, ""deletions"": 0, ""lines"": 7}, ""src/Make_mvc.mak"": {""insertions"": 1, ""deletions"": 1, ""lines"": 2}, ""src/gui.c"": {""insertions"": 23, ""deletions"": 0, ""lines"": 23}, ""src/main.c"": {""insertions"": 30, ""deletions"": 0, ""lines"": 30}, ""src/message.c"": {""insertions"": 5, ""deletions"": 1, ""lines"": 6}, ""src/os_mswin.c"": {""insertions"": 4, ""deletions"": 1, ""lines"": 5}, ""src/proto/gui.pro"": {""insertions"": 1, ""deletions"": 0, ""lines"": 1}, ""src/proto/main.pro"": {""insertions"": 1, ""deletions"": 0, ""lines"": 1}, ""src/structs.h"": {""insertions"": 3, ""deletions"": 0, ""lines"": 3}, ""src/testdir/Make_dos.mak"": {""insertions"": 12, ""deletions"": 7, ""lines"": 19}, ""src/testdir/Make_ming.mak"": {""insertions"": 12, ""deletions"": 7, ""lines"": 19}, ""src/testdir/Makefile"": {""insertions"": 3, ""deletions"": 1, ""lines"": 4}, ""src/testdir/runtest.vim"": {""insertions"": 6, ""deletions"": 0, ""lines"": 6}, ""src/testdir/shared.vim"": {""insertions"": 1, ""deletions"": 0, ""lines"": 1}, ""src/version.c"": {""insertions"": 2, ""deletions"": 0, ""lines"": 2}}"
2022-06-12 22:26:50,db77c49401145d76441fbb3d22a1d7d987681c13,Bram Moolenaar,3,4,7,2,"{""src/testdir/test_autocmd.vim"": {""insertions"": 1, ""deletions"": 4, ""lines"": 5}, ""src/version.c"": {""insertions"": 2, ""deletions"": 0, ""lines"": 2}}"
2022-06-12 22:05:07,93974239857318fe604e53abd41ffead04b7c657,Bram Moolenaar,7,3,10,2,"{""src/testdir/test_retab.vim"": {""insertions"": 5, ""deletions"": 3, ""lines"": 8}, ""src/version.c"": {""insertions"": 2, ""deletions"": 0, ""lines"": 2}}"
2022-06-12 21:33:33,7c0d0c3c75151e716184397a41ff74ab0429db5a,Bram Moolenaar,5,0,5,2,"{""src/testdir/test_autocmd.vim"": {""insertions"": 3, ""deletions"": 0, ""lines"": 3}, ""src/version.c"": {""insertions"": 2, ""deletions"": 0, ""lines"": 2}}"
2022-06-12 21:15:57,6ba83ba9ee292f68aa0b218b3eef42db31c0b632,Bram Moolenaar,120,54,174,10,"{""runtime/doc/builtin.txt"": {""insertions"": 42, ""deletions"": 8, ""lines"": 50}, ""runtime/doc/index.txt"": {""insertions"": 2, ""deletions"": 2, ""lines"": 4}, ""runtime/doc/syntax.txt"": {""insertions"": 3, ""deletions"": 3, ""lines"": 6}, ""runtime/doc/todo.txt"": {""insertions"": 4, ""deletions"": 1, ""lines"": 5}, ""runtime/doc/usr_41.txt"": {""insertions"": 3, ""deletions"": 3, ""lines"": 6}, ""runtime/doc/vim9.txt"": {""insertions"": 6, ""deletions"": 4, ""lines"": 10}, ""runtime/import/dist/vimhelp.vim"": {""insertions"": 19, ""deletions"": 15, ""lines"": 34}, ""runtime/syntax/m4.vim"": {""insertions"": 2, ""deletions"": 1, ""lines"": 3}, ""runtime/syntax/sh.vim"": {""insertions"": 33, ""deletions"": 13, ""lines"": 46}, ""runtime/syntax/vim.vim"": {""insertions"": 6, ""deletions"": 4, ""lines"": 10}}"
2022-06-12 20:11:03,a7ac4c9c395d64059437e37045fa0ad5f9fecb0b,Bram Moolenaar,4,0,4,2,"{""src/indent.c"": {""insertions"": 2, ""deletions"": 0, ""lines"": 2}, ""src/version.c"": {""insertions"": 2, ""deletions"": 0, ""lines"": 2}}"
2022-06-12 10:49:16,d8c9d32c8932e93008bfd4e8828ed42f4e9f8315,Bram Moolenaar,12,1,13,3,"{""src/ex_docmd.c"": {""insertions"": 3, ""deletions"": 1, ""lines"": 4}, ""src/testdir/test_autocmd.vim"": {""insertions"": 7, ""deletions"": 0, ""lines"": 7}, ""src/version.c"": {""insertions"": 2, ""deletions"": 0, ""lines"": 2}}"
2022-06-12 10:13:05,3269efdf014dd3b6e60e330950d40a7cc5d13d3a,zeertzjq,9,5,14,2,"{""src/testdir/test_substitute.vim"": {""insertions"": 7, ""deletions"": 5, ""lines"": 12}, ""src/version.c"": {""insertions"": 2, ""deletions"": 0, ""lines"": 2}}"
2022-06-11 09:43:26,a34b4460c2843c67a35a2d236b01e6cb9bc38734,Yegappan Lakshmanan,24,18,42,7,"{""src/dosinst.c"": {""insertions"": 1, ""deletions"": 1, ""lines"": 2}, ""src/dosinst.h"": {""insertions"": 9, ""deletions"": 9, ""lines"": 18}, ""src/filepath.c"": {""insertions"": 2, ""deletions"": 1, ""lines"": 3}, ""src/gui_w32.c"": {""insertions"": 1, ""deletions"": 1, ""lines"": 2}, ""src/misc1.c"": {""insertions"": 4, ""deletions"": 1, ""lines"": 5}, ""src/os_win32.c"": {""insertions"": 5, ""deletions"": 5, ""lines"": 10}, ""src/version.c"": {""insertions"": 2, ""deletions"": 0, ""lines"": 2}}"
2022-06-10 14:30:32,2e7cba347fc8b746add12aa5e0e9f6218a76c788,zeertzjq,10,28,38,3,"{""src/drawline.c"": {""insertions"": 5, ""deletions"": 4, ""lines"": 9}, ""src/getchar.c"": {""insertions"": 3, ""deletions"": 24, ""lines"": 27}, ""src/version.c"": {""insertions"": 2, ""deletions"": 0, ""lines"": 2}}"
2022-06-10 13:52:35,b74e04649168aec579183dfef70b8784d2afe993,Bram Moolenaar,4,1,5,2,"{""src/ui.c"": {""insertions"": 2, ""deletions"": 1, ""lines"": 3}, ""src/version.c"": {""insertions"": 2, ""deletions"": 0, ""lines"": 2}}"
2022-06-09 23:02:10,ad73cc2ff2a8b5397ed20598757b702a4e686256,Bram Moolenaar,3,3,6,2,"{""src/testdir/test_spell_utf8.vim"": {""insertions"": 1, ""deletions"": 3, ""lines"": 4}, ""src/version.c"": {""insertions"": 2, ""deletions"": 0, ""lines"": 2}}"
2022-06-09 19:53:54,35d7a2fb13fc833aa1b654ca6fd6e429e72e6b49,Bram Moolenaar,137,105,242,12,"{""src/dosinst.c"": {""insertions"": 3, ""deletions"": 3, ""lines"": 6}, ""src/dosinst.h"": {""insertions"": 7, ""deletions"": 1, ""lines"": 8}, ""src/gui_dwrite.cpp"": {""insertions"": 29, ""deletions"": 23, ""lines"": 52}, ""src/gui_w32.c"": {""insertions"": 23, ""deletions"": 21, ""lines"": 44}, ""src/iscygpty.c"": {""insertions"": 9, ""deletions"": 4, ""lines"": 13}, ""src/libvterm/src/vterm_internal.h"": {""insertions"": 5, ""deletions"": 1, ""lines"": 6}, ""src/mbyte.c"": {""insertions"": 11, ""deletions"": 6, ""lines"": 17}, ""src/os_win32.c"": {""insertions"": 12, ""deletions"": 10, ""lines"": 22}, ""src/os_win32.h"": {""insertions"": 1, ""deletions"": 1, ""lines"": 2}, ""src/term.c"": {""insertions"": 34, ""deletions"": 34, ""lines"": 68}, ""src/version.c"": {""insertions"": 2, ""deletions"": 0, ""lines"": 2}, ""src/xdiff/xinclude.h"": {""insertions"": 1, ""deletions"": 1, ""lines"": 2}}"
2022-06-09 19:45:54,63f32603789d1a27c559fc440325955fd0b8b500,Bram Moolenaar,1136,1829,2965,19,"{""runtime/doc/options.txt"": {""insertions"": 1, ""deletions"": 1, ""lines"": 2}, ""runtime/doc/tags"": {""insertions"": 4, ""deletions"": 0, ""lines"": 4}, ""runtime/doc/terminal.txt"": {""insertions"": 2, ""deletions"": 2, ""lines"": 4}, ""runtime/doc/todo.txt"": {""insertions"": 6, ""deletions"": 1, ""lines"": 7}, ""runtime/doc/usr_41.txt"": {""insertions"": 69, ""deletions"": 130, ""lines"": 199}, ""runtime/doc/usr_50.txt"": {""insertions"": 96, ""deletions"": 26, ""lines"": 122}, ""runtime/doc/usr_toc.txt"": {""insertions"": 7, ""deletions"": 4, ""lines"": 11}, ""runtime/doc/vim9.txt"": {""insertions"": 52, ""deletions"": 31, ""lines"": 83}, ""runtime/ftplugin/cs.vim"": {""insertions"": 29, ""deletions"": 15, ""lines"": 44}, ""runtime/import/dist/vimhelp.vim"": {""insertions"": 1, ""deletions"": 1, ""lines"": 2}, ""runtime/indent/cs.vim"": {""insertions"": 12, ""deletions"": 10, ""lines"": 22}, ""runtime/syntax/cs.vim"": {""insertions"": 188, ""deletions"": 88, ""lines"": 276}, ""runtime/syntax/java.vim"": {""insertions"": 38, ""deletions"": 13, ""lines"": 51}, ""runtime/syntax/javascript.vim"": {""insertions"": 10, ""deletions"": 3, ""lines"": 13}, ""runtime/syntax/m4.vim"": {""insertions"": 2, ""deletions"": 1, ""lines"": 3}, ""runtime/syntax/webmacro.vim"": {""insertions"": 3, ""deletions"": 3, ""lines"": 6}, ""src/po/cleanup.vim"": {""insertions"": 2, ""deletions"": 1, ""lines"": 3}, ""src/po/sr.po"": {""insertions"": 506, ""deletions"": 1315, ""lines"": 1821}, ""src/po/tr.po"": {""insertions"": 108, ""deletions"": 184, ""lines"": 292}}"
2022-06-09 18:54:24,2813f38e021c6e6581c0c88fcf107e41788bc835,Bram Moolenaar,24,3,27,3,"{""src/spell.c"": {""insertions"": 7, ""deletions"": 3, ""lines"": 10}, ""src/testdir/test_spell_utf8.vim"": {""insertions"": 15, ""deletions"": 0, ""lines"": 15}, ""src/version.c"": {""insertions"": 2, ""deletions"": 0, ""lines"": 2}}"
2022-06-09 13:50:10,f5465ff5c83f5a8a3e05bec64a0c013e5bdeb46e,ichizok,5,4,9,2,"{""src/os_mac.h"": {""insertions"": 3, ""deletions"": 4, ""lines"": 7}, ""src/version.c"": {""insertions"": 2, ""deletions"": 0, ""lines"": 2}}"
2022-06-09 12:55:28,b5f0801b1f043b5cf99380f58eca51b75b3236c7,zeertzjq,12,16,28,3,"{""src/message.c"": {""insertions"": 4, ""deletions"": 10, ""lines"": 14}, ""src/screen.c"": {""insertions"": 6, ""deletions"": 6, ""lines"": 12}, ""src/version.c"": {""insertions"": 2, ""deletions"": 0, ""lines"": 2}}"
2022-06-08 14:14:09,ebb01bdb273216607f60faddf791a1b378cccfa8,Yegappan Lakshmanan,9,8,17,6,"{""src/dosinst.c"": {""insertions"": 2, ""deletions"": 2, ""lines"": 4}, ""src/fileio.c"": {""insertions"": 0, ""deletions"": 1, ""lines"": 1}, ""src/gui_w32.c"": {""insertions"": 3, ""deletions"": 2, ""lines"": 5}, ""src/os_mswin.c"": {""insertions"": 1, ""deletions"": 1, ""lines"": 2}, ""src/os_win32.c"": {""insertions"": 1, ""deletions"": 2, ""lines"": 3}, ""src/version.c"": {""insertions"": 2, ""deletions"": 0, ""lines"": 2}}"
2022-06-08 12:11:45,68093d36bf87caf2c2ba7404c06d14ef8416c27a,Bram Moolenaar,5,2,7,2,"{""src/tee/tee.c"": {""insertions"": 3, ""deletions"": 2, ""lines"": 5}, ""src/version.c"": {""insertions"": 2, ""deletions"": 0, ""lines"": 2}}"
2022-06-08 09:48:18,f78b52ba24d8d294869cd013dcc4cd5d4a65cea7,Bram Moolenaar,3,1,4,2,"{""src/os_unix.c"": {""insertions"": 1, ""deletions"": 1, ""lines"": 2}, ""src/version.c"": {""insertions"": 2, ""deletions"": 0, ""lines"": 2}}"
2022-06-07 09:16:15,aca12fd89b082dd9cc12ae085a84f1805747bbdf,Bram Moolenaar,246,13,259,8,"{""runtime/doc/options.txt"": {""insertions"": 11, ""deletions"": 2, ""lines"": 13}, ""src/drawline.c"": {""insertions"": 20, ""deletions"": 3, ""lines"": 23}, ""src/message.c"": {""insertions"": 18, ""deletions"": 2, ""lines"": 20}, ""src/screen.c"": {""insertions"": 51, ""deletions"": 1, ""lines"": 52}, ""src/structs.h"": {""insertions"": 1, ""deletions"": 0, ""lines"": 1}, ""src/testdir/test_listchars.vim"": {""insertions"": 142, ""deletions"": 5, ""lines"": 147}, ""src/version.c"": {""insertions"": 2, ""deletions"": 0, ""lines"": 2}, ""src/window.c"": {""insertions"": 1, ""deletions"": 0, ""lines"": 1}}"
2022-06-06 21:16:09,739f7998ab6c2383abbd8bbc7fad35e6bc3e7c43,Bram Moolenaar,3,2,5,2,"{""src/tee/tee.c"": {""insertions"": 1, ""deletions"": 2, ""lines"": 3}, ""src/version.c"": {""insertions"": 2, ""deletions"": 0, ""lines"": 2}}"
2022-06-06 19:52:59,016188fd8a30cfbaca3faa0daea9a47138dc5c4b,Bram Moolenaar,225,1190,1415,13,"{""runtime/doc/builtin.txt"": {""insertions"": 67, ""deletions"": 16, ""lines"": 83}, ""runtime/doc/channel.txt"": {""insertions"": 1, ""deletions"": 1, ""lines"": 2}, ""runtime/doc/popup.txt"": {""insertions"": 6, ""deletions"": 2, ""lines"": 8}, ""runtime/doc/starting.txt"": {""insertions"": 1, ""deletions"": 1, ""lines"": 2}, ""runtime/doc/todo.txt"": {""insertions"": 8, ""deletions"": 5, ""lines"": 13}, ""runtime/doc/usr_41.txt"": {""insertions"": 4, ""deletions"": 3, ""lines"": 7}, ""runtime/doc/usr_50.txt"": {""insertions"": 2, ""deletions"": 2, ""lines"": 4}, ""runtime/doc/usr_52.txt"": {""insertions"": 107, ""deletions"": 47, ""lines"": 154}, ""runtime/plugin/manpager.vim"": {""insertions"": 7, ""deletions"": 4, ""lines"": 11}, ""runtime/syntax/i3config.vim"": {""insertions"": 2, ""deletions"": 6, ""lines"": 8}, ""src/po/af.po"": {""insertions"": 0, ""deletions"": 352, ""lines"": 352}, ""src/po/cleanup.vim"": {""insertions"": 3, ""deletions"": 0, ""lines"": 3}, ""src/po/it.po"": {""insertions"": 17, ""deletions"": 751, ""lines"": 768}}"
2022-06-06 15:22:46,3760bfddc414e4d3e1c4203db8c22e293cf08d09,zeertzjq,34,2,36,3,"{""src/getchar.c"": {""insertions"": 2, ""deletions"": 2, ""lines"": 4}, ""src/testdir/test_mapping.vim"": {""insertions"": 30, ""deletions"": 0, ""lines"": 30}, ""src/version.c"": {""insertions"": 2, ""deletions"": 0, ""lines"": 2}}"
2022-06-06 14:38:21,44a3f3353e0407e9fffee138125a6927d1c9e7e5,Bram Moolenaar,17,2,19,3,"{""src/ex_docmd.c"": {""insertions"": 10, ""deletions"": 2, ""lines"": 12}, ""src/testdir/test_cmdline.vim"": {""insertions"": 5, ""deletions"": 0, ""lines"": 5}, ""src/version.c"": {""insertions"": 2, ""deletions"": 0, ""lines"": 2}}"
2022-06-06 09:07:01,1f89abf69d2c485c38da9a45161e806de0f86f2f,Bram Moolenaar,3,9,12,3,"{""src/match.c"": {""insertions"": 0, ""deletions"": 8, ""lines"": 8}, ""src/os_unix.c"": {""insertions"": 1, ""deletions"": 1, ""lines"": 2}, ""src/version.c"": {""insertions"": 2, ""deletions"": 0, ""lines"": 2}}"
2022-06-05 21:05:19,99c48fe9974b8d70ca33674658a3da722b0d6466,Bram Moolenaar,49,129,178,10,"{""src/auto/configure"": {""insertions"": 0, ""deletions"": 42, ""lines"": 42}, ""src/config.h.in"": {""insertions"": 0, ""deletions"": 6, ""lines"": 6}, ""src/configure.ac"": {""insertions"": 0, ""deletions"": 11, ""lines"": 11}, ""src/if_cscope.c"": {""insertions"": 1, ""deletions"": 2, ""lines"": 3}, ""src/os_mac.h"": {""insertions"": 0, ""deletions"": 2, ""lines"": 2}, ""src/os_unix.c"": {""insertions"": 41, ""deletions"": 52, ""lines"": 93}, ""src/os_vms_conf.h"": {""insertions"": 0, ""deletions"": 9, ""lines"": 9}, ""src/osdef1.h.in"": {""insertions"": 2, ""deletions"": 2, ""lines"": 4}, ""src/pty.c"": {""insertions"": 3, ""deletions"": 3, ""lines"": 6}, ""src/version.c"": {""insertions"": 2, ""deletions"": 0, ""lines"": 2}}"
2022-06-05 19:03:17,de1d7343794a950bd624043901ce7b3caca3c49b,Bram Moolenaar,4,4,8,3,"{""src/auto/configure"": {""insertions"": 1, ""deletions"": 2, ""lines"": 3}, ""src/configure.ac"": {""insertions"": 1, ""deletions"": 2, ""lines"": 3}, ""src/version.c"": {""insertions"": 2, ""deletions"": 0, ""lines"": 2}}"
2022-06-05 18:51:55,1004b3d970f19964816eedf89d3ba7aa9416ed24,Bram Moolenaar,185,171,356,3,"{""src/auto/configure"": {""insertions"": 17, ""deletions"": 7, ""lines"": 24}, ""src/configure.ac"": {""insertions"": 166, ""deletions"": 164, ""lines"": 330}, ""src/version.c"": {""insertions"": 2, ""deletions"": 0, ""lines"": 2}}"
2022-06-05 18:01:37,e3a529bc877909a9eccf792461050b4f6737ed33,zeertzjq,7,1,8,3,"{""src/getchar.c"": {""insertions"": 1, ""deletions"": 1, ""lines"": 2}, ""src/testdir/test_functions.vim"": {""insertions"": 4, ""deletions"": 0, ""lines"": 4}, ""src/version.c"": {""insertions"": 2, ""deletions"": 0, ""lines"": 2}}"
2022-06-05 15:55:54,6574577cacd393ab7591fc776ea060eebc939e55,Paul Ollis,811,242,1053,29,"{""src/auto/configure"": {""insertions"": 76, ""deletions"": 18, ""lines"": 94}, ""src/config.h.in"": {""insertions"": 1, ""deletions"": 0, ""lines"": 1}, ""src/configure.ac"": {""insertions"": 38, ""deletions"": 2, ""lines"": 40}, ""src/drawscreen.c"": {""insertions"": 2, ""deletions"": 6, ""lines"": 8}, ""src/errors.h"": {""insertions"": 12, ""deletions"": 0, ""lines"": 12}, ""src/evalfunc.c"": {""insertions"": 2, ""deletions"": 16, ""lines"": 18}, ""src/ex_cmds.c"": {""insertions"": 5, ""deletions"": 5, ""lines"": 10}, ""src/ex_getln.c"": {""insertions"": 2, ""deletions"": 6, ""lines"": 8}, ""src/match.c"": {""insertions"": 3, ""deletions"": 13, ""lines"": 16}, ""src/os_mac.h"": {""insertions"": 52, ""deletions"": 0, ""lines"": 52}, ""src/os_macosx.m"": {""insertions"": 176, ""deletions"": 0, ""lines"": 176}, ""src/os_unix.c"": {""insertions"": 214, ""deletions"": 0, ""lines"": 214}, ""src/os_win32.c"": {""insertions"": 86, ""deletions"": 0, ""lines"": 86}, ""src/proto/os_unix.pro"": {""insertions"": 3, ""deletions"": 1, ""lines"": 4}, ""src/proto/os_win32.pro"": {""insertions"": 3, ""deletions"": 1, ""lines"": 4}, ""src/proto/regexp.pro"": {""insertions"": 3, ""deletions"": 1, ""lines"": 4}, ""src/quickfix.c"": {""insertions"": 1, ""deletions"": 1, ""lines"": 2}, ""src/regexp.c"": {""insertions"": 25, ""deletions"": 6, ""lines"": 31}, ""src/regexp.h"": {""insertions"": 1, ""deletions"": 1, ""lines"": 2}, ""src/regexp_bt.c"": {""insertions"": 15, ""deletions"": 39, ""lines"": 54}, ""src/regexp_nfa.c"": {""insertions"": 12, ""deletions"": 34, ""lines"": 46}, ""src/screen.c"": {""insertions"": 0, ""deletions"": 5, ""lines"": 5}, ""src/search.c"": {""insertions"": 27, ""deletions"": 55, ""lines"": 82}, ""src/structs.h"": {""insertions"": 1, ""deletions"": 4, ""lines"": 5}, ""src/syntax.c"": {""insertions"": 1, ""deletions"": 24, ""lines"": 25}, ""src/testdir/test_hlsearch.vim"": {""insertions"": 10, ""deletions"": 1, ""lines"": 11}, ""src/testdir/test_search.vim"": {""insertions"": 26, ""deletions"": 0, ""lines"": 26}, ""src/testdir/test_syntax.vim"": {""insertions"": 12, ""deletions"": 3, ""lines"": 15}, ""src/version.c"": {""insertions"": 2, ""deletions"": 0, ""lines"": 2}}"
2022-06-04 21:15:54,1d97db3d987c05af88c30ad20f537bcf3024f9c1,Bram Moolenaar,58,63,121,10,"{""runtime/doc/channel.txt"": {""insertions"": 6, ""deletions"": 3, ""lines"": 9}, ""runtime/doc/starting.txt"": {""insertions"": 1, ""deletions"": 1, ""lines"": 2}, ""src/channel.c"": {""insertions"": 8, ""deletions"": 2, ""lines"": 10}, ""src/edit.c"": {""insertions"": 4, ""deletions"": 6, ""lines"": 10}, ""src/main.c"": {""insertions"": 1, ""deletions"": 1, ""lines"": 2}, ""src/normal.c"": {""insertions"": 4, ""deletions"": 6, ""lines"": 10}, ""src/optionstr.c"": {""insertions"": 2, ""deletions"": 3, ""lines"": 5}, ""src/term.c"": {""insertions"": 19, ""deletions"": 41, ""lines"": 60}, ""src/version.c"": {""insertions"": 2, ""deletions"": 0, ""lines"": 2}, ""src/vim.h"": {""insertions"": 11, ""deletions"": 0, ""lines"": 11}}"
2022-06-04 18:57:59,327e6dd82235d70f6d5aa33ac8281e7fd79b7381,LemonBoy,5,0,5,2,"{""src/terminal.c"": {""insertions"": 3, ""deletions"": 0, ""lines"": 3}, ""src/version.c"": {""insertions"": 2, ""deletions"": 0, ""lines"": 2}}"
2022-06-03 20:59:47,cfa8f9a3f285060152ebbdbf86fbc7aecf1dd756,Bram Moolenaar,1423,2012,3435,31,"{"".github/CODEOWNERS"": {""insertions"": 8, ""deletions"": 0, ""lines"": 8}, ""runtime/doc/autocmd.txt"": {""insertions"": 2, ""deletions"": 2, ""lines"": 4}, ""runtime/doc/builtin.txt"": {""insertions"": 1, ""deletions"": 1, ""lines"": 2}, ""runtime/doc/change.txt"": {""insertions"": 2, ""deletions"": 2, ""lines"": 4}, ""runtime/doc/eval.txt"": {""insertions"": 11, ""deletions"": 6, ""lines"": 17}, ""runtime/doc/map.txt"": {""insertions"": 25, ""deletions"": 5, ""lines"": 30}, ""runtime/doc/options.txt"": {""insertions"": 5, ""deletions"": 5, ""lines"": 10}, ""runtime/doc/os_win32.txt"": {""insertions"": 2, ""deletions"": 2, ""lines"": 4}, ""runtime/doc/popup.txt"": {""insertions"": 16, ""deletions"": 12, ""lines"": 28}, ""runtime/doc/sponsor.txt"": {""insertions"": 1, ""deletions"": 1, ""lines"": 2}, ""runtime/doc/syntax.txt"": {""insertions"": 9, ""deletions"": 1, ""lines"": 10}, ""runtime/doc/tags"": {""insertions"": 17, ""deletions"": 7, ""lines"": 24}, ""runtime/doc/terminal.txt"": {""insertions"": 1, ""deletions"": 1, ""lines"": 2}, ""runtime/doc/todo.txt"": {""insertions"": 91, ""deletions"": 139, ""lines"": 230}, ""runtime/doc/undo.txt"": {""insertions"": 7, ""deletions"": 3, ""lines"": 10}, ""runtime/doc/usr_41.txt"": {""insertions"": 180, ""deletions"": 171, ""lines"": 351}, ""runtime/doc/usr_50.txt"": {""insertions"": 55, ""deletions"": 6, ""lines"": 61}, ""runtime/doc/usr_51.txt"": {""insertions"": 89, ""deletions"": 255, ""lines"": 344}, ""runtime/doc/usr_52.txt"": {""insertions"": 187, ""deletions"": 98, ""lines"": 285}, ""runtime/doc/usr_toc.txt"": {""insertions"": 12, ""deletions"": 11, ""lines"": 23}, ""runtime/filetype.vim"": {""insertions"": 1, ""deletions"": 1, ""lines"": 2}, ""runtime/ftplugin/confini.vim"": {""insertions"": 10, ""deletions"": 0, ""lines"": 10}, ""runtime/ftplugin/fortran.vim"": {""insertions"": 5, ""deletions"": 3, ""lines"": 8}, ""runtime/indent/confini.vim"": {""insertions"": 10, ""deletions"": 0, ""lines"": 10}, ""runtime/syntax/confini.vim"": {""insertions"": 12, ""deletions"": 0, ""lines"": 12}, ""runtime/syntax/vim.vim"": {""insertions"": 9, ""deletions"": 9, ""lines"": 18}, ""src/po/de.po"": {""insertions"": 207, ""deletions"": 168, ""lines"": 375}, ""src/po/es.po"": {""insertions"": 335, ""deletions"": 726, ""lines"": 1061}, ""src/po/pt_BR.po"": {""insertions"": 1, ""deletions"": 1, ""lines"": 2}, ""src/po/uk.cp1251.po"": {""insertions"": 56, ""deletions"": 188, ""lines"": 244}, ""src/po/uk.po"": {""insertions"": 56, ""deletions"": 188, ""lines"": 244}}"
2022-06-03 17:40:53,635f48010dcf6d97f3a65b4785e1726ad386d3eb,Mudskipper875,22,19,41,3,"{""runtime/filetype.vim"": {""insertions"": 18, ""deletions"": 18, ""lines"": 36}, ""src/testdir/test_filetype.vim"": {""insertions"": 2, ""deletions"": 1, ""lines"": 3}, ""src/version.c"": {""insertions"": 2, ""deletions"": 0, ""lines"": 2}}"
2022-06-03 16:39:46,75ebd2aab0f009049561f60424d521ba5f80063a,Bram Moolenaar,49,2,51,3,"{""src/eval.c"": {""insertions"": 31, ""deletions"": 2, ""lines"": 33}, ""src/testdir/test_autocmd.vim"": {""insertions"": 16, ""deletions"": 0, ""lines"": 16}, ""src/version.c"": {""insertions"": 2, ""deletions"": 0, ""lines"": 2}}"
2022-06-01 20:26:34,bfaa24f95343af9c058696644375d04e660f1b00,Philip H,11,5,16,4,"{"".github/workflows/ci.yml"": {""insertions"": 6, ""deletions"": 3, ""lines"": 9}, "".github/workflows/codeql-analysis.yml"": {""insertions"": 1, ""deletions"": 1, ""lines"": 2}, "".github/workflows/coverity.yml"": {""insertions"": 2, ""deletions"": 1, ""lines"": 3}, ""src/version.c"": {""insertions"": 2, ""deletions"": 0, ""lines"": 2}}"
2022-06-01 15:02:38,882476ad7b4944a8386993e94b7e31139a314f91,Bram Moolenaar,8,8,16,2,"{""src/autocmd.c"": {""insertions"": 6, ""deletions"": 8, ""lines"": 14}, ""src/version.c"": {""insertions"": 2, ""deletions"": 0, ""lines"": 2}}"
2022-06-01 14:23:13,409510c588b1eec1ae33511ae97a21eb8e110895,Bram Moolenaar,31,3,34,3,"{""src/search.c"": {""insertions"": 18, ""deletions"": 3, ""lines"": 21}, ""src/testdir/test_tagjump.vim"": {""insertions"": 11, ""deletions"": 0, ""lines"": 11}, ""src/version.c"": {""insertions"": 2, ""deletions"": 0, ""lines"": 2}}"
2022-06-01 11:31:53,00e977cb83625f979d13639249a7788d5a1cb71e,Yegappan Lakshmanan,37,26,63,5,"{""src/autocmd.c"": {""insertions"": 15, ""deletions"": 25, ""lines"": 40}, ""src/testdir/gen_opt_test.vim"": {""insertions"": 1, ""deletions"": 1, ""lines"": 2}, ""src/testdir/test_autocmd.vim"": {""insertions"": 10, ""deletions"": 0, ""lines"": 10}, ""src/testdir/test_cmdline.vim"": {""insertions"": 9, ""deletions"": 0, ""lines"": 9}, ""src/version.c"": {""insertions"": 2, ""deletions"": 0, ""lines"": 2}}"
2022-05-31 16:03:14,b5912e0643dc21b1b88c517d3ac1282eba57293d,Bram Moolenaar,8,1,9,2,"{""src/testdir/test_gui.vim"": {""insertions"": 6, ""deletions"": 1, ""lines"": 7}, ""src/version.c"": {""insertions"": 2, ""deletions"": 0, ""lines"": 2}}"
2022-05-31 12:43:12,368137aa525982984beed73940af481ac53a62af,Bram Moolenaar,49,6,55,7,"{""src/change.c"": {""insertions"": 4, ""deletions"": 0, ""lines"": 4}, ""src/drawscreen.c"": {""insertions"": 17, ""deletions"": 0, ""lines"": 17}, ""src/globals.h"": {""insertions"": 8, ""deletions"": 6, ""lines"": 14}, ""src/match.c"": {""insertions"": 4, ""deletions"": 0, ""lines"": 4}, ""src/testdir/dumps/Test_hlsearch_cursearch_changed_1.dump"": {""insertions"": 9, ""deletions"": 0, ""lines"": 9}, ""src/testdir/test_search.vim"": {""insertions"": 5, ""deletions"": 0, ""lines"": 5}, ""src/version.c"": {""insertions"": 2, ""deletions"": 0, ""lines"": 2}}"
2022-05-30 19:58:55,4aaf3e7f4db599932d01d87e5bbcdc342cccee27,Bram Moolenaar,111,37,148,6,"{""src/eval.c"": {""insertions"": 4, ""deletions"": 3, ""lines"": 7}, ""src/ex_cmds.c"": {""insertions"": 6, ""deletions"": 2, ""lines"": 8}, ""src/proto/regexp.pro"": {""insertions"": 2, ""deletions"": 2, ""lines"": 4}, ""src/regexp.c"": {""insertions"": 92, ""deletions"": 30, ""lines"": 122}, ""src/regexp.h"": {""insertions"": 5, ""deletions"": 0, ""lines"": 5}, ""src/version.c"": {""insertions"": 2, ""deletions"": 0, ""lines"": 2}}"
2022-05-30 16:58:03,10db31f9493425a20f1e53d0f214e621f16d65de,Bram Moolenaar,49,26,75,7,"{""src/popupwin.c"": {""insertions"": 0, ""deletions"": 1, ""lines"": 1}, ""src/testdir/dumps/Test_popupwin_poptermscroll_1.dump"": {""insertions"": 5, ""deletions"": 5, ""lines"": 10}, ""src/testdir/dumps/Test_popupwin_poptermscroll_2.dump"": {""insertions"": 5, ""deletions"": 5, ""lines"": 10}, ""src/testdir/dumps/Test_popupwin_poptermscroll_3.dump"": {""insertions"": 14, ""deletions"": 14, ""lines"": 28}, ""src/testdir/dumps/Test_popupwin_poptermscroll_4.dump"": {""insertions"": 15, ""deletions"": 0, ""lines"": 15}, ""src/testdir/test_popupwin.vim"": {""insertions"": 8, ""deletions"": 1, ""lines"": 9}, ""src/version.c"": {""insertions"": 2, ""deletions"": 0, ""lines"": 2}}"
2022-05-30 15:01:42,be99042b03edf7b8156c9adbc23516bfcf2cec0f,Bram Moolenaar,7,6,13,3,"{""src/ex_getln.c"": {""insertions"": 2, ""deletions"": 4, ""lines"": 6}, ""src/testdir/test_substitute.vim"": {""insertions"": 3, ""deletions"": 2, ""lines"": 5}, ""src/version.c"": {""insertions"": 2, ""deletions"": 0, ""lines"": 2}}"
2022-05-30 14:23:09,71223e2db87c2bf3b09aecb46266b56cda26191d,Bram Moolenaar,51,12,63,6,"{""src/buffer.c"": {""insertions"": 1, ""deletions"": 6, ""lines"": 7}, ""src/ex_getln.c"": {""insertions"": 19, ""deletions"": 0, ""lines"": 19}, ""src/proto/ex_getln.pro"": {""insertions"": 3, ""deletions"": 2, ""lines"": 5}, ""src/testdir/test_substitute.vim"": {""insertions"": 25, ""deletions"": 0, ""lines"": 25}, ""src/version.c"": {""insertions"": 2, ""deletions"": 0, ""lines"": 2}, ""src/window.c"": {""insertions"": 1, ""deletions"": 4, ""lines"": 5}}"
2022-05-30 12:20:56,89b25585ccecf223ca41ca212df8ebc227fc035a,Bram Moolenaar,12,10,22,4,"{""src/popupwin.c"": {""insertions"": 1, ""deletions"": 1, ""lines"": 2}, ""src/testdir/dumps/Test_popupwin_scroll_13.dump"": {""insertions"": 7, ""deletions"": 7, ""lines"": 14}, ""src/testdir/test_popupwin.vim"": {""insertions"": 2, ""deletions"": 2, ""lines"": 4}, ""src/version.c"": {""insertions"": 2, ""deletions"": 0, ""lines"": 2}}"
2022-05-29 21:37:05,9e636b9d2ef54552383daebf290d916b3d001823,Bram Moolenaar,36,5,41,6,"{""src/buffer.c"": {""insertions"": 3, ""deletions"": 3, ""lines"": 6}, ""src/proto/terminal.pro"": {""insertions"": 1, ""deletions"": 0, ""lines"": 1}, ""src/terminal.c"": {""insertions"": 11, ""deletions"": 1, ""lines"": 12}, ""src/testdir/test_popupwin.vim"": {""insertions"": 18, ""deletions"": 0, ""lines"": 18}, ""src/undo.c"": {""insertions"": 1, ""deletions"": 1, ""lines"": 2}, ""src/version.c"": {""insertions"": 2, ""deletions"": 0, ""lines"": 2}}"
2022-05-29 17:18:18,fc376e0b1a36a2ef153e28752c61342554386886,Bram Moolenaar,28,2,30,4,"{""src/popupwin.c"": {""insertions"": 5, ""deletions"": 0, ""lines"": 5}, ""src/testdir/dumps/Test_popupwin_scroll_13.dump"": {""insertions"": 10, ""deletions"": 0, ""lines"": 10}, ""src/testdir/test_popupwin.vim"": {""insertions"": 11, ""deletions"": 2, ""lines"": 13}, ""src/version.c"": {""insertions"": 2, ""deletions"": 0, ""lines"": 2}}"
2022-05-29 16:13:24,83bd7a974056fd61e142c791e79d9dd89acd5ba4,Bram Moolenaar,17,4,21,5,"{""src/errors.h"": {""insertions"": 4, ""deletions"": 0, ""lines"": 4}, ""src/popupwin.c"": {""insertions"": 4, ""deletions"": 2, ""lines"": 6}, ""src/testdir/dumps/Test_popup_settext_07.dump"": {""insertions"": 1, ""deletions"": 1, ""lines"": 2}, ""src/testdir/test_popupwin.vim"": {""insertions"": 6, ""deletions"": 1, ""lines"": 7}, ""src/version.c"": {""insertions"": 2, ""deletions"": 0, ""lines"": 2}}"
2022-05-29 13:13:04,d28950f9540f77032cee0a3047b05bef50ea81dc,Bram Moolenaar,108,10,118,6,"{""src/popupwin.c"": {""insertions"": 24, ""deletions"": 9, ""lines"": 33}, ""src/testdir/dumps/Test_popupwin_poptermscroll_1.dump"": {""insertions"": 15, ""deletions"": 0, ""lines"": 15}, ""src/testdir/dumps/Test_popupwin_poptermscroll_2.dump"": {""insertions"": 15, ""deletions"": 0, ""lines"": 15}, ""src/testdir/dumps/Test_popupwin_poptermscroll_3.dump"": {""insertions"": 15, ""deletions"": 0, ""lines"": 15}, ""src/testdir/test_popupwin.vim"": {""insertions"": 37, ""deletions"": 1, ""lines"": 38}, ""src/version.c"": {""insertions"": 2, ""deletions"": 0, ""lines"": 2}}"
2022-05-28 13:25:35,4d97a565ae8be0d4debba04ebd2ac3e75a0c8010,Bram Moolenaar,27,7,34,3,"{""src/ex_docmd.c"": {""insertions"": 17, ""deletions"": 7, ""lines"": 24}, ""src/testdir/test_excmd.vim"": {""insertions"": 8, ""deletions"": 0, ""lines"": 8}, ""src/version.c"": {""insertions"": 2, ""deletions"": 0, ""lines"": 2}}"
2022-05-28 10:08:40,305abc612330772615638b8a1aa3c51421c7a90b,Bram Moolenaar,19,21,40,2,"{""src/regexp_nfa.c"": {""insertions"": 17, ""deletions"": 21, ""lines"": 38}, ""src/version.c"": {""insertions"": 2, ""deletions"": 0, ""lines"": 2}}"
2022-05-28 09:49:44,e6f13b473cf2c270e4eab214e09be9825320c11b,zeertzjq,41,28,69,4,"{""src/testdir/test_changelist.vim"": {""insertions"": 35, ""deletions"": 0, ""lines"": 35}, ""src/testdir/test_normal.vim"": {""insertions"": 0, ""deletions"": 25, ""lines"": 25}, ""src/version.c"": {""insertions"": 2, ""deletions"": 0, ""lines"": 2}, ""src/window.c"": {""insertions"": 4, ""deletions"": 3, ""lines"": 7}}"
2022-05-27 20:58:00,5a6ec10cc80ab02eeff644ab19b82312630ea855,Bram Moolenaar,89,0,89,7,"{""runtime/doc/builtin.txt"": {""insertions"": 28, ""deletions"": 0, ""lines"": 28}, ""runtime/doc/usr_41.txt"": {""insertions"": 1, ""deletions"": 0, ""lines"": 1}, ""src/evalfunc.c"": {""insertions"": 2, ""deletions"": 0, ""lines"": 2}, ""src/move.c"": {""insertions"": 33, ""deletions"": 0, ""lines"": 33}, ""src/proto/move.pro"": {""insertions"": 1, ""deletions"": 0, ""lines"": 1}, ""src/testdir/test_cursor_func.vim"": {""insertions"": 22, ""deletions"": 0, ""lines"": 22}, ""src/version.c"": {""insertions"": 2, ""deletions"": 0, ""lines"": 2}}"
2022-05-27 20:16:34,968443efb5a2a1ed7e1084f2aff65a95f2d0a17b,Bram Moolenaar,6,3,9,3,"{""src/autocmd.c"": {""insertions"": 2, ""deletions"": 1, ""lines"": 3}, ""src/errors.h"": {""insertions"": 2, ""deletions"": 2, ""lines"": 4}, ""src/version.c"": {""insertions"": 2, ""deletions"": 0, ""lines"": 2}}"
2022-05-27 19:23:20,ddf531292971f44e8545a3e097c0d8a11773eb38,Bram Moolenaar,5,1,6,2,"{""src/testdir/test_python3.vim"": {""insertions"": 3, ""deletions"": 1, ""lines"": 4}, ""src/version.c"": {""insertions"": 2, ""deletions"": 0, ""lines"": 2}}"
2022-05-27 19:13:28,76381a5b4f3f6de1df33a8ab3e1f7db2e1764af6,Bram Moolenaar,10,1,11,3,"{""src/Makefile"": {""insertions"": 4, ""deletions"": 1, ""lines"": 5}, ""src/testdir/Makefile"": {""insertions"": 4, ""deletions"": 0, ""lines"": 4}, ""src/version.c"": {""insertions"": 2, ""deletions"": 0, ""lines"": 2}}"
2022-05-27 17:05:33,e0ff3a7de6030b73d94121626deb8229e66e82b2,Yegappan Lakshmanan,221,46,267,5,"{""runtime/doc/builtin.txt"": {""insertions"": 5, ""deletions"": 2, ""lines"": 7}, ""src/autocmd.c"": {""insertions"": 134, ""deletions"": 41, ""lines"": 175}, ""src/errors.h"": {""insertions"": 3, ""deletions"": 3, ""lines"": 6}, ""src/testdir/test_autocmd.vim"": {""insertions"": 77, ""deletions"": 0, ""lines"": 77}, ""src/version.c"": {""insertions"": 2, ""deletions"": 0, ""lines"": 2}}"
2022-05-27 16:26:55,cfe456543e840d133399551f8626d985e1fb1958,zeertzjq,51,76,127,22,"{""runtime/doc/insert.txt"": {""insertions"": 1, ""deletions"": 1, ""lines"": 2}, ""runtime/doc/tags"": {""insertions"": 0, ""deletions"": 1, ""lines"": 1}, ""src/beval.c"": {""insertions"": 2, ""deletions"": 2, ""lines"": 4}, ""src/change.c"": {""insertions"": 3, ""deletions"": 3, ""lines"": 6}, ""src/edit.c"": {""insertions"": 3, ""deletions"": 4, ""lines"": 7}, ""src/errors.h"": {""insertions"": 1, ""deletions"": 2, ""lines"": 3}, ""src/eval.c"": {""insertions"": 5, ""deletions"": 5, ""lines"": 10}, ""src/ex_cmds.c"": {""insertions"": 4, ""deletions"": 4, ""lines"": 8}, ""src/ex_getln.c"": {""insertions"": 9, ""deletions"": 21, ""lines"": 30}, ""src/globals.h"": {""insertions"": 1, ""deletions"": 6, ""lines"": 7}, ""src/indent.c"": {""insertions"": 2, ""deletions"": 2, ""lines"": 4}, ""src/insexpand.c"": {""insertions"": 6, ""deletions"": 12, ""lines"": 18}, ""src/map.c"": {""insertions"": 2, ""deletions"": 2, ""lines"": 4}, ""src/proto/ex_getln.pro"": {""insertions"": 0, ""deletions"": 1, ""lines"": 1}, ""src/register.c"": {""insertions"": 2, ""deletions"": 2, ""lines"": 4}, ""src/testdir/test_edit.vim"": {""insertions"": 1, ""deletions"": 1, ""lines"": 2}, ""src/testdir/test_ins_complete.vim"": {""insertions"": 2, ""deletions"": 2, ""lines"": 4}, ""src/testdir/test_popup.vim"": {""insertions"": 1, ""deletions"": 1, ""lines"": 2}, ""src/testdir/test_quickfix.vim"": {""insertions"": 1, ""deletions"": 1, ""lines"": 2}, ""src/undo.c"": {""insertions"": 2, ""deletions"": 2, ""lines"": 4}, ""src/version.c"": {""insertions"": 2, ""deletions"": 0, ""lines"": 2}, ""src/window.c"": {""insertions"": 1, ""deletions"": 1, ""lines"": 2}}"
2022-05-27 14:35:28,02e8d4e4ffcdd6ee919e19692d591da8e18a565d,Bram Moolenaar,31,9,40,3,"{""src/regexp_bt.c"": {""insertions"": 9, ""deletions"": 5, ""lines"": 14}, ""src/regexp_nfa.c"": {""insertions"": 20, ""deletions"": 4, ""lines"": 24}, ""src/version.c"": {""insertions"": 2, ""deletions"": 0, ""lines"": 2}}"
2022-05-27 12:52:08,bf79a4e48d09a5ae08645592885d54230fed30b8,Bram Moolenaar,21,1,22,3,"{""src/ex_docmd.c"": {""insertions"": 2, ""deletions"": 1, ""lines"": 3}, ""src/testdir/test_trycatch.vim"": {""insertions"": 17, ""deletions"": 0, ""lines"": 17}, ""src/version.c"": {""insertions"": 2, ""deletions"": 0, ""lines"": 2}}"
2022-05-26 21:24:43,31d9948e3a2529c2f619d56bdb48291dc261233d,Bram Moolenaar,182,51,233,7,"{""src/ex_docmd.c"": {""insertions"": 19, ""deletions"": 0, ""lines"": 19}, ""src/proto/ex_docmd.pro"": {""insertions"": 1, ""deletions"": 0, ""lines"": 1}, ""src/testdir/test_vim9_assign.vim"": {""insertions"": 57, ""deletions"": 0, ""lines"": 57}, ""src/testdir/test_vim9_func.vim"": {""insertions"": 57, ""deletions"": 0, ""lines"": 57}, ""src/version.c"": {""insertions"": 2, ""deletions"": 0, ""lines"": 2}, ""src/vim9compile.c"": {""insertions"": 3, ""deletions"": 1, ""lines"": 4}, ""src/vim9type.c"": {""insertions"": 43, ""deletions"": 50, ""lines"": 93}}"
2022-05-26 18:54:05,5cb53b7afe6bde8f2bf6fc6b65b86071b67a8554,Bram Moolenaar,44,1,45,4,"{""src/testdir/test_vim9_assign.vim"": {""insertions"": 2, ""deletions"": 0, ""lines"": 2}, ""src/testdir/test_vim9_import.vim"": {""insertions"": 39, ""deletions"": 0, ""lines"": 39}, ""src/version.c"": {""insertions"": 2, ""deletions"": 0, ""lines"": 2}, ""src/vim9script.c"": {""insertions"": 1, ""deletions"": 1, ""lines"": 2}}"
2022-05-26 15:32:44,e2fa213cf571041dbd04ab0329303ffdc980678a,Bram Moolenaar,14,0,14,3,"{""src/normal.c"": {""insertions"": 6, ""deletions"": 0, ""lines"": 6}, ""src/testdir/test_tagjump.vim"": {""insertions"": 6, ""deletions"": 0, ""lines"": 6}, ""src/version.c"": {""insertions"": 2, ""deletions"": 0, ""lines"": 2}}"
2022-05-26 14:56:23,338f1fc0ee3ca929387448fe464579d6113fa76a,Bram Moolenaar,51,21,72,4,"{""src/normal.c"": {""insertions"": 21, ""deletions"": 21, ""lines"": 42}, ""src/testdir/test_substitute.vim"": {""insertions"": 22, ""deletions"": 0, ""lines"": 22}, ""src/undo.c"": {""insertions"": 6, ""deletions"": 0, ""lines"": 6}, ""src/version.c"": {""insertions"": 2, ""deletions"": 0, ""lines"": 2}}"
2022-05-26 14:23:26,9bcb9ca9c7dd1632385dc3351b5e019739368658,LemonBoy,31,4,35,3,"{""src/insexpand.c"": {""insertions"": 5, ""deletions"": 4, ""lines"": 9}, ""src/testdir/test_ins_complete.vim"": {""insertions"": 24, ""deletions"": 0, ""lines"": 24}, ""src/version.c"": {""insertions"": 2, ""deletions"": 0, ""lines"": 2}}"
2022-05-26 13:06:37,30b9a41ad9963b8c57afea1f33a4e180fc23a892,Bram Moolenaar,32,20,52,2,"{""src/terminal.c"": {""insertions"": 30, ""deletions"": 20, ""lines"": 50}, ""src/version.c"": {""insertions"": 2, ""deletions"": 0, ""lines"": 2}}"
2022-05-26 12:16:25,c7e54efe4dc2bd8fd86feb4a26b4485b7b4c8578,Milly,37,0,37,3,"{""src/gui_xim.c"": {""insertions"": 6, ""deletions"": 0, ""lines"": 6}, ""src/testdir/test_iminsert.vim"": {""insertions"": 29, ""deletions"": 0, ""lines"": 29}, ""src/version.c"": {""insertions"": 2, ""deletions"": 0, ""lines"": 2}}"
2022-05-26 11:10:37,0f7a3e1de6f71e8e1423fe594890d6aa7f94e132,LemonBoy,96,26,122,5,"{""runtime/doc/builtin.txt"": {""insertions"": 31, ""deletions"": 13, ""lines"": 44}, ""src/evalfunc.c"": {""insertions"": 39, ""deletions"": 9, ""lines"": 48}, ""src/testdir/test_functions.vim"": {""insertions"": 11, ""deletions"": 0, ""lines"": 11}, ""src/testdir/test_vim9_builtin.vim"": {""insertions"": 13, ""deletions"": 4, ""lines"": 17}, ""src/version.c"": {""insertions"": 2, ""deletions"": 0, ""lines"": 2}}"
2022-05-25 18:15:10,c3caa7f78808e405b7cdbcdf89c9d35a43d2c3eb,Bram Moolenaar,103,126,229,5,"{""src/proto/vim9instr.pro"": {""insertions"": 1, ""deletions"": 1, ""lines"": 2}, ""src/version.c"": {""insertions"": 2, ""deletions"": 0, ""lines"": 2}, ""src/vim9compile.c"": {""insertions"": 1, ""deletions"": 1, ""lines"": 2}, ""src/vim9expr.c"": {""insertions"": 1, ""deletions"": 1, ""lines"": 2}, ""src/vim9instr.c"": {""insertions"": 98, ""deletions"": 123, ""lines"": 221}}"
2022-05-25 16:29:46,8be36eecdc6728021f9c384c2305f114e671ec32,mityu,3,1,4,2,"{""src/evalvars.c"": {""insertions"": 1, ""deletions"": 1, ""lines"": 2}, ""src/version.c"": {""insertions"": 2, ""deletions"": 0, ""lines"": 2}}"
2022-05-25 14:15:38,2a585c85013be22f59f184d49612074fd9b115d7,Bram Moolenaar,16,2,18,3,"{""src/register.c"": {""insertions"": 5, ""deletions"": 2, ""lines"": 7}, ""src/testdir/test_put.vim"": {""insertions"": 9, ""deletions"": 0, ""lines"": 9}, ""src/version.c"": {""insertions"": 2, ""deletions"": 0, ""lines"": 2}}"
2022-05-25 11:42:08,bf82df0dd48a26404b92a596498b6892c9572c53,=?UTF-8?q?Dundar=20G=C3=B6c?=,12,2,14,3,"{""runtime/filetype.vim"": {""insertions"": 7, ""deletions"": 1, ""lines"": 8}, ""src/testdir/test_filetype.vim"": {""insertions"": 3, ""deletions"": 1, ""lines"": 4}, ""src/version.c"": {""insertions"": 2, ""deletions"": 0, ""lines"": 2}}"
2022-05-24 20:26:37,4c3d21acaa09d929e6afe10288babe1d0af3de35,Paul Ollis,106,6,112,4,"{""src/memline.c"": {""insertions"": 2, ""deletions"": 4, ""lines"": 6}, ""src/testdir/test_textprop.vim"": {""insertions"": 93, ""deletions"": 0, ""lines"": 93}, ""src/textprop.c"": {""insertions"": 9, ""deletions"": 2, ""lines"": 11}, ""src/version.c"": {""insertions"": 2, ""deletions"": 0, ""lines"": 2}}"
2022-05-24 12:57:54,78d52883e10d71f23ab72a3d8b9733b00da8c9ad,Bram Moolenaar,17,0,17,3,"{""src/testdir/test_textformat.vim"": {""insertions"": 12, ""deletions"": 0, ""lines"": 12}, ""src/textformat.c"": {""insertions"": 3, ""deletions"": 0, ""lines"": 3}, ""src/version.c"": {""insertions"": 2, ""deletions"": 0, ""lines"": 2}}"
2022-05-24 10:49:31,53737b5eeeab1f95964f78b055d6094fab559533,LemonBoy,24,2,26,3,"{""src/testdir/test_textobjects.vim"": {""insertions"": 20, ""deletions"": 2, ""lines"": 22}, ""src/textobject.c"": {""insertions"": 2, ""deletions"": 0, ""lines"": 2}, ""src/version.c"": {""insertions"": 2, ""deletions"": 0, ""lines"": 2}}"
2022-05-24 10:40:11,971f6825ee845828bd5c8869487928a3f32cd467,Yegappan Lakshmanan,58,11,69,5,"{""runtime/doc/autocmd.txt"": {""insertions"": 24, ""deletions"": 1, ""lines"": 25}, ""runtime/doc/builtin.txt"": {""insertions"": 14, ""deletions"": 8, ""lines"": 22}, ""src/autocmd.c"": {""insertions"": 6, ""deletions"": 2, ""lines"": 8}, ""src/testdir/test_autocmd.vim"": {""insertions"": 12, ""deletions"": 0, ""lines"": 12}, ""src/version.c"": {""insertions"": 2, ""deletions"": 0, ""lines"": 2}}"
2022-05-23 20:49:41,c9a431c7638ecebb6f2cb3eabd0e1b2b5e269c1e,Bram Moolenaar,134,48,182,3,"{""runtime/doc/terminal.txt"": {""insertions"": 44, ""deletions"": 13, ""lines"": 57}, ""runtime/pack/dist/opt/termdebug/plugin/termdebug.vim"": {""insertions"": 88, ""deletions"": 35, ""lines"": 123}, ""src/version.c"": {""insertions"": 2, ""deletions"": 0, ""lines"": 2}}"
2022-05-23 14:33:08,e8c4a64bffbe628a46dc172d04cfc2db6e8dd8b6,Brandon Simmons,22,0,22,3,"{""src/fold.c"": {""insertions"": 1, ""deletions"": 0, ""lines"": 1}, ""src/testdir/test_fold.vim"": {""insertions"": 19, ""deletions"": 0, ""lines"": 19}, ""src/version.c"": {""insertions"": 2, ""deletions"": 0, ""lines"": 2}}"
2022-05-23 12:10:48,7e667788150be617aeac42b0d668618ac33ab9da,Bram Moolenaar,29,7,36,5,"{""src/change.c"": {""insertions"": 2, ""deletions"": 1, ""lines"": 3}, ""src/testdir/test_textformat.vim"": {""insertions"": 18, ""deletions"": 1, ""lines"": 19}, ""src/textformat.c"": {""insertions"": 1, ""deletions"": 0, ""lines"": 1}, ""src/version.c"": {""insertions"": 2, ""deletions"": 0, ""lines"": 2}, ""src/vim.h"": {""insertions"": 6, ""deletions"": 5, ""lines"": 11}}"
2022-05-23 11:01:50,6d24b4ff69913270ce1e5267dd6bd8454f75e2b9,Bram Moolenaar,24,4,28,3,"{""src/spellsuggest.c"": {""insertions"": 2, ""deletions"": 1, ""lines"": 3}, ""src/testdir/test_spell_utf8.vim"": {""insertions"": 20, ""deletions"": 3, ""lines"": 23}, ""src/version.c"": {""insertions"": 2, ""deletions"": 0, ""lines"": 2}}"
2022-05-22 21:07:52,68e64d2c1735f2a39afa8a0475ae29bedb116684,Bram Moolenaar,6,3,9,4,"{""src/eval.c"": {""insertions"": 1, ""deletions"": 1, ""lines"": 2}, ""src/version.c"": {""insertions"": 2, ""deletions"": 0, ""lines"": 2}, ""src/vim9execute.c"": {""insertions"": 1, ""deletions"": 1, ""lines"": 2}, ""src/vim9expr.c"": {""insertions"": 2, ""deletions"": 1, ""lines"": 3}}"
2022-05-22 20:53:26,5b529230f144028b67ed1d59207af098c18a1858,Bram Moolenaar,7,6,13,2,"{""src/version.c"": {""insertions"": 2, ""deletions"": 0, ""lines"": 2}, ""src/vim9expr.c"": {""insertions"": 5, ""deletions"": 6, ""lines"": 11}}"
2022-05-22 19:16:32,338bf58eba758585ffef3fdfdba7d48477aacb7c,Bram Moolenaar,26,19,45,7,"{""runtime/doc/eval.txt"": {""insertions"": 8, ""deletions"": 3, ""lines"": 11}, ""src/charset.c"": {""insertions"": 1, ""deletions"": 0, ""lines"": 1}, ""src/eval.c"": {""insertions"": 1, ""deletions"": 5, ""lines"": 6}, ""src/testdir/test_expr.vim"": {""insertions"": 11, ""deletions"": 0, ""lines"": 11}, ""src/version.c"": {""insertions"": 2, ""deletions"": 0, ""lines"": 2}, ""src/vim9execute.c"": {""insertions"": 1, ""deletions"": 6, ""lines"": 7}, ""src/vim9expr.c"": {""insertions"": 2, ""deletions"": 5, ""lines"": 7}}"
2022-05-22 18:13:49,a061f34191712df7dde7716705fe0ec074e9758e,Yegappan Lakshmanan,554,160,714,11,"{""runtime/doc/eval.txt"": {""insertions"": 80, ""deletions"": 65, ""lines"": 145}, ""src/errors.h"": {""insertions"": 6, ""deletions"": 0, ""lines"": 6}, ""src/eval.c"": {""insertions"": 139, ""deletions"": 24, ""lines"": 163}, ""src/structs.h"": {""insertions"": 2, ""deletions"": 0, ""lines"": 2}, ""src/testdir/test_expr.vim"": {""insertions"": 62, ""deletions"": 0, ""lines"": 62}, ""src/testdir/test_vim9_disassemble.vim"": {""insertions"": 27, ""deletions"": 0, ""lines"": 27}, ""src/testdir/test_vim9_expr.vim"": {""insertions"": 64, ""deletions"": 59, ""lines"": 123}, ""src/version.c"": {""insertions"": 2, ""deletions"": 0, ""lines"": 2}, ""src/vim.h"": {""insertions"": 1, ""deletions"": 0, ""lines"": 1}, ""src/vim9execute.c"": {""insertions"": 28, ""deletions"": 0, ""lines"": 28}, ""src/vim9expr.c"": {""insertions"": 143, ""deletions"": 12, ""lines"": 155}}"
2022-05-22 14:35:53,9b2edfd3bf2f14a1faaee9b62930598a2e77a798,LemonBoy,22,0,22,3,"{""src/evalbuffer.c"": {""insertions"": 3, ""deletions"": 0, ""lines"": 3}, ""src/testdir/test_bufline.vim"": {""insertions"": 17, ""deletions"": 0, ""lines"": 17}, ""src/version.c"": {""insertions"": 2, ""deletions"": 0, ""lines"": 2}}"
2022-05-22 14:28:31,8a3704723c40779d688ef957dbe5bd8b65c25f95,Bram Moolenaar,5,3,8,2,"{""src/po/check.vim"": {""insertions"": 3, ""deletions"": 3, ""lines"": 6}, ""src/version.c"": {""insertions"": 2, ""deletions"": 0, ""lines"": 2}}"
2022-05-22 13:50:16,835ee980eedd1aa0fa2d731312ce38697a12a897,Bram Moolenaar,37,39,76,9,"{""runtime/doc/builtin.txt"": {""insertions"": 1, ""deletions"": 1, ""lines"": 2}, ""runtime/doc/indent.txt"": {""insertions"": 1, ""deletions"": 1, ""lines"": 2}, ""runtime/doc/options.txt"": {""insertions"": 1, ""deletions"": 1, ""lines"": 2}, ""runtime/doc/os_win32.txt"": {""insertions"": 6, ""deletions"": 1, ""lines"": 7}, ""runtime/doc/todo.txt"": {""insertions"": 3, ""deletions"": 9, ""lines"": 12}, ""runtime/doc/usr_52.txt"": {""insertions"": 21, ""deletions"": 24, ""lines"": 45}, ""runtime/doc/various.txt"": {""insertions"": 1, ""deletions"": 1, ""lines"": 2}, ""runtime/doc/vim9.txt"": {""insertions"": 1, ""deletions"": 1, ""lines"": 2}, ""src/version.c"": {""insertions"": 2, ""deletions"": 0, ""lines"": 2}}"
2022-05-22 13:26:54,aa9729b652aa93b547b5c7006f54a143d99ea149,Bram Moolenaar,33,30,63,2,"{""src/testdir/test_filetype.vim"": {""insertions"": 31, ""deletions"": 30, ""lines"": 61}, ""src/version.c"": {""insertions"": 2, ""deletions"": 0, ""lines"": 2}}"
2022-05-22 12:45:52,bce69d65dd41020ea1d727337a3baf9e95b40c35,Bram Moolenaar,48,1,49,3,"{""src/testdir/test_vim9_func.vim"": {""insertions"": 41, ""deletions"": 0, ""lines"": 41}, ""src/version.c"": {""insertions"": 2, ""deletions"": 0, ""lines"": 2}, ""src/vim9type.c"": {""insertions"": 5, ""deletions"": 1, ""lines"": 6}}"
2022-05-22 11:23:48,37233f6022b3ed16985a91d22752b3ca162e21d0,Bram Moolenaar,41,1,42,3,"{""src/if_py_both.h"": {""insertions"": 3, ""deletions"": 1, ""lines"": 4}, ""src/testdir/test_python3.vim"": {""insertions"": 36, ""deletions"": 0, ""lines"": 36}, ""src/version.c"": {""insertions"": 2, ""deletions"": 0, ""lines"": 2}}"
2022-05-22 10:59:25,0ad00a7fd3e0389f565876521e395c35144d8009,Bram Moolenaar,21,0,21,3,"{""src/evalbuffer.c"": {""insertions"": 3, ""deletions"": 0, ""lines"": 3}, ""src/testdir/test_bufline.vim"": {""insertions"": 16, ""deletions"": 0, ""lines"": 16}, ""src/version.c"": {""insertions"": 2, ""deletions"": 0, ""lines"": 2}}"
2022-05-21 20:55:55,dafef51b1cbe8aa836c4cfa52623f775bd85a190,Bram Moolenaar,4,2,6,2,"{""src/version.c"": {""insertions"": 2, ""deletions"": 0, ""lines"": 2}, ""src/vim9execute.c"": {""insertions"": 2, ""deletions"": 2, ""lines"": 4}}"
2022-05-21 20:30:50,7e569d09d2ec4fa334a2d3d5b0b6dbca16d97133,Bram Moolenaar,521,504,1025,2,"{""src/testdir/test_cindent.vim"": {""insertions"": 519, ""deletions"": 504, ""lines"": 1023}, ""src/version.c"": {""insertions"": 2, ""deletions"": 0, ""lines"": 2}}"
2022-05-21 19:17:31,8e145b82464a21ee4fdf7948f04e2a1d505f8bfa,Bram Moolenaar,80,508,588,27,"{""runtime/doc/builtin.txt"": {""insertions"": 2, ""deletions"": 4, ""lines"": 6}, ""runtime/doc/indent.txt"": {""insertions"": 0, ""deletions"": 3, ""lines"": 3}, ""runtime/doc/options.txt"": {""insertions"": 2, ""deletions"": 20, ""lines"": 22}, ""runtime/doc/various.txt"": {""insertions"": 3, ""deletions"": 3, ""lines"": 6}, ""src/buffer.c"": {""insertions"": 1, ""deletions"": 9, ""lines"": 10}, ""src/change.c"": {""insertions"": 10, ""deletions"": 57, ""lines"": 67}, ""src/charset.c"": {""insertions"": 0, ""deletions"": 2, ""lines"": 2}, ""src/cindent.c"": {""insertions"": 2, ""deletions"": 11, ""lines"": 13}, ""src/edit.c"": {""insertions"": 1, ""deletions"": 65, ""lines"": 66}, ""src/evalfunc.c"": {""insertions"": 3, ""deletions"": 21, ""lines"": 24}, ""src/feature.h"": {""insertions"": 3, ""deletions"": 19, ""lines"": 22}, ""src/globals.h"": {""insertions"": 0, ""deletions"": 2, ""lines"": 2}, ""src/indent.c"": {""insertions"": 1, ""deletions"": 32, ""lines"": 33}, ""src/insexpand.c"": {""insertions"": 1, ""deletions"": 12, ""lines"": 13}, ""src/main.c"": {""insertions"": 0, ""deletions"": 4, ""lines"": 4}, ""src/mouse.c"": {""insertions"": 0, ""deletions"": 4, ""lines"": 4}, ""src/ops.c"": {""insertions"": 3, ""deletions"": 17, ""lines"": 20}, ""src/option.c"": {""insertions"": 6, ""deletions"": 38, ""lines"": 44}, ""src/option.h"": {""insertions"": 2, ""deletions"": 20, ""lines"": 22}, ""src/optiondefs.h"": {""insertions"": 13, ""deletions"": 59, ""lines"": 72}, ""src/optionstr.c"": {""insertions"": 1, ""deletions"": 13, ""lines"": 14}, ""src/register.c"": {""insertions"": 0, ""deletions"": 2, ""lines"": 2}, ""src/search.c"": {""insertions"": 15, ""deletions"": 45, ""lines"": 60}, ""src/structs.h"": {""insertions"": 1, ""deletions"": 13, ""lines"": 14}, ""src/testdir/test_edit.vim"": {""insertions"": 7, ""deletions"": 9, ""lines"": 16}, ""src/textformat.c"": {""insertions"": 1, ""deletions"": 12, ""lines"": 13}, ""src/version.c"": {""insertions"": 2, ""deletions"": 12, ""lines"": 14}}"
2022-05-21 17:56:58,5a01caa90428a5f87600528d68529383c0b2f78c,Bram Moolenaar,5,3,8,3,"{""src/userfunc.c"": {""insertions"": 2, ""deletions"": 2, ""lines"": 4}, ""src/version.c"": {""insertions"": 2, ""deletions"": 0, ""lines"": 2}, ""src/vim9execute.c"": {""insertions"": 1, ""deletions"": 1, ""lines"": 2}}"
2022-05-21 15:34:38,93c1573dd284dc9cf5ed9265a0143aaf520d2920,zeertzjq,22,0,22,2,"{""src/testdir/test_fold.vim"": {""insertions"": 20, ""deletions"": 0, ""lines"": 20}, ""src/version.c"": {""insertions"": 2, ""deletions"": 0, ""lines"": 2}}"
2022-05-21 15:28:42,1a56ea8381b79c4e7697b6a05451dde5940228ea,Bram Moolenaar,3,0,3,2,"{""src/userfunc.c"": {""insertions"": 1, ""deletions"": 0, ""lines"": 1}, ""src/version.c"": {""insertions"": 2, ""deletions"": 0, ""lines"": 2}}"
2022-05-21 14:39:02,f79d9dd43f6fe05711d7e2616ab4b8bde2ccb089,Bram Moolenaar,126,64,190,8,"{""runtime/doc/vim9.txt"": {""insertions"": 8, ""deletions"": 1, ""lines"": 9}, ""src/ex_cmds.h"": {""insertions"": 1, ""deletions"": 1, ""lines"": 2}, ""src/proto/userfunc.pro"": {""insertions"": 1, ""deletions"": 0, ""lines"": 1}, ""src/testdir/test_vim9_cmd.vim"": {""insertions"": 10, ""deletions"": 0, ""lines"": 10}, ""src/testdir/test_vim9_disassemble.vim"": {""insertions"": 3, ""deletions"": 0, ""lines"": 3}, ""src/userfunc.c"": {""insertions"": 99, ""deletions"": 20, ""lines"": 119}, ""src/version.c"": {""insertions"": 2, ""deletions"": 0, ""lines"": 2}, ""src/vim9execute.c"": {""insertions"": 2, ""deletions"": 42, ""lines"": 44}}"
2022-05-21 12:08:16,2d8ed0203aedd5f6c22efa99394a3677c17c7a7a,Bram Moolenaar,8650,4548,13198,23,"{"".github/CODEOWNERS"": {""insertions"": 8, ""deletions"": 1, ""lines"": 9}, ""runtime/colors/README.txt"": {""insertions"": 20, ""deletions"": 13, ""lines"": 33}, ""runtime/doc/builtin.txt"": {""insertions"": 16, ""deletions"": 14, ""lines"": 30}, ""runtime/doc/map.txt"": {""insertions"": 2, ""deletions"": 1, ""lines"": 3}, ""runtime/doc/syntax.txt"": {""insertions"": 78, ""deletions"": 51, ""lines"": 129}, ""runtime/doc/tags"": {""insertions"": 6, ""deletions"": 0, ""lines"": 6}, ""runtime/doc/testing.txt"": {""insertions"": 1, ""deletions"": 1, ""lines"": 2}, ""runtime/doc/todo.txt"": {""insertions"": 33, ""deletions"": 40, ""lines"": 73}, ""runtime/doc/usr_41.txt"": {""insertions"": 3, ""deletions"": 1, ""lines"": 4}, ""runtime/doc/usr_51.txt"": {""insertions"": 3, ""deletions"": 3, ""lines"": 6}, ""runtime/doc/usr_52.txt"": {""insertions"": 12, ""deletions"": 8, ""lines"": 20}, ""runtime/ftplugin/spec.vim"": {""insertions"": 3, ""deletions"": 2, ""lines"": 5}, ""runtime/gvim.desktop"": {""insertions"": 4, ""deletions"": 1, ""lines"": 5}, ""runtime/indent/fortran.vim"": {""insertions"": 4, ""deletions"": 3, ""lines"": 7}, ""runtime/indent/postscr.vim"": {""insertions"": 1, ""deletions"": 3, ""lines"": 4}, ""runtime/syntax/help.vim"": {""insertions"": 2, ""deletions"": 2, ""lines"": 4}, ""runtime/syntax/vim.vim"": {""insertions"": 8, ""deletions"": 8, ""lines"": 16}, ""runtime/vim.desktop"": {""insertions"": 4, ""deletions"": 1, ""lines"": 5}, ""src/po/en_GB.po"": {""insertions"": 1, ""deletions"": 2, ""lines"": 3}, ""src/po/es.po"": {""insertions"": 8329, ""deletions"": 4147, ""lines"": 12476}, ""src/po/ga.po"": {""insertions"": 112, ""deletions"": 244, ""lines"": 356}, ""src/po/gvim.desktop.in"": {""insertions"": 0, ""deletions"": 1, ""lines"": 1}, ""src/po/vim.desktop.in"": {""insertions"": 0, ""deletions"": 1, ""lines"": 1}}"
2022-05-21 10:20:42,0d534d9cf2ae95fc85ef7fe048d9ff590586a6a6,LemonBoy,15,1,16,3,"{""src/change.c"": {""insertions"": 6, ""deletions"": 1, ""lines"": 7}, ""src/testdir/test_textprop.vim"": {""insertions"": 7, ""deletions"": 0, ""lines"": 7}, ""src/version.c"": {""insertions"": 2, ""deletions"": 0, ""lines"": 2}}"
2022-05-20 17:25:21,3fcccf94e8bc142d2c79c3b62087145896df6b36,Brandon Simmons,43,4,47,3,"{""src/fold.c"": {""insertions"": 12, ""deletions"": 4, ""lines"": 16}, ""src/testdir/test_fold.vim"": {""insertions"": 29, ""deletions"": 0, ""lines"": 29}, ""src/version.c"": {""insertions"": 2, ""deletions"": 0, ""lines"": 2}}"
2022-05-20 16:19:06,8a83ffdc43a4fc904f686864a24a5b0f240df593,Philip H,10,8,18,4,"{"".github/workflows/ci.yml"": {""insertions"": 3, ""deletions"": 3, ""lines"": 6}, "".github/workflows/codeql-analysis.yml"": {""insertions"": 4, ""deletions"": 4, ""lines"": 8}, "".github/workflows/coverity.yml"": {""insertions"": 1, ""deletions"": 1, ""lines"": 2}, ""src/version.c"": {""insertions"": 2, ""deletions"": 0, ""lines"": 2}}"
2022-05-20 13:10:50,875339b22a989d0782097036169e8fb9e2100d7e,Bram Moolenaar,3,1,4,2,"{""src/spell.c"": {""insertions"": 1, ""deletions"": 1, ""lines"": 2}, ""src/version.c"": {""insertions"": 2, ""deletions"": 0, ""lines"": 2}}"
2022-05-20 12:45:59,6dab00aa5417f62f8c2c85c7c4ae871b4f1171f4,zeertzjq,31,1,32,3,"{""src/mouse.c"": {""insertions"": 1, ""deletions"": 1, ""lines"": 2}, ""src/testdir/test_winbar.vim"": {""insertions"": 28, ""deletions"": 0, ""lines"": 28}, ""src/version.c"": {""insertions"": 2, ""deletions"": 0, ""lines"": 2}}"
2022-05-20 09:39:18,b0855f5324b348921d412d97193e8c8bc3b5d1dd,Bram Moolenaar,3,0,3,2,"{""src/testdir/test_functions.vim"": {""insertions"": 1, ""deletions"": 0, ""lines"": 1}, ""src/version.c"": {""insertions"": 2, ""deletions"": 0, ""lines"": 2}}"
2022-05-20 09:10:34,b2b3acbf2b3ae29ecf517f03b46fbeadf0c1a905,LemonBoy,204,49,253,9,"{""src/job.c"": {""insertions"": 2, ""deletions"": 2, ""lines"": 4}, ""src/option.c"": {""insertions"": 1, ""deletions"": 0, ""lines"": 1}, ""src/proto/term.pro"": {""insertions"": 1, ""deletions"": 0, ""lines"": 1}, ""src/proto/terminal.pro"": {""insertions"": 1, ""deletions"": 0, ""lines"": 1}, ""src/term.c"": {""insertions"": 20, ""deletions"": 1, ""lines"": 21}, ""src/terminal.c"": {""insertions"": 163, ""deletions"": 44, ""lines"": 207}, ""src/testdir/test_functions.vim"": {""insertions"": 2, ""deletions"": 2, ""lines"": 4}, ""src/testdir/test_terminal.vim"": {""insertions"": 12, ""deletions"": 0, ""lines"": 12}, ""src/version.c"": {""insertions"": 2, ""deletions"": 0, ""lines"": 2}}"
2022-05-19 09:31:47,1755a91851f7022fdd3eecfbd2cc0b508a2f2a8f,Yegappan Lakshmanan,801,1,802,9,"{""runtime/doc/autocmd.txt"": {""insertions"": 9, ""deletions"": 0, ""lines"": 9}, ""runtime/doc/builtin.txt"": {""insertions"": 142, ""deletions"": 0, ""lines"": 142}, ""runtime/doc/usr_41.txt"": {""insertions"": 5, ""deletions"": 0, ""lines"": 5}, ""src/autocmd.c"": {""insertions"": 352, ""deletions"": 1, ""lines"": 353}, ""src/evalfunc.c"": {""insertions"": 6, ""deletions"": 0, ""lines"": 6}, ""src/proto/autocmd.pro"": {""insertions"": 3, ""deletions"": 0, ""lines"": 3}, ""src/testdir/test_autocmd.vim"": {""insertions"": 270, ""deletions"": 0, ""lines"": 270}, ""src/testdir/test_vim9_builtin.vim"": {""insertions"": 12, ""deletions"": 0, ""lines"": 12}, ""src/version.c"": {""insertions"": 2, ""deletions"": 0, ""lines"": 2}}"
2022-05-18 21:07:47,aaadb5b6f76ea03e5eb460121f3dbf46ad04ce50,Bram Moolenaar,31,2,33,3,"{""src/session.c"": {""insertions"": 7, ""deletions"": 2, ""lines"": 9}, ""src/testdir/test_mksession.vim"": {""insertions"": 22, ""deletions"": 0, ""lines"": 22}, ""src/version.c"": {""insertions"": 2, ""deletions"": 0, ""lines"": 2}}"
2022-05-18 15:29:08,28d032cc688ccfda18c5bbcab8b50aba6e18cde5,Bram Moolenaar,18,0,18,3,"{""src/testdir/test_tagjump.vim"": {""insertions"": 9, ""deletions"": 0, ""lines"": 9}, ""src/version.c"": {""insertions"": 2, ""deletions"": 0, ""lines"": 2}, ""src/window.c"": {""insertions"": 7, ""deletions"": 0, ""lines"": 7}}"
2022-05-18 14:04:02,360da40b47a84ee8586c3b5d062f8c64a2ac9cc6,Christian Brabandt,39,1,40,6,"{""runtime/doc/pattern.txt"": {""insertions"": 1, ""deletions"": 1, ""lines"": 2}, ""src/errors.h"": {""insertions"": 2, ""deletions"": 0, ""lines"": 2}, ""src/regexp_bt.c"": {""insertions"": 8, ""deletions"": 0, ""lines"": 8}, ""src/regexp_nfa.c"": {""insertions"": 8, ""deletions"": 0, ""lines"": 8}, ""src/testdir/test_regexp_latin.vim"": {""insertions"": 18, ""deletions"": 0, ""lines"": 18}, ""src/version.c"": {""insertions"": 2, ""deletions"": 0, ""lines"": 2}}"
2022-05-18 12:11:57,e2bd8600b873d2cd1f9d667c28cba8b1dba18839,Bram Moolenaar,26,0,26,3,"{""src/ex_cmds.c"": {""insertions"": 11, ""deletions"": 0, ""lines"": 11}, ""src/testdir/test_substitute.vim"": {""insertions"": 13, ""deletions"": 0, ""lines"": 13}, ""src/version.c"": {""insertions"": 2, ""deletions"": 0, ""lines"": 2}}"
2022-05-18 10:00:48,b1040dc11fa15818eda724c35a334f460cf98005,Bram Moolenaar,6,3,9,2,"{""src/version.c"": {""insertions"": 2, ""deletions"": 0, ""lines"": 2}, ""src/vim9execute.c"": {""insertions"": 4, ""deletions"": 3, ""lines"": 7}}"
2022-05-17 19:11:02,51f0bfb88a3554ca2dde777d78a59880d1ee37a8,Bram Moolenaar,26,0,26,3,"{""src/ex_getln.c"": {""insertions"": 12, ""deletions"": 0, ""lines"": 12}, ""src/testdir/test_cmdline.vim"": {""insertions"": 12, ""deletions"": 0, ""lines"": 12}, ""src/version.c"": {""insertions"": 2, ""deletions"": 0, ""lines"": 2}}"
2022-05-17 16:47:07,4748c4bd64610cf943a431d215bb1aad51f8d0b4,Bram Moolenaar,15,1,16,3,"{""src/scriptfile.c"": {""insertions"": 2, ""deletions"": 1, ""lines"": 3}, ""src/testdir/test_source.vim"": {""insertions"": 11, ""deletions"": 0, ""lines"": 11}, ""src/version.c"": {""insertions"": 2, ""deletions"": 0, ""lines"": 2}}"
2022-05-17 15:12:39,bd3a9d2c946bae0427d7c9b9249716064935fb4e,Bram Moolenaar,20,10,30,8,"{""src/proto/vim9instr.pro"": {""insertions"": 2, ""deletions"": 2, ""lines"": 4}, ""src/testdir/test_vim9_disassemble.vim"": {""insertions"": 2, ""deletions"": 2, ""lines"": 4}, ""src/testdir/test_vim9_script.vim"": {""insertions"": 1, ""deletions"": 1, ""lines"": 2}, ""src/version.c"": {""insertions"": 2, ""deletions"": 0, ""lines"": 2}, ""src/vim9.h"": {""insertions"": 1, ""deletions"": 0, ""lines"": 1}, ""src/vim9compile.c"": {""insertions"": 2, ""deletions"": 1, ""lines"": 3}, ""src/vim9execute.c"": {""insertions"": 7, ""deletions"": 3, ""lines"": 10}, ""src/vim9instr.c"": {""insertions"": 3, ""deletions"": 1, ""lines"": 4}}"
2022-05-17 14:03:33,1ff9c44267ce487145d22d75a96370d7f96ae8dd,Bram Moolenaar,10,1,11,3,"{""src/testdir/test_vim9_expr.vim"": {""insertions"": 6, ""deletions"": 0, ""lines"": 6}, ""src/version.c"": {""insertions"": 2, ""deletions"": 0, ""lines"": 2}, ""src/vim9expr.c"": {""insertions"": 2, ""deletions"": 1, ""lines"": 3}}"
2022-05-17 12:14:23,40c141d333292d625907f4de13766cbbc2223911,Bram Moolenaar,13,4,17,3,"{""src/ex_docmd.c"": {""insertions"": 8, ""deletions"": 3, ""lines"": 11}, ""src/testdir/test_vim9_expr.vim"": {""insertions"": 3, ""deletions"": 1, ""lines"": 4}, ""src/version.c"": {""insertions"": 2, ""deletions"": 0, ""lines"": 2}}"
2022-05-17 11:45:15,0d03263fd731986c0eee1a08e0f1b19f1bc3a7ad,Bram Moolenaar,25,2,27,3,"{""src/ex_eval.c"": {""insertions"": 13, ""deletions"": 2, ""lines"": 15}, ""src/testdir/test_vim9_cmd.vim"": {""insertions"": 10, ""deletions"": 0, ""lines"": 10}, ""src/version.c"": {""insertions"": 2, ""deletions"": 0, ""lines"": 2}}"
2022-05-16 18:40:59,7ce5b2b590256ce53d6af28c1d203fb3bc1d2d97,Bram Moolenaar,44,11,55,6,"{""src/change.c"": {""insertions"": 3, ""deletions"": 0, ""lines"": 3}, ""src/edit.c"": {""insertions"": 2, ""deletions"": 10, ""lines"": 12}, ""src/misc2.c"": {""insertions"": 26, ""deletions"": 1, ""lines"": 27}, ""src/proto/misc2.pro"": {""insertions"": 1, ""deletions"": 0, ""lines"": 1}, ""src/testdir/test_visual.vim"": {""insertions"": 10, ""deletions"": 0, ""lines"": 10}, ""src/version.c"": {""insertions"": 2, ""deletions"": 0, ""lines"": 2}}"
2022-05-16 17:06:15,60ae0e71490c97f2871a6344aca61cacf220f813,Bram Moolenaar,10,1,11,3,"{""src/cindent.c"": {""insertions"": 1, ""deletions"": 1, ""lines"": 2}, ""src/testdir/test_cindent.vim"": {""insertions"": 7, ""deletions"": 0, ""lines"": 7}, ""src/version.c"": {""insertions"": 2, ""deletions"": 0, ""lines"": 2}}"
2022-05-16 16:07:41,3c25a8617aad9860a1b179d40a183c638b3b70cc,Bram Moolenaar,4,2,6,2,"{""src/testdir/test_gui.vim"": {""insertions"": 2, ""deletions"": 2, ""lines"": 4}, ""src/version.c"": {""insertions"": 2, ""deletions"": 0, ""lines"": 2}}"
2022-05-16 15:41:35,e5162e76c0a8bd71fbfb0840a8c0014788d8808b,Bram Moolenaar,7,0,7,2,"{""src/testdir/test_gui.vim"": {""insertions"": 5, ""deletions"": 0, ""lines"": 5}, ""src/version.c"": {""insertions"": 2, ""deletions"": 0, ""lines"": 2}}"
2022-05-16 14:27:46,7add8d373185a6b20aeeb8c30adb9acc68de66ec,Bram Moolenaar,38,20,58,4,"{""runtime/doc/testing.txt"": {""insertions"": 4, ""deletions"": 1, ""lines"": 5}, ""src/testdir/test_gui.vim"": {""insertions"": 24, ""deletions"": 19, ""lines"": 43}, ""src/testing.c"": {""insertions"": 8, ""deletions"": 0, ""lines"": 8}, ""src/version.c"": {""insertions"": 2, ""deletions"": 0, ""lines"": 2}}"
2022-05-16 12:34:44,3b675c276c71472022b684b7b1dec213824d3104,Bram Moolenaar,33,28,61,2,"{""src/testdir/test_gui.vim"": {""insertions"": 31, ""deletions"": 28, ""lines"": 59}, ""src/version.c"": {""insertions"": 2, ""deletions"": 0, ""lines"": 2}}"
2022-05-16 11:37:36,386c24cd262edac66a31add2fd989c96c4c2c952,Bram Moolenaar,8,4,12,2,"{""src/filepath.c"": {""insertions"": 6, ""deletions"": 4, ""lines"": 10}, ""src/version.c"": {""insertions"": 2, ""deletions"": 0, ""lines"": 2}}"
2022-05-16 10:14:09,5a8fad32ea9c075f045b37d6c7739891d458f82b,shane.xb.qian,9,4,13,3,"{"".gitignore"": {""insertions"": 5, ""deletions"": 2, ""lines"": 7}, ""src/testdir/Makefile"": {""insertions"": 2, ""deletions"": 2, ""lines"": 4}, ""src/version.c"": {""insertions"": 2, ""deletions"": 0, ""lines"": 2}}"
2022-05-16 09:04:51,9f28eeb694cec8f5019b8fbde3f92f4a90dc5006,Bram Moolenaar,4,1,5,2,"{""src/memline.c"": {""insertions"": 2, ""deletions"": 1, ""lines"": 3}, ""src/version.c"": {""insertions"": 2, ""deletions"": 0, ""lines"": 2}}"
2022-05-15 21:24:55,1bdc60eb91b9e6320318d96ea59bd2aad775f408,Paul Ollis,58,4,62,3,"{""src/memline.c"": {""insertions"": 5, ""deletions"": 4, ""lines"": 9}, ""src/testdir/test_textprop.vim"": {""insertions"": 51, ""deletions"": 0, ""lines"": 51}, ""src/version.c"": {""insertions"": 2, ""deletions"": 0, ""lines"": 2}}"
2022-05-15 13:50:12,b62dc5e7825bc195efe3041d5b3a9f1528359e1c,Bram Moolenaar,30,13,43,3,"{""src/buffer.c"": {""insertions"": 22, ""deletions"": 13, ""lines"": 35}, ""src/testdir/test_buffer.vim"": {""insertions"": 6, ""deletions"": 0, ""lines"": 6}, ""src/version.c"": {""insertions"": 2, ""deletions"": 0, ""lines"": 2}}"
2022-05-15 12:59:11,dd41037552c1be3548d2ce34bb1c889f14edb553,=?UTF-8?q?Dundar=20G=C3=B6c?=,28,29,57,3,"{""src/evalfunc.c"": {""insertions"": 25, ""deletions"": 28, ""lines"": 53}, ""src/quickfix.c"": {""insertions"": 1, ""deletions"": 1, ""lines"": 2}, ""src/version.c"": {""insertions"": 2, ""deletions"": 0, ""lines"": 2}}"
2022-05-15 12:08:02,b559b302e0ecc6fced03d5201dc30f10cff7af0a,LemonBoy,41,0,41,3,"{""src/ops.c"": {""insertions"": 6, ""deletions"": 0, ""lines"": 6}, ""src/testdir/test_textprop.vim"": {""insertions"": 33, ""deletions"": 0, ""lines"": 33}, ""src/version.c"": {""insertions"": 2, ""deletions"": 0, ""lines"": 2}}"
2022-05-14 20:29:44,395bd1f6d3edc9f7edb5d1f2d7deaf5a9e3ab93c,Bram Moolenaar,27,3,30,3,"{""src/normal.c"": {""insertions"": 10, ""deletions"": 3, ""lines"": 13}, ""src/testdir/test_gf.vim"": {""insertions"": 15, ""deletions"": 0, ""lines"": 15}, ""src/version.c"": {""insertions"": 2, ""deletions"": 0, ""lines"": 2}}"
2022-05-14 17:48:05,788c06a2492b546dd0824b119251cd8ea7da9cb5,LemonBoy,24,3,27,3,"{""src/change.c"": {""insertions"": 10, ""deletions"": 3, ""lines"": 13}, ""src/testdir/test_textprop.vim"": {""insertions"": 12, ""deletions"": 0, ""lines"": 12}, ""src/version.c"": {""insertions"": 2, ""deletions"": 0, ""lines"": 2}}"
2022-05-14 17:10:15,698cb4c8fa16a4dbe4830648532c09d7e5c89095,LemonBoy,40,4,44,3,"{""src/testdir/test_textprop.vim"": {""insertions"": 33, ""deletions"": 0, ""lines"": 33}, ""src/textprop.c"": {""insertions"": 5, ""deletions"": 4, ""lines"": 9}, ""src/version.c"": {""insertions"": 2, ""deletions"": 0, ""lines"": 2}}"
2022-05-14 12:33:50,30ab04e16e1e9e6133590181197b3f8e70cb495e,Bram Moolenaar,7431,2016,9447,34,"{"".github/CODEOWNERS"": {""insertions"": 19, ""deletions"": 0, ""lines"": 19}, ""runtime/colors/README.txt"": {""insertions"": 57, ""deletions"": 10, ""lines"": 67}, ""runtime/colors/blue.vim"": {""insertions"": 442, ""deletions"": 50, ""lines"": 492}, ""runtime/colors/darkblue.vim"": {""insertions"": 460, ""deletions"": 57, ""lines"": 517}, ""runtime/colors/delek.vim"": {""insertions"": 335, ""deletions"": 51, ""lines"": 386}, ""runtime/colors/desert.vim"": {""insertions"": 326, ""deletions"": 99, ""lines"": 425}, ""runtime/colors/elflord.vim"": {""insertions"": 371, ""deletions"": 46, ""lines"": 417}, ""runtime/colors/evening.vim"": {""insertions"": 440, ""deletions"": 48, ""lines"": 488}, ""runtime/colors/industry.vim"": {""insertions"": 331, ""deletions"": 34, ""lines"": 365}, ""runtime/colors/koehler.vim"": {""insertions"": 357, ""deletions"": 70, ""lines"": 427}, ""runtime/colors/morning.vim"": {""insertions"": 326, ""deletions"": 48, ""lines"": 374}, ""runtime/colors/murphy.vim"": {""insertions"": 332, ""deletions"": 38, ""lines"": 370}, ""runtime/colors/pablo.vim"": {""insertions"": 359, ""deletions"": 23, ""lines"": 382}, ""runtime/colors/peachpuff.vim"": {""insertions"": 328, ""deletions"": 53, ""lines"": 381}, ""runtime/colors/ron.vim"": {""insertions"": 374, ""deletions"": 41, ""lines"": 415}, ""runtime/colors/shine.vim"": {""insertions"": 345, ""deletions"": 52, ""lines"": 397}, ""runtime/colors/slate.vim"": {""insertions"": 349, ""deletions"": 55, ""lines"": 404}, ""runtime/colors/tools/check_colors.vim"": {""insertions"": 189, ""deletions"": 220, ""lines"": 409}, ""runtime/colors/torte.vim"": {""insertions"": 356, ""deletions"": 44, ""lines"": 400}, ""runtime/colors/zellner.vim"": {""insertions"": 337, ""deletions"": 50, ""lines"": 387}, ""runtime/doc/Makefile"": {""insertions"": 6, ""deletions"": 2, ""lines"": 8}, ""runtime/doc/eval.txt"": {""insertions"": 3, ""deletions"": 3, ""lines"": 6}, ""runtime/doc/help.txt"": {""insertions"": 6, ""deletions"": 3, ""lines"": 9}, ""runtime/doc/tags"": {""insertions"": 35, ""deletions"": 32, ""lines"": 67}, ""runtime/doc/todo.txt"": {""insertions"": 9, ""deletions"": 2, ""lines"": 11}, ""runtime/doc/usr_41.txt"": {""insertions"": 3, ""deletions"": 846, ""lines"": 849}, ""runtime/doc/usr_45.txt"": {""insertions"": 3, ""deletions"": 3, ""lines"": 6}, ""runtime/doc/usr_50.txt"": {""insertions"": 25, ""deletions"": 0, ""lines"": 25}, ""runtime/doc/usr_51.txt"": {""insertions"": 860, ""deletions"": 0, ""lines"": 860}, ""runtime/doc/{usr_46.txt => usr_52.txt}"": {""insertions"": 10, ""deletions"": 10, ""lines"": 20}, ""runtime/doc/usr_90.txt"": {""insertions"": 2, ""deletions"": 2, ""lines"": 4}, ""runtime/doc/usr_toc.txt"": {""insertions"": 31, ""deletions"": 20, ""lines"": 51}, ""runtime/doc/vim9.txt"": {""insertions"": 3, ""deletions"": 2, ""lines"": 5}, ""runtime/syntax/help.vim"": {""insertions"": 2, ""deletions"": 2, ""lines"": 4}}"
2022-05-14 11:54:23,2e444bbef0f36535bf941f007f2961f3f66bbe87,Bram Moolenaar,9,1,10,3,"{""src/indent.c"": {""insertions"": 2, ""deletions"": 1, ""lines"": 3}, ""src/testdir/test_smartindent.vim"": {""insertions"": 5, ""deletions"": 0, ""lines"": 5}, ""src/version.c"": {""insertions"": 2, ""deletions"": 0, ""lines"": 2}}"
2022-05-14 11:34:43,98feacedf9c03b8db79da03508a2c3c25dac3e53,Bram Moolenaar,5,1,6,2,"{""src/testdir/test_gui.vim"": {""insertions"": 3, ""deletions"": 1, ""lines"": 4}, ""src/version.c"": {""insertions"": 2, ""deletions"": 0, ""lines"": 2}}"
2022-05-14 10:52:23,de5cf287812510d2c8ffe66b99cf33c4e1a6e6f1,Bram Moolenaar,40,16,56,7,"{""src/change.c"": {""insertions"": 1, ""deletions"": 8, ""lines"": 9}, ""src/edit.c"": {""insertions"": 1, ""deletions"": 1, ""lines"": 2}, ""src/indent.c"": {""insertions"": 17, ""deletions"": 1, ""lines"": 18}, ""src/ops.c"": {""insertions"": 1, ""deletions"": 6, ""lines"": 7}, ""src/proto/indent.pro"": {""insertions"": 1, ""deletions"": 0, ""lines"": 1}, ""src/testdir/test_smartindent.vim"": {""insertions"": 17, ""deletions"": 0, ""lines"": 17}, ""src/version.c"": {""insertions"": 2, ""deletions"": 0, ""lines"": 2}}"
2022-05-13 20:56:28,4b93674159d60c985de906c30f45dbaf2b64056f,LemonBoy,49,20,69,3,"{""src/ops.c"": {""insertions"": 23, ""deletions"": 20, ""lines"": 43}, ""src/testdir/test_textprop.vim"": {""insertions"": 24, ""deletions"": 0, ""lines"": 24}, ""src/version.c"": {""insertions"": 2, ""deletions"": 0, ""lines"": 2}}"
2022-05-13 15:23:37,31ad32a325cc31f0f2bdd530c68bfb856a2187c5,Bram Moolenaar,37,1,38,3,"{""src/testdir/test_vim9_expr.vim"": {""insertions"": 32, ""deletions"": 0, ""lines"": 32}, ""src/version.c"": {""insertions"": 2, ""deletions"": 0, ""lines"": 2}, ""src/vim9expr.c"": {""insertions"": 3, ""deletions"": 1, ""lines"": 4}}"
2022-05-13 12:50:36,d881d1598467d88808bafd2fa86982ebbca7dcc1,Bram Moolenaar,61,37,98,3,"{""src/testdir/test_vim9_func.vim"": {""insertions"": 18, ""deletions"": 0, ""lines"": 18}, ""src/userfunc.c"": {""insertions"": 41, ""deletions"": 37, ""lines"": 78}, ""src/version.c"": {""insertions"": 2, ""deletions"": 0, ""lines"": 2}}"
2022-05-13 11:41:50,b7a701255578b38896631ba20556b856e8888069,LemonBoy,55,0,55,4,"{""src/spell.c"": {""insertions"": 3, ""deletions"": 0, ""lines"": 3}, ""src/spellsuggest.c"": {""insertions"": 5, ""deletions"": 0, ""lines"": 5}, ""src/testdir/test_textprop.vim"": {""insertions"": 45, ""deletions"": 0, ""lines"": 45}, ""src/version.c"": {""insertions"": 2, ""deletions"": 0, ""lines"": 2}}"
2022-05-12 21:03:01,7f8a3b11bfc02f24dfd877d0a81392d679008180,Bram Moolenaar,22,7,29,4,"{""src/testdir/test_vim9_builtin.vim"": {""insertions"": 1, ""deletions"": 0, ""lines"": 1}, ""src/testdir/test_vim9_expr.vim"": {""insertions"": 18, ""deletions"": 0, ""lines"": 18}, ""src/version.c"": {""insertions"": 2, ""deletions"": 0, ""lines"": 2}, ""src/vim9expr.c"": {""insertions"": 1, ""deletions"": 7, ""lines"": 8}}"
2022-05-12 19:35:35,9f1983de4e8293bae32fdab72a459b1b64bf767f,Bram Moolenaar,74,72,146,7,"{""src/if_py_both.h"": {""insertions"": 1, ""deletions"": 1, ""lines"": 2}, ""src/os_amiga.c"": {""insertions"": 52, ""deletions"": 52, ""lines"": 104}, ""src/os_mswin.c"": {""insertions"": 5, ""deletions"": 5, ""lines"": 10}, ""src/os_vms.c"": {""insertions"": 1, ""deletions"": 1, ""lines"": 2}, ""src/os_vms_conf.h"": {""insertions"": 1, ""deletions"": 1, ""lines"": 2}, ""src/os_win32.c"": {""insertions"": 12, ""deletions"": 12, ""lines"": 24}, ""src/version.c"": {""insertions"": 2, ""deletions"": 0, ""lines"": 2}}"
2022-05-12 19:34:15,3f32a5f1601ab2b0eba0caad00d4c26fb86a02a2,Bram Moolenaar,4165,5225,9390,55,"{""runtime/compiler/scdoc.vim"": {""insertions"": 2, ""deletions"": 1, ""lines"": 3}, ""runtime/doc/builtin.txt"": {""insertions"": 1, ""deletions"": 1, ""lines"": 2}, ""runtime/doc/eval.txt"": {""insertions"": 14, ""deletions"": 6, ""lines"": 20}, ""runtime/doc/starting.txt"": {""insertions"": 2, ""deletions"": 2, ""lines"": 4}, ""runtime/doc/syntax.txt"": {""insertions"": 82, ""deletions"": 84, ""lines"": 166}, ""runtime/doc/tags"": {""insertions"": 1, ""deletions"": 0, ""lines"": 1}, ""runtime/doc/todo.txt"": {""insertions"": 3, ""deletions"": 13, ""lines"": 16}, ""runtime/doc/windows.txt"": {""insertions"": 2, ""deletions"": 2, ""lines"": 4}, ""runtime/evim.vim"": {""insertions"": 4, ""deletions"": 1, ""lines"": 5}, ""runtime/ftplugin/scdoc.vim"": {""insertions"": 3, ""deletions"": 7, ""lines"": 10}, ""runtime/syntax/debchangelog.vim"": {""insertions"": 2, ""deletions"": 2, ""lines"": 4}, ""runtime/syntax/debcontrol.vim"": {""insertions"": 2, ""deletions"": 2, ""lines"": 4}, ""runtime/syntax/debsources.vim"": {""insertions"": 2, ""deletions"": 2, ""lines"": 4}, ""runtime/syntax/help.vim"": {""insertions"": 2, ""deletions"": 2, ""lines"": 4}, ""runtime/syntax/scdoc.vim"": {""insertions"": 37, ""deletions"": 26, ""lines"": 63}, ""src/po/af.po"": {""insertions"": 3238, ""deletions"": 3871, ""lines"": 7109}, ""src/po/ca.po"": {""insertions"": 13, ""deletions"": 8, ""lines"": 21}, ""src/po/cs.cp1250.po"": {""insertions"": 8, ""deletions"": 5, ""lines"": 13}, ""src/po/cs.po"": {""insertions"": 8, ""deletions"": 5, ""lines"": 13}, ""src/po/da.po"": {""insertions"": 13, ""deletions"": 8, ""lines"": 21}, ""src/po/de.po"": {""insertions"": 13, ""deletions"": 8, ""lines"": 21}, ""src/po/en_GB.po"": {""insertions"": 194, ""deletions"": 678, ""lines"": 872}, ""src/po/eo.po"": {""insertions"": 13, ""deletions"": 8, ""lines"": 21}, ""src/po/es.po"": {""insertions"": 8, ""deletions"": 5, ""lines"": 13}, ""src/po/fi.po"": {""insertions"": 13, ""deletions"": 8, ""lines"": 21}, ""src/po/fr.po"": {""insertions"": 13, ""deletions"": 8, ""lines"": 21}, ""src/po/ga.po"": {""insertions"": 13, ""deletions"": 8, ""lines"": 21}, ""src/po/it.po"": {""insertions"": 185, ""deletions"": 297, ""lines"": 482}, ""src/po/ja.euc-jp.po"": {""insertions"": 13, ""deletions"": 8, ""lines"": 21}, ""src/po/ja.po"": {""insertions"": 13, ""deletions"": 8, ""lines"": 21}, ""src/po/ja.sjis.po"": {""insertions"": 13, ""deletions"": 8, ""lines"": 21}, ""src/po/ko.UTF-8.po"": {""insertions"": 2, ""deletions"": 0, ""lines"": 2}, ""src/po/ko.po"": {""insertions"": 2, ""deletions"": 0, ""lines"": 2}, ""src/po/nb.po"": {""insertions"": 8, ""deletions"": 5, ""lines"": 13}, ""src/po/nl.po"": {""insertions"": 4, ""deletions"": 2, ""lines"": 6}, ""src/po/no.po"": {""insertions"": 8, ""deletions"": 5, ""lines"": 13}, ""src/po/pl.UTF-8.po"": {""insertions"": 12, ""deletions"": 6, ""lines"": 18}, ""src/po/pl.cp1250.po"": {""insertions"": 12, ""deletions"": 6, ""lines"": 18}, ""src/po/pl.po"": {""insertions"": 12, ""deletions"": 6, ""lines"": 18}, ""src/po/pt_BR.po"": {""insertions"": 13, ""deletions"": 8, ""lines"": 21}, ""src/po/ru.cp1251.po"": {""insertions"": 15, ""deletions"": 8, ""lines"": 23}, ""src/po/ru.po"": {""insertions"": 15, ""deletions"": 8, ""lines"": 23}, ""src/po/sk.cp1250.po"": {""insertions"": 11, ""deletions"": 5, ""lines"": 16}, ""src/po/sk.po"": {""insertions"": 11, ""deletions"": 5, ""lines"": 16}, ""src/po/sr.po"": {""insertions"": 13, ""deletions"": 8, ""lines"": 21}, ""src/po/sv.po"": {""insertions"": 8, ""deletions"": 5, ""lines"": 13}, ""src/po/tr.po"": {""insertions"": 13, ""deletions"": 8, ""lines"": 21}, ""src/po/uk.cp1251.po"": {""insertions"": 14, ""deletions"": 9, ""lines"": 23}, ""src/po/uk.po"": {""insertions"": 14, ""deletions"": 9, ""lines"": 23}, ""src/po/vi.po"": {""insertions"": 8, ""deletions"": 5, ""lines"": 13}, ""src/po/zh_CN.UTF-8.po"": {""insertions"": 8, ""deletions"": 5, ""lines"": 13}, ""src/po/zh_CN.cp936.po"": {""insertions"": 8, ""deletions"": 5, ""lines"": 13}, ""src/po/zh_CN.po"": {""insertions"": 8, ""deletions"": 5, ""lines"": 13}, ""src/po/zh_TW.UTF-8.po"": {""insertions"": 8, ""deletions"": 5, ""lines"": 13}, ""src/po/zh_TW.po"": {""insertions"": 8, ""deletions"": 5, ""lines"": 13}}"
2022-05-12 17:45:18,d0b1a09f44654bb5e29b09de1311845200f17d90,LemonBoy,26,2,28,3,"{""src/change.c"": {""insertions"": 6, ""deletions"": 2, ""lines"": 8}, ""src/testdir/test_textprop.vim"": {""insertions"": 18, ""deletions"": 0, ""lines"": 18}, ""src/version.c"": {""insertions"": 2, ""deletions"": 0, ""lines"": 2}}"
2022-05-12 16:44:29,39c46b43780ad00ea27a93d92aadd44753d4c3ea,Sean Dewar,14,0,14,3,"{""src/optionstr.c"": {""insertions"": 1, ""deletions"": 0, ""lines"": 1}, ""src/testdir/test_options.vim"": {""insertions"": 11, ""deletions"": 0, ""lines"": 11}, ""src/version.c"": {""insertions"": 2, ""deletions"": 0, ""lines"": 2}}"
2022-05-12 16:24:49,de216732d45caa87e6f08f4319aa71e805a89a0e,Bram Moolenaar,13,5,18,2,"{""runtime/import/dist/vimhelp.vim"": {""insertions"": 11, ""deletions"": 5, ""lines"": 16}, ""src/version.c"": {""insertions"": 2, ""deletions"": 0, ""lines"": 2}}"
2022-05-12 14:39:31,82444cefa3fef87624a078ea86a72af7ef4ef42e,LemonBoy,27,1,28,3,"{""src/testdir/test_undo.vim"": {""insertions"": 17, ""deletions"": 0, ""lines"": 17}, ""src/undo.c"": {""insertions"": 8, ""deletions"": 1, ""lines"": 9}, ""src/version.c"": {""insertions"": 2, ""deletions"": 0, ""lines"": 2}}"
2022-05-12 10:05:40,d0132f4862342eebe6d8e7a9096adf956ba6588b,Bram Moolenaar,32,16,48,6,"{""src/proto/vim9expr.pro"": {""insertions"": 1, ""deletions"": 1, ""lines"": 2}, ""src/testdir/test_vim9_builtin.vim"": {""insertions"": 5, ""deletions"": 0, ""lines"": 5}, ""src/testdir/test_vim9_expr.vim"": {""insertions"": 15, ""deletions"": 0, ""lines"": 15}, ""src/version.c"": {""insertions"": 2, ""deletions"": 0, ""lines"": 2}, ""src/vim9compile.c"": {""insertions"": 1, ""deletions"": 1, ""lines"": 2}, ""src/vim9expr.c"": {""insertions"": 8, ""deletions"": 14, ""lines"": 22}}"
2022-05-11 13:15:37,9af2bc075169e14fd06ed967d28eac7206d21f36,zeertzjq,9,5,14,4,"{""runtime/doc/builtin.txt"": {""insertions"": 3, ""deletions"": 4, ""lines"": 7}, ""src/search.c"": {""insertions"": 1, ""deletions"": 1, ""lines"": 2}, ""src/testdir/test_matchfuzzy.vim"": {""insertions"": 3, ""deletions"": 0, ""lines"": 3}, ""src/version.c"": {""insertions"": 2, ""deletions"": 0, ""lines"": 2}}"
2022-05-11 10:42:28,a59f2dfd0cf9ee1a584d3de5b7c2d47648e79060,Bram Moolenaar,7,1,8,3,"{""src/buffer.c"": {""insertions"": 1, ""deletions"": 1, ""lines"": 2}, ""src/testdir/test_buffer.vim"": {""insertions"": 4, ""deletions"": 0, ""lines"": 4}, ""src/version.c"": {""insertions"": 2, ""deletions"": 0, ""lines"": 2}}"
2022-05-10 20:11:12,ead241538cdd26cbf02599b6e23cd8baeafbcbb2,Bram Moolenaar,12,0,12,2,"{""src/testdir/test_perl.vim"": {""insertions"": 10, ""deletions"": 0, ""lines"": 10}, ""src/version.c"": {""insertions"": 2, ""deletions"": 0, ""lines"": 2}}"
2022-05-10 19:54:46,a773d84570e224035389f6697ac5634d7f27cccc,LemonBoy,15,11,26,2,"{""src/gui_w32.c"": {""insertions"": 13, ""deletions"": 11, ""lines"": 24}, ""src/version.c"": {""insertions"": 2, ""deletions"": 0, ""lines"": 2}}"
2022-05-10 18:13:23,d98e75e23666c159c7e00bcf5b6ad9a933bb0534,Brandon Simmons,29,0,29,3,"{""src/fold.c"": {""insertions"": 7, ""deletions"": 0, ""lines"": 7}, ""src/testdir/test_fold.vim"": {""insertions"": 20, ""deletions"": 0, ""lines"": 20}, ""src/version.c"": {""insertions"": 2, ""deletions"": 0, ""lines"": 2}}"
2022-05-10 17:11:43,70c41241c2701f26a99085e433925a206ca265a3,Bram Moolenaar,24,11,35,5,"{""src/evalvars.c"": {""insertions"": 13, ""deletions"": 9, ""lines"": 22}, ""src/proto/evalvars.pro"": {""insertions"": 1, ""deletions"": 1, ""lines"": 2}, ""src/testdir/test_vim9_expr.vim"": {""insertions"": 7, ""deletions"": 0, ""lines"": 7}, ""src/typval.c"": {""insertions"": 1, ""deletions"": 1, ""lines"": 2}, ""src/version.c"": {""insertions"": 2, ""deletions"": 0, ""lines"": 2}}"
2022-05-10 16:51:55,df6e0e46c55c9c6d788f94482a8858c0f31391f4,Bram Moolenaar,7,5,12,2,"{""src/errors.h"": {""insertions"": 5, ""deletions"": 5, ""lines"": 10}, ""src/version.c"": {""insertions"": 2, ""deletions"": 0, ""lines"": 2}}"
2022-05-10 16:50:39,d8f5f766219273a8579947cc80b92580b6988a4b,Ernie Rael,36,6,42,5,"{""runtime/doc/builtin.txt"": {""insertions"": 26, ""deletions"": 0, ""lines"": 26}, ""src/map.c"": {""insertions"": 1, ""deletions"": 0, ""lines"": 1}, ""src/testdir/test_map_functions.vim"": {""insertions"": 5, ""deletions"": 5, ""lines"": 10}, ""src/testdir/test_vim9_builtin.vim"": {""insertions"": 2, ""deletions"": 1, ""lines"": 3}, ""src/version.c"": {""insertions"": 2, ""deletions"": 0, ""lines"": 2}}"
2022-05-10 12:32:24,0f267621c04883de010a6379217a5f182cc03dda,Bram Moolenaar,3,1,4,2,"{""src/if_perl.xs"": {""insertions"": 1, ""deletions"": 1, ""lines"": 2}, ""src/version.c"": {""insertions"": 2, ""deletions"": 0, ""lines"": 2}}"
2022-05-10 12:24:30,0abc2871c105882ed1c1effb9a7757fad8a395bd,Bram Moolenaar,286,121,407,15,"{""src/alloc.c"": {""insertions"": 7, ""deletions"": 7, ""lines"": 14}, ""src/dict.c"": {""insertions"": 2, ""deletions"": 2, ""lines"": 4}, ""src/eval.c"": {""insertions"": 2, ""deletions"": 2, ""lines"": 4}, ""src/evalvars.c"": {""insertions"": 43, ""deletions"": 31, ""lines"": 74}, ""src/proto/alloc.pro"": {""insertions"": 2, ""deletions"": 2, ""lines"": 4}, ""src/proto/evalvars.pro"": {""insertions"": 2, ""deletions"": 2, ""lines"": 4}, ""src/proto/typval.pro"": {""insertions"": 3, ""deletions"": 3, ""lines"": 6}, ""src/proto/vim9compile.pro"": {""insertions"": 1, ""deletions"": 0, ""lines"": 1}, ""src/testdir/test_expr.vim"": {""insertions"": 4, ""deletions"": 4, ""lines"": 8}, ""src/testdir/test_let.vim"": {""insertions"": 2, ""deletions"": 3, ""lines"": 5}, ""src/typval.c"": {""insertions"": 124, ""deletions"": 32, ""lines"": 156}, ""src/version.c"": {""insertions"": 2, ""deletions"": 0, ""lines"": 2}, ""src/vim9compile.c"": {""insertions"": 33, ""deletions"": 19, ""lines"": 52}, ""src/vim9expr.c"": {""insertions"": 57, ""deletions"": 14, ""lines"": 71}, ""src/vim9instr.c"": {""insertions"": 2, ""deletions"": 0, ""lines"": 2}}"
2022-05-09 20:03:47,57ff52677bf5ba1651281ffe40505df8feba4a36,LemonBoy,28,2,30,4,"{""src/buffer.c"": {""insertions"": 2, ""deletions"": 1, ""lines"": 3}, ""src/testdir/dumps/Test_statusline_hl.dump"": {""insertions"": 6, ""deletions"": 0, ""lines"": 6}, ""src/testdir/test_statusline.vim"": {""insertions"": 18, ""deletions"": 1, ""lines"": 19}, ""src/version.c"": {""insertions"": 2, ""deletions"": 0, ""lines"": 2}}"
2022-05-09 19:09:23,6ed545e79735f23ff8e650bc2f0967e5a0baedc9,Bram Moolenaar,166,161,327,49,"{""src/bufwrite.c"": {""insertions"": 2, ""deletions"": 2, ""lines"": 4}, ""src/channel.c"": {""insertions"": 1, ""deletions"": 1, ""lines"": 2}, ""src/cindent.c"": {""insertions"": 2, ""deletions"": 2, ""lines"": 4}, ""src/crypt.c"": {""insertions"": 3, ""deletions"": 3, ""lines"": 6}, ""src/debugger.c"": {""insertions"": 1, ""deletions"": 1, ""lines"": 2}, ""src/digraph.c"": {""insertions"": 2, ""deletions"": 1, ""lines"": 3}, ""src/edit.c"": {""insertions"": 6, ""deletions"": 7, ""lines"": 13}, ""src/evalwindow.c"": {""insertions"": 18, ""deletions"": 16, ""lines"": 34}, ""src/ex_cmds.c"": {""insertions"": 1, ""deletions"": 1, ""lines"": 2}, ""src/ex_docmd.c"": {""insertions"": 1, ""deletions"": 1, ""lines"": 2}, ""src/ex_getln.c"": {""insertions"": 1, ""deletions"": 1, ""lines"": 2}, ""src/fileio.c"": {""insertions"": 2, ""deletions"": 2, ""lines"": 4}, ""src/filepath.c"": {""insertions"": 2, ""deletions"": 2, ""lines"": 4}, ""src/gui.c"": {""insertions"": 2, ""deletions"": 2, ""lines"": 4}, ""src/highlight.c"": {""insertions"": 1, ""deletions"": 1, ""lines"": 2}, ""src/if_lua.c"": {""insertions"": 14, ""deletions"": 14, ""lines"": 28}, ""src/indent.c"": {""insertions"": 2, ""deletions"": 2, ""lines"": 4}, ""src/insexpand.c"": {""insertions"": 3, ""deletions"": 3, ""lines"": 6}, ""src/job.c"": {""insertions"": 1, ""deletions"": 1, ""lines"": 2}, ""src/keymap.h"": {""insertions"": 1, ""deletions"": 1, ""lines"": 2}, ""src/macros.h"": {""insertions"": 2, ""deletions"": 2, ""lines"": 4}, ""src/menu.c"": {""insertions"": 1, ""deletions"": 1, ""lines"": 2}, ""src/misc1.c"": {""insertions"": 3, ""deletions"": 2, ""lines"": 5}, ""src/misc2.c"": {""insertions"": 1, ""deletions"": 1, ""lines"": 2}, ""src/mouse.c"": {""insertions"": 3, ""deletions"": 3, ""lines"": 6}, ""src/move.c"": {""insertions"": 7, ""deletions"": 7, ""lines"": 14}, ""src/normal.c"": {""insertions"": 2, ""deletions"": 2, ""lines"": 4}, ""src/ops.c"": {""insertions"": 3, ""deletions"": 3, ""lines"": 6}, ""src/option.c"": {""insertions"": 13, ""deletions"": 13, ""lines"": 26}, ""src/option.h"": {""insertions"": 2, ""deletions"": 2, ""lines"": 4}, ""src/os_unix.c"": {""insertions"": 5, ""deletions"": 5, ""lines"": 10}, ""src/search.c"": {""insertions"": 4, ""deletions"": 4, ""lines"": 8}, ""src/session.c"": {""insertions"": 4, ""deletions"": 4, ""lines"": 8}, ""src/spellsuggest.c"": {""insertions"": 2, ""deletions"": 2, ""lines"": 4}, ""src/structs.h"": {""insertions"": 10, ""deletions"": 10, ""lines"": 20}, ""src/tag.c"": {""insertions"": 4, ""deletions"": 4, ""lines"": 8}, ""src/term.c"": {""insertions"": 1, ""deletions"": 1, ""lines"": 2}, ""src/terminal.c"": {""insertions"": 4, ""deletions"": 4, ""lines"": 8}, ""src/testdir/test_cursorline.vim"": {""insertions"": 1, ""deletions"": 1, ""lines"": 2}, ""src/textformat.c"": {""insertions"": 1, ""deletions"": 1, ""lines"": 2}, ""src/typval.c"": {""insertions"": 1, ""deletions"": 1, ""lines"": 2}, ""src/ui.c"": {""insertions"": 9, ""deletions"": 9, ""lines"": 18}, ""src/userfunc.c"": {""insertions"": 1, ""deletions"": 1, ""lines"": 2}, ""src/version.c"": {""insertions"": 2, ""deletions"": 0, ""lines"": 2}, ""src/vim.h"": {""insertions"": 2, ""deletions"": 2, ""lines"": 4}, ""src/vim9.h"": {""insertions"": 1, ""deletions"": 1, ""lines"": 2}, ""src/vim9compile.c"": {""insertions"": 1, ""deletions"": 1, ""lines"": 2}, ""src/vim9execute.c"": {""insertions"": 8, ""deletions"": 8, ""lines"": 16}, ""src/window.c"": {""insertions"": 2, ""deletions"": 2, ""lines"": 4}}"
2022-05-09 18:50:35,921bde88804663a7cb825d7f7e8a5d8ae6b58650,Bram Moolenaar,7982,3973,11955,49,"{""runtime/doc/builtin.txt"": {""insertions"": 3, ""deletions"": 3, ""lines"": 6}, ""runtime/doc/map.txt"": {""insertions"": 3, ""deletions"": 2, ""lines"": 5}, ""runtime/doc/starting.txt"": {""insertions"": 3, ""deletions"": 1, ""lines"": 4}, ""runtime/doc/tags"": {""insertions"": 10, ""deletions"": 0, ""lines"": 10}, ""runtime/doc/todo.txt"": {""insertions"": 8, ""deletions"": 5, ""lines"": 13}, ""runtime/doc/usr_41.txt"": {""insertions"": 2, ""deletions"": 1, ""lines"": 3}, ""runtime/ftplugin/abaqus.vim"": {""insertions"": 4, ""deletions"": 4, ""lines"": 8}, ""runtime/pack/dist/opt/termdebug/plugin/termdebug.vim"": {""insertions"": 3, ""deletions"": 3, ""lines"": 6}, ""src/po/af.po"": {""insertions"": 145, ""deletions"": 72, ""lines"": 217}, ""src/po/ca.po"": {""insertions"": 253, ""deletions"": 126, ""lines"": 379}, ""src/po/cs.cp1250.po"": {""insertions"": 84, ""deletions"": 42, ""lines"": 126}, ""src/po/cs.po"": {""insertions"": 84, ""deletions"": 42, ""lines"": 126}, ""src/po/da.po"": {""insertions"": 215, ""deletions"": 107, ""lines"": 322}, ""src/po/de.po"": {""insertions"": 251, ""deletions"": 125, ""lines"": 376}, ""src/po/en_GB.po"": {""insertions"": 198, ""deletions"": 99, ""lines"": 297}, ""src/po/eo.po"": {""insertions"": 247, ""deletions"": 123, ""lines"": 370}, ""src/po/es.po"": {""insertions"": 175, ""deletions"": 87, ""lines"": 262}, ""src/po/fi.po"": {""insertions"": 252, ""deletions"": 125, ""lines"": 377}, ""src/po/fr.po"": {""insertions"": 247, ""deletions"": 123, ""lines"": 370}, ""src/po/ga.po"": {""insertions"": 252, ""deletions"": 125, ""lines"": 377}, ""src/po/it.po"": {""insertions"": 255, ""deletions"": 127, ""lines"": 382}, ""src/po/ja.euc-jp.po"": {""insertions"": 253, ""deletions"": 126, ""lines"": 379}, ""src/po/ja.po"": {""insertions"": 253, ""deletions"": 126, ""lines"": 379}, ""src/po/ja.sjis.po"": {""insertions"": 253, ""deletions"": 126, ""lines"": 379}, ""src/po/ko.UTF-8.po"": {""insertions"": 207, ""deletions"": 103, ""lines"": 310}, ""src/po/ko.po"": {""insertions"": 207, ""deletions"": 103, ""lines"": 310}, ""src/po/lv.po"": {""insertions"": 10, ""deletions"": 5, ""lines"": 15}, ""src/po/nb.po"": {""insertions"": 171, ""deletions"": 85, ""lines"": 256}, ""src/po/nl.po"": {""insertions"": 114, ""deletions"": 57, ""lines"": 171}, ""src/po/no.po"": {""insertions"": 171, ""deletions"": 85, ""lines"": 256}, ""src/po/pl.UTF-8.po"": {""insertions"": 187, ""deletions"": 93, ""lines"": 280}, ""src/po/pl.cp1250.po"": {""insertions"": 187, ""deletions"": 93, ""lines"": 280}, ""src/po/pl.po"": {""insertions"": 187, ""deletions"": 93, ""lines"": 280}, ""src/po/pt_BR.po"": {""insertions"": 215, ""deletions"": 107, ""lines"": 322}, ""src/po/ru.cp1251.po"": {""insertions"": 235, ""deletions"": 117, ""lines"": 352}, ""src/po/ru.po"": {""insertions"": 235, ""deletions"": 117, ""lines"": 352}, ""src/po/sk.cp1250.po"": {""insertions"": 159, ""deletions"": 79, ""lines"": 238}, ""src/po/sk.po"": {""insertions"": 159, ""deletions"": 79, ""lines"": 238}, ""src/po/sr.po"": {""insertions"": 251, ""deletions"": 125, ""lines"": 376}, ""src/po/sv.po"": {""insertions"": 173, ""deletions"": 86, ""lines"": 259}, ""src/po/tr.po"": {""insertions"": 255, ""deletions"": 127, ""lines"": 382}, ""src/po/uk.cp1251.po"": {""insertions"": 253, ""deletions"": 126, ""lines"": 379}, ""src/po/uk.po"": {""insertions"": 253, ""deletions"": 126, ""lines"": 379}, ""src/po/vi.po"": {""insertions"": 143, ""deletions"": 71, ""lines"": 214}, ""src/po/zh_CN.UTF-8.po"": {""insertions"": 157, ""deletions"": 78, ""lines"": 235}, ""src/po/zh_CN.cp936.po"": {""insertions"": 157, ""deletions"": 78, ""lines"": 235}, ""src/po/zh_CN.po"": {""insertions"": 157, ""deletions"": 78, ""lines"": 235}, ""src/po/zh_TW.UTF-8.po"": {""insertions"": 143, ""deletions"": 71, ""lines"": 214}, ""src/po/zh_TW.po"": {""insertions"": 143, ""deletions"": 71, ""lines"": 214}}"
2022-05-09 13:12:14,2ac037f54bb2588b7a86e61c9c6e9504884edbec,Bram Moolenaar,13,7,20,3,"{""src/evalfunc.c"": {""insertions"": 6, ""deletions"": 1, ""lines"": 7}, ""src/testdir/test_vim9_builtin.vim"": {""insertions"": 5, ""deletions"": 6, ""lines"": 11}, ""src/version.c"": {""insertions"": 2, ""deletions"": 0, ""lines"": 2}}"
2022-05-09 12:33:39,51f0bc31d3cf512508419064faac0e5b7e52c98b,zeertzjq,6,4,10,2,"{""src/option.c"": {""insertions"": 4, ""deletions"": 4, ""lines"": 8}, ""src/version.c"": {""insertions"": 2, ""deletions"": 0, ""lines"": 2}}"
2022-05-09 12:15:07,53a70289c2712808e6d4e88927e03cac01b470dd,Bram Moolenaar,15,1,16,3,"{""src/testdir/test_textobjects.vim"": {""insertions"": 9, ""deletions"": 1, ""lines"": 10}, ""src/textobject.c"": {""insertions"": 4, ""deletions"": 0, ""lines"": 4}, ""src/version.c"": {""insertions"": 2, ""deletions"": 0, ""lines"": 2}}"
2022-05-09 11:16:19,0519ce00394474055bd58c089ea90a19986443eb,zeertzjq,60,21,81,6,"{""src/message.c"": {""insertions"": 15, ""deletions"": 21, ""lines"": 36}, ""src/option.c"": {""insertions"": 2, ""deletions"": 0, ""lines"": 2}, ""src/testdir/test_map_functions.vim"": {""insertions"": 14, ""deletions"": 0, ""lines"": 14}, ""src/testdir/test_mapping.vim"": {""insertions"": 7, ""deletions"": 0, ""lines"": 7}, ""src/testdir/test_options.vim"": {""insertions"": 20, ""deletions"": 0, ""lines"": 20}, ""src/version.c"": {""insertions"": 2, ""deletions"": 0, ""lines"": 2}}"
2022-05-09 10:03:19,194843028ed486366b89e8f7d3bdd611a11ce7b4,zeertzjq,2,2,4,2,"{""src/testdir/test_matchadd_conceal.vim"": {""insertions"": 0, ""deletions"": 2, ""lines"": 2}, ""src/version.c"": {""insertions"": 2, ""deletions"": 0, ""lines"": 2}}"
2022-05-08 21:49:43,b370771bffc8395204f53209b69e35dff95a9237,Bram Moolenaar,4,0,4,2,"{""src/testdir/test_edit.vim"": {""insertions"": 2, ""deletions"": 0, ""lines"": 2}, ""src/version.c"": {""insertions"": 2, ""deletions"": 0, ""lines"": 2}}"
2022-05-08 21:43:51,fe978c2b6bb9d897d962595a4a51dd7a71dc8e89,Bram Moolenaar,2,8,10,2,"{""src/testdir/test_spell.vim"": {""insertions"": 0, ""deletions"": 8, ""lines"": 8}, ""src/version.c"": {""insertions"": 2, ""deletions"": 0, ""lines"": 2}}"
2022-05-08 21:37:45,728a05c4ab605ae96e906cdf704031ff298d1f89,Bram Moolenaar,2,4,6,2,"{""src/gui_w32.c"": {""insertions"": 0, ""deletions"": 4, ""lines"": 4}, ""src/version.c"": {""insertions"": 2, ""deletions"": 0, ""lines"": 2}}"
2022-05-08 21:32:58,7c824682d2028432ee082703ef0ab399867a089b,Bram Moolenaar,22,1,23,5,"{""src/errors.h"": {""insertions"": 4, ""deletions"": 0, ""lines"": 4}, ""src/mbyte.c"": {""insertions"": 1, ""deletions"": 1, ""lines"": 2}, ""src/spellfile.c"": {""insertions"": 10, ""deletions"": 0, ""lines"": 10}, ""src/testdir/test_spell_utf8.vim"": {""insertions"": 5, ""deletions"": 0, ""lines"": 5}, ""src/version.c"": {""insertions"": 2, ""deletions"": 0, ""lines"": 2}}"
2022-05-08 20:25:20,9830db63057db76044eca89cc4cfb2758ae7a543,LemonBoy,28,3,31,3,"{""src/drawline.c"": {""insertions"": 5, ""deletions"": 3, ""lines"": 8}, ""src/testdir/test_matchadd_conceal.vim"": {""insertions"": 21, ""deletions"": 0, ""lines"": 21}, ""src/version.c"": {""insertions"": 2, ""deletions"": 0, ""lines"": 2}}"
2022-05-08 20:10:56,cb747899bd99361a299a163f3aa55d5fe7d6f798,Christian Brabandt,29,4,33,5,"{""src/cmdexpand.c"": {""insertions"": 1, ""deletions"": 1, ""lines"": 2}, ""src/option.c"": {""insertions"": 3, ""deletions"": 2, ""lines"": 5}, ""src/proto/option.pro"": {""insertions"": 1, ""deletions"": 1, ""lines"": 2}, ""src/testdir/test_options.vim"": {""insertions"": 22, ""deletions"": 0, ""lines"": 22}, ""src/version.c"": {""insertions"": 2, ""deletions"": 0, ""lines"": 2}}"
2022-05-08 19:38:06,8e8dc9b32326c6fbd37671b6072296404b481d4a,Bram Moolenaar,18,8,26,2,"{""src/testdir/test_edit.vim"": {""insertions"": 16, ""deletions"": 8, ""lines"": 24}, ""src/version.c"": {""insertions"": 2, ""deletions"": 0, ""lines"": 2}}"
2022-05-08 18:39:31,a91cb98bb36b0f9dc3c378c0bbd9a69de29830fa,Bram Moolenaar,4,1,5,2,"{""src/move.c"": {""insertions"": 2, ""deletions"": 1, ""lines"": 3}, ""src/version.c"": {""insertions"": 2, ""deletions"": 0, ""lines"": 2}}"
2022-05-08 15:37:07,933c2922b5e81b238c2e56361c76cf7c9548a2d7,Bram Moolenaar,15,4,19,3,"{""src/testdir/test_vim9_expr.vim"": {""insertions"": 13, ""deletions"": 0, ""lines"": 13}, ""src/version.c"": {""insertions"": 2, ""deletions"": 0, ""lines"": 2}, ""src/vim9compile.c"": {""insertions"": 0, ""deletions"": 4, ""lines"": 4}}"
2022-05-08 14:00:04,27724251bc73f97b55240731f4316ee1b4eac1c5,Bram Moolenaar,47,13,60,6,"{""src/popupwin.c"": {""insertions"": 8, ""deletions"": 3, ""lines"": 11}, ""src/testdir/dumps/Test_popup_prop_not_visible_01a.dump"": {""insertions"": 10, ""deletions"": 0, ""lines"": 10}, ""src/testdir/dumps/Test_popup_prop_not_visible_01b.dump"": {""insertions"": 10, ""deletions"": 0, ""lines"": 10}, ""src/testdir/test_popupwin.vim"": {""insertions"": 7, ""deletions"": 1, ""lines"": 8}, ""src/version.c"": {""insertions"": 2, ""deletions"": 0, ""lines"": 2}, ""src/vim.h"": {""insertions"": 10, ""deletions"": 9, ""lines"": 19}}"
2022-05-07 20:54:03,d899e51120798d3fb5420abb1f19dddf3f014d05,Bram Moolenaar,17709,11101,28810,33,"{"".github/CODEOWNERS"": {""insertions"": 3, ""deletions"": 0, ""lines"": 3}, ""runtime/doc/builtin.txt"": {""insertions"": 2, ""deletions"": 2, ""lines"": 4}, ""runtime/doc/change.txt"": {""insertions"": 1, ""deletions"": 1, ""lines"": 2}, ""runtime/doc/cmdline.txt"": {""insertions"": 1, ""deletions"": 1, ""lines"": 2}, ""runtime/doc/eval.txt"": {""insertions"": 15, ""deletions"": 14, ""lines"": 29}, ""runtime/doc/options.txt"": {""insertions"": 1, ""deletions"": 1, ""lines"": 2}, ""runtime/doc/quickref.txt"": {""insertions"": 2, ""deletions"": 2, ""lines"": 4}, ""runtime/doc/scroll.txt"": {""insertions"": 1, ""deletions"": 1, ""lines"": 2}, ""runtime/doc/syntax.txt"": {""insertions"": 6, ""deletions"": 1, ""lines"": 7}, ""runtime/doc/todo.txt"": {""insertions"": 11, ""deletions"": 5, ""lines"": 16}, ""runtime/doc/vim9.txt"": {""insertions"": 10, ""deletions"": 4, ""lines"": 14}, ""runtime/doc/visual.txt"": {""insertions"": 1, ""deletions"": 1, ""lines"": 2}, ""runtime/ftplugin/wget.vim"": {""insertions"": 29, ""deletions"": 0, ""lines"": 29}, ""runtime/ftplugin/wget2.vim"": {""insertions"": 29, ""deletions"": 0, ""lines"": 29}, ""runtime/gvim.desktop"": {""insertions"": 5, ""deletions"": 2, ""lines"": 7}, ""runtime/indent/testdir/yaml.in"": {""insertions"": 0, ""deletions"": 5, ""lines"": 5}, ""runtime/indent/testdir/yaml.ok"": {""insertions"": 0, ""deletions"": 5, ""lines"": 5}, ""runtime/indent/yaml.vim"": {""insertions"": 3, ""deletions"": 3, ""lines"": 6}, ""runtime/pack/dist/opt/termdebug/plugin/termdebug.vim"": {""insertions"": 2, ""deletions"": 2, ""lines"": 4}, ""runtime/syntax/help.vim"": {""insertions"": 7, ""deletions"": 1, ""lines"": 8}, ""runtime/syntax/i3config.vim"": {""insertions"": 6, ""deletions"": 1, ""lines"": 7}, ""runtime/syntax/plsql.vim"": {""insertions"": 139, ""deletions"": 201, ""lines"": 340}, ""runtime/syntax/vim.vim"": {""insertions"": 8, ""deletions"": 8, ""lines"": 16}, ""runtime/syntax/wget.vim"": {""insertions"": 197, ""deletions"": 143, ""lines"": 340}, ""runtime/syntax/wget2.vim"": {""insertions"": 250, ""deletions"": 0, ""lines"": 250}, ""runtime/tutor/Makefile"": {""insertions"": 3, ""deletions"": 3, ""lines"": 6}, ""runtime/tutor/tutor.es"": {""insertions"": 579, ""deletions"": 325, ""lines"": 904}, ""runtime/tutor/tutor.es.utf-8"": {""insertions"": 579, ""deletions"": 325, ""lines"": 904}, ""runtime/vim.desktop"": {""insertions"": 4, ""deletions"": 1, ""lines"": 5}, ""src/po/gvim.desktop.in"": {""insertions"": 1, ""deletions"": 2, ""lines"": 3}, ""src/po/uk.cp1251.po"": {""insertions"": 7907, ""deletions"": 5020, ""lines"": 12927}, ""src/po/uk.po"": {""insertions"": 7907, ""deletions"": 5020, ""lines"": 12927}, ""src/po/vim.desktop.in"": {""insertions"": 0, ""deletions"": 1, ""lines"": 1}}"
2022-05-07 20:14:05,a7583c42cd6b64fd276a5d7bb0db5ce7bfafa730,Bram Moolenaar,26,3,29,5,"{""src/eval.c"": {""insertions"": 1, ""deletions"": 1, ""lines"": 2}, ""src/evalfunc.c"": {""insertions"": 1, ""deletions"": 1, ""lines"": 2}, ""src/proto/evalfunc.pro"": {""insertions"": 2, ""deletions"": 1, ""lines"": 3}, ""src/testdir/test_vim9_func.vim"": {""insertions"": 20, ""deletions"": 0, ""lines"": 20}, ""src/version.c"": {""insertions"": 2, ""deletions"": 0, ""lines"": 2}}"
2022-05-07 19:01:16,249591057b4840785c50e41dd850efb8a8faf435,Bram Moolenaar,516,492,1008,49,"{""src/autocmd.c"": {""insertions"": 2, ""deletions"": 2, ""lines"": 4}, ""src/buffer.c"": {""insertions"": 8, ""deletions"": 8, ""lines"": 16}, ""src/change.c"": {""insertions"": 30, ""deletions"": 29, ""lines"": 59}, ""src/charset.c"": {""insertions"": 1, ""deletions"": 1, ""lines"": 2}, ""src/cindent.c"": {""insertions"": 1, ""deletions"": 1, ""lines"": 2}, ""src/clipboard.c"": {""insertions"": 6, ""deletions"": 6, ""lines"": 12}, ""src/debugger.c"": {""insertions"": 1, ""deletions"": 1, ""lines"": 2}, ""src/digraph.c"": {""insertions"": 2, ""deletions"": 2, ""lines"": 4}, ""src/drawline.c"": {""insertions"": 2, ""deletions"": 2, ""lines"": 4}, ""src/drawscreen.c"": {""insertions"": 9, ""deletions"": 7, ""lines"": 16}, ""src/edit.c"": {""insertions"": 42, ""deletions"": 42, ""lines"": 84}, ""src/evalfunc.c"": {""insertions"": 1, ""deletions"": 1, ""lines"": 2}, ""src/ex_cmds.c"": {""insertions"": 9, ""deletions"": 9, ""lines"": 18}, ""src/ex_docmd.c"": {""insertions"": 3, ""deletions"": 3, ""lines"": 6}, ""src/ex_getln.c"": {""insertions"": 10, ""deletions"": 10, ""lines"": 20}, ""src/fileio.c"": {""insertions"": 3, ""deletions"": 2, ""lines"": 5}, ""src/fold.c"": {""insertions"": 2, ""deletions"": 2, ""lines"": 4}, ""src/getchar.c"": {""insertions"": 33, ""deletions"": 31, ""lines"": 64}, ""src/globals.h"": {""insertions"": 6, ""deletions"": 6, ""lines"": 12}, ""src/gui.c"": {""insertions"": 36, ""deletions"": 34, ""lines"": 70}, ""src/gui_gtk.c"": {""insertions"": 1, ""deletions"": 1, ""lines"": 2}, ""src/gui_w32.c"": {""insertions"": 5, ""deletions"": 4, ""lines"": 9}, ""src/gui_xim.c"": {""insertions"": 12, ""deletions"": 11, ""lines"": 23}, ""src/indent.c"": {""insertions"": 12, ""deletions"": 12, ""lines"": 24}, ""src/insexpand.c"": {""insertions"": 1, ""deletions"": 1, ""lines"": 2}, ""src/macros.h"": {""insertions"": 1, ""deletions"": 1, ""lines"": 2}, ""src/main.c"": {""insertions"": 2, ""deletions"": 2, ""lines"": 4}, ""src/map.c"": {""insertions"": 97, ""deletions"": 92, ""lines"": 189}, ""src/menu.c"": {""insertions"": 9, ""deletions"": 8, ""lines"": 17}, ""src/message.c"": {""insertions"": 15, ""deletions"": 15, ""lines"": 30}, ""src/misc1.c"": {""insertions"": 18, ""deletions"": 17, ""lines"": 35}, ""src/misc2.c"": {""insertions"": 17, ""deletions"": 15, ""lines"": 32}, ""src/mouse.c"": {""insertions"": 16, ""deletions"": 14, ""lines"": 30}, ""src/netbeans.c"": {""insertions"": 3, ""deletions"": 3, ""lines"": 6}, ""src/normal.c"": {""insertions"": 14, ""deletions"": 14, ""lines"": 28}, ""src/ops.c"": {""insertions"": 4, ""deletions"": 4, ""lines"": 8}, ""src/option.c"": {""insertions"": 2, ""deletions"": 2, ""lines"": 4}, ""src/os_unix.c"": {""insertions"": 1, ""deletions"": 1, ""lines"": 2}, ""src/os_win32.c"": {""insertions"": 1, ""deletions"": 1, ""lines"": 2}, ""src/popupmenu.c"": {""insertions"": 5, ""deletions"": 5, ""lines"": 10}, ""src/screen.c"": {""insertions"": 8, ""deletions"": 8, ""lines"": 16}, ""src/search.c"": {""insertions"": 1, ""deletions"": 1, ""lines"": 2}, ""src/tag.c"": {""insertions"": 1, ""deletions"": 1, ""lines"": 2}, ""src/term.c"": {""insertions"": 16, ""deletions"": 16, ""lines"": 32}, ""src/terminal.c"": {""insertions"": 3, ""deletions"": 3, ""lines"": 6}, ""src/textformat.c"": {""insertions"": 5, ""deletions"": 5, ""lines"": 10}, ""src/version.c"": {""insertions"": 2, ""deletions"": 0, ""lines"": 2}, ""src/vim.h"": {""insertions"": 35, ""deletions"": 34, ""lines"": 69}, ""src/window.c"": {""insertions"": 2, ""deletions"": 2, ""lines"": 4}}"
2022-05-07 16:45:16,9ff7d717aa3176de5c61de340deb93f41c7780fc,Bram Moolenaar,4,2,6,2,"{""src/ex_getln.c"": {""insertions"": 2, ""deletions"": 2, ""lines"": 4}, ""src/version.c"": {""insertions"": 2, ""deletions"": 0, ""lines"": 2}}"
2022-05-07 15:38:24,ac4174e166dd76c72907caa76db0e7cd878ac667,Bram Moolenaar,56,51,107,5,"{""src/channel.c"": {""insertions"": 38, ""deletions"": 36, ""lines"": 74}, ""src/job.c"": {""insertions"": 6, ""deletions"": 6, ""lines"": 12}, ""src/structs.h"": {""insertions"": 5, ""deletions"": 5, ""lines"": 10}, ""src/terminal.c"": {""insertions"": 5, ""deletions"": 4, ""lines"": 9}, ""src/version.c"": {""insertions"": 2, ""deletions"": 0, ""lines"": 2}}"
2022-05-07 14:43:52,48a8a833033e10fc1eba96f2fc8dd19c2408eddf,Bram Moolenaar,35,1,36,3,"{""src/testdir/test_textformat.vim"": {""insertions"": 12, ""deletions"": 0, ""lines"": 12}, ""src/textformat.c"": {""insertions"": 21, ""deletions"": 1, ""lines"": 22}, ""src/version.c"": {""insertions"": 2, ""deletions"": 0, ""lines"": 2}}"
2022-05-07 13:54:11,2bf875f881f7c6f6900bc0eb2a93a552db894109,Bram Moolenaar,26,7,33,5,"{""runtime/doc/change.txt"": {""insertions"": 7, ""deletions"": 4, ""lines"": 11}, ""src/change.c"": {""insertions"": 2, ""deletions"": 1, ""lines"": 3}, ""src/option.h"": {""insertions"": 3, ""deletions"": 2, ""lines"": 5}, ""src/testdir/test_textformat.vim"": {""insertions"": 12, ""deletions"": 0, ""lines"": 12}, ""src/version.c"": {""insertions"": 2, ""deletions"": 0, ""lines"": 2}}"
2022-05-07 13:09:19,aa04e1b0be343ff606e25a48d59bc057edcc6e87,Yasuhiro Matsumoto,17,10,27,4,"{""runtime/doc/options.txt"": {""insertions"": 7, ""deletions"": 0, ""lines"": 7}, ""src/os_win32.c"": {""insertions"": 6, ""deletions"": 9, ""lines"": 15}, ""src/term.c"": {""insertions"": 2, ""deletions"": 1, ""lines"": 3}, ""src/version.c"": {""insertions"": 2, ""deletions"": 0, ""lines"": 2}}"
2022-05-07 12:25:37,3f1cfcb86407c15a3037d5595bb192a00c661303,Bram Moolenaar,3,0,3,2,"{"".codecov.yml"": {""insertions"": 1, ""deletions"": 0, ""lines"": 1}, ""src/version.c"": {""insertions"": 2, ""deletions"": 0, ""lines"": 2}}"
2022-05-07 12:00:42,4649c121232ac65ccfea4ed1235630c7fe81e286,Bram Moolenaar,7,0,7,2,"{"".codecov.yml"": {""insertions"": 5, ""deletions"": 0, ""lines"": 5}, ""src/version.c"": {""insertions"": 2, ""deletions"": 0, ""lines"": 2}}"
2022-05-07 11:48:29,79d599b8772022af1d657f368c2fc97aa342c0da,Shougo Matsushita,125,3,128,11,"{""runtime/doc/builtin.txt"": {""insertions"": 20, ""deletions"": 0, ""lines"": 20}, ""runtime/doc/usr_41.txt"": {""insertions"": 4, ""deletions"": 0, ""lines"": 4}, ""src/cmdexpand.c"": {""insertions"": 1, ""deletions"": 2, ""lines"": 3}, ""src/evalfunc.c"": {""insertions"": 4, ""deletions"": 0, ""lines"": 4}, ""src/ex_getln.c"": {""insertions"": 58, ""deletions"": 0, ""lines"": 58}, ""src/proto/cmdexpand.pro"": {""insertions"": 1, ""deletions"": 0, ""lines"": 1}, ""src/proto/ex_getln.pro"": {""insertions"": 2, ""deletions"": 0, ""lines"": 2}, ""src/proto/usercmd.pro"": {""insertions"": 2, ""deletions"": 1, ""lines"": 3}, ""src/testdir/test_cmdline.vim"": {""insertions"": 12, ""deletions"": 0, ""lines"": 12}, ""src/usercmd.c"": {""insertions"": 19, ""deletions"": 0, ""lines"": 19}, ""src/version.c"": {""insertions"": 2, ""deletions"": 0, ""lines"": 2}}"
2022-05-07 11:25:40,c27747e6ddcbda7d1d3b39867898f746dc4db471,LemonBoy,95,58,153,7,"{""runtime/doc/scroll.txt"": {""insertions"": 12, ""deletions"": 9, ""lines"": 21}, ""src/gui_w32.c"": {""insertions"": 30, ""deletions"": 35, ""lines"": 65}, ""src/mouse.c"": {""insertions"": 42, ""deletions"": 14, ""lines"": 56}, ""src/proto/mouse.pro"": {""insertions"": 2, ""deletions"": 0, ""lines"": 2}, ""src/testdir/test_gui.vim"": {""insertions"": 2, ""deletions"": 0, ""lines"": 2}, ""src/testing.c"": {""insertions"": 5, ""deletions"": 0, ""lines"": 5}, ""src/version.c"": {""insertions"": 2, ""deletions"": 0, ""lines"": 2}}"
2022-05-07 10:28:06,8e4b76da1d7e987d43ca960dfbc372d1c617466f,Bram Moolenaar,10,1,11,3,"{""src/buffer.c"": {""insertions"": 1, ""deletions"": 1, ""lines"": 2}, ""src/testdir/test_buffer.vim"": {""insertions"": 7, ""deletions"": 0, ""lines"": 7}, ""src/version.c"": {""insertions"": 2, ""deletions"": 0, ""lines"": 2}}"
2022-05-07 10:00:08,801c3c1dbed88bfb59dcf25045365dc65f795f4e,Dominique Pelle,8,4,12,2,"{""src/testdir/test_vim9_expr.vim"": {""insertions"": 6, ""deletions"": 4, ""lines"": 10}, ""src/version.c"": {""insertions"": 2, ""deletions"": 0, ""lines"": 2}}"
2022-05-07 09:49:10,ef02f16609ff0a26ffc6e20263523424980898fe,Bram Moolenaar,12,4,16,3,"{""src/ex_getln.c"": {""insertions"": 7, ""deletions"": 4, ""lines"": 11}, ""src/testdir/test_cmdline.vim"": {""insertions"": 3, ""deletions"": 0, ""lines"": 3}, ""src/version.c"": {""insertions"": 2, ""deletions"": 0, ""lines"": 2}}"
2022-05-07 09:03:27,70d87690a39222277c2beab0649e343a78dee908,Bram Moolenaar,19,14,33,2,"{""src/version.c"": {""insertions"": 2, ""deletions"": 0, ""lines"": 2}, ""src/vim9compile.c"": {""insertions"": 17, ""deletions"": 14, ""lines"": 31}}"
2022-05-06 20:51:50,39be4981cdd93a185b110536f84d99ce56e2c3cc,Bram Moolenaar,21,2,23,3,"{""src/eval.c"": {""insertions"": 9, ""deletions"": 2, ""lines"": 11}, ""src/testdir/test_lambda.vim"": {""insertions"": 10, ""deletions"": 0, ""lines"": 10}, ""src/version.c"": {""insertions"": 2, ""deletions"": 0, ""lines"": 2}}"
2022-05-06 20:24:31,a13e7acba9928a9c5e97be28946418d8d4323988,Bram Moolenaar,9,1,10,3,"{""src/eval.c"": {""insertions"": 2, ""deletions"": 1, ""lines"": 3}, ""src/testdir/test_usercommands.vim"": {""insertions"": 5, ""deletions"": 0, ""lines"": 5}, ""src/version.c"": {""insertions"": 2, ""deletions"": 0, ""lines"": 2}}"
2022-05-06 19:38:47,d88934406c5375d88f8f1b65331c9f0cab68cc6c,Bram Moolenaar,16,1,17,3,"{""src/ex_docmd.c"": {""insertions"": 3, ""deletions"": 1, ""lines"": 4}, ""src/testdir/test_cmdline.vim"": {""insertions"": 11, ""deletions"": 0, ""lines"": 11}, ""src/version.c"": {""insertions"": 2, ""deletions"": 0, ""lines"": 2}}"
2022-05-06 17:38:41,5a7b6dc23cd16450b5773849520d513de56bccbf,LemonBoy,36,66,102,2,"{""src/term.c"": {""insertions"": 34, ""deletions"": 66, ""lines"": 100}, ""src/version.c"": {""insertions"": 2, ""deletions"": 0, ""lines"": 2}}"
2022-05-06 17:08:52,44433da5345e5c459f5e5812e30fca12fe297cd6,Bram Moolenaar,21,1,22,3,"{""nsis/gvim.nsi"": {""insertions"": 4, ""deletions"": 0, ""lines"": 4}, ""src/Makefile"": {""insertions"": 15, ""deletions"": 1, ""lines"": 16}, ""src/version.c"": {""insertions"": 2, ""deletions"": 0, ""lines"": 2}}"
2022-05-06 16:53:06,ec892234788d37bfed47d8bf82dd4cae8d335ad9,Bram Moolenaar,14,12,26,9,"{""src/testdir/test_expand.vim"": {""insertions"": 1, ""deletions"": 1, ""lines"": 2}, ""src/testdir/test_tcl.vim"": {""insertions"": 1, ""deletions"": 1, ""lines"": 2}, ""src/testdir/test_vim9_assign.vim"": {""insertions"": 2, ""deletions"": 2, ""lines"": 4}, ""src/testdir/test_vim9_builtin.vim"": {""insertions"": 4, ""deletions"": 4, ""lines"": 8}, ""src/testdir/test_vim9_expr.vim"": {""insertions"": 1, ""deletions"": 1, ""lines"": 2}, ""src/testdir/test_vim9_func.vim"": {""insertions"": 1, ""deletions"": 1, ""lines"": 2}, ""src/testdir/test_vim9_script.vim"": {""insertions"": 1, ""deletions"": 1, ""lines"": 2}, ""src/testdir/test_vimscript.vim"": {""insertions"": 1, ""deletions"": 1, ""lines"": 2}, ""src/version.c"": {""insertions"": 2, ""deletions"": 0, ""lines"": 2}}"
2022-05-06 15:32:46,b3c9077a5be76cd88b9a0c07b6d6c072d5c8ac3e,Bram Moolenaar,24,0,24,3,"{""Filelist"": {""insertions"": 1, ""deletions"": 0, ""lines"": 1}, ""runtime/import/dist/vimhelp.vim"": {""insertions"": 21, ""deletions"": 0, ""lines"": 21}, ""src/version.c"": {""insertions"": 2, ""deletions"": 0, ""lines"": 2}}"
2022-05-06 15:18:41,cf030578b26460643dca4a40e7f2e3bc19c749aa,Bram Moolenaar,153,151,304,2,"{""src/errors.h"": {""insertions"": 151, ""deletions"": 151, ""lines"": 302}, ""src/version.c"": {""insertions"": 2, ""deletions"": 0, ""lines"": 2}}"
2022-05-06 15:10:50,009e79c7b7f20d8e176a16fa8e1d510273c0a259,Philip H,11,3,14,2,"{"".cirrus.yml"": {""insertions"": 9, ""deletions"": 3, ""lines"": 12}, ""src/version.c"": {""insertions"": 2, ""deletions"": 0, ""lines"": 2}}"
2022-05-06 14:47:07,521bf32bb4f86676ce3617d25309770f1440ba79,Bram Moolenaar,12,4,16,2,"{""src/userfunc.c"": {""insertions"": 10, ""deletions"": 4, ""lines"": 14}, ""src/version.c"": {""insertions"": 2, ""deletions"": 0, ""lines"": 2}}"
