date,hexsha,author,insertions,deletions,lines,files,files_json
2021-05-30 14:43:11,e71c0ebe2cee4a4916c49e206733200299e4c065,Bram Moolenaar,35,1,36,4,"{""src/regexp.c"": {""insertions"": 4, ""deletions"": 1, ""lines"": 5}, ""src/testdir/dumps/Test_hlsearch_block_visual_match.dump"": {""insertions"": 9, ""deletions"": 0, ""lines"": 9}, ""src/testdir/test_search.vim"": {""insertions"": 20, ""deletions"": 0, ""lines"": 20}, ""src/version.c"": {""insertions"": 2, ""deletions"": 0, ""lines"": 2}}"
2021-05-30 12:21:57,0b49648486c5857047433c11d0871f79b53613a5,Bram Moolenaar,3,0,3,2,"{""src/testdir/test_cmdline.vim"": {""insertions"": 1, ""deletions"": 0, ""lines"": 1}, ""src/version.c"": {""insertions"": 2, ""deletions"": 0, ""lines"": 2}}"
2021-05-30 12:02:05,e0a7658bc8048aa29ff5c26b377dc5c6816fe422,Bram Moolenaar,5,3,8,2,"{""src/version.c"": {""insertions"": 2, ""deletions"": 0, ""lines"": 2}, ""src/vim.h"": {""insertions"": 3, ""deletions"": 3, ""lines"": 6}}"
2021-05-30 11:54:03,e5b4486c4279a9674a9bb76130b4db53fb9303a0,Bram Moolenaar,37,0,37,5,"{""src/errors.h"": {""insertions"": 2, ""deletions"": 0, ""lines"": 2}, ""src/terminal.c"": {""insertions"": 7, ""deletions"": 0, ""lines"": 7}, ""src/testdir/dumps/Test_cmdwin_no_terminal.dump"": {""insertions"": 12, ""deletions"": 0, ""lines"": 12}, ""src/testdir/test_cmdline.vim"": {""insertions"": 14, ""deletions"": 0, ""lines"": 14}, ""src/version.c"": {""insertions"": 2, ""deletions"": 0, ""lines"": 2}}"
2021-05-29 20:34:19,28cf44f761a7bf261bcd0760a1c5f61070f69595,Dominique Pelle,3,0,3,2,"{""src/term.c"": {""insertions"": 1, ""deletions"": 0, ""lines"": 1}, ""src/version.c"": {""insertions"": 2, ""deletions"": 0, ""lines"": 2}}"
2021-05-29 20:25:17,a5787c3742b43a8e662045a4e38c7a6ba957acbf,Bram Moolenaar,14,11,25,2,"{""src/testdir/test_startup.vim"": {""insertions"": 12, ""deletions"": 11, ""lines"": 23}, ""src/version.c"": {""insertions"": 2, ""deletions"": 0, ""lines"": 2}}"
2021-05-29 17:53:50,1d3a14ecf0cdde026984894c592dc140a2b46887,Christian Brabandt,26,3,29,5,"{""runtime/doc/starting.txt"": {""insertions"": 1, ""deletions"": 1, ""lines"": 2}, ""src/errors.h"": {""insertions"": 2, ""deletions"": 0, ""lines"": 2}, ""src/main.c"": {""insertions"": 8, ""deletions"": 2, ""lines"": 10}, ""src/testdir/test_startup.vim"": {""insertions"": 13, ""deletions"": 0, ""lines"": 13}, ""src/version.c"": {""insertions"": 2, ""deletions"": 0, ""lines"": 2}}"
2021-05-29 17:18:01,74ede80aeb272ac81d41a256057c4f250372dd00,Bram Moolenaar,38,3,41,3,"{""src/normal.c"": {""insertions"": 11, ""deletions"": 0, ""lines"": 11}, ""src/testdir/test_normal.vim"": {""insertions"": 25, ""deletions"": 3, ""lines"": 28}, ""src/version.c"": {""insertions"": 2, ""deletions"": 0, ""lines"": 2}}"
2021-05-29 15:56:37,a06e345af5b8261c072c95b0446e67cfda439848,Bram Moolenaar,25,0,25,3,"{""src/drawline.c"": {""insertions"": 6, ""deletions"": 0, ""lines"": 6}, ""src/testdir/test_display.vim"": {""insertions"": 17, ""deletions"": 0, ""lines"": 17}, ""src/version.c"": {""insertions"": 2, ""deletions"": 0, ""lines"": 2}}"
2021-05-29 15:29:33,5a6cfb3ff2f2f422a3732f3855616c89dd19c19d,Dominique Pelle,95,2,97,2,"{""src/testdir/test_spellfile.vim"": {""insertions"": 93, ""deletions"": 2, ""lines"": 95}, ""src/version.c"": {""insertions"": 2, ""deletions"": 0, ""lines"": 2}}"
2021-05-29 14:30:12,3e72dcad8b752a42b6eaf71213e3f5d534175256,Bram Moolenaar,167,12,179,6,"{""src/testdir/test_cpoptions.vim"": {""insertions"": 1, ""deletions"": 0, ""lines"": 1}, ""src/testdir/test_increment.vim"": {""insertions"": 17, ""deletions"": 0, ""lines"": 17}, ""src/testdir/test_normal.vim"": {""insertions"": 31, ""deletions"": 0, ""lines"": 31}, ""src/testdir/test_virtualedit.vim"": {""insertions"": 27, ""deletions"": 0, ""lines"": 27}, ""src/testdir/test_visual.vim"": {""insertions"": 89, ""deletions"": 12, ""lines"": 101}, ""src/version.c"": {""insertions"": 2, ""deletions"": 0, ""lines"": 2}}"
2021-05-29 12:30:43,1174b018a6d705ddb8c04f3d21f78ae760aa0856,Bram Moolenaar,31,8,39,3,"{""src/ex_docmd.c"": {""insertions"": 8, ""deletions"": 8, ""lines"": 16}, ""src/testdir/test_writefile.vim"": {""insertions"": 21, ""deletions"": 0, ""lines"": 21}, ""src/version.c"": {""insertions"": 2, ""deletions"": 0, ""lines"": 2}}"
2021-05-29 10:42:47,f89be8de14cc9055d12f7b0f2c270a5bc09fc86c,K.Takata,16,6,22,2,"{""ci/appveyor.bat"": {""insertions"": 14, ""deletions"": 6, ""lines"": 20}, ""src/version.c"": {""insertions"": 2, ""deletions"": 0, ""lines"": 2}}"
2021-05-29 10:21:58,3552e742898cd57adaf9b8ce32a9056271eab8d2,Bram Moolenaar,9,5,14,4,"{""src/ex_docmd.c"": {""insertions"": 2, ""deletions"": 2, ""lines"": 4}, ""src/gui.c"": {""insertions"": 3, ""deletions"": 2, ""lines"": 5}, ""src/proto/ex_docmd.pro"": {""insertions"": 2, ""deletions"": 1, ""lines"": 3}, ""src/version.c"": {""insertions"": 2, ""deletions"": 0, ""lines"": 2}}"
2021-05-28 19:06:08,d0edaf9dc253e619ccc321ceaac321aee11c1ea5,Bram Moolenaar,39,19,58,6,"{""src/eval.c"": {""insertions"": 3, ""deletions"": 0, ""lines"": 3}, ""src/proto/vim9script.pro"": {""insertions"": 1, ""deletions"": 0, ""lines"": 1}, ""src/testdir/test_vim9_assign.vim"": {""insertions"": 7, ""deletions"": 0, ""lines"": 7}, ""src/version.c"": {""insertions"": 2, ""deletions"": 0, ""lines"": 2}, ""src/vim9compile.c"": {""insertions"": 2, ""deletions"": 17, ""lines"": 19}, ""src/vim9script.c"": {""insertions"": 24, ""deletions"": 2, ""lines"": 26}}"
2021-05-28 16:32:12,dc3275a1ac73b6c4d0c9d2e238ea80b477705b6f,Dominique Pelle,68,0,68,2,"{""src/testdir/test_spellfile.vim"": {""insertions"": 66, ""deletions"": 0, ""lines"": 66}, ""src/version.c"": {""insertions"": 2, ""deletions"": 0, ""lines"": 2}}"
2021-05-28 15:52:40,4ac198c61cb3097d4839d5a697cc8b2b256ac575,mityu,63,9,72,4,"{""src/eval.c"": {""insertions"": 10, ""deletions"": 7, ""lines"": 17}, ""src/testdir/test_vim9_expr.vim"": {""insertions"": 50, ""deletions"": 1, ""lines"": 51}, ""src/version.c"": {""insertions"": 2, ""deletions"": 0, ""lines"": 2}, ""src/vim9compile.c"": {""insertions"": 1, ""deletions"": 1, ""lines"": 2}}"
2021-05-28 13:49:34,2c4a1d0a619b0f1e0f7dac98681da6fee58c6a44,K.Takata,17,1,18,2,"{""src/time.c"": {""insertions"": 15, ""deletions"": 1, ""lines"": 16}, ""src/version.c"": {""insertions"": 2, ""deletions"": 0, ""lines"": 2}}"
2021-05-28 12:12:14,bc869874fedf094129831836f131c64f10d98854,Ralf Schandl,69,8,77,5,"{""src/message_test.c"": {""insertions"": 32, ""deletions"": 0, ""lines"": 32}, ""src/popupwin.c"": {""insertions"": 20, ""deletions"": 8, ""lines"": 28}, ""src/testdir/dumps/Test_popupwin_multibytetitle.dump"": {""insertions"": 10, ""deletions"": 0, ""lines"": 10}, ""src/testdir/test_popupwin.vim"": {""insertions"": 5, ""deletions"": 0, ""lines"": 5}, ""src/version.c"": {""insertions"": 2, ""deletions"": 0, ""lines"": 2}}"
2021-05-28 11:50:17,89dcb4dce369de22fba13b9c3c63f11f8d42650b,mityu,11,2,13,3,"{""src/eval.c"": {""insertions"": 1, ""deletions"": 1, ""lines"": 2}, ""src/testdir/test_vim9_expr.vim"": {""insertions"": 8, ""deletions"": 1, ""lines"": 9}, ""src/version.c"": {""insertions"": 2, ""deletions"": 0, ""lines"": 2}}"
2021-05-27 16:05:14,543467136f001708f4c63376ac5d18adde82db30,ichizok,32,1,33,2,"{""src/if_perl.xs"": {""insertions"": 30, ""deletions"": 1, ""lines"": 31}, ""src/version.c"": {""insertions"": 2, ""deletions"": 0, ""lines"": 2}}"
2021-05-26 20:32:10,840f91f110c4790a145e76eec453326445290f21,Bram Moolenaar,29,2,31,4,"{""src/memline.c"": {""insertions"": 7, ""deletions"": 2, ""lines"": 9}, ""src/structs.h"": {""insertions"": 1, ""deletions"": 0, ""lines"": 1}, ""src/testdir/test_textprop.vim"": {""insertions"": 19, ""deletions"": 0, ""lines"": 19}, ""src/version.c"": {""insertions"": 2, ""deletions"": 0, ""lines"": 2}}"
2021-05-26 19:49:18,c512599b22aac7305b171566c2f595e0ae85b885,K.Takata,4,2,6,3,"{""Makefile"": {""insertions"": 1, ""deletions"": 1, ""lines"": 2}, ""src/testdir/Makefile"": {""insertions"": 1, ""deletions"": 1, ""lines"": 2}, ""src/version.c"": {""insertions"": 2, ""deletions"": 0, ""lines"": 2}}"
2021-05-26 19:10:11,7d840e9ac7529ec144e103d2a13abce8aa8c1ff1,Bram Moolenaar,50,7,57,4,"{""src/ex_docmd.c"": {""insertions"": 21, ""deletions"": 5, ""lines"": 26}, ""src/testdir/test_vim9_builtin.vim"": {""insertions"": 23, ""deletions"": 0, ""lines"": 23}, ""src/testdir/test_vim9_script.vim"": {""insertions"": 4, ""deletions"": 2, ""lines"": 6}, ""src/version.c"": {""insertions"": 2, ""deletions"": 0, ""lines"": 2}}"
2021-05-26 17:49:09,4c8e8c6e19b75d632b042aa0ba0a2ab769b2162e,Bram Moolenaar,9,3,12,3,"{""src/ex_docmd.c"": {""insertions"": 6, ""deletions"": 3, ""lines"": 9}, ""src/testdir/test_cmdline.vim"": {""insertions"": 1, ""deletions"": 0, ""lines"": 1}, ""src/version.c"": {""insertions"": 2, ""deletions"": 0, ""lines"": 2}}"
2021-05-25 18:14:00,34fcb697240c1bc9e69417ed75db3b1a83479724,Yegappan Lakshmanan,53,0,53,9,"{""src/testdir/test_expr.vim"": {""insertions"": 1, ""deletions"": 0, ""lines"": 1}, ""src/testdir/test_functions.vim"": {""insertions"": 7, ""deletions"": 0, ""lines"": 7}, ""src/testdir/test_listdict.vim"": {""insertions"": 5, ""deletions"": 0, ""lines"": 5}, ""src/testdir/test_registers.vim"": {""insertions"": 9, ""deletions"": 0, ""lines"": 9}, ""src/testdir/test_user_func.vim"": {""insertions"": 10, ""deletions"": 0, ""lines"": 10}, ""src/testdir/test_vim9_builtin.vim"": {""insertions"": 8, ""deletions"": 0, ""lines"": 8}, ""src/testdir/test_vim9_expr.vim"": {""insertions"": 3, ""deletions"": 0, ""lines"": 3}, ""src/testdir/test_vim9_func.vim"": {""insertions"": 8, ""deletions"": 0, ""lines"": 8}, ""src/version.c"": {""insertions"": 2, ""deletions"": 0, ""lines"": 2}}"
2021-05-24 20:56:15,872bee557e5f8ab0e4a523a6a845868a2801b17e,Bram Moolenaar,54,17,71,4,"{""src/regexp_bt.c"": {""insertions"": 16, ""deletions"": 4, ""lines"": 20}, ""src/regexp_nfa.c"": {""insertions"": 19, ""deletions"": 11, ""lines"": 30}, ""src/testdir/test_search.vim"": {""insertions"": 17, ""deletions"": 2, ""lines"": 19}, ""src/version.c"": {""insertions"": 2, ""deletions"": 0, ""lines"": 2}}"
2021-05-24 17:37:26,1e469c72ee2914fcffbcd49258036acdabd6f500,Dominique Pelle,15,1,16,2,"{""src/testdir/test_cscope.vim"": {""insertions"": 13, ""deletions"": 1, ""lines"": 14}, ""src/version.c"": {""insertions"": 2, ""deletions"": 0, ""lines"": 2}}"
2021-05-24 16:48:27,e97c7c962ca0fd7cad0d157f1762eb5cc5887fca,matveyt,23,17,40,9,"{"".gitignore"": {""insertions"": 0, ""deletions"": 1, ""lines"": 1}, "".hgignore"": {""insertions"": 0, ""deletions"": 1, ""lines"": 1}, ""Filelist"": {""insertions"": 1, ""deletions"": 1, ""lines"": 2}, ""Makefile"": {""insertions"": 2, ""deletions"": 2, ""lines"": 4}, ""src/Make_cyg_ming.mak"": {""insertions"": 8, ""deletions"": 8, ""lines"": 16}, ""src/Make_mvc.mak"": {""insertions"": 3, ""deletions"": 3, ""lines"": 6}, ""src/version.c"": {""insertions"": 2, ""deletions"": 0, ""lines"": 2}, ""src/{gvim.exe.mnf => vim.manifest}"": {""insertions"": 6, ""deletions"": 0, ""lines"": 6}, ""src/vim.rc"": {""insertions"": 1, ""deletions"": 1, ""lines"": 2}}"
2021-05-24 13:45:29,15bbb8f4f38d25d491d7dff83ef0552e2d442d5d,Bram Moolenaar,6,0,6,2,"{""src/userfunc.c"": {""insertions"": 4, ""deletions"": 0, ""lines"": 4}, ""src/version.c"": {""insertions"": 2, ""deletions"": 0, ""lines"": 2}}"
2021-05-24 13:15:47,611728f80604dd56960e8c197e5749d203c8feb1,Yegappan Lakshmanan,49,2,51,8,"{""src/testdir/test_const.vim"": {""insertions"": 21, ""deletions"": 1, ""lines"": 22}, ""src/testdir/test_functions.vim"": {""insertions"": 4, ""deletions"": 0, ""lines"": 4}, ""src/testdir/test_python2.vim"": {""insertions"": 2, ""deletions"": 0, ""lines"": 2}, ""src/testdir/test_python3.vim"": {""insertions"": 2, ""deletions"": 0, ""lines"": 2}, ""src/testdir/test_user_func.vim"": {""insertions"": 8, ""deletions"": 1, ""lines"": 9}, ""src/testdir/test_vim9_expr.vim"": {""insertions"": 3, ""deletions"": 0, ""lines"": 3}, ""src/testdir/test_vim9_func.vim"": {""insertions"": 7, ""deletions"": 0, ""lines"": 7}, ""src/version.c"": {""insertions"": 2, ""deletions"": 0, ""lines"": 2}}"
2021-05-24 12:20:53,ad5c178a191cf2cf37a27c2a789d7afda3879831,glacambre,10,3,13,3,"{""src/diff.c"": {""insertions"": 4, ""deletions"": 2, ""lines"": 6}, ""src/testdir/test_diffmode.vim"": {""insertions"": 4, ""deletions"": 1, ""lines"": 5}, ""src/version.c"": {""insertions"": 2, ""deletions"": 0, ""lines"": 2}}"
2021-05-23 09:18:50,f5409dbf66f4e4a0461d3f2079c1bffacbf12392,Marcin Szamotulski,4,2,6,3,"{""runtime/filetype.vim"": {""insertions"": 1, ""deletions"": 1, ""lines"": 2}, ""src/testdir/test_filetype.vim"": {""insertions"": 1, ""deletions"": 1, ""lines"": 2}, ""src/version.c"": {""insertions"": 2, ""deletions"": 0, ""lines"": 2}}"
2021-05-22 19:40:39,b777da9be8eb421982e567702db3195475383dec,Bram Moolenaar,14,0,14,3,"{""src/testdir/test_vim9_script.vim"": {""insertions"": 6, ""deletions"": 0, ""lines"": 6}, ""src/version.c"": {""insertions"": 2, ""deletions"": 0, ""lines"": 2}, ""src/vim9compile.c"": {""insertions"": 6, ""deletions"": 0, ""lines"": 6}}"
2021-05-22 15:12:46,1e615669c0f1f4125001b2c01c30b00d8c68035e,Yegappan Lakshmanan,100,0,100,6,"{""src/testdir/dumps/Test_pum_rightleft_01.dump"": {""insertions"": 8, ""deletions"": 0, ""lines"": 8}, ""src/testdir/dumps/Test_pum_rightleft_02.dump"": {""insertions"": 7, ""deletions"": 0, ""lines"": 7}, ""src/testdir/dumps/Test_pum_scrollbar_01.dump"": {""insertions"": 7, ""deletions"": 0, ""lines"": 7}, ""src/testdir/dumps/Test_pum_scrollbar_02.dump"": {""insertions"": 7, ""deletions"": 0, ""lines"": 7}, ""src/testdir/test_popup.vim"": {""insertions"": 69, ""deletions"": 0, ""lines"": 69}, ""src/version.c"": {""insertions"": 2, ""deletions"": 0, ""lines"": 2}}"
2021-05-21 09:43:58,23c0192166760b0d73bd39252ca72e3cfe596f6e,Bram Moolenaar,4,2,6,3,"{""src/auto/configure"": {""insertions"": 1, ""deletions"": 1, ""lines"": 2}, ""src/configure.ac"": {""insertions"": 1, ""deletions"": 1, ""lines"": 2}, ""src/version.c"": {""insertions"": 2, ""deletions"": 0, ""lines"": 2}}"
2021-05-20 19:14:20,5cf94577cf2045fec87344d7d89422fe6dfce62f,=?UTF-8?q?Luka=20Marku=C5=A1i=C4=87?=,12,1,13,3,"{""src/misc1.c"": {""insertions"": 6, ""deletions"": 1, ""lines"": 7}, ""src/testdir/test_functions.vim"": {""insertions"": 4, ""deletions"": 0, ""lines"": 4}, ""src/version.c"": {""insertions"": 2, ""deletions"": 0, ""lines"": 2}}"
2021-05-20 09:54:10,4eb1914e1bd870a7ea829cae150e1f9fdc3df7b1,matveyt,5,1,6,2,"{""src/os_win32.c"": {""insertions"": 3, ""deletions"": 1, ""lines"": 4}, ""src/version.c"": {""insertions"": 2, ""deletions"": 0, ""lines"": 2}}"
2021-05-19 15:15:04,46aa6f93acb5d932d2893606d980a6b4b8a9594c,Yegappan Lakshmanan,72,3,75,5,"{""src/testdir/test_buffer.vim"": {""insertions"": 20, ""deletions"": 0, ""lines"": 20}, ""src/testdir/test_cmdline.vim"": {""insertions"": 29, ""deletions"": 1, ""lines"": 30}, ""src/testdir/test_functions.vim"": {""insertions"": 1, ""deletions"": 0, ""lines"": 1}, ""src/testdir/test_writefile.vim"": {""insertions"": 20, ""deletions"": 2, ""lines"": 22}, ""src/version.c"": {""insertions"": 2, ""deletions"": 0, ""lines"": 2}}"
2021-05-18 22:16:14,56c9fd01076bc62b55c8cb89d8a66f6136e52f3a,Dominique Pelle,14,4,18,3,"{""src/testdir/test_python2.vim"": {""insertions"": 6, ""deletions"": 2, ""lines"": 8}, ""src/testdir/test_python3.vim"": {""insertions"": 6, ""deletions"": 2, ""lines"": 8}, ""src/version.c"": {""insertions"": 2, ""deletions"": 0, ""lines"": 2}}"
2021-05-18 19:46:31,4781d6fd8670af415c3b78f00d70036af85bd286,Dominique Pelle,21,20,41,8,"{""src/charset.c"": {""insertions"": 2, ""deletions"": 4, ""lines"": 6}, ""src/evalfunc.c"": {""insertions"": 3, ""deletions"": 3, ""lines"": 6}, ""src/ex_docmd.c"": {""insertions"": 2, ""deletions"": 2, ""lines"": 4}, ""src/json.c"": {""insertions"": 1, ""deletions"": 1, ""lines"": 2}, ""src/ops.c"": {""insertions"": 5, ""deletions"": 4, ""lines"": 9}, ""src/tag.c"": {""insertions"": 1, ""deletions"": 1, ""lines"": 2}, ""src/version.c"": {""insertions"": 2, ""deletions"": 0, ""lines"": 2}, ""src/vim9compile.c"": {""insertions"": 5, ""deletions"": 5, ""lines"": 10}}"
2021-05-18 19:38:45,796139ae3ac89e27ee96dce3c7fdb87d8c839f53,Bram Moolenaar,12,1,13,3,"{""src/ex_getln.c"": {""insertions"": 4, ""deletions"": 1, ""lines"": 5}, ""src/testdir/test_cmdline.vim"": {""insertions"": 6, ""deletions"": 0, ""lines"": 6}, ""src/version.c"": {""insertions"": 2, ""deletions"": 0, ""lines"": 2}}"
2021-05-18 17:19:03,485b62710004431a16feb4eb861365d082304a08,Bram Moolenaar,27,3,30,2,"{""src/testdir/test_diffmode.vim"": {""insertions"": 25, ""deletions"": 3, ""lines"": 28}, ""src/version.c"": {""insertions"": 2, ""deletions"": 0, ""lines"": 2}}"
2021-05-18 15:49:59,cbe178e3dc4ad45d9b2ed5e713e7c4cc88bf8b8b,Bram Moolenaar,67,57,124,3,"{""src/testdir/test_vim9_builtin.vim"": {""insertions"": 4, ""deletions"": 1, ""lines"": 5}, ""src/version.c"": {""insertions"": 2, ""deletions"": 0, ""lines"": 2}, ""src/vim9execute.c"": {""insertions"": 61, ""deletions"": 56, ""lines"": 117}}"
2021-05-18 13:32:11,082a3bf961efd3668d06e3137cb1ad27c3998d07,Bram Moolenaar,3,1,4,2,"{""src/globals.h"": {""insertions"": 1, ""deletions"": 1, ""lines"": 2}, ""src/version.c"": {""insertions"": 2, ""deletions"": 0, ""lines"": 2}}"
2021-05-18 13:09:18,ecb664501d3b04d124fca69029b275c520401d40,Bram Moolenaar,21,8,29,4,"{""src/eval.c"": {""insertions"": 10, ""deletions"": 2, ""lines"": 12}, ""src/structs.h"": {""insertions"": 2, ""deletions"": 0, ""lines"": 2}, ""src/userfunc.c"": {""insertions"": 7, ""deletions"": 6, ""lines"": 13}, ""src/version.c"": {""insertions"": 2, ""deletions"": 0, ""lines"": 2}}"
2021-05-18 11:40:33,d87c21a918d8d611750f22d68fc638bf7a79b1d5,Bram Moolenaar,6,1,7,2,"{""src/userfunc.c"": {""insertions"": 4, ""deletions"": 1, ""lines"": 5}, ""src/version.c"": {""insertions"": 2, ""deletions"": 0, ""lines"": 2}}"
2021-05-18 09:47:44,074f84c01fbe70554feb6a71c0d9cacf2ef77ca5,Bram Moolenaar,102,7,109,3,"{""src/testdir/test_vim9_func.vim"": {""insertions"": 14, ""deletions"": 0, ""lines"": 14}, ""src/userfunc.c"": {""insertions"": 86, ""deletions"": 7, ""lines"": 93}, ""src/version.c"": {""insertions"": 2, ""deletions"": 0, ""lines"": 2}}"
2021-05-16 22:22:06,965c04486c9364ded99b49c86f4c41228503df1f,Bram Moolenaar,10,8,18,2,"{""src/textprop.c"": {""insertions"": 8, ""deletions"": 8, ""lines"": 16}, ""src/version.c"": {""insertions"": 2, ""deletions"": 0, ""lines"": 2}}"
2021-05-16 22:15:18,fc643e6016af80ed5be4570db5c26a6410f52d16,Bram Moolenaar,11,1,12,2,"{""src/textprop.c"": {""insertions"": 9, ""deletions"": 1, ""lines"": 10}, ""src/version.c"": {""insertions"": 2, ""deletions"": 0, ""lines"": 2}}"
2021-05-16 22:01:42,3b1373b193ce5fbf25e852277a4ecc98688c7bb8,Bram Moolenaar,95,7,102,5,"{""src/testdir/test_vim9_expr.vim"": {""insertions"": 15, ""deletions"": 0, ""lines"": 15}, ""src/version.c"": {""insertions"": 2, ""deletions"": 0, ""lines"": 2}, ""src/vim9.h"": {""insertions"": 1, ""deletions"": 0, ""lines"": 1}, ""src/vim9compile.c"": {""insertions"": 52, ""deletions"": 7, ""lines"": 59}, ""src/vim9execute.c"": {""insertions"": 25, ""deletions"": 0, ""lines"": 25}}"
2021-05-16 18:18:57,1764faa38645a559172e9a31f08447385835de81,Bram Moolenaar,6,2,8,4,"{""src/change.c"": {""insertions"": 1, ""deletions"": 1, ""lines"": 2}, ""src/proto/change.pro"": {""insertions"": 1, ""deletions"": 0, ""lines"": 1}, ""src/textprop.c"": {""insertions"": 2, ""deletions"": 1, ""lines"": 3}, ""src/version.c"": {""insertions"": 2, ""deletions"": 0, ""lines"": 2}}"
2021-05-16 18:06:59,dcfc311198b174468c007ec4b5b22b33c2c11c92,Bram Moolenaar,3,1,4,2,"{""src/testdir/test_tcl.vim"": {""insertions"": 1, ""deletions"": 1, ""lines"": 2}, ""src/version.c"": {""insertions"": 2, ""deletions"": 0, ""lines"": 2}}"
2021-05-16 14:19:37,6b02b38ed06879f5e6befe2140aee11a6ad66884,Bram Moolenaar,4,2,6,2,"{""src/testdir/test_ex_mode.vim"": {""insertions"": 2, ""deletions"": 2, ""lines"": 4}, ""src/version.c"": {""insertions"": 2, ""deletions"": 0, ""lines"": 2}}"
2021-05-16 13:24:49,ff65288aa89dcd50760ad942d58baff70c6e93e6,Bram Moolenaar,23,4,27,5,"{""src/globals.h"": {""insertions"": 1, ""deletions"": 1, ""lines"": 2}, ""src/testdir/test_vim9_builtin.vim"": {""insertions"": 14, ""deletions"": 0, ""lines"": 14}, ""src/version.c"": {""insertions"": 2, ""deletions"": 0, ""lines"": 2}, ""src/vim9compile.c"": {""insertions"": 3, ""deletions"": 2, ""lines"": 5}, ""src/vim9execute.c"": {""insertions"": 3, ""deletions"": 1, ""lines"": 4}}"
2021-05-16 10:39:47,3ec3217f0491e9ba8aa8ea02f7e454cd19a287ef,Bram Moolenaar,243,74,317,19,"{"".github/CODEOWNERS"": {""insertions"": 17, ""deletions"": 5, ""lines"": 22}, ""runtime/doc/cmdline.txt"": {""insertions"": 6, ""deletions"": 4, ""lines"": 10}, ""runtime/doc/eval.txt"": {""insertions"": 6, ""deletions"": 1, ""lines"": 7}, ""runtime/doc/map.txt"": {""insertions"": 17, ""deletions"": 1, ""lines"": 18}, ""runtime/doc/options.txt"": {""insertions"": 1, ""deletions"": 1, ""lines"": 2}, ""runtime/doc/pattern.txt"": {""insertions"": 35, ""deletions"": 1, ""lines"": 36}, ""runtime/doc/quickfix.txt"": {""insertions"": 3, ""deletions"": 3, ""lines"": 6}, ""runtime/doc/repeat.txt"": {""insertions"": 14, ""deletions"": 5, ""lines"": 19}, ""runtime/doc/starting.txt"": {""insertions"": 2, ""deletions"": 2, ""lines"": 4}, ""runtime/doc/tags"": {""insertions"": 4, ""deletions"": 1, ""lines"": 5}, ""runtime/doc/todo.txt"": {""insertions"": 22, ""deletions"": 8, ""lines"": 30}, ""runtime/doc/version7.txt"": {""insertions"": 2, ""deletions"": 2, ""lines"": 4}, ""runtime/doc/version8.txt"": {""insertions"": 2, ""deletions"": 2, ""lines"": 4}, ""runtime/ftplugin/meson.vim"": {""insertions"": 1, ""deletions"": 0, ""lines"": 1}, ""runtime/ftplugin/systemverilog.vim"": {""insertions"": 34, ""deletions"": 1, ""lines"": 35}, ""runtime/indent/meson.vim"": {""insertions"": 1, ""deletions"": 0, ""lines"": 1}, ""runtime/pack/dist/opt/termdebug/plugin/termdebug.vim"": {""insertions"": 4, ""deletions"": 2, ""lines"": 6}, ""runtime/syntax/dts.vim"": {""insertions"": 51, ""deletions"": 3, ""lines"": 54}, ""runtime/syntax/meson.vim"": {""insertions"": 21, ""deletions"": 32, ""lines"": 53}}"
2021-05-15 21:21:05,50157ef1c2e36d8696e79fd688bdd08312196bc6,Bram Moolenaar,21,2,23,3,"{""src/ex_cmds.c"": {""insertions"": 18, ""deletions"": 1, ""lines"": 19}, ""src/testdir/test_writefile.vim"": {""insertions"": 1, ""deletions"": 1, ""lines"": 2}, ""src/version.c"": {""insertions"": 2, ""deletions"": 0, ""lines"": 2}}"
2021-05-15 18:06:58,0820f4de5872bfbdc25bf6cba6ec5646dbcec156,Bram Moolenaar,14,3,17,3,"{""src/eval.c"": {""insertions"": 10, ""deletions"": 2, ""lines"": 12}, ""src/testdir/test_method.vim"": {""insertions"": 2, ""deletions"": 1, ""lines"": 3}, ""src/version.c"": {""insertions"": 2, ""deletions"": 0, ""lines"": 2}}"
2021-05-15 15:23:28,30e3de21fc36153c5f7c9cf9db90bcc60dd67fb9,shadmansaleh,106,5,111,5,"{""runtime/doc/options.txt"": {""insertions"": 12, ""deletions"": 0, ""lines"": 12}, ""src/buffer.c"": {""insertions"": 69, ""deletions"": 4, ""lines"": 73}, ""src/optionstr.c"": {""insertions"": 3, ""deletions"": 1, ""lines"": 4}, ""src/testdir/test_statusline.vim"": {""insertions"": 20, ""deletions"": 0, ""lines"": 20}, ""src/version.c"": {""insertions"": 2, ""deletions"": 0, ""lines"": 2}}"
2021-05-15 13:09:06,d832c3c56ec7043322ad3e99897e312700fa1d3e,Bram Moolenaar,8,3,11,2,"{""src/ex_getln.c"": {""insertions"": 6, ""deletions"": 3, ""lines"": 9}, ""src/version.c"": {""insertions"": 2, ""deletions"": 0, ""lines"": 2}}"
2021-05-15 12:25:37,761ead497feff5fd259c9f6ca76d184bb8755373,Natanael Copa,8,2,10,3,"{""src/auto/configure"": {""insertions"": 3, ""deletions"": 1, ""lines"": 4}, ""src/configure.ac"": {""insertions"": 3, ""deletions"": 1, ""lines"": 4}, ""src/version.c"": {""insertions"": 2, ""deletions"": 0, ""lines"": 2}}"
2021-05-15 11:19:16,847fe7d750001a46a09b97ad57286612d0be8100,Bram Moolenaar,32,3,35,3,"{""src/ex_getln.c"": {""insertions"": 11, ""deletions"": 3, ""lines"": 14}, ""src/testdir/test_cmdline.vim"": {""insertions"": 19, ""deletions"": 0, ""lines"": 19}, ""src/version.c"": {""insertions"": 2, ""deletions"": 0, ""lines"": 2}}"
2021-05-13 18:23:10,71c6f7a665eb467054fbf319989d97c252af28d2,obcat,50,0,50,2,"{""src/testdir/test_cmdline.vim"": {""insertions"": 48, ""deletions"": 0, ""lines"": 48}, ""src/version.c"": {""insertions"": 2, ""deletions"": 0, ""lines"": 2}}"
2021-05-13 16:33:16,36f96a515109dc1fad279571a645c0f0d65f2de4,Yegappan Lakshmanan,214,0,214,3,"{""src/testdir/test_startup.vim"": {""insertions"": 15, ""deletions"": 0, ""lines"": 15}, ""src/testdir/test_writefile.vim"": {""insertions"": 197, ""deletions"": 0, ""lines"": 197}, ""src/version.c"": {""insertions"": 2, ""deletions"": 0, ""lines"": 2}}"
2021-05-13 12:55:55,fe8ebdbe5c4e116311c0c0d5937b89ded5c92d01,Dominique Pelle,18,8,26,5,"{""src/eval.c"": {""insertions"": 7, ""deletions"": 4, ""lines"": 11}, ""src/evalfunc.c"": {""insertions"": 4, ""deletions"": 4, ""lines"": 8}, ""src/testdir/test_functions.vim"": {""insertions"": 4, ""deletions"": 0, ""lines"": 4}, ""src/testdir/test_listdict.vim"": {""insertions"": 1, ""deletions"": 0, ""lines"": 1}, ""src/version.c"": {""insertions"": 2, ""deletions"": 0, ""lines"": 2}}"
2021-05-10 21:49:39,588cf7547bafaff46a82bc125d05d24a1cedf827,Dominique Pelle,31,2,33,3,"{""src/testdir/test_arabic.vim"": {""insertions"": 8, ""deletions"": 0, ""lines"": 8}, ""src/testdir/test_perl.vim"": {""insertions"": 21, ""deletions"": 2, ""lines"": 23}, ""src/version.c"": {""insertions"": 2, ""deletions"": 0, ""lines"": 2}}"
2021-05-09 21:19:22,68db996b621b98066fb7ab7028ed5c6aaa3954a8,Bram Moolenaar,65,9,74,9,"{""src/errors.h"": {""insertions"": 4, ""deletions"": 0, ""lines"": 4}, ""src/eval.c"": {""insertions"": 14, ""deletions"": 5, ""lines"": 19}, ""src/evalfunc.c"": {""insertions"": 2, ""deletions"": 1, ""lines"": 3}, ""src/globals.h"": {""insertions"": 0, ""deletions"": 1, ""lines"": 1}, ""src/testdir/test_vim9_cmd.vim"": {""insertions"": 23, ""deletions"": 0, ""lines"": 23}, ""src/typval.c"": {""insertions"": 2, ""deletions"": 1, ""lines"": 3}, ""src/version.c"": {""insertions"": 2, ""deletions"": 0, ""lines"": 2}, ""src/vim9compile.c"": {""insertions"": 16, ""deletions"": 0, ""lines"": 16}, ""src/vim9execute.c"": {""insertions"": 2, ""deletions"": 1, ""lines"": 3}}"
2021-05-08 18:09:24,918b08957c51ae079f8f456198f8a1869a3d2a4c,Bram Moolenaar,4,2,6,2,"{""src/terminal.c"": {""insertions"": 2, ""deletions"": 2, ""lines"": 4}, ""src/version.c"": {""insertions"": 2, ""deletions"": 0, ""lines"": 2}}"
2021-05-07 18:43:54,24f720998f852dd1ba861ec67d56625a507b915e,Bram Moolenaar,6,1,7,2,"{""src/typval.c"": {""insertions"": 4, ""deletions"": 1, ""lines"": 5}, ""src/version.c"": {""insertions"": 2, ""deletions"": 0, ""lines"": 2}}"
2021-05-07 17:44:21,f06ab6ba388c1ac907adbbde95b63769f67bc59b,Bram Moolenaar,29,2,31,3,"{""src/testdir/test_vim9_builtin.vim"": {""insertions"": 21, ""deletions"": 0, ""lines"": 21}, ""src/version.c"": {""insertions"": 2, ""deletions"": 0, ""lines"": 2}, ""src/vim9compile.c"": {""insertions"": 6, ""deletions"": 2, ""lines"": 8}}"
2021-05-07 15:55:55,f18332fb9e2e4208a97d800f096b02c6681780e7,Bram Moolenaar,235,17,252,18,"{""src/eval.c"": {""insertions"": 13, ""deletions"": 0, ""lines"": 13}, ""src/evalfunc.c"": {""insertions"": 3, ""deletions"": 0, ""lines"": 3}, ""src/evalvars.c"": {""insertions"": 1, ""deletions"": 0, ""lines"": 1}, ""src/if_py_both.h"": {""insertions"": 1, ""deletions"": 0, ""lines"": 1}, ""src/json.c"": {""insertions"": 1, ""deletions"": 0, ""lines"": 1}, ""src/proto/vim9execute.pro"": {""insertions"": 1, ""deletions"": 0, ""lines"": 1}, ""src/structs.h"": {""insertions"": 3, ""deletions"": 0, ""lines"": 3}, ""src/testdir/test_vim9_builtin.vim"": {""insertions"": 14, ""deletions"": 0, ""lines"": 14}, ""src/testdir/test_vim9_disassemble.vim"": {""insertions"": 29, ""deletions"": 0, ""lines"": 29}, ""src/testing.c"": {""insertions"": 1, ""deletions"": 0, ""lines"": 1}, ""src/typval.c"": {""insertions"": 11, ""deletions"": 0, ""lines"": 11}, ""src/version.c"": {""insertions"": 2, ""deletions"": 0, ""lines"": 2}, ""src/vim.h"": {""insertions"": 1, ""deletions"": 0, ""lines"": 1}, ""src/vim9.h"": {""insertions"": 2, ""deletions"": 0, ""lines"": 2}, ""src/vim9compile.c"": {""insertions"": 90, ""deletions"": 17, ""lines"": 107}, ""src/vim9execute.c"": {""insertions"": 59, ""deletions"": 0, ""lines"": 59}, ""src/vim9type.c"": {""insertions"": 2, ""deletions"": 0, ""lines"": 2}, ""src/viminfo.c"": {""insertions"": 1, ""deletions"": 0, ""lines"": 1}}"
2021-05-07 13:00:17,e08795e1ecf0b85751e9f41021603c39ef026d92,matveyt,5,3,8,2,"{""src/os_win32.c"": {""insertions"": 3, ""deletions"": 3, ""lines"": 6}, ""src/version.c"": {""insertions"": 2, ""deletions"": 0, ""lines"": 2}}"
2021-05-06 19:04:55,261417b872e6449fe1ca4e7d10f1cfd9736ea453,Bram Moolenaar,45,21,66,3,"{""src/testdir/test_vim9_expr.vim"": {""insertions"": 22, ""deletions"": 0, ""lines"": 22}, ""src/version.c"": {""insertions"": 2, ""deletions"": 0, ""lines"": 2}, ""src/vim9compile.c"": {""insertions"": 21, ""deletions"": 21, ""lines"": 42}}"
2021-05-06 16:46:35,56318369750066718b880afa69e7ae3843d0410b,Natanael Copa,9,4,13,3,"{""runtime/doc/options.txt"": {""insertions"": 3, ""deletions"": 3, ""lines"": 6}, ""src/option.c"": {""insertions"": 4, ""deletions"": 1, ""lines"": 5}, ""src/version.c"": {""insertions"": 2, ""deletions"": 0, ""lines"": 2}}"
2021-05-06 15:45:22,e3e598e82b79a2ab5ba5e312d54e65c940e2e809,Liam Beguin,4,1,5,3,"{""runtime/filetype.vim"": {""insertions"": 1, ""deletions"": 0, ""lines"": 1}, ""src/testdir/test_filetype.vim"": {""insertions"": 1, ""deletions"": 1, ""lines"": 2}, ""src/version.c"": {""insertions"": 2, ""deletions"": 0, ""lines"": 2}}"
2021-05-06 15:36:55,6d37e8e3baafba460bd2d051170d213c1ba9a523,Dominique Pelle,49,0,49,7,"{""src/testdir/test_excmd.vim"": {""insertions"": 6, ""deletions"": 0, ""lines"": 6}, ""src/testdir/test_functions.vim"": {""insertions"": 2, ""deletions"": 0, ""lines"": 2}, ""src/testdir/test_options.vim"": {""insertions"": 28, ""deletions"": 0, ""lines"": 28}, ""src/testdir/test_startup.vim"": {""insertions"": 7, ""deletions"": 0, ""lines"": 7}, ""src/testdir/test_syntax.vim"": {""insertions"": 3, ""deletions"": 0, ""lines"": 3}, ""src/testdir/test_vim9_cmd.vim"": {""insertions"": 1, ""deletions"": 0, ""lines"": 1}, ""src/version.c"": {""insertions"": 2, ""deletions"": 0, ""lines"": 2}}"
2021-05-05 20:51:39,b7c978154e0816f4dcfae8a06b4ba1bfb7f796f6,Bram Moolenaar,18,1,19,4,"{""src/tag.c"": {""insertions"": 1, ""deletions"": 1, ""lines"": 2}, ""src/version.c"": {""insertions"": 2, ""deletions"": 0, ""lines"": 2}, ""src/vim9compile.c"": {""insertions"": 7, ""deletions"": 0, ""lines"": 7}, ""src/vim9execute.c"": {""insertions"": 8, ""deletions"": 0, ""lines"": 8}}"
2021-05-05 20:40:56,dc3e2e65c9dddcace4b24f0f364883d7ce448efb,Bram Moolenaar,3,0,3,2,"{""src/version.c"": {""insertions"": 2, ""deletions"": 0, ""lines"": 2}, ""src/vim9compile.c"": {""insertions"": 1, ""deletions"": 0, ""lines"": 1}}"
2021-05-05 19:31:39,5f7d4c049e934dbc8d2c3f2720797c10ee3c55c2,Bram Moolenaar,205,53,258,8,"{""src/proto/quickfix.pro"": {""insertions"": 3, ""deletions"": 0, ""lines"": 3}, ""src/quickfix.c"": {""insertions"": 69, ""deletions"": 53, ""lines"": 122}, ""src/testdir/test_quickfix.vim"": {""insertions"": 16, ""deletions"": 0, ""lines"": 16}, ""src/testdir/test_vim9_disassemble.vim"": {""insertions"": 19, ""deletions"": 0, ""lines"": 19}, ""src/version.c"": {""insertions"": 2, ""deletions"": 0, ""lines"": 2}, ""src/vim9.h"": {""insertions"": 16, ""deletions"": 0, ""lines"": 16}, ""src/vim9compile.c"": {""insertions"": 43, ""deletions"": 0, ""lines"": 43}, ""src/vim9execute.c"": {""insertions"": 37, ""deletions"": 0, ""lines"": 37}}"
2021-05-05 17:58:17,3a00659db740ebcf0be6153b47a5734eea4a18ba,Bram Moolenaar,5,1,6,2,"{""src/getchar.c"": {""insertions"": 3, ""deletions"": 1, ""lines"": 4}, ""src/version.c"": {""insertions"": 2, ""deletions"": 0, ""lines"": 2}}"
2021-05-04 19:56:28,1ad72c8eb601d681c84b47380fc31b6d23602d51,Bram Moolenaar,5,2,7,2,"{""src/normal.c"": {""insertions"": 3, ""deletions"": 2, ""lines"": 5}, ""src/version.c"": {""insertions"": 2, ""deletions"": 0, ""lines"": 2}}"
2021-05-03 19:40:26,02795104442764cd162c2213c7d942a8ddc0a691,Bram Moolenaar,9,0,9,2,"{""src/testdir/test_vim9_builtin.vim"": {""insertions"": 7, ""deletions"": 0, ""lines"": 7}, ""src/version.c"": {""insertions"": 2, ""deletions"": 0, ""lines"": 2}}"
2021-05-03 18:40:38,ad431995721b2a886f789e2ea7db4c84b732eb18,Bram Moolenaar,27,7,34,4,"{""src/optionstr.c"": {""insertions"": 4, ""deletions"": 1, ""lines"": 5}, ""src/proto/terminal.pro"": {""insertions"": 3, ""deletions"": 2, ""lines"": 5}, ""src/terminal.c"": {""insertions"": 18, ""deletions"": 4, ""lines"": 22}, ""src/version.c"": {""insertions"": 2, ""deletions"": 0, ""lines"": 2}}"
2021-05-03 18:01:45,df36514a6455342e178af693553ef9df9fcf8c83,Bram Moolenaar,16,5,21,5,"{""src/regexp_bt.c"": {""insertions"": 1, ""deletions"": 1, ""lines"": 2}, ""src/regexp_nfa.c"": {""insertions"": 1, ""deletions"": 1, ""lines"": 2}, ""src/testdir/test_exec_while_if.vim"": {""insertions"": 3, ""deletions"": 3, ""lines"": 6}, ""src/testdir/test_substitute.vim"": {""insertions"": 9, ""deletions"": 0, ""lines"": 9}, ""src/version.c"": {""insertions"": 2, ""deletions"": 0, ""lines"": 2}}"
2021-05-03 17:49:51,97a6c6a1fb6043fd6520fbaaafc6970334186167,Bram Moolenaar,3,1,4,2,"{""src/fileio.c"": {""insertions"": 1, ""deletions"": 1, ""lines"": 2}, ""src/version.c"": {""insertions"": 2, ""deletions"": 0, ""lines"": 2}}"
2021-05-03 17:08:37,5f8ed7408aaf477215bcfde3e487e24b9e6ad870,Dominique Pelle,4,2,6,2,"{""src/testdir/test_mksession.vim"": {""insertions"": 2, ""deletions"": 2, ""lines"": 4}, ""src/version.c"": {""insertions"": 2, ""deletions"": 0, ""lines"": 2}}"
2021-05-03 16:57:05,551c1aed65817558ac1ece541c246ea585645807,Bram Moolenaar,4,2,6,3,"{""src/map.c"": {""insertions"": 1, ""deletions"": 1, ""lines"": 2}, ""src/quickfix.c"": {""insertions"": 1, ""deletions"": 1, ""lines"": 2}, ""src/version.c"": {""insertions"": 2, ""deletions"": 0, ""lines"": 2}}"
2021-05-02 18:16:24,2bf6034e5caf36b319148f46ba9a12e36c3bd41d,Dominique Pelle,57,0,57,2,"{""src/testdir/test_excmd.vim"": {""insertions"": 55, ""deletions"": 0, ""lines"": 55}, ""src/version.c"": {""insertions"": 2, ""deletions"": 0, ""lines"": 2}}"
2021-05-02 17:15:05,1bb0da25a6581cd09d6df91f11ce866dc775597b,Bram Moolenaar,18,4,22,4,"{""Filelist"": {""insertions"": 2, ""deletions"": 2, ""lines"": 4}, ""src/testdir/shared.vim"": {""insertions"": 2, ""deletions"": 0, ""lines"": 2}, ""src/testdir/test_function_lists.vim"": {""insertions"": 12, ""deletions"": 2, ""lines"": 14}, ""src/version.c"": {""insertions"": 2, ""deletions"": 0, ""lines"": 2}}"
2021-05-02 15:19:11,4c295027a426986566cd7a76c47a6d3a529727e7,Bram Moolenaar,425,198,623,20,"{"".github/CODEOWNERS"": {""insertions"": 4, ""deletions"": 0, ""lines"": 4}, ""nsis/lang/english.nsi"": {""insertions"": 1, ""deletions"": 1, ""lines"": 2}, ""runtime/autoload/syntaxcomplete.vim"": {""insertions"": 99, ""deletions"": 49, ""lines"": 148}, ""runtime/doc/autocmd.txt"": {""insertions"": 9, ""deletions"": 2, ""lines"": 11}, ""runtime/doc/eval.txt"": {""insertions"": 5, ""deletions"": 2, ""lines"": 7}, ""runtime/doc/gui.txt"": {""insertions"": 6, ""deletions"": 1, ""lines"": 7}, ""runtime/doc/index.txt"": {""insertions"": 1, ""deletions"": 1, ""lines"": 2}, ""runtime/doc/map.txt"": {""insertions"": 7, ""deletions"": 4, ""lines"": 11}, ""runtime/doc/options.txt"": {""insertions"": 3, ""deletions"": 2, ""lines"": 5}, ""runtime/doc/quickfix.txt"": {""insertions"": 17, ""deletions"": 8, ""lines"": 25}, ""runtime/doc/tags"": {""insertions"": 4, ""deletions"": 0, ""lines"": 4}, ""runtime/doc/todo.txt"": {""insertions"": 19, ""deletions"": 32, ""lines"": 51}, ""runtime/doc/usr_02.txt"": {""insertions"": 2, ""deletions"": 2, ""lines"": 4}, ""runtime/doc/vim9.txt"": {""insertions"": 55, ""deletions"": 38, ""lines"": 93}, ""runtime/ftplugin/fpcmake.vim"": {""insertions"": 25, ""deletions"": 0, ""lines"": 25}, ""runtime/ftplugin/pascal.vim"": {""insertions"": 41, ""deletions"": 11, ""lines"": 52}, ""runtime/indent/make.vim"": {""insertions"": 2, ""deletions"": 2, ""lines"": 4}, ""runtime/syntax/conf.vim"": {""insertions"": 3, ""deletions"": 3, ""lines"": 6}, ""runtime/syntax/fpcmake.vim"": {""insertions"": 58, ""deletions"": 0, ""lines"": 58}, ""runtime/syntax/pascal.vim"": {""insertions"": 64, ""deletions"": 40, ""lines"": 104}}"
2021-05-02 11:59:46,5f628a12e5c7ebd1145ae1c089d1be1751b700c1,Bram Moolenaar,3,1,4,2,"{""nsis/gvim.nsi"": {""insertions"": 1, ""deletions"": 1, ""lines"": 2}, ""src/version.c"": {""insertions"": 2, ""deletions"": 0, ""lines"": 2}}"
2021-05-01 20:41:39,4a22897591dc8ff64560bef693af49f171faf557,Bram Moolenaar,16,5,21,4,"{""nsis/README.txt"": {""insertions"": 3, ""deletions"": 0, ""lines"": 3}, ""nsis/gvim.nsi"": {""insertions"": 7, ""deletions"": 2, ""lines"": 9}, ""src/main.c"": {""insertions"": 4, ""deletions"": 3, ""lines"": 7}, ""src/version.c"": {""insertions"": 2, ""deletions"": 0, ""lines"": 2}}"
2021-05-01 15:46:03,3d0e7a956afb6f913466e96bd462eff0c92ad4c6,Bram Moolenaar,21,0,21,4,"{""src/globals.h"": {""insertions"": 1, ""deletions"": 0, ""lines"": 1}, ""src/main.c"": {""insertions"": 14, ""deletions"": 0, ""lines"": 14}, ""src/os_win32.c"": {""insertions"": 4, ""deletions"": 0, ""lines"": 4}, ""src/version.c"": {""insertions"": 2, ""deletions"": 0, ""lines"": 2}}"
2021-04-30 19:37:51,b6c2e9a010ebd7db586081957e634903d4972fa1,Bram Moolenaar,27,3,30,3,"{""src/session.c"": {""insertions"": 11, ""deletions"": 3, ""lines"": 14}, ""src/testdir/test_mksession.vim"": {""insertions"": 14, ""deletions"": 0, ""lines"": 14}, ""src/version.c"": {""insertions"": 2, ""deletions"": 0, ""lines"": 2}}"
2021-04-30 17:43:11,4934ed34c3e2090d1963c89c629cd3ce81d3ecd1,Bram Moolenaar,25,1,26,3,"{""src/map.c"": {""insertions"": 14, ""deletions"": 1, ""lines"": 15}, ""src/testdir/test_mapping.vim"": {""insertions"": 9, ""deletions"": 0, ""lines"": 9}, ""src/version.c"": {""insertions"": 2, ""deletions"": 0, ""lines"": 2}}"
2021-04-29 18:18:45,aeed2a6359e9ca692e1397884c3678685132d360,Bram Moolenaar,10,0,10,3,"{""src/terminal.c"": {""insertions"": 1, ""deletions"": 0, ""lines"": 1}, ""src/testdir/test_terminal.vim"": {""insertions"": 7, ""deletions"": 0, ""lines"": 7}, ""src/version.c"": {""insertions"": 2, ""deletions"": 0, ""lines"": 2}}"
2021-04-28 18:40:44,227c58a486d2459e7bf6ed2c917ede7e324e3570,Bram Moolenaar,28,7,35,5,"{""src/ex_docmd.c"": {""insertions"": 5, ""deletions"": 2, ""lines"": 7}, ""src/testdir/test_vim9_assign.vim"": {""insertions"": 2, ""deletions"": 2, ""lines"": 4}, ""src/testdir/test_vim9_func.vim"": {""insertions"": 3, ""deletions"": 3, ""lines"": 6}, ""src/testdir/test_vim9_script.vim"": {""insertions"": 16, ""deletions"": 0, ""lines"": 16}, ""src/version.c"": {""insertions"": 2, ""deletions"": 0, ""lines"": 2}}"
2021-04-28 18:00:40,03717bf6a27d753fe8f9d713d66594fb1940515f,Bram Moolenaar,23,3,26,3,"{""src/eval.c"": {""insertions"": 14, ""deletions"": 3, ""lines"": 17}, ""src/testdir/test_vim9_expr.vim"": {""insertions"": 7, ""deletions"": 0, ""lines"": 7}, ""src/version.c"": {""insertions"": 2, ""deletions"": 0, ""lines"": 2}}"
2021-04-27 18:06:57,b80d2fb0e7b9adec4cff1bc4e2d30635cb70502e,Bram Moolenaar,11,0,11,2,"{""src/popupmenu.c"": {""insertions"": 9, ""deletions"": 0, ""lines"": 9}, ""src/version.c"": {""insertions"": 2, ""deletions"": 0, ""lines"": 2}}"
2021-04-26 19:39:25,b06b50dfa06e1cbefd634e2735e7cd5ddd5b911c,Bram Moolenaar,4,2,6,2,"{""src/version.c"": {""insertions"": 2, ""deletions"": 0, ""lines"": 2}, ""src/vim9execute.c"": {""insertions"": 2, ""deletions"": 2, ""lines"": 4}}"
2021-04-26 19:17:52,bb01a1ef3a093cdb36877ba73474719c531dc8cb,Yegappan Lakshmanan,160,62,222,8,"{""runtime/doc/quickfix.txt"": {""insertions"": 4, ""deletions"": 4, ""lines"": 8}, ""src/ex_cmds.c"": {""insertions"": 4, ""deletions"": 2, ""lines"": 6}, ""src/proto/search.pro"": {""insertions"": 1, ""deletions"": 0, ""lines"": 1}, ""src/quickfix.c"": {""insertions"": 80, ""deletions"": 33, ""lines"": 113}, ""src/search.c"": {""insertions"": 17, ""deletions"": 21, ""lines"": 38}, ""src/testdir/test_quickfix.vim"": {""insertions"": 48, ""deletions"": 2, ""lines"": 50}, ""src/version.c"": {""insertions"": 2, ""deletions"": 0, ""lines"": 2}, ""src/vim.h"": {""insertions"": 4, ""deletions"": 0, ""lines"": 4}}"
2021-04-26 18:32:59,5930ddcd25c3c31a323cdb1b74c228958e124527,Bram Moolenaar,15,11,26,4,"{""src/testdir/test_vim9_cmd.vim"": {""insertions"": 4, ""deletions"": 0, ""lines"": 4}, ""src/version.c"": {""insertions"": 2, ""deletions"": 0, ""lines"": 2}, ""src/vim9.h"": {""insertions"": 6, ""deletions"": 4, ""lines"": 10}, ""src/vim9execute.c"": {""insertions"": 3, ""deletions"": 7, ""lines"": 10}}"
2021-04-25 14:35:55,b98cec28d95b2184c64a0646458c1e62deb2524b,Bram Moolenaar,21,8,29,4,"{""src/errors.h"": {""insertions"": 2, ""deletions"": 2, ""lines"": 4}, ""src/ex_docmd.c"": {""insertions"": 4, ""deletions"": 1, ""lines"": 5}, ""src/testdir/test_vim9_cmd.vim"": {""insertions"": 13, ""deletions"": 5, ""lines"": 18}, ""src/version.c"": {""insertions"": 2, ""deletions"": 0, ""lines"": 2}}"
2021-04-25 12:48:49,d386e923c751f389b2ac038ff2cb7b40035f8cc6,Bram Moolenaar,30,1,31,3,"{""src/testdir/test_vim9_cmd.vim"": {""insertions"": 22, ""deletions"": 1, ""lines"": 23}, ""src/version.c"": {""insertions"": 2, ""deletions"": 0, ""lines"": 2}, ""src/vim9execute.c"": {""insertions"": 6, ""deletions"": 0, ""lines"": 6}}"
2021-04-25 11:54:42,dc4c2309f2af347068edd60548269018f476dab9,Bram Moolenaar,17,0,17,3,"{""src/testdir/test_vim9_func.vim"": {""insertions"": 10, ""deletions"": 0, ""lines"": 10}, ""src/version.c"": {""insertions"": 2, ""deletions"": 0, ""lines"": 2}, ""src/vim9compile.c"": {""insertions"": 5, ""deletions"": 0, ""lines"": 5}}"
2021-04-24 18:43:56,730bf300202d82eff575581abc915b804275f18d,Bram Moolenaar,11,3,14,2,"{""src/testdir/test_vim9_assign.vim"": {""insertions"": 9, ""deletions"": 3, ""lines"": 12}, ""src/version.c"": {""insertions"": 2, ""deletions"": 0, ""lines"": 2}}"
2021-04-24 18:37:03,340c59ec6f9635e8cbf61db7996d68f61b48679f,Bram Moolenaar,3,0,3,2,"{""src/ex_docmd.c"": {""insertions"": 1, ""deletions"": 0, ""lines"": 1}, ""src/version.c"": {""insertions"": 2, ""deletions"": 0, ""lines"": 2}}"
2021-04-24 17:08:24,bdc0f1c6986e5d64f647e0924a4de795b47c549a,Bram Moolenaar,97,27,124,10,"{""src/eval.c"": {""insertions"": 3, ""deletions"": 0, ""lines"": 3}, ""src/ex_cmdidxs.h"": {""insertions"": 1, ""deletions"": 1, ""lines"": 2}, ""src/ex_cmds.h"": {""insertions"": 8, ""deletions"": 0, ""lines"": 8}, ""src/ex_docmd.c"": {""insertions"": 7, ""deletions"": 0, ""lines"": 7}, ""src/proto/vim9script.pro"": {""insertions"": 1, ""deletions"": 0, ""lines"": 1}, ""src/testdir/test_vim9_assign.vim"": {""insertions"": 16, ""deletions"": 0, ""lines"": 16}, ""src/testdir/test_vim9_expr.vim"": {""insertions"": 0, ""deletions"": 13, ""lines"": 13}, ""src/version.c"": {""insertions"": 2, ""deletions"": 0, ""lines"": 2}, ""src/vim9compile.c"": {""insertions"": 37, ""deletions"": 13, ""lines"": 50}, ""src/vim9script.c"": {""insertions"": 22, ""deletions"": 0, ""lines"": 22}}"
2021-04-24 12:15:41,96cf4ba8fb96e5778192d2dab7458b9a7da0a49d,Bram Moolenaar,64,28,92,11,"{""runtime/doc/index.txt"": {""insertions"": 1, ""deletions"": 0, ""lines"": 1}, ""runtime/doc/vim9.txt"": {""insertions"": 7, ""deletions"": 2, ""lines"": 9}, ""src/ex_cmdidxs.h"": {""insertions"": 16, ""deletions"": 16, ""lines"": 32}, ""src/ex_cmds.h"": {""insertions"": 3, ""deletions"": 0, ""lines"": 3}, ""src/ex_docmd.c"": {""insertions"": 11, ""deletions"": 0, ""lines"": 11}, ""src/structs.h"": {""insertions"": 1, ""deletions"": 0, ""lines"": 1}, ""src/testdir/test_vim9_assign.vim"": {""insertions"": 8, ""deletions"": 8, ""lines"": 16}, ""src/testdir/test_vim9_func.vim"": {""insertions"": 8, ""deletions"": 0, ""lines"": 8}, ""src/version.c"": {""insertions"": 2, ""deletions"": 0, ""lines"": 2}, ""src/vim9compile.c"": {""insertions"": 4, ""deletions"": 0, ""lines"": 4}, ""src/vim9script.c"": {""insertions"": 3, ""deletions"": 2, ""lines"": 5}}"
2021-04-24 11:12:38,7ba1e4d363164e32a93cceab64b42e8c6d89e9f3,Bram Moolenaar,43,6,49,3,"{""src/map.c"": {""insertions"": 20, ""deletions"": 6, ""lines"": 26}, ""src/testdir/test_maparg.vim"": {""insertions"": 21, ""deletions"": 0, ""lines"": 21}, ""src/version.c"": {""insertions"": 2, ""deletions"": 0, ""lines"": 2}}"
2021-04-23 19:01:34,e0c03c8e107f109eadab145e18544d8e74a6976e,Bram Moolenaar,43,10,53,5,"{""src/drawscreen.c"": {""insertions"": 8, ""deletions"": 0, ""lines"": 8}, ""src/globals.h"": {""insertions"": 4, ""deletions"": 0, ""lines"": 4}, ""src/popupmenu.c"": {""insertions"": 28, ""deletions"": 10, ""lines"": 38}, ""src/proto/popupmenu.pro"": {""insertions"": 1, ""deletions"": 0, ""lines"": 1}, ""src/version.c"": {""insertions"": 2, ""deletions"": 0, ""lines"": 2}}"
2021-04-23 17:32:23,a6aa16423fdd0518ec9f3074b0d32b1d651d41e8,Bram Moolenaar,15,2,17,3,"{""src/eval.c"": {""insertions"": 3, ""deletions"": 2, ""lines"": 5}, ""src/testdir/test_vim9_func.vim"": {""insertions"": 10, ""deletions"": 0, ""lines"": 10}, ""src/version.c"": {""insertions"": 2, ""deletions"": 0, ""lines"": 2}}"
2021-04-23 16:06:48,f6d9935a13a7b37272ad71761d3d86b7f40c3d5f,Bram Moolenaar,6,0,6,3,"{""runtime/filetype.vim"": {""insertions"": 3, ""deletions"": 0, ""lines"": 3}, ""src/testdir/test_filetype.vim"": {""insertions"": 1, ""deletions"": 0, ""lines"": 1}, ""src/version.c"": {""insertions"": 2, ""deletions"": 0, ""lines"": 2}}"
2021-04-22 19:39:30,9f28416e54cefe8b6a2382d078c78f1d469e60cd,Bram Moolenaar,31,0,31,3,"{""src/drawscreen.c"": {""insertions"": 7, ""deletions"": 0, ""lines"": 7}, ""src/testdir/test_timers.vim"": {""insertions"": 22, ""deletions"": 0, ""lines"": 22}, ""src/version.c"": {""insertions"": 2, ""deletions"": 0, ""lines"": 2}}"
2021-04-21 16:09:37,11e3c5ba820325b69cb56f70e13c21d7b8808d33,Bram Moolenaar,2367,2410,4777,24,"{""runtime/doc/Makefile"": {""insertions"": 2, ""deletions"": 0, ""lines"": 2}, ""runtime/doc/ft_raku.txt"": {""insertions"": 126, ""deletions"": 0, ""lines"": 126}, ""runtime/doc/options.txt"": {""insertions"": 1, ""deletions"": 1, ""lines"": 2}, ""runtime/doc/tags"": {""insertions"": 3, ""deletions"": 0, ""lines"": 3}, ""runtime/doc/todo.txt"": {""insertions"": 10, ""deletions"": 21, ""lines"": 31}, ""runtime/doc/usr_12.txt"": {""insertions"": 3, ""deletions"": 3, ""lines"": 6}, ""runtime/doc/usr_41.txt"": {""insertions"": 15, ""deletions"": 7, ""lines"": 22}, ""runtime/ftplugin/perl6.vim"": {""insertions"": 0, ""deletions"": 77, ""lines"": 77}, ""runtime/ftplugin/r.vim"": {""insertions"": 2, ""deletions"": 2, ""lines"": 4}, ""runtime/ftplugin/raku.vim"": {""insertions"": 127, ""deletions"": 0, ""lines"": 127}, ""runtime/ftplugin/rhelp.vim"": {""insertions"": 2, ""deletions"": 2, ""lines"": 4}, ""runtime/ftplugin/rmd.vim"": {""insertions"": 2, ""deletions"": 2, ""lines"": 4}, ""runtime/ftplugin/rnoweb.vim"": {""insertions"": 2, ""deletions"": 2, ""lines"": 4}, ""runtime/ftplugin/rrst.vim"": {""insertions"": 2, ""deletions"": 2, ""lines"": 4}, ""runtime/indent/{perl6.vim => raku.vim}"": {""insertions"": 8, ""deletions"": 13, ""lines"": 21}, ""runtime/indent/rmd.vim"": {""insertions"": 25, ""deletions"": 7, ""lines"": 32}, ""runtime/indent/vim.vim"": {""insertions"": 3, ""deletions"": 2, ""lines"": 5}, ""runtime/syntax/perl6.vim"": {""insertions"": 0, ""deletions"": 2242, ""lines"": 2242}, ""runtime/syntax/r.vim"": {""insertions"": 27, ""deletions"": 11, ""lines"": 38}, ""runtime/syntax/raku.vim"": {""insertions"": 1971, ""deletions"": 0, ""lines"": 1971}, ""runtime/syntax/rmd.vim"": {""insertions"": 32, ""deletions"": 12, ""lines"": 44}, ""runtime/syntax/rnoweb.vim"": {""insertions"": 2, ""deletions"": 2, ""lines"": 4}, ""runtime/tutor/tutor.tr.iso9"": {""insertions"": 1, ""deletions"": 1, ""lines"": 2}, ""src/INSTALL"": {""insertions"": 1, ""deletions"": 1, ""lines"": 2}}"
2021-04-21 15:57:26,459fbdbf9216bc7b4721fc192e08b35039036caa,Bram Moolenaar,101,9,110,3,"{""src/eval.c"": {""insertions"": 83, ""deletions"": 2, ""lines"": 85}, ""src/testdir/test_vim9_expr.vim"": {""insertions"": 16, ""deletions"": 7, ""lines"": 23}, ""src/version.c"": {""insertions"": 2, ""deletions"": 0, ""lines"": 2}}"
2021-04-21 14:00:10,a369c3d9c1217cd932bc3d1751a8cff1f5aef1e4,Bram Moolenaar,44,25,69,3,"{""src/testdir/test_vim9_cmd.vim"": {""insertions"": 5, ""deletions"": 0, ""lines"": 5}, ""src/version.c"": {""insertions"": 2, ""deletions"": 0, ""lines"": 2}, ""src/vim9compile.c"": {""insertions"": 37, ""deletions"": 25, ""lines"": 62}}"
2021-04-21 13:11:42,2d5f385cee3668c44089edcb9d60b0b5d751ee5d,Bram Moolenaar,31,0,31,4,"{""src/drawline.c"": {""insertions"": 3, ""deletions"": 0, ""lines"": 3}, ""src/testdir/dumps/Test_hlsearch_visual_1.dump"": {""insertions"": 6, ""deletions"": 0, ""lines"": 6}, ""src/testdir/test_search.vim"": {""insertions"": 20, ""deletions"": 0, ""lines"": 20}, ""src/version.c"": {""insertions"": 2, ""deletions"": 0, ""lines"": 2}}"
2021-04-21 12:24:24,753bcf8c7d7cf7b9e1572a80cc513a67020814ac,Bram Moolenaar,64,13,77,3,"{""src/testdir/test_vim9_cmd.vim"": {""insertions"": 25, ""deletions"": 0, ""lines"": 25}, ""src/version.c"": {""insertions"": 2, ""deletions"": 0, ""lines"": 2}, ""src/vim9compile.c"": {""insertions"": 37, ""deletions"": 13, ""lines"": 50}}"
2021-04-21 10:19:35,169502fb0beb7eb21f72d6c4590483c069353b53,Bram Moolenaar,7,3,10,2,"{""src/version.c"": {""insertions"": 2, ""deletions"": 0, ""lines"": 2}, ""src/vim9compile.c"": {""insertions"": 5, ""deletions"": 3, ""lines"": 8}}"
2021-04-21 09:57:59,16678eb50f7fcb7138600bd0364edb2c9def8cb8,Bram Moolenaar,4,0,4,3,"{""src/auto/configure"": {""insertions"": 1, ""deletions"": 0, ""lines"": 1}, ""src/configure.ac"": {""insertions"": 1, ""deletions"": 0, ""lines"": 1}, ""src/version.c"": {""insertions"": 2, ""deletions"": 0, ""lines"": 2}}"
2021-04-21 09:30:48,d23f8bde5cd16b7752cc4a73da106673839ed824,Bram Moolenaar,9,6,15,3,"{""src/Make_mvc.mak"": {""insertions"": 1, ""deletions"": 1, ""lines"": 2}, ""src/os_win32.c"": {""insertions"": 6, ""deletions"": 5, ""lines"": 11}, ""src/version.c"": {""insertions"": 2, ""deletions"": 0, ""lines"": 2}}"
2021-04-20 20:16:39,9ce47ec0b65f81358febacbd9b808ac8ef7af85c,Bram Moolenaar,25,2,27,3,"{""src/testdir/test_vim9_disassemble.vim"": {""insertions"": 4, ""deletions"": 2, ""lines"": 6}, ""src/version.c"": {""insertions"": 2, ""deletions"": 0, ""lines"": 2}, ""src/vim9execute.c"": {""insertions"": 19, ""deletions"": 0, ""lines"": 19}}"
2021-04-20 19:49:35,5c787fb7928c4cc1e7d6eec0be1bbd63d903cc8d,Bram Moolenaar,5,5,10,2,"{""src/version.c"": {""insertions"": 2, ""deletions"": 0, ""lines"": 2}, ""src/vim9compile.c"": {""insertions"": 3, ""deletions"": 5, ""lines"": 8}}"
2021-04-20 19:14:09,63276685f90fca8b1a0be3a6734759fa82b7be0c,Bram Moolenaar,6,4,10,2,"{""runtime/scripts.vim"": {""insertions"": 4, ""deletions"": 4, ""lines"": 8}, ""src/version.c"": {""insertions"": 2, ""deletions"": 0, ""lines"": 2}}"
2021-04-20 19:10:48,8238f08838c0b481d0b14a741bc03f2e45c211d3,Bram Moolenaar,60,38,98,3,"{""src/testdir/test_vim9_cmd.vim"": {""insertions"": 6, ""deletions"": 0, ""lines"": 6}, ""src/version.c"": {""insertions"": 2, ""deletions"": 0, ""lines"": 2}, ""src/vim9compile.c"": {""insertions"": 52, ""deletions"": 38, ""lines"": 90}}"
2021-04-20 18:21:23,3f88e71fa2b8b1fc97f3c218989474ea8687d197,Bram Moolenaar,7,6,13,3,"{""runtime/filetype.vim"": {""insertions"": 3, ""deletions"": 3, ""lines"": 6}, ""src/testdir/test_filetype.vim"": {""insertions"": 2, ""deletions"": 3, ""lines"": 5}, ""src/version.c"": {""insertions"": 2, ""deletions"": 0, ""lines"": 2}}"
2021-04-20 08:33:28,6d4c1c7ba816294408097d72717366a97781655d,Bram Moolenaar,6,2,8,2,"{""src/os_win32.c"": {""insertions"": 4, ""deletions"": 2, ""lines"": 6}, ""src/version.c"": {""insertions"": 2, ""deletions"": 0, ""lines"": 2}}"
2021-04-19 19:06:31,4f2df37a0d297a0f40ff15f8ce31285c7b529bcd,Bram Moolenaar,11,2,13,2,"{""src/version.c"": {""insertions"": 2, ""deletions"": 0, ""lines"": 2}, ""src/vim9compile.c"": {""insertions"": 9, ""deletions"": 2, ""lines"": 11}}"
2021-04-19 18:50:03,2d1c57ed3dd25c44b41b9ddd4cf63c01ae89007e,Bram Moolenaar,335,97,432,9,"{""src/errors.h"": {""insertions"": 4, ""deletions"": 0, ""lines"": 4}, ""src/evalvars.c"": {""insertions"": 37, ""deletions"": 3, ""lines"": 40}, ""src/proto/evalvars.pro"": {""insertions"": 5, ""deletions"": 1, ""lines"": 6}, ""src/testdir/test_vim9_cmd.vim"": {""insertions"": 18, ""deletions"": 0, ""lines"": 18}, ""src/testdir/test_vim9_disassemble.vim"": {""insertions"": 27, ""deletions"": 0, ""lines"": 27}, ""src/version.c"": {""insertions"": 2, ""deletions"": 0, ""lines"": 2}, ""src/vim9.h"": {""insertions"": 3, ""deletions"": 0, ""lines"": 3}, ""src/vim9compile.c"": {""insertions"": 201, ""deletions"": 93, ""lines"": 294}, ""src/vim9execute.c"": {""insertions"": 38, ""deletions"": 0, ""lines"": 38}}"
2021-04-19 14:48:48,4c13721482d7786f92f5a56e43b0f5c499264b7e,Bram Moolenaar,1070,779,1849,11,"{""src/ex_cmds.c"": {""insertions"": 24, ""deletions"": 12, ""lines"": 36}, ""src/globals.h"": {""insertions"": 3, ""deletions"": 0, ""lines"": 3}, ""src/proto/ex_cmds.pro"": {""insertions"": 1, ""deletions"": 0, ""lines"": 1}, ""src/proto/vim9execute.pro"": {""insertions"": 1, ""deletions"": 0, ""lines"": 1}, ""src/regexp.c"": {""insertions"": 3, ""deletions"": 0, ""lines"": 3}, ""src/testdir/test_vim9_cmd.vim"": {""insertions"": 22, ""deletions"": 0, ""lines"": 22}, ""src/testdir/test_vim9_disassemble.vim"": {""insertions"": 19, ""deletions"": 0, ""lines"": 19}, ""src/version.c"": {""insertions"": 2, ""deletions"": 0, ""lines"": 2}, ""src/vim9.h"": {""insertions"": 13, ""deletions"": 2, ""lines"": 15}, ""src/vim9compile.c"": {""insertions"": 92, ""deletions"": 0, ""lines"": 92}, ""src/vim9execute.c"": {""insertions"": 890, ""deletions"": 765, ""lines"": 1655}}"
2021-04-18 14:08:52,e8209b91b9974da95899b51dba4058b411d04d5b,Bram Moolenaar,4,16,20,3,"{""src/eval.c"": {""insertions"": 1, ""deletions"": 15, ""lines"": 16}, ""src/testdir/test_blob.vim"": {""insertions"": 1, ""deletions"": 1, ""lines"": 2}, ""src/version.c"": {""insertions"": 2, ""deletions"": 0, ""lines"": 2}}"
2021-04-18 13:48:04,39211cba723a2cb58a97c7e08826713164b86efc,Bram Moolenaar,255,103,358,4,"{""src/list.c"": {""insertions"": 33, ""deletions"": 21, ""lines"": 54}, ""src/testdir/test_blob.vim"": {""insertions"": 210, ""deletions"": 82, ""lines"": 292}, ""src/testdir/test_vim9_builtin.vim"": {""insertions"": 10, ""deletions"": 0, ""lines"": 10}, ""src/version.c"": {""insertions"": 2, ""deletions"": 0, ""lines"": 2}}"
2021-04-18 12:12:31,b7c21afef14bba0208f2c40d47c050a004eb2f34,Bram Moolenaar,101,20,121,6,"{""src/evalvars.c"": {""insertions"": 6, ""deletions"": 0, ""lines"": 6}, ""src/list.c"": {""insertions"": 19, ""deletions"": 8, ""lines"": 27}, ""src/testdir/test_blob.vim"": {""insertions"": 44, ""deletions"": 12, ""lines"": 56}, ""src/testdir/test_vim9_builtin.vim"": {""insertions"": 26, ""deletions"": 0, ""lines"": 26}, ""src/version.c"": {""insertions"": 2, ""deletions"": 0, ""lines"": 2}, ""src/vim9execute.c"": {""insertions"": 4, ""deletions"": 0, ""lines"": 4}}"
2021-04-18 11:15:58,d551d6c268e435e2fbba22775510fbd0a54477f6,Bram Moolenaar,72,33,105,4,"{""src/testdir/test_blob.vim"": {""insertions"": 29, ""deletions"": 26, ""lines"": 55}, ""src/version.c"": {""insertions"": 2, ""deletions"": 0, ""lines"": 2}, ""src/vim9compile.c"": {""insertions"": 5, ""deletions"": 4, ""lines"": 9}, ""src/vim9execute.c"": {""insertions"": 36, ""deletions"": 3, ""lines"": 39}}"
2021-04-17 19:22:49,f7e92aae1581203306a340b4c0059cc74adea9d6,Bram Moolenaar,5,2,7,2,"{""src/blob.c"": {""insertions"": 3, ""deletions"": 2, ""lines"": 5}, ""src/version.c"": {""insertions"": 2, ""deletions"": 0, ""lines"": 2}}"
2021-04-17 19:04:34,d23b714d8b9ed8e16ef553098acc6da0979e94fc,Bram Moolenaar,15,8,23,4,"{""runtime/doc/options.txt"": {""insertions"": 1, ""deletions"": 1, ""lines"": 2}, ""src/option.c"": {""insertions"": 2, ""deletions"": 1, ""lines"": 3}, ""src/testdir/test_mksession.vim"": {""insertions"": 10, ""deletions"": 6, ""lines"": 16}, ""src/version.c"": {""insertions"": 2, ""deletions"": 0, ""lines"": 2}}"
2021-04-17 18:44:56,51e933261b984db014e858d79387a826d2626fb6,Bram Moolenaar,233,96,329,8,"{""src/blob.c"": {""insertions"": 23, ""deletions"": 3, ""lines"": 26}, ""src/errors.h"": {""insertions"": 2, ""deletions"": 0, ""lines"": 2}, ""src/proto/blob.pro"": {""insertions"": 2, ""deletions"": 1, ""lines"": 3}, ""src/testdir/test_blob.vim"": {""insertions"": 147, ""deletions"": 69, ""lines"": 216}, ""src/testdir/test_vim9_disassemble.vim"": {""insertions"": 13, ""deletions"": 3, ""lines"": 16}, ""src/version.c"": {""insertions"": 2, ""deletions"": 0, ""lines"": 2}, ""src/vim9compile.c"": {""insertions"": 13, ""deletions"": 6, ""lines"": 19}, ""src/vim9execute.c"": {""insertions"": 31, ""deletions"": 14, ""lines"": 45}}"
2021-04-17 16:38:54,0995c81f2ffe276669daa004f7778ecc6f5ee09d,Bram Moolenaar,65,28,93,3,"{""src/session.c"": {""insertions"": 45, ""deletions"": 28, ""lines"": 73}, ""src/testdir/test_mksession.vim"": {""insertions"": 18, ""deletions"": 0, ""lines"": 18}, ""src/version.c"": {""insertions"": 2, ""deletions"": 0, ""lines"": 2}}"
2021-04-17 15:59:19,c70fe460b09f6182a13e4385f3232df4fdcd0741,Bram Moolenaar,46,5,51,5,"{""src/structs.h"": {""insertions"": 1, ""deletions"": 1, ""lines"": 2}, ""src/testdir/test_vim9_script.vim"": {""insertions"": 31, ""deletions"": 0, ""lines"": 31}, ""src/version.c"": {""insertions"": 2, ""deletions"": 0, ""lines"": 2}, ""src/vim9compile.c"": {""insertions"": 8, ""deletions"": 0, ""lines"": 8}, ""src/vim9execute.c"": {""insertions"": 4, ""deletions"": 4, ""lines"": 8}}"
2021-04-17 14:38:50,6c7cc347af4f4bc1bf180d80ef81413f89e78f56,Bram Moolenaar,6,1,7,3,"{""src/testdir/test_vim9_script.vim"": {""insertions"": 2, ""deletions"": 0, ""lines"": 2}, ""src/version.c"": {""insertions"": 2, ""deletions"": 0, ""lines"": 2}, ""src/vim9script.c"": {""insertions"": 2, ""deletions"": 1, ""lines"": 3}}"
2021-04-17 14:31:09,56994d215815139207f3c5ce02a1720e44e93c09,Bram Moolenaar,761,170,931,29,"{"".github/CODEOWNERS"": {""insertions"": 7, ""deletions"": 0, ""lines"": 7}, ""README.md"": {""insertions"": 17, ""deletions"": 12, ""lines"": 29}, ""READMEdir/README_mac.txt"": {""insertions"": 6, ""deletions"": 22, ""lines"": 28}, ""runtime/compiler/cm3.vim"": {""insertions"": 26, ""deletions"": 0, ""lines"": 26}, ""runtime/doc/options.txt"": {""insertions"": 1, ""deletions"": 1, ""lines"": 2}, ""runtime/doc/tags"": {""insertions"": 5, ""deletions"": 0, ""lines"": 5}, ""runtime/doc/todo.txt"": {""insertions"": 20, ""deletions"": 8, ""lines"": 28}, ""runtime/doc/vim.1"": {""insertions"": 4, ""deletions"": 0, ""lines"": 4}, ""runtime/doc/vim.man"": {""insertions"": 4, ""deletions"": 0, ""lines"": 4}, ""runtime/doc/vim9.txt"": {""insertions"": 3, ""deletions"": 2, ""lines"": 5}, ""runtime/doc/windows.txt"": {""insertions"": 4, ""deletions"": 4, ""lines"": 8}, ""runtime/filetype.vim"": {""insertions"": 1, ""deletions"": 1, ""lines"": 2}, ""runtime/ftplugin/gprof.vim"": {""insertions"": 2, ""deletions"": 2, ""lines"": 4}, ""runtime/ftplugin/m3build.vim"": {""insertions"": 24, ""deletions"": 0, ""lines"": 24}, ""runtime/ftplugin/m3quake.vim"": {""insertions"": 33, ""deletions"": 0, ""lines"": 33}, ""runtime/ftplugin/modula2.vim"": {""insertions"": 39, ""deletions"": 0, ""lines"": 39}, ""runtime/ftplugin/modula3.vim"": {""insertions"": 38, ""deletions"": 0, ""lines"": 38}, ""runtime/ftplugin/vim.vim"": {""insertions"": 5, ""deletions"": 5, ""lines"": 10}, ""runtime/lang/menu_fr_fr.latin1.vim"": {""insertions"": 31, ""deletions"": 19, ""lines"": 50}, ""runtime/plugin/matchparen.vim"": {""insertions"": 2, ""deletions"": 2, ""lines"": 4}, ""runtime/syntax/gprof.vim"": {""insertions"": 3, ""deletions"": 3, ""lines"": 6}, ""runtime/syntax/hollywood.vim"": {""insertions"": 6, ""deletions"": 7, ""lines"": 13}, ""runtime/syntax/m3build.vim"": {""insertions"": 177, ""deletions"": 0, ""lines"": 177}, ""runtime/syntax/m3quake.vim"": {""insertions"": 74, ""deletions"": 0, ""lines"": 74}, ""runtime/syntax/modula3.vim"": {""insertions"": 75, ""deletions"": 38, ""lines"": 113}, ""runtime/syntax/psl.vim"": {""insertions"": 83, ""deletions"": 0, ""lines"": 83}, ""runtime/syntax/ratpoison.vim"": {""insertions"": 15, ""deletions"": 7, ""lines"": 22}, ""runtime/tutor/tutor.tr.utf-8"": {""insertions"": 1, ""deletions"": 1, ""lines"": 2}, ""src/INSTALLmac.txt"": {""insertions"": 55, ""deletions"": 36, ""lines"": 91}}"
2021-04-17 12:06:39,112a006417a0d4700ff39ddba3bb5e985ae9770f,Bram Moolenaar,10,4,14,3,"{""runtime/filetype.vim"": {""insertions"": 7, ""deletions"": 4, ""lines"": 11}, ""src/testdir/test_filetype.vim"": {""insertions"": 1, ""deletions"": 0, ""lines"": 1}, ""src/version.c"": {""insertions"": 2, ""deletions"": 0, ""lines"": 2}}"
2021-04-16 17:58:22,635bd60804966803490287e97460ecdc91d5fe0a,Bram Moolenaar,46,3,49,8,"{""runtime/doc/options.txt"": {""insertions"": 1, ""deletions"": 0, ""lines"": 1}, ""src/option.c"": {""insertions"": 3, ""deletions"": 0, ""lines"": 3}, ""src/option.h"": {""insertions"": 1, ""deletions"": 0, ""lines"": 1}, ""src/optionstr.c"": {""insertions"": 3, ""deletions"": 2, ""lines"": 5}, ""src/session.c"": {""insertions"": 9, ""deletions"": 1, ""lines"": 10}, ""src/testdir/test_mksession.vim"": {""insertions"": 26, ""deletions"": 0, ""lines"": 26}, ""src/version.c"": {""insertions"": 2, ""deletions"": 0, ""lines"": 2}, ""src/vim.h"": {""insertions"": 1, ""deletions"": 0, ""lines"": 1}}"
2021-04-15 20:13:39,aa1959bd5e82350bb4a82d9a5188c29d70706ec4,Bram Moolenaar,17,1,18,3,"{""src/ex_docmd.c"": {""insertions"": 3, ""deletions"": 1, ""lines"": 4}, ""src/testdir/test_vim9_assign.vim"": {""insertions"": 12, ""deletions"": 0, ""lines"": 12}, ""src/version.c"": {""insertions"": 2, ""deletions"": 0, ""lines"": 2}}"
2021-04-15 19:48:32,fe090eb58fad1aaf83267d0b4ace9f024a5ba2bc,Bram Moolenaar,35,5,40,3,"{""src/testdir/test_vim9_script.vim"": {""insertions"": 12, ""deletions"": 0, ""lines"": 12}, ""src/version.c"": {""insertions"": 2, ""deletions"": 0, ""lines"": 2}, ""src/vim9compile.c"": {""insertions"": 21, ""deletions"": 5, ""lines"": 26}}"
2021-04-15 12:29:17,6bc00699c5049c40761d212bef1b490e2af7944c,Bram Moolenaar,10,2,12,3,"{""runtime/filetype.vim"": {""insertions"": 6, ""deletions"": 2, ""lines"": 8}, ""src/testdir/test_filetype.vim"": {""insertions"": 2, ""deletions"": 0, ""lines"": 2}, ""src/version.c"": {""insertions"": 2, ""deletions"": 0, ""lines"": 2}}"
2021-04-15 11:42:21,f387f5dfbc5accbfbbbb87486f6af42a82acaa7d,Bram Moolenaar,3,1,4,2,"{""src/version.c"": {""insertions"": 2, ""deletions"": 0, ""lines"": 2}, ""src/vim9compile.c"": {""insertions"": 1, ""deletions"": 1, ""lines"": 2}}"
2021-04-14 19:30:06,bd6406f15db210b78fa24dece3bd021a7ac085dc,Bram Moolenaar,6,5,11,5,"{""src/blob.c"": {""insertions"": 1, ""deletions"": 1, ""lines"": 2}, ""src/eval.c"": {""insertions"": 1, ""deletions"": 2, ""lines"": 3}, ""src/proto/blob.pro"": {""insertions"": 1, ""deletions"": 1, ""lines"": 2}, ""src/version.c"": {""insertions"": 2, ""deletions"": 0, ""lines"": 2}, ""src/vim9execute.c"": {""insertions"": 1, ""deletions"": 1, ""lines"": 2}}"
2021-04-14 18:54:07,b1419268901b194b295b7cea18a1d0968f9dddfc,Bram Moolenaar,3,1,4,2,"{""src/version.c"": {""insertions"": 2, ""deletions"": 0, ""lines"": 2}, ""src/vim9compile.c"": {""insertions"": 1, ""deletions"": 1, ""lines"": 2}}"
2021-04-14 18:35:23,0e3ff1919603ee4c4a347fdf761dbdbdeb068015,Bram Moolenaar,140,24,164,8,"{""src/blob.c"": {""insertions"": 30, ""deletions"": 0, ""lines"": 30}, ""src/errors.h"": {""insertions"": 2, ""deletions"": 0, ""lines"": 2}, ""src/eval.c"": {""insertions"": 4, ""deletions"": 12, ""lines"": 16}, ""src/proto/blob.pro"": {""insertions"": 2, ""deletions"": 0, ""lines"": 2}, ""src/testdir/test_blob.vim"": {""insertions"": 41, ""deletions"": 10, ""lines"": 51}, ""src/testdir/vim9.vim"": {""insertions"": 47, ""deletions"": 0, ""lines"": 47}, ""src/version.c"": {""insertions"": 2, ""deletions"": 0, ""lines"": 2}, ""src/vim9execute.c"": {""insertions"": 12, ""deletions"": 2, ""lines"": 14}}"
2021-04-14 15:06:43,b47bed2f7ada4dfae78f76f27473b83507e40315,Bram Moolenaar,20,0,20,3,"{""src/testdir/test_functions.vim"": {""insertions"": 9, ""deletions"": 0, ""lines"": 9}, ""src/userfunc.c"": {""insertions"": 9, ""deletions"": 0, ""lines"": 9}, ""src/version.c"": {""insertions"": 2, ""deletions"": 0, ""lines"": 2}}"
2021-04-14 11:30:46,a3589a0d6cdb314e70421c0f2e5a2d1abf68e597,Bram Moolenaar,18,9,27,3,"{""src/evalvars.c"": {""insertions"": 1, ""deletions"": 1, ""lines"": 2}, ""src/testdir/test_vim9_script.vim"": {""insertions"": 15, ""deletions"": 8, ""lines"": 23}, ""src/version.c"": {""insertions"": 2, ""deletions"": 0, ""lines"": 2}}"
2021-04-14 10:40:00,f62d73933af7830301989eb8162ce94a80e61fbf,Bram Moolenaar,51,0,51,3,"{""src/testdir/test_vim9_disassemble.vim"": {""insertions"": 39, ""deletions"": 0, ""lines"": 39}, ""src/version.c"": {""insertions"": 2, ""deletions"": 0, ""lines"": 2}, ""src/vim9compile.c"": {""insertions"": 10, ""deletions"": 0, ""lines"": 10}}"
2021-04-14 09:15:08,2e240bd428c0033d16f201d7f837636412358199,Bram Moolenaar,28,4,32,3,"{""src/syntax.c"": {""insertions"": 9, ""deletions"": 4, ""lines"": 13}, ""src/testdir/test_syntax.vim"": {""insertions"": 17, ""deletions"": 0, ""lines"": 17}, ""src/version.c"": {""insertions"": 2, ""deletions"": 0, ""lines"": 2}}"
2021-04-13 19:48:03,f6a8d420a8d2924737f713de046947dcb487550c,Bram Moolenaar,41,12,53,6,"{""src/eval.c"": {""insertions"": 9, ""deletions"": 4, ""lines"": 13}, ""src/evalvars.c"": {""insertions"": 20, ""deletions"": 7, ""lines"": 27}, ""src/testdir/test_vim9_script.vim"": {""insertions"": 8, ""deletions"": 0, ""lines"": 8}, ""src/version.c"": {""insertions"": 2, ""deletions"": 0, ""lines"": 2}, ""src/vim.h"": {""insertions"": 1, ""deletions"": 0, ""lines"": 1}, ""src/vim9compile.c"": {""insertions"": 1, ""deletions"": 1, ""lines"": 2}}"
2021-04-13 18:53:13,f2253963c28e4791092620df6a6bb238c33168df,Bram Moolenaar,112,85,197,8,"{""src/list.c"": {""insertions"": 2, ""deletions"": 2, ""lines"": 4}, ""src/proto/vim9script.pro"": {""insertions"": 1, ""deletions"": 1, ""lines"": 2}, ""src/proto/vim9type.pro"": {""insertions"": 1, ""deletions"": 1, ""lines"": 2}, ""src/testdir/test_vim9_script.vim"": {""insertions"": 83, ""deletions"": 68, ""lines"": 151}, ""src/version.c"": {""insertions"": 2, ""deletions"": 0, ""lines"": 2}, ""src/vim.h"": {""insertions"": 1, ""deletions"": 0, ""lines"": 1}, ""src/vim9script.c"": {""insertions"": 6, ""deletions"": 3, ""lines"": 9}, ""src/vim9type.c"": {""insertions"": 16, ""deletions"": 10, ""lines"": 26}}"
2021-04-12 20:02:36,f48b2fa33cda94e963f6fa8b78f344385c9ebea6,Bram Moolenaar,30,0,30,3,"{""src/testdir/test_vim9_func.vim"": {""insertions"": 24, ""deletions"": 0, ""lines"": 24}, ""src/userfunc.c"": {""insertions"": 4, ""deletions"": 0, ""lines"": 4}, ""src/version.c"": {""insertions"": 2, ""deletions"": 0, ""lines"": 2}}"
2021-04-12 19:21:02,68452177ca4cda4a9d5f93892e437447cf9404c8,Bram Moolenaar,258,98,356,11,"{""src/blob.c"": {""insertions"": 22, ""deletions"": 0, ""lines"": 22}, ""src/errors.h"": {""insertions"": 2, ""deletions"": 0, ""lines"": 2}, ""src/eval.c"": {""insertions"": 2, ""deletions"": 13, ""lines"": 15}, ""src/ex_docmd.c"": {""insertions"": 12, ""deletions"": 9, ""lines"": 21}, ""src/proto/blob.pro"": {""insertions"": 1, ""deletions"": 0, ""lines"": 1}, ""src/testdir/test_blob.vim"": {""insertions"": 70, ""deletions"": 60, ""lines"": 130}, ""src/testdir/vim9.vim"": {""insertions"": 35, ""deletions"": 0, ""lines"": 35}, ""src/version.c"": {""insertions"": 2, ""deletions"": 0, ""lines"": 2}, ""src/vim9.h"": {""insertions"": 2, ""deletions"": 0, ""lines"": 2}, ""src/vim9compile.c"": {""insertions"": 48, ""deletions"": 16, ""lines"": 64}, ""src/vim9execute.c"": {""insertions"": 62, ""deletions"": 0, ""lines"": 62}}"
2021-04-11 18:26:34,cfc3023cb6ce5aaec13f49bc4b821feb05e3fb03,Bram Moolenaar,142,72,214,8,"{""src/blob.c"": {""insertions"": 77, ""deletions"": 0, ""lines"": 77}, ""src/eval.c"": {""insertions"": 2, ""deletions"": 62, ""lines"": 64}, ""src/proto/blob.pro"": {""insertions"": 1, ""deletions"": 0, ""lines"": 1}, ""src/testdir/test_vim9_expr.vim"": {""insertions"": 20, ""deletions"": 0, ""lines"": 20}, ""src/version.c"": {""insertions"": 2, ""deletions"": 0, ""lines"": 2}, ""src/vim9.h"": {""insertions"": 2, ""deletions"": 0, ""lines"": 2}, ""src/vim9compile.c"": {""insertions"": 15, ""deletions"": 3, ""lines"": 18}, ""src/vim9execute.c"": {""insertions"": 23, ""deletions"": 7, ""lines"": 30}}"
2021-04-11 16:24:46,af8ea0d066d31cf3cd0a39c5c49ce0342728588d,Bram Moolenaar,24,5,29,4,"{""src/testdir/test_vim9_disassemble.vim"": {""insertions"": 4, ""deletions"": 4, ""lines"": 8}, ""src/testdir/test_vim9_expr.vim"": {""insertions"": 17, ""deletions"": 0, ""lines"": 17}, ""src/version.c"": {""insertions"": 2, ""deletions"": 0, ""lines"": 2}, ""src/vim9compile.c"": {""insertions"": 1, ""deletions"": 1, ""lines"": 2}}"
2021-04-11 11:29:18,09f067fca38c9f89ad088e8c096c4df3998575e2,Bram Moolenaar,52,4,56,6,"{""src/drawscreen.c"": {""insertions"": 3, ""deletions"": 2, ""lines"": 5}, ""src/ex_docmd.c"": {""insertions"": 4, ""deletions"": 1, ""lines"": 5}, ""src/gui.c"": {""insertions"": 5, ""deletions"": 0, ""lines"": 5}, ""src/proto/term.pro"": {""insertions"": 3, ""deletions"": 0, ""lines"": 3}, ""src/term.c"": {""insertions"": 35, ""deletions"": 1, ""lines"": 36}, ""src/version.c"": {""insertions"": 2, ""deletions"": 0, ""lines"": 2}}"
2021-04-10 20:35:43,f93bbd026205f36915312193784f987ad49fb114,Bram Moolenaar,46,22,68,7,"{""runtime/doc/vim9.txt"": {""insertions"": 12, ""deletions"": 7, ""lines"": 19}, ""src/eval.c"": {""insertions"": 1, ""deletions"": 1, ""lines"": 2}, ""src/evalvars.c"": {""insertions"": 7, ""deletions"": 5, ""lines"": 12}, ""src/testdir/test_vim9_assign.vim"": {""insertions"": 8, ""deletions"": 0, ""lines"": 8}, ""src/version.c"": {""insertions"": 2, ""deletions"": 0, ""lines"": 2}, ""src/vim.h"": {""insertions"": 5, ""deletions"": 4, ""lines"": 9}, ""src/vim9compile.c"": {""insertions"": 11, ""deletions"": 5, ""lines"": 16}}"
2021-04-10 19:46:05,e8e307818495d1a5d821df9bd4bde83add0520e5,Bram Moolenaar,3,4,7,2,"{""src/typval.c"": {""insertions"": 1, ""deletions"": 4, ""lines"": 5}, ""src/version.c"": {""insertions"": 2, ""deletions"": 0, ""lines"": 2}}"
2021-04-10 19:38:38,fed9e830fcffa90cf73dd125a27d27ed7eafbd68,Bram Moolenaar,6,2,8,2,"{""src/userfunc.c"": {""insertions"": 4, ""deletions"": 2, ""lines"": 6}, ""src/version.c"": {""insertions"": 2, ""deletions"": 0, ""lines"": 2}}"
2021-04-10 19:01:38,da479c7597a61c4d50c842df21c9294bd9bf1037,Bram Moolenaar,8,0,8,3,"{""src/testdir/test_vim9_func.vim"": {""insertions"": 2, ""deletions"": 0, ""lines"": 2}, ""src/version.c"": {""insertions"": 2, ""deletions"": 0, ""lines"": 2}, ""src/vim9compile.c"": {""insertions"": 4, ""deletions"": 0, ""lines"": 4}}"
2021-04-10 18:52:43,fe95b94ffa75c4925ad16c43f94092f2b1d35fc6,Bram Moolenaar,3,1,4,2,"{""src/testdir/test_vim9_script.vim"": {""insertions"": 1, ""deletions"": 1, ""lines"": 2}, ""src/version.c"": {""insertions"": 2, ""deletions"": 0, ""lines"": 2}}"
2021-04-10 18:46:48,c4297697761230489a025b3e39b992cca845b1b3,Bram Moolenaar,3,1,4,2,"{""src/version.c"": {""insertions"": 2, ""deletions"": 0, ""lines"": 2}, ""src/vim9execute.c"": {""insertions"": 1, ""deletions"": 1, ""lines"": 2}}"
2021-04-10 18:10:26,bb8a7ce0a1bcfafca715275dbadc2ead612f82dd,Bram Moolenaar,27,4,31,4,"{""src/testdir/test_vim9_builtin.vim"": {""insertions"": 2, ""deletions"": 2, ""lines"": 4}, ""src/testdir/test_vim9_func.vim"": {""insertions"": 13, ""deletions"": 2, ""lines"": 15}, ""src/version.c"": {""insertions"": 2, ""deletions"": 0, ""lines"": 2}, ""src/vim9execute.c"": {""insertions"": 10, ""deletions"": 0, ""lines"": 10}}"
2021-04-10 16:21:30,87795939d01932b0d8155fd69c7494fa51c523f3,Bram Moolenaar,3,1,4,2,"{""src/userfunc.c"": {""insertions"": 1, ""deletions"": 1, ""lines"": 2}, ""src/version.c"": {""insertions"": 2, ""deletions"": 0, ""lines"": 2}}"
2021-04-10 15:46:52,51e7e78de7320a734ddc2d7931e767bccaf7e6f2,Bram Moolenaar,15,11,26,2,"{""src/userfunc.c"": {""insertions"": 13, ""deletions"": 11, ""lines"": 24}, ""src/version.c"": {""insertions"": 2, ""deletions"": 0, ""lines"": 2}}"
2021-04-10 15:18:09,962c43bf0d6a33b905f2acd920d3701476ebb5c9,Bram Moolenaar,86,5,91,7,"{""runtime/doc/vim9.txt"": {""insertions"": 25, ""deletions"": 4, ""lines"": 29}, ""src/errors.h"": {""insertions"": 2, ""deletions"": 0, ""lines"": 2}, ""src/eval.c"": {""insertions"": 6, ""deletions"": 1, ""lines"": 7}, ""src/evalvars.c"": {""insertions"": 5, ""deletions"": 0, ""lines"": 5}, ""src/testdir/test_vim9_func.vim"": {""insertions"": 35, ""deletions"": 0, ""lines"": 35}, ""src/version.c"": {""insertions"": 2, ""deletions"": 0, ""lines"": 2}, ""src/vim9compile.c"": {""insertions"": 11, ""deletions"": 0, ""lines"": 11}}"
2021-04-10 12:03:43,599410cb3cb19946cd6df22441da5de003e114bb,Bram Moolenaar,27,1,28,5,"{""src/globals.h"": {""insertions"": 3, ""deletions"": 0, ""lines"": 3}, ""src/message.c"": {""insertions"": 3, ""deletions"": 0, ""lines"": 3}, ""src/testdir/test_vim9_func.vim"": {""insertions"": 14, ""deletions"": 0, ""lines"": 14}, ""src/version.c"": {""insertions"": 2, ""deletions"": 0, ""lines"": 2}, ""src/vim9compile.c"": {""insertions"": 5, ""deletions"": 1, ""lines"": 6}}"
2021-04-10 11:33:48,701cc6ca9e940665a9424541f989bb38c853a498,Bram Moolenaar,34,13,47,5,"{""src/structs.h"": {""insertions"": 5, ""deletions"": 4, ""lines"": 9}, ""src/testdir/test_vim9_func.vim"": {""insertions"": 15, ""deletions"": 1, ""lines"": 16}, ""src/version.c"": {""insertions"": 2, ""deletions"": 0, ""lines"": 2}, ""src/vim9compile.c"": {""insertions"": 11, ""deletions"": 8, ""lines"": 19}, ""src/vim9execute.c"": {""insertions"": 1, ""deletions"": 0, ""lines"": 1}}"
2021-04-09 20:12:44,1088b69451c739c698cf4c2003c2b994458ad18b,Bram Moolenaar,5,1,6,3,"{""src/testdir/test_vim9_func.vim"": {""insertions"": 2, ""deletions"": 0, ""lines"": 2}, ""src/version.c"": {""insertions"": 2, ""deletions"": 0, ""lines"": 2}, ""src/vim9compile.c"": {""insertions"": 1, ""deletions"": 1, ""lines"": 2}}"
2021-04-09 18:24:31,2a38908b05c1d3973a8edbeb5b3e05a11332faf0,Bram Moolenaar,68,31,99,7,"{""src/errors.h"": {""insertions"": 2, ""deletions"": 0, ""lines"": 2}, ""src/testdir/test_vim9_func.vim"": {""insertions"": 19, ""deletions"": 2, ""lines"": 21}, ""src/testdir/test_vim9_script.vim"": {""insertions"": 3, ""deletions"": 3, ""lines"": 6}, ""src/userfunc.c"": {""insertions"": 38, ""deletions"": 23, ""lines"": 61}, ""src/version.c"": {""insertions"": 2, ""deletions"": 0, ""lines"": 2}, ""src/vim9compile.c"": {""insertions"": 3, ""deletions"": 2, ""lines"": 5}, ""src/vim9execute.c"": {""insertions"": 1, ""deletions"": 1, ""lines"": 2}}"
2021-04-09 15:24:52,767034c5b82ba8999d9fed2f997436e6e3e99419,Bram Moolenaar,13,5,18,4,"{""src/testdir/test_vim9_func.vim"": {""insertions"": 7, ""deletions"": 2, ""lines"": 9}, ""src/testdir/test_vim9_script.vim"": {""insertions"": 1, ""deletions"": 1, ""lines"": 2}, ""src/userfunc.c"": {""insertions"": 3, ""deletions"": 2, ""lines"": 5}, ""src/version.c"": {""insertions"": 2, ""deletions"": 0, ""lines"": 2}}"
2021-04-08 18:10:10,dcae51facc4d6de1edd62f0242b40972be841103,Bram Moolenaar,24,1,25,3,"{""src/list.c"": {""insertions"": 8, ""deletions"": 1, ""lines"": 9}, ""src/testdir/test_listdict.vim"": {""insertions"": 14, ""deletions"": 0, ""lines"": 14}, ""src/version.c"": {""insertions"": 2, ""deletions"": 0, ""lines"": 2}}"
2021-04-08 16:27:53,d8db8383926cb8729417d9515cbfaf455dbbd8d1,Bram Moolenaar,27,11,38,5,"{""src/ex_getln.c"": {""insertions"": 12, ""deletions"": 3, ""lines"": 15}, ""src/testdir/dumps/Test_statusline_mode_1.dump"": {""insertions"": 4, ""deletions"": 2, ""lines"": 6}, ""src/testdir/dumps/Test_statusline_mode_2.dump"": {""insertions"": 4, ""deletions"": 2, ""lines"": 6}, ""src/testdir/test_statusline.vim"": {""insertions"": 5, ""deletions"": 4, ""lines"": 9}, ""src/version.c"": {""insertions"": 2, ""deletions"": 0, ""lines"": 2}}"
2021-04-08 16:05:03,175a41c13f3e27e30c662f2f418c5a347dbc645d,Bram Moolenaar,3,2,5,2,"{""src/version.c"": {""insertions"": 2, ""deletions"": 0, ""lines"": 2}, ""src/vim9execute.c"": {""insertions"": 1, ""deletions"": 2, ""lines"": 3}}"
2021-04-07 19:58:16,fa5963880df1d11613594ab78c0a68f894d34aa3,Bram Moolenaar,43,8,51,3,"{""src/testdir/test_vim9_expr.vim"": {""insertions"": 23, ""deletions"": 0, ""lines"": 23}, ""src/version.c"": {""insertions"": 2, ""deletions"": 0, ""lines"": 2}, ""src/vim9compile.c"": {""insertions"": 18, ""deletions"": 8, ""lines"": 26}}"
2021-04-07 19:21:13,15e5e53ef29a457126f7c699931ab5842431f2ea,Bram Moolenaar,25,16,41,4,"{""src/proto/vim9compile.pro"": {""insertions"": 0, ""deletions"": 1, ""lines"": 1}, ""src/testdir/test_vim9_expr.vim"": {""insertions"": 15, ""deletions"": 0, ""lines"": 15}, ""src/version.c"": {""insertions"": 2, ""deletions"": 0, ""lines"": 2}, ""src/vim9compile.c"": {""insertions"": 8, ""deletions"": 15, ""lines"": 23}}"
2021-04-07 19:07:20,130cbfc31235c6cb52ffe718ea0a5bb50fbbc9fd,Bram Moolenaar,619,68,687,30,"{"".github/CODEOWNERS"": {""insertions"": 7, ""deletions"": 0, ""lines"": 7}, ""runtime/compiler/powershell.vim"": {""insertions"": 84, ""deletions"": 0, ""lines"": 84}, ""runtime/doc/Makefile"": {""insertions"": 2, ""deletions"": 0, ""lines"": 2}, ""runtime/doc/cmdline.txt"": {""insertions"": 3, ""deletions"": 1, ""lines"": 4}, ""runtime/doc/editing.txt"": {""insertions"": 2, ""deletions"": 2, ""lines"": 4}, ""runtime/doc/eval.txt"": {""insertions"": 8, ""deletions"": 5, ""lines"": 13}, ""runtime/doc/ft_ps1.txt"": {""insertions"": 64, ""deletions"": 0, ""lines"": 64}, ""runtime/doc/gui_w32.txt"": {""insertions"": 2, ""deletions"": 2, ""lines"": 4}, ""runtime/doc/if_lua.txt"": {""insertions"": 1, ""deletions"": 1, ""lines"": 2}, ""runtime/doc/mbyte.txt"": {""insertions"": 2, ""deletions"": 2, ""lines"": 4}, ""runtime/doc/options.txt"": {""insertions"": 18, ""deletions"": 10, ""lines"": 28}, ""runtime/doc/os_win32.txt"": {""insertions"": 2, ""deletions"": 2, ""lines"": 4}, ""runtime/doc/syntax.txt"": {""insertions"": 1, ""deletions"": 1, ""lines"": 2}, ""runtime/doc/tags"": {""insertions"": 9, ""deletions"": 0, ""lines"": 9}, ""runtime/doc/testing.txt"": {""insertions"": 1, ""deletions"": 1, ""lines"": 2}, ""runtime/doc/todo.txt"": {""insertions"": 5, ""deletions"": 10, ""lines"": 15}, ""runtime/doc/usr_02.txt"": {""insertions"": 1, ""deletions"": 1, ""lines"": 2}, ""runtime/doc/version5.txt"": {""insertions"": 3, ""deletions"": 3, ""lines"": 6}, ""runtime/doc/version6.txt"": {""insertions"": 2, ""deletions"": 2, ""lines"": 4}, ""runtime/doc/vim9.txt"": {""insertions"": 27, ""deletions"": 9, ""lines"": 36}, ""runtime/ftplugin/fortran.vim"": {""insertions"": 11, ""deletions"": 4, ""lines"": 15}, ""runtime/ftplugin/ps1.vim"": {""insertions"": 59, ""deletions"": 0, ""lines"": 59}, ""runtime/ftplugin/ps1xml.vim"": {""insertions"": 34, ""deletions"": 0, ""lines"": 34}, ""runtime/indent/ps1.vim"": {""insertions"": 17, ""deletions"": 0, ""lines"": 17}, ""runtime/plugin/matchparen.vim"": {""insertions"": 4, ""deletions"": 3, ""lines"": 7}, ""runtime/syntax/fortran.vim"": {""insertions"": 13, ""deletions"": 6, ""lines"": 19}, ""runtime/syntax/nasm.vim"": {""insertions"": 3, ""deletions"": 2, ""lines"": 5}, ""runtime/syntax/ps1.vim"": {""insertions"": 182, ""deletions"": 0, ""lines"": 182}, ""runtime/syntax/ps1xml.vim"": {""insertions"": 51, ""deletions"": 0, ""lines"": 51}, ""src/po/fr.po"": {""insertions"": 1, ""deletions"": 1, ""lines"": 2}}"
2021-04-07 18:11:12,125ed2745c0a0570c1f81f249aebb023b2deef1b,Bram Moolenaar,29,13,42,5,"{""ci/if_ver-1.vim"": {""insertions"": 1, ""deletions"": 1, ""lines"": 2}, ""runtime/doc/if_lua.txt"": {""insertions"": 2, ""deletions"": 0, ""lines"": 2}, ""src/if_lua.c"": {""insertions"": 23, ""deletions"": 0, ""lines"": 23}, ""src/testdir/test_lua.vim"": {""insertions"": 1, ""deletions"": 12, ""lines"": 13}, ""src/version.c"": {""insertions"": 2, ""deletions"": 0, ""lines"": 2}}"
2021-04-07 17:42:57,e5b0b98a90acf420bb611fc99534982c98d0645b,Bram Moolenaar,6,0,6,3,"{""src/ex_cmds.c"": {""insertions"": 1, ""deletions"": 0, ""lines"": 1}, ""src/testdir/test_ex_mode.vim"": {""insertions"": 3, ""deletions"": 0, ""lines"": 3}, ""src/version.c"": {""insertions"": 2, ""deletions"": 0, ""lines"": 2}}"
2021-04-07 17:00:25,8dddc1f0e2e9eeb29fc59477b515bcd6bb1243ec,Bram Moolenaar,11,0,11,2,"{""src/mbyte.c"": {""insertions"": 9, ""deletions"": 0, ""lines"": 9}, ""src/version.c"": {""insertions"": 2, ""deletions"": 0, ""lines"": 2}}"
2021-04-06 19:29:32,c9605f0595173bca0f158f2782de950ac6bed147,Bram Moolenaar,3,0,3,2,"{""src/version.c"": {""insertions"": 2, ""deletions"": 0, ""lines"": 2}, ""src/vim9compile.c"": {""insertions"": 1, ""deletions"": 0, ""lines"": 1}}"
2021-04-06 19:17:27,643ce6c0c694667a2afd24bb39d8e9d36d94d7a9,Bram Moolenaar,40,11,51,3,"{""src/testdir/test_vim9_assign.vim"": {""insertions"": 35, ""deletions"": 0, ""lines"": 35}, ""src/version.c"": {""insertions"": 2, ""deletions"": 0, ""lines"": 2}, ""src/vim9compile.c"": {""insertions"": 3, ""deletions"": 11, ""lines"": 14}}"
2021-04-06 18:21:59,e3d1f4c982bd0fe05496448d7868268c75ff7bfb,Bram Moolenaar,20,4,24,5,"{""src/charset.c"": {""insertions"": 10, ""deletions"": 0, ""lines"": 10}, ""src/misc2.c"": {""insertions"": 3, ""deletions"": 3, ""lines"": 6}, ""src/proto/charset.pro"": {""insertions"": 1, ""deletions"": 0, ""lines"": 1}, ""src/testdir/test_mapping.vim"": {""insertions"": 4, ""deletions"": 1, ""lines"": 5}, ""src/version.c"": {""insertions"": 2, ""deletions"": 0, ""lines"": 2}}"
2021-04-06 18:18:29,e9b8b78e046b40b877c999432c4698edb3413d5d,Bram Moolenaar,3,1,4,2,"{""src/testdir/test_user_func.vim"": {""insertions"": 1, ""deletions"": 1, ""lines"": 2}, ""src/version.c"": {""insertions"": 2, ""deletions"": 0, ""lines"": 2}}"
2021-04-06 17:01:03,86cdb8a4bd1abff40b5f80c3c4149b33cbaab990,Bram Moolenaar,22,0,22,3,"{""src/testdir/test_vim9_func.vim"": {""insertions"": 9, ""deletions"": 0, ""lines"": 9}, ""src/userfunc.c"": {""insertions"": 11, ""deletions"": 0, ""lines"": 11}, ""src/version.c"": {""insertions"": 2, ""deletions"": 0, ""lines"": 2}}"
2021-04-05 20:27:37,e8c4660a55364a5d3e395652d1202b8702666823,Bram Moolenaar,50,7,57,5,"{""src/ex_docmd.c"": {""insertions"": 6, ""deletions"": 2, ""lines"": 8}, ""src/ex_eval.c"": {""insertions"": 1, ""deletions"": 0, ""lines"": 1}, ""src/structs.h"": {""insertions"": 2, ""deletions"": 1, ""lines"": 3}, ""src/testdir/test_vim9_func.vim"": {""insertions"": 39, ""deletions"": 4, ""lines"": 43}, ""src/version.c"": {""insertions"": 2, ""deletions"": 0, ""lines"": 2}}"
2021-04-05 19:05:26,0d351a04e137b5c25dd558476182e4cbc81a287d,Bram Moolenaar,6,0,6,2,"{""src/testdir/test_vim9_assign.vim"": {""insertions"": 4, ""deletions"": 0, ""lines"": 4}, ""src/version.c"": {""insertions"": 2, ""deletions"": 0, ""lines"": 2}}"
2021-04-05 18:59:41,58fb7c39a04aabfa399ae4f2142ee0728bc22483,Bram Moolenaar,3,1,4,2,"{""src/testdir/test_let.vim"": {""insertions"": 1, ""deletions"": 1, ""lines"": 2}, ""src/version.c"": {""insertions"": 2, ""deletions"": 0, ""lines"": 2}}"
2021-04-05 18:51:00,b9c0cd897ab4ad54f514187e89719c0241393f8b,Bram Moolenaar,61,31,92,4,"{""src/eval.c"": {""insertions"": 1, ""deletions"": 1, ""lines"": 2}, ""src/testdir/test_vim9_assign.vim"": {""insertions"": 13, ""deletions"": 0, ""lines"": 13}, ""src/version.c"": {""insertions"": 2, ""deletions"": 0, ""lines"": 2}, ""src/vim9compile.c"": {""insertions"": 45, ""deletions"": 30, ""lines"": 75}}"
2021-04-05 17:41:21,2927c07b0ec627c13e863e1b84bec831743bce12,Bram Moolenaar,49,20,69,3,"{""src/testdir/test_vim9_expr.vim"": {""insertions"": 1, ""deletions"": 3, ""lines"": 4}, ""src/version.c"": {""insertions"": 2, ""deletions"": 0, ""lines"": 2}, ""src/vim9compile.c"": {""insertions"": 46, ""deletions"": 17, ""lines"": 63}}"
2021-04-05 16:20:45,01ac0a1f664c5b1ffd5c9ef196d4b47edf2fd494,Bram Moolenaar,8,0,8,2,"{""src/gui_gtk.c"": {""insertions"": 6, ""deletions"": 0, ""lines"": 6}, ""src/version.c"": {""insertions"": 2, ""deletions"": 0, ""lines"": 2}}"
2021-04-05 15:11:17,e42939af87be3adad8c08ceb454e3a31114d7165,Bram Moolenaar,195,118,313,3,"{""src/testdir/test_vim9_assign.vim"": {""insertions"": 40, ""deletions"": 3, ""lines"": 43}, ""src/version.c"": {""insertions"": 2, ""deletions"": 0, ""lines"": 2}, ""src/vim9compile.c"": {""insertions"": 153, ""deletions"": 115, ""lines"": 268}}"
2021-04-05 13:38:51,0865b15bc6d869d56713f674d66ad3d0509bf4b9,Bram Moolenaar,26,0,26,2,"{""src/testdir/test_vim9_func.vim"": {""insertions"": 24, ""deletions"": 0, ""lines"": 24}, ""src/version.c"": {""insertions"": 2, ""deletions"": 0, ""lines"": 2}}"
2021-04-05 12:13:20,ce5b06a6a972dcc36e460782e10e21a09b227b5d,Bram Moolenaar,29,2,31,2,"{""src/gui_gtk.c"": {""insertions"": 27, ""deletions"": 2, ""lines"": 29}, ""src/version.c"": {""insertions"": 2, ""deletions"": 0, ""lines"": 2}}"
2021-04-05 11:59:53,0b94e297afd072c51bf2eed12c7ffe3978d93399,Bram Moolenaar,790,466,1256,4,"{""src/regexp_bt.c"": {""insertions"": 385, ""deletions"": 219, ""lines"": 604}, ""src/regexp_nfa.c"": {""insertions"": 399, ""deletions"": 243, ""lines"": 642}, ""src/testdir/test_regexp_utf8.vim"": {""insertions"": 4, ""deletions"": 4, ""lines"": 8}, ""src/version.c"": {""insertions"": 2, ""deletions"": 0, ""lines"": 2}}"
2021-04-05 11:36:34,886e5e737d0b2eea755c415a86997ca3b7fe5349,Bram Moolenaar,7,1,8,3,"{""src/testdir/test_vim9_builtin.vim"": {""insertions"": 3, ""deletions"": 0, ""lines"": 3}, ""src/testdir/test_vim9_expr.vim"": {""insertions"": 2, ""deletions"": 1, ""lines"": 3}, ""src/version.c"": {""insertions"": 2, ""deletions"": 0, ""lines"": 2}}"
2021-04-05 11:10:43,409da842db9dc24d88e415e518c02c05ac7de760,Bram Moolenaar,10,6,16,3,"{""runtime/filetype.vim"": {""insertions"": 6, ""deletions"": 4, ""lines"": 10}, ""src/testdir/test_filetype.vim"": {""insertions"": 2, ""deletions"": 2, ""lines"": 4}, ""src/version.c"": {""insertions"": 2, ""deletions"": 0, ""lines"": 2}}"
2021-04-05 10:47:25,68ffe8cade5e0c52680c00cb9f3f87104fbe653a,Bram Moolenaar,122,0,122,2,"{""src/testdir/test_fold.vim"": {""insertions"": 120, ""deletions"": 0, ""lines"": 120}, ""src/version.c"": {""insertions"": 2, ""deletions"": 0, ""lines"": 2}}"
2021-04-04 19:55:23,f2dd9cb9958962302d33fab8fe6439645a2d1e1b,Bram Moolenaar,7,3,10,2,"{""src/eval.c"": {""insertions"": 5, ""deletions"": 3, ""lines"": 8}, ""src/version.c"": {""insertions"": 2, ""deletions"": 0, ""lines"": 2}}"
2021-04-04 19:26:04,3c49e74e18993915a779cafe4af3749b39fd3e2a,Bram Moolenaar,28,13,41,3,"{""src/normal.c"": {""insertions"": 10, ""deletions"": 2, ""lines"": 12}, ""src/testdir/test_fold.vim"": {""insertions"": 16, ""deletions"": 11, ""lines"": 27}, ""src/version.c"": {""insertions"": 2, ""deletions"": 0, ""lines"": 2}}"
2021-04-04 18:49:50,90193e6140e5e7f1945e3e144a95697b0e16237a,Bram Moolenaar,756,737,1493,6,"{""src/eval.c"": {""insertions"": 13, ""deletions"": 6, ""lines"": 19}, ""src/testdir/test_vim9_expr.vim"": {""insertions"": 709, ""deletions"": 726, ""lines"": 1435}, ""src/testdir/vim9.vim"": {""insertions"": 20, ""deletions"": 0, ""lines"": 20}, ""src/version.c"": {""insertions"": 2, ""deletions"": 0, ""lines"": 2}, ""src/vim9compile.c"": {""insertions"": 2, ""deletions"": 2, ""lines"": 4}, ""src/vim9execute.c"": {""insertions"": 10, ""deletions"": 3, ""lines"": 13}}"
2021-04-04 13:57:12,26af8e54ff0d423b7258ef84d175c8570740629a,Bram Moolenaar,20,6,26,2,"{""src/gui_gtk.c"": {""insertions"": 18, ""deletions"": 6, ""lines"": 24}, ""src/version.c"": {""insertions"": 2, ""deletions"": 0, ""lines"": 2}}"
2021-04-04 13:28:59,3a6aadb3289be5114db6cce1c8c18b3f5f14d17c,Bram Moolenaar,6,4,10,3,"{""src/testdir/term_util.vim"": {""insertions"": 2, ""deletions"": 2, ""lines"": 4}, ""src/testdir/test_mksession.vim"": {""insertions"": 2, ""deletions"": 2, ""lines"": 4}, ""src/version.c"": {""insertions"": 2, ""deletions"": 0, ""lines"": 2}}"
2021-04-04 13:05:22,ceb06194337f1a9d30cd12edb7b0dc51830b9cb7,Bram Moolenaar,6,1,7,2,"{""src/insexpand.c"": {""insertions"": 4, ""deletions"": 1, ""lines"": 5}, ""src/version.c"": {""insertions"": 2, ""deletions"": 0, ""lines"": 2}}"
2021-04-03 19:47:07,a7511c0f4f779140e8b893be506ecffd0ededf04,Bram Moolenaar,33,8,41,3,"{""src/testdir/test_vim9_expr.vim"": {""insertions"": 22, ""deletions"": 8, ""lines"": 30}, ""src/version.c"": {""insertions"": 2, ""deletions"": 0, ""lines"": 2}, ""src/vim9compile.c"": {""insertions"": 9, ""deletions"": 0, ""lines"": 9}}"
2021-04-03 19:01:01,77709b194c71eb02f765521f31b463593bd07cda,Bram Moolenaar,14,1,15,3,"{""src/testdir/test_vim9_assign.vim"": {""insertions"": 8, ""deletions"": 0, ""lines"": 8}, ""src/version.c"": {""insertions"": 2, ""deletions"": 0, ""lines"": 2}, ""src/vim9compile.c"": {""insertions"": 4, ""deletions"": 1, ""lines"": 5}}"
2021-04-03 18:13:30,440cf096fad7bf628974abc344343b823d79a006,Bram Moolenaar,13,7,20,2,"{""src/insexpand.c"": {""insertions"": 11, ""deletions"": 7, ""lines"": 18}, ""src/version.c"": {""insertions"": 2, ""deletions"": 0, ""lines"": 2}}"
2021-04-03 17:32:44,6e50ec2f0af85940e40ed3f897bfcfa445adbb0e,Bram Moolenaar,10,1,11,3,"{""src/testdir/test_vim9_assign.vim"": {""insertions"": 2, ""deletions"": 1, ""lines"": 3}, ""src/version.c"": {""insertions"": 2, ""deletions"": 0, ""lines"": 2}, ""src/vim9execute.c"": {""insertions"": 6, ""deletions"": 0, ""lines"": 6}}"
2021-04-03 17:07:05,c17ba791a9edfa12926ce29f1eef39044bee5ab7,Bram Moolenaar,4,2,6,2,"{""src/testdir/test_compiler.vim"": {""insertions"": 2, ""deletions"": 2, ""lines"": 4}, ""src/version.c"": {""insertions"": 2, ""deletions"": 0, ""lines"": 2}}"
2021-04-03 15:33:52,26f201345dadef2a048db5aea804f6c1b54f1a0b,Bram Moolenaar,6,4,10,3,"{""src/auto/configure"": {""insertions"": 2, ""deletions"": 2, ""lines"": 4}, ""src/configure.ac"": {""insertions"": 2, ""deletions"": 2, ""lines"": 4}, ""src/version.c"": {""insertions"": 2, ""deletions"": 0, ""lines"": 2}}"
2021-04-03 15:22:29,6437475ffb421d6ac35572aa779ff24b70c5206b,Bram Moolenaar,4,2,6,2,"{""src/testdir/test_terminal.vim"": {""insertions"": 2, ""deletions"": 2, ""lines"": 4}, ""src/version.c"": {""insertions"": 2, ""deletions"": 0, ""lines"": 2}}"
2021-04-03 15:18:52,c48f2dc0be158531511adc3065b52bdd1e64acf7,Bram Moolenaar,3,1,4,2,"{""src/testdir/test_lua.vim"": {""insertions"": 1, ""deletions"": 1, ""lines"": 2}, ""src/version.c"": {""insertions"": 2, ""deletions"": 0, ""lines"": 2}}"
2021-04-03 13:35:50,b9c6b6fb73711f64943340b2c3f0bdf8744451b6,Bram Moolenaar,11,1,12,2,"{""src/testdir/test_lua.vim"": {""insertions"": 9, ""deletions"": 1, ""lines"": 10}, ""src/version.c"": {""insertions"": 2, ""deletions"": 0, ""lines"": 2}}"
2021-04-03 13:15:47,0df603014589c663f4b49dc6fd36c3b99db1718f,Bram Moolenaar,3,0,3,2,"{""runtime/doc/usr_41.txt"": {""insertions"": 1, ""deletions"": 0, ""lines"": 1}, ""src/version.c"": {""insertions"": 2, ""deletions"": 0, ""lines"": 2}}"
2021-04-03 12:13:33,f65ed86f6f60e1b73f4203206cd3df024b7d61f3,Bram Moolenaar,54,25,79,2,"{""src/testdir/test_lua.vim"": {""insertions"": 52, ""deletions"": 25, ""lines"": 77}, ""src/version.c"": {""insertions"": 2, ""deletions"": 0, ""lines"": 2}}"
2021-04-03 11:19:26,1e6bbfb5607c82d872070219c26e2aae20db68ed,Bram Moolenaar,35,4,39,3,"{""src/autocmd.c"": {""insertions"": 6, ""deletions"": 4, ""lines"": 10}, ""src/testdir/test_terminal.vim"": {""insertions"": 27, ""deletions"": 0, ""lines"": 27}, ""src/version.c"": {""insertions"": 2, ""deletions"": 0, ""lines"": 2}}"
2021-04-02 16:55:57,5b8cabfef7c3707f3e53e13844d90e5a217e1e84,Bram Moolenaar,42,5,47,8,"{""runtime/doc/eval.txt"": {""insertions"": 1, ""deletions"": 0, ""lines"": 1}, ""runtime/doc/testing.txt"": {""insertions"": 10, ""deletions"": 1, ""lines"": 11}, ""src/evalfunc.c"": {""insertions"": 2, ""deletions"": 0, ""lines"": 2}, ""src/proto/testing.pro"": {""insertions"": 1, ""deletions"": 0, ""lines"": 1}, ""src/search.c"": {""insertions"": 2, ""deletions"": 0, ""lines"": 2}, ""src/testdir/test_textformat.vim"": {""insertions"": 8, ""deletions"": 0, ""lines"": 8}, ""src/testing.c"": {""insertions"": 16, ""deletions"": 4, ""lines"": 20}, ""src/version.c"": {""insertions"": 2, ""deletions"": 0, ""lines"": 2}}"
2021-04-02 12:44:02,dcf29ac87f4d7a62c503ba6de0d92c7779446bf2,Bram Moolenaar,17,2,19,3,"{""src/testdir/test_vim9_assign.vim"": {""insertions"": 12, ""deletions"": 2, ""lines"": 14}, ""src/version.c"": {""insertions"": 2, ""deletions"": 0, ""lines"": 2}, ""src/vim9execute.c"": {""insertions"": 3, ""deletions"": 0, ""lines"": 3}}"
2021-04-02 12:35:15,f5906aa7807e9a14159cbc09a141138a2a068ab2,Bram Moolenaar,20,0,20,3,"{""src/testdir/test_vim9_assign.vim"": {""insertions"": 11, ""deletions"": 0, ""lines"": 11}, ""src/version.c"": {""insertions"": 2, ""deletions"": 0, ""lines"": 2}, ""src/vim9execute.c"": {""insertions"": 7, ""deletions"": 0, ""lines"": 7}}"
2021-04-02 11:30:59,3fa5e64e0ed55de718e48d0268edc360b2352bc1,Bram Moolenaar,6,4,10,3,"{""src/auto/configure"": {""insertions"": 2, ""deletions"": 2, ""lines"": 4}, ""src/configure.ac"": {""insertions"": 2, ""deletions"": 2, ""lines"": 4}, ""src/version.c"": {""insertions"": 2, ""deletions"": 0, ""lines"": 2}}"
2021-04-02 11:00:15,ef38bcf05196ad7e795dd77b4922fa9db58fc310,Bram Moolenaar,10,1,11,3,"{""runtime/filetype.vim"": {""insertions"": 5, ""deletions"": 0, ""lines"": 5}, ""src/testdir/test_filetype.vim"": {""insertions"": 3, ""deletions"": 1, ""lines"": 4}, ""src/version.c"": {""insertions"": 2, ""deletions"": 0, ""lines"": 2}}"
2021-04-01 19:57:46,160a2b4dac198f31fbcff9d696548e011c4602c1,Bram Moolenaar,4,0,4,2,"{""src/ex_getln.c"": {""insertions"": 2, ""deletions"": 0, ""lines"": 2}, ""src/version.c"": {""insertions"": 2, ""deletions"": 0, ""lines"": 2}}"
2021-04-01 19:38:53,ca51cc0a335d0c449784440501c7d46ee8f84ce4,Bram Moolenaar,6,3,9,3,"{""src/testdir/test_vim9_script.vim"": {""insertions"": 3, ""deletions"": 2, ""lines"": 5}, ""src/version.c"": {""insertions"": 2, ""deletions"": 0, ""lines"": 2}, ""src/vim9compile.c"": {""insertions"": 1, ""deletions"": 1, ""lines"": 2}}"
2021-04-01 17:42:48,d877a5700fe9d5b92562514924549316382384aa,Bram Moolenaar,27,2,29,4,"{""src/testdir/test_vim9_assign.vim"": {""insertions"": 18, ""deletions"": 0, ""lines"": 18}, ""src/version.c"": {""insertions"": 2, ""deletions"": 0, ""lines"": 2}, ""src/vim9compile.c"": {""insertions"": 3, ""deletions"": 1, ""lines"": 4}, ""src/vim9execute.c"": {""insertions"": 4, ""deletions"": 1, ""lines"": 5}}"
2021-04-01 16:47:14,ce0b75711afb3ff260967a0843bca46ec09604b5,Bram Moolenaar,42,0,42,5,"{""src/ex_getln.c"": {""insertions"": 9, ""deletions"": 0, ""lines"": 9}, ""src/testdir/dumps/Test_statusline_mode_1.dump"": {""insertions"": 5, ""deletions"": 0, ""lines"": 5}, ""src/testdir/dumps/Test_statusline_mode_2.dump"": {""insertions"": 5, ""deletions"": 0, ""lines"": 5}, ""src/testdir/test_statusline.vim"": {""insertions"": 21, ""deletions"": 0, ""lines"": 21}, ""src/version.c"": {""insertions"": 2, ""deletions"": 0, ""lines"": 2}}"
2021-04-01 14:16:18,49c51b825a7435a750e64f7f0ebd09166e8559df,Bram Moolenaar,35,2,37,6,"{""src/drawscreen.c"": {""insertions"": 1, ""deletions"": 1, ""lines"": 2}, ""src/proto/drawscreen.pro"": {""insertions"": 1, ""deletions"": 0, ""lines"": 1}, ""src/screen.c"": {""insertions"": 1, ""deletions"": 1, ""lines"": 2}, ""src/testdir/dumps/Test_winbar_not_visible_custom_statusline.dump"": {""insertions"": 10, ""deletions"": 0, ""lines"": 10}, ""src/testdir/test_winbar.vim"": {""insertions"": 20, ""deletions"": 0, ""lines"": 20}, ""src/version.c"": {""insertions"": 2, ""deletions"": 0, ""lines"": 2}}"
2021-04-01 11:39:51,5c504f680e63120fea36becfabb8d939d4449e34,Bram Moolenaar,254,18,272,4,"{""src/testdir/test_fold.vim"": {""insertions"": 204, ""deletions"": 18, ""lines"": 222}, ""src/testdir/test_mksession.vim"": {""insertions"": 31, ""deletions"": 0, ""lines"": 31}, ""src/testdir/test_source.vim"": {""insertions"": 17, ""deletions"": 0, ""lines"": 17}, ""src/version.c"": {""insertions"": 2, ""deletions"": 0, ""lines"": 2}}"
2021-04-01 11:17:50,b91d3f857fb6aadbbc01f80f775967bb40d361de,Bram Moolenaar,4,0,4,2,"{""src/version.c"": {""insertions"": 2, ""deletions"": 0, ""lines"": 2}, ""src/vim9script.c"": {""insertions"": 2, ""deletions"": 0, ""lines"": 2}}"
2021-04-01 10:57:57,529fb5a5f62378bbaac00e1ed9b9c32c6e20c1b9,Bram Moolenaar,35,4,39,4,"{""src/testdir/test_vim9_script.vim"": {""insertions"": 17, ""deletions"": 0, ""lines"": 17}, ""src/version.c"": {""insertions"": 2, ""deletions"": 0, ""lines"": 2}, ""src/vim9compile.c"": {""insertions"": 8, ""deletions"": 2, ""lines"": 10}, ""src/vim9script.c"": {""insertions"": 8, ""deletions"": 2, ""lines"": 10}}"
2021-03-31 19:47:33,12be734faffe1da04dfa9098e73abaa864204bc5,Bram Moolenaar,9,6,15,2,"{""src/evalvars.c"": {""insertions"": 7, ""deletions"": 6, ""lines"": 13}, ""src/version.c"": {""insertions"": 2, ""deletions"": 0, ""lines"": 2}}"
2021-03-31 19:07:24,e535db86e76db5e8fcd2fa8ad54050e171e8adc3,Bram Moolenaar,57,7,64,5,"{""src/evalvars.c"": {""insertions"": 6, ""deletions"": 4, ""lines"": 10}, ""src/proto/vim9script.pro"": {""insertions"": 1, ""deletions"": 0, ""lines"": 1}, ""src/testdir/test_vim9_script.vim"": {""insertions"": 29, ""deletions"": 0, ""lines"": 29}, ""src/version.c"": {""insertions"": 2, ""deletions"": 0, ""lines"": 2}, ""src/vim9script.c"": {""insertions"": 19, ""deletions"": 3, ""lines"": 22}}"
2021-03-31 18:07:33,dad4473f02e1fec86d43a2fc094536a4b27d3b25,Bram Moolenaar,275,239,514,28,"{"".github/CODEOWNERS"": {""insertions"": 5, ""deletions"": 1, ""lines"": 6}, ""runtime/doc/autocmd.txt"": {""insertions"": 6, ""deletions"": 4, ""lines"": 10}, ""runtime/doc/eval.txt"": {""insertions"": 14, ""deletions"": 7, ""lines"": 21}, ""runtime/doc/index.txt"": {""insertions"": 2, ""deletions"": 1, ""lines"": 3}, ""runtime/doc/map.txt"": {""insertions"": 3, ""deletions"": 3, ""lines"": 6}, ""runtime/doc/motion.txt"": {""insertions"": 39, ""deletions"": 33, ""lines"": 72}, ""runtime/doc/options.txt"": {""insertions"": 7, ""deletions"": 7, ""lines"": 14}, ""runtime/doc/quickref.txt"": {""insertions"": 1, ""deletions"": 1, ""lines"": 2}, ""runtime/doc/syntax.txt"": {""insertions"": 3, ""deletions"": 2, ""lines"": 5}, ""runtime/doc/tags"": {""insertions"": 7, ""deletions"": 0, ""lines"": 7}, ""runtime/doc/textprop.txt"": {""insertions"": 3, ""deletions"": 3, ""lines"": 6}, ""runtime/doc/todo.txt"": {""insertions"": 26, ""deletions"": 57, ""lines"": 83}, ""runtime/doc/usr_41.txt"": {""insertions"": 1, ""deletions"": 1, ""lines"": 2}, ""runtime/doc/various.txt"": {""insertions"": 2, ""deletions"": 2, ""lines"": 4}, ""runtime/doc/version7.txt"": {""insertions"": 1, ""deletions"": 1, ""lines"": 2}, ""runtime/doc/version8.txt"": {""insertions"": 1, ""deletions"": 1, ""lines"": 2}, ""runtime/doc/vim9.txt"": {""insertions"": 23, ""deletions"": 25, ""lines"": 48}, ""runtime/doc/windows.txt"": {""insertions"": 3, ""deletions"": 3, ""lines"": 6}, ""runtime/filetype.vim"": {""insertions"": 1, ""deletions"": 1, ""lines"": 2}, ""runtime/ftplugin/lisp.vim"": {""insertions"": 1, ""deletions"": 1, ""lines"": 2}, ""runtime/indent/cdl.vim"": {""insertions"": 8, ""deletions"": 4, ""lines"": 12}, ""runtime/syntax/dot.vim"": {""insertions"": 75, ""deletions"": 51, ""lines"": 126}, ""runtime/syntax/groff.vim"": {""insertions"": 2, ""deletions"": 2, ""lines"": 4}, ""runtime/syntax/javascript.vim"": {""insertions"": 2, ""deletions"": 1, ""lines"": 3}, ""runtime/syntax/nroff.vim"": {""insertions"": 19, ""deletions"": 19, ""lines"": 38}, ""runtime/syntax/sshconfig.vim"": {""insertions"": 9, ""deletions"": 3, ""lines"": 12}, ""runtime/syntax/sshdconfig.vim"": {""insertions"": 7, ""deletions"": 2, ""lines"": 9}, ""runtime/syntax/sudoers.vim"": {""insertions"": 4, ""deletions"": 3, ""lines"": 7}}"
2021-03-30 20:12:12,ae0f151ddf76dcbb233cff02282deb4f98a355ec,Bram Moolenaar,57,6,63,4,"{""src/drawscreen.c"": {""insertions"": 25, ""deletions"": 6, ""lines"": 31}, ""src/testdir/dumps/Test_winbar_not_visible.dump"": {""insertions"": 10, ""deletions"": 0, ""lines"": 10}, ""src/testdir/test_winbar.vim"": {""insertions"": 20, ""deletions"": 0, ""lines"": 20}, ""src/version.c"": {""insertions"": 2, ""deletions"": 0, ""lines"": 2}}"
2021-03-30 18:54:28,82820d9bf14ba5374c24fff2ed6e577a67c6ddf2,Bram Moolenaar,4,0,4,2,"{""src/testdir/test_terminal3.vim"": {""insertions"": 2, ""deletions"": 0, ""lines"": 2}, ""src/version.c"": {""insertions"": 2, ""deletions"": 0, ""lines"": 2}}"
2021-03-29 20:14:55,38a3bfa9a2931729a5e0c28dc087f745b68988ef,Bram Moolenaar,170,65,235,9,"{""runtime/doc/vim9.txt"": {""insertions"": 58, ""deletions"": 1, ""lines"": 59}, ""src/structs.h"": {""insertions"": 0, ""deletions"": 2, ""lines"": 2}, ""src/testdir/test_vim9_disassemble.vim"": {""insertions"": 11, ""deletions"": 4, ""lines"": 15}, ""src/testdir/test_vim9_func.vim"": {""insertions"": 19, ""deletions"": 2, ""lines"": 21}, ""src/userfunc.c"": {""insertions"": 0, ""deletions"": 9, ""lines"": 9}, ""src/version.c"": {""insertions"": 2, ""deletions"": 0, ""lines"": 2}, ""src/vim9.h"": {""insertions"": 8, ""deletions"": 0, ""lines"": 8}, ""src/vim9compile.c"": {""insertions"": 37, ""deletions"": 9, ""lines"": 46}, ""src/vim9execute.c"": {""insertions"": 35, ""deletions"": 38, ""lines"": 73}}"
2021-03-29 19:06:04,9ea7e55ab9eacbdcfde76627fdc070a9cb4d1d45,Bram Moolenaar,4,0,4,2,"{""src/errors.h"": {""insertions"": 2, ""deletions"": 0, ""lines"": 2}, ""src/version.c"": {""insertions"": 2, ""deletions"": 0, ""lines"": 2}}"
2021-03-29 18:49:05,8b9abfd86c736ed3f298dfa8b50a962c118b3983,Bram Moolenaar,145,2,147,11,"{""runtime/doc/options.txt"": {""insertions"": 9, ""deletions"": 0, ""lines"": 9}, ""runtime/doc/quickref.txt"": {""insertions"": 1, ""deletions"": 0, ""lines"": 1}, ""runtime/optwin.vim"": {""insertions"": 2, ""deletions"": 0, ""lines"": 2}, ""src/charset.c"": {""insertions"": 2, ""deletions"": 1, ""lines"": 3}, ""src/feature.h"": {""insertions"": 6, ""deletions"": 0, ""lines"": 6}, ""src/option.h"": {""insertions"": 3, ""deletions"": 0, ""lines"": 3}, ""src/optiondefs.h"": {""insertions"": 9, ""deletions"": 0, ""lines"": 9}, ""src/terminal.c"": {""insertions"": 74, ""deletions"": 1, ""lines"": 75}, ""src/testdir/check.vim"": {""insertions"": 8, ""deletions"": 0, ""lines"": 8}, ""src/testdir/test_terminal3.vim"": {""insertions"": 29, ""deletions"": 0, ""lines"": 29}, ""src/version.c"": {""insertions"": 2, ""deletions"": 0, ""lines"": 2}}"
2021-03-29 18:10:26,9dbe701fe19597ad59c0e0c70a05927b587bea9f,Bram Moolenaar,15,2,17,3,"{""src/gui_motif.c"": {""insertions"": 7, ""deletions"": 2, ""lines"": 9}, ""src/gui_x11.c"": {""insertions"": 6, ""deletions"": 0, ""lines"": 6}, ""src/version.c"": {""insertions"": 2, ""deletions"": 0, ""lines"": 2}}"
2021-03-28 19:14:06,3215466af9abfc9fbbfba81d166d625176993486,Bram Moolenaar,32,2,34,3,"{""src/evalvars.c"": {""insertions"": 4, ""deletions"": 2, ""lines"": 6}, ""src/testdir/test_vim9_assign.vim"": {""insertions"": 26, ""deletions"": 0, ""lines"": 26}, ""src/version.c"": {""insertions"": 2, ""deletions"": 0, ""lines"": 2}}"
2021-03-28 18:38:34,b2cb6c8bbd215177ed05c1d952e7ef2ad8f7ef4b,Bram Moolenaar,97,10,107,4,"{""src/errors.h"": {""insertions"": 2, ""deletions"": 0, ""lines"": 2}, ""src/testdir/test_vim9_cmd.vim"": {""insertions"": 38, ""deletions"": 0, ""lines"": 38}, ""src/version.c"": {""insertions"": 2, ""deletions"": 0, ""lines"": 2}, ""src/vim9compile.c"": {""insertions"": 55, ""deletions"": 10, ""lines"": 65}}"
2021-03-28 14:26:41,f6bdd82c7e2076dbacb764a5d288189d61c68451,Bram Moolenaar,4,1,5,2,"{""src/typval.c"": {""insertions"": 2, ""deletions"": 1, ""lines"": 3}, ""src/version.c"": {""insertions"": 2, ""deletions"": 0, ""lines"": 2}}"
2021-03-28 13:46:16,b2ac7d0663ef31a335c50c6afca042ed9ace5059,Bram Moolenaar,7,1,8,3,"{""src/testdir/test_vim9_builtin.vim"": {""insertions"": 4, ""deletions"": 0, ""lines"": 4}, ""src/typval.c"": {""insertions"": 1, ""deletions"": 1, ""lines"": 2}, ""src/version.c"": {""insertions"": 2, ""deletions"": 0, ""lines"": 2}}"
2021-03-28 13:29:43,df749a2b9cab579b8c0ca6ca91889aa03d2da704,Bram Moolenaar,10,3,13,4,"{""src/cmdexpand.c"": {""insertions"": 3, ""deletions"": 2, ""lines"": 5}, ""src/ex_docmd.c"": {""insertions"": 1, ""deletions"": 1, ""lines"": 2}, ""src/testdir/test_cmdline.vim"": {""insertions"": 4, ""deletions"": 0, ""lines"": 4}, ""src/version.c"": {""insertions"": 2, ""deletions"": 0, ""lines"": 2}}"
2021-03-27 21:20:21,f49a1fcdb952ca270f108fcc27bb8ad6922e0807,Bram Moolenaar,84,53,137,3,"{""src/ex_docmd.c"": {""insertions"": 76, ""deletions"": 47, ""lines"": 123}, ""src/testdir/test_vim9_builtin.vim"": {""insertions"": 6, ""deletions"": 6, ""lines"": 12}, ""src/version.c"": {""insertions"": 2, ""deletions"": 0, ""lines"": 2}}"
2021-03-27 21:07:29,24f21fdfca294fec25861343f8928f6480da95f4,Bram Moolenaar,32,1,33,4,"{""runtime/doc/textprop.txt"": {""insertions"": 2, ""deletions"": 0, ""lines"": 2}, ""src/testdir/test_textprop.vim"": {""insertions"": 19, ""deletions"": 0, ""lines"": 19}, ""src/textprop.c"": {""insertions"": 9, ""deletions"": 1, ""lines"": 10}, ""src/version.c"": {""insertions"": 2, ""deletions"": 0, ""lines"": 2}}"
2021-03-27 20:23:30,c580943965fc9b006ec233bdee4ea5380f5594ea,Bram Moolenaar,54,0,54,6,"{""src/channel.c"": {""insertions"": 5, ""deletions"": 0, ""lines"": 5}, ""src/eval.c"": {""insertions"": 3, ""deletions"": 0, ""lines"": 3}, ""src/evalfunc.c"": {""insertions"": 9, ""deletions"": 0, ""lines"": 9}, ""src/filepath.c"": {""insertions"": 4, ""deletions"": 0, ""lines"": 4}, ""src/testdir/test_vim9_builtin.vim"": {""insertions"": 31, ""deletions"": 0, ""lines"": 31}, ""src/version.c"": {""insertions"": 2, ""deletions"": 0, ""lines"": 2}}"
2021-03-27 18:09:02,7b45d46cf7db0d2d7a4defc2d81b233a2c672b74,Bram Moolenaar,5,1,6,3,"{""src/evalbuffer.c"": {""insertions"": 2, ""deletions"": 0, ""lines"": 2}, ""src/testdir/test_vim9_builtin.vim"": {""insertions"": 1, ""deletions"": 1, ""lines"": 2}, ""src/version.c"": {""insertions"": 2, ""deletions"": 0, ""lines"": 2}}"
2021-03-27 17:59:25,32105ae88f3aa6a6af30336f0bc9f8eb81292cd7,Bram Moolenaar,58,29,87,7,"{""src/evalfunc.c"": {""insertions"": 9, ""deletions"": 2, ""lines"": 11}, ""src/filepath.c"": {""insertions"": 14, ""deletions"": 14, ""lines"": 28}, ""src/mbyte.c"": {""insertions"": 1, ""deletions"": 1, ""lines"": 2}, ""src/proto/typval.pro"": {""insertions"": 2, ""deletions"": 2, ""lines"": 4}, ""src/testdir/test_vim9_builtin.vim"": {""insertions"": 20, ""deletions"": 0, ""lines"": 20}, ""src/typval.c"": {""insertions"": 10, ""deletions"": 10, ""lines"": 20}, ""src/version.c"": {""insertions"": 2, ""deletions"": 0, ""lines"": 2}}"
2021-03-27 14:40:11,79efa2e3b3cdab8c21d95ba4ed9cb573566af531,Bram Moolenaar,11,4,15,2,"{""src/userfunc.c"": {""insertions"": 9, ""deletions"": 4, ""lines"": 13}, ""src/version.c"": {""insertions"": 2, ""deletions"": 0, ""lines"": 2}}"
2021-03-27 11:11:33,7007e31bde75b6360a1b54c7572e4f855458f37d,Bram Moolenaar,50,10,60,4,"{""src/main.c"": {""insertions"": 15, ""deletions"": 6, ""lines"": 21}, ""src/os_unix.c"": {""insertions"": 7, ""deletions"": 4, ""lines"": 11}, ""src/testdir/test_startup.vim"": {""insertions"": 26, ""deletions"": 0, ""lines"": 26}, ""src/version.c"": {""insertions"": 2, ""deletions"": 0, ""lines"": 2}}"
2021-03-26 21:15:26,bb5d87c8504588be9c9d2fecc5b6455a2b2f6201,Bram Moolenaar,5,1,6,2,"{""src/eval.c"": {""insertions"": 3, ""deletions"": 1, ""lines"": 4}, ""src/version.c"": {""insertions"": 2, ""deletions"": 0, ""lines"": 2}}"
2021-03-26 20:27:52,ccc25aa285498d572a735bba5afd22aec9f605f4,Bram Moolenaar,15,3,18,3,"{""src/evalvars.c"": {""insertions"": 5, ""deletions"": 2, ""lines"": 7}, ""src/testdir/test_vim9_assign.vim"": {""insertions"": 8, ""deletions"": 1, ""lines"": 9}, ""src/version.c"": {""insertions"": 2, ""deletions"": 0, ""lines"": 2}}"
2021-03-26 19:56:45,c61cb8bfe1ec2cc50e6edd195cae2a3cd93d6590,Bram Moolenaar,3,1,4,2,"{""src/testdir/test_eval_stuff.vim"": {""insertions"": 1, ""deletions"": 1, ""lines"": 2}, ""src/version.c"": {""insertions"": 2, ""deletions"": 0, ""lines"": 2}}"
2021-03-26 19:41:29,74e54fcb447e5db32f9c2df34c0554bbecdccca2,Bram Moolenaar,163,32,195,9,"{""runtime/doc/eval.txt"": {""insertions"": 11, ""deletions"": 3, ""lines"": 14}, ""src/errors.h"": {""insertions"": 2, ""deletions"": 0, ""lines"": 2}, ""src/eval.c"": {""insertions"": 34, ""deletions"": 4, ""lines"": 38}, ""src/testdir/test_vim9_disassemble.vim"": {""insertions"": 1, ""deletions"": 2, ""lines"": 3}, ""src/testdir/test_vim9_script.vim"": {""insertions"": 27, ""deletions"": 1, ""lines"": 28}, ""src/testdir/test_vimscript.vim"": {""insertions"": 20, ""deletions"": 0, ""lines"": 20}, ""src/version.c"": {""insertions"": 2, ""deletions"": 0, ""lines"": 2}, ""src/vim9compile.c"": {""insertions"": 7, ""deletions"": 3, ""lines"": 10}, ""src/vim9execute.c"": {""insertions"": 59, ""deletions"": 19, ""lines"": 78}}"
2021-03-26 17:49:22,522eefd9a247c574a51bfe9bf73467a8dc3bac42,Bram Moolenaar,40,7,47,3,"{""src/ex_eval.c"": {""insertions"": 31, ""deletions"": 7, ""lines"": 38}, ""src/testdir/test_vim9_script.vim"": {""insertions"": 7, ""deletions"": 0, ""lines"": 7}, ""src/version.c"": {""insertions"": 2, ""deletions"": 0, ""lines"": 2}}"
2021-03-26 16:24:34,a2b3e7dc9201fb3d8782c6b4ab53862160e254da,Bram Moolenaar,24,9,33,3,"{""src/testdir/test_regexp_latin.vim"": {""insertions"": 10, ""deletions"": 1, ""lines"": 11}, ""src/testdir/test_startup.vim"": {""insertions"": 12, ""deletions"": 8, ""lines"": 20}, ""src/version.c"": {""insertions"": 2, ""deletions"": 0, ""lines"": 2}}"
2021-03-26 13:14:18,0a1a6a1aa4004d0e4d64cc375540156b8bd92a87,Bram Moolenaar,14,2,16,3,"{""src/term.c"": {""insertions"": 3, ""deletions"": 2, ""lines"": 5}, ""src/testdir/test_startup.vim"": {""insertions"": 9, ""deletions"": 0, ""lines"": 9}, ""src/version.c"": {""insertions"": 2, ""deletions"": 0, ""lines"": 2}}"
2021-03-26 12:34:05,ff871400461183010d3ab98f3f326e4bb75e221b,Bram Moolenaar,21,3,24,2,"{""src/version.c"": {""insertions"": 2, ""deletions"": 0, ""lines"": 2}, ""src/vim9execute.c"": {""insertions"": 19, ""deletions"": 3, ""lines"": 22}}"
2021-03-25 21:22:30,3a0f092ac0dbdd4ce71f9c4abe020e89f13df36c,Bram Moolenaar,5,1,6,2,"{""src/errors.h"": {""insertions"": 3, ""deletions"": 1, ""lines"": 4}, ""src/version.c"": {""insertions"": 2, ""deletions"": 0, ""lines"": 2}}"
2021-03-25 21:15:28,fa984418e7becd8e7d6543cd3ea25f605e9ac97f,Bram Moolenaar,131,25,156,8,"{""src/ex_docmd.c"": {""insertions"": 27, ""deletions"": 0, ""lines"": 27}, ""src/ex_eval.c"": {""insertions"": 17, ""deletions"": 0, ""lines"": 17}, ""src/proto/ex_docmd.pro"": {""insertions"": 2, ""deletions"": 0, ""lines"": 2}, ""src/testdir/test_vim9_builtin.vim"": {""insertions"": 3, ""deletions"": 3, ""lines"": 6}, ""src/testdir/test_vim9_cmd.vim"": {""insertions"": 49, ""deletions"": 0, ""lines"": 49}, ""src/testdir/test_vim9_disassemble.vim"": {""insertions"": 6, ""deletions"": 6, ""lines"": 12}, ""src/version.c"": {""insertions"": 2, ""deletions"": 0, ""lines"": 2}, ""src/vim9compile.c"": {""insertions"": 25, ""deletions"": 16, ""lines"": 41}}"
2021-03-25 20:12:15,a91a71322dc2e6a1640e73b6da1f1a2f94f39a54,Bram Moolenaar,192,41,233,4,"{""src/testdir/test_vim9_disassemble.vim"": {""insertions"": 89, ""deletions"": 15, ""lines"": 104}, ""src/version.c"": {""insertions"": 2, ""deletions"": 0, ""lines"": 2}, ""src/vim9compile.c"": {""insertions"": 76, ""deletions"": 16, ""lines"": 92}, ""src/vim9execute.c"": {""insertions"": 25, ""deletions"": 10, ""lines"": 35}}"
2021-03-24 21:00:56,2fecb53115e25de6203363be8018ee676ad1422b,Bram Moolenaar,127,45,172,4,"{""src/testdir/test_vim9_func.vim"": {""insertions"": 23, ""deletions"": 0, ""lines"": 23}, ""src/version.c"": {""insertions"": 2, ""deletions"": 0, ""lines"": 2}, ""src/vim9.h"": {""insertions"": 4, ""deletions"": 2, ""lines"": 6}, ""src/vim9execute.c"": {""insertions"": 98, ""deletions"": 43, ""lines"": 141}}"
2021-03-24 19:08:12,1ff89deeaa07a161afbe91f57c340f3758d34f49,Bram Moolenaar,26,4,30,3,"{""src/testdir/test_vim9_cmd.vim"": {""insertions"": 21, ""deletions"": 0, ""lines"": 21}, ""src/version.c"": {""insertions"": 2, ""deletions"": 0, ""lines"": 2}, ""src/window.c"": {""insertions"": 3, ""deletions"": 4, ""lines"": 7}}"
2021-03-23 18:22:12,c54f347d63bcca97ead673d01ac6b59914bb04e5,Bram Moolenaar,10,0,10,2,"{""src/testdir/test_terminal2.vim"": {""insertions"": 8, ""deletions"": 0, ""lines"": 8}, ""src/version.c"": {""insertions"": 2, ""deletions"": 0, ""lines"": 2}}"
2021-03-23 15:25:09,f4a2ed071447ad4984fad55b9d1671b55140ae1c,Bram Moolenaar,4,0,4,2,"{""src/testdir/test_terminal.vim"": {""insertions"": 2, ""deletions"": 0, ""lines"": 2}, ""src/version.c"": {""insertions"": 2, ""deletions"": 0, ""lines"": 2}}"
2021-03-22 21:21:26,f28f2ac425600b88da0bdcc12a82cd620f575681,Bram Moolenaar,76,42,118,7,"{""src/errors.h"": {""insertions"": 4, ""deletions"": 0, ""lines"": 4}, ""src/filepath.c"": {""insertions"": 16, ""deletions"": 11, ""lines"": 27}, ""src/mbyte.c"": {""insertions"": 1, ""deletions"": 1, ""lines"": 2}, ""src/proto/typval.pro"": {""insertions"": 2, ""deletions"": 2, ""lines"": 4}, ""src/testdir/test_vim9_builtin.vim"": {""insertions"": 40, ""deletions"": 23, ""lines"": 63}, ""src/typval.c"": {""insertions"": 11, ""deletions"": 5, ""lines"": 16}, ""src/version.c"": {""insertions"": 2, ""deletions"": 0, ""lines"": 2}}"
2021-03-22 19:49:02,49f1e9ec3e7f4e1b3572367d02a83c2b6ebbed97,Bram Moolenaar,57,7,64,5,"{""src/errors.h"": {""insertions"": 2, ""deletions"": 0, ""lines"": 2}, ""src/testdir/test_vim9_expr.vim"": {""insertions"": 33, ""deletions"": 0, ""lines"": 33}, ""src/testdir/test_vim9_func.vim"": {""insertions"": 10, ""deletions"": 0, ""lines"": 10}, ""src/userfunc.c"": {""insertions"": 10, ""deletions"": 7, ""lines"": 17}, ""src/version.c"": {""insertions"": 2, ""deletions"": 0, ""lines"": 2}}"
2021-03-22 18:43:34,da1dbed0dfac00952b42982f8fffa42c4f5ed0c8,Bram Moolenaar,6,1,7,2,"{""src/textprop.c"": {""insertions"": 4, ""deletions"": 1, ""lines"": 5}, ""src/version.c"": {""insertions"": 2, ""deletions"": 0, ""lines"": 2}}"
2021-03-22 18:37:06,1f448d906b3c516e5864dc5bae3ddbf3664ee649,Bram Moolenaar,83,1,84,6,"{""src/testdir/test_edit.vim"": {""insertions"": 27, ""deletions"": 0, ""lines"": 27}, ""src/testdir/test_functions.vim"": {""insertions"": 1, ""deletions"": 1, ""lines"": 2}, ""src/testdir/test_mapping.vim"": {""insertions"": 10, ""deletions"": 0, ""lines"": 10}, ""src/testdir/test_termcodes.vim"": {""insertions"": 34, ""deletions"": 0, ""lines"": 34}, ""src/testdir/test_undo.vim"": {""insertions"": 9, ""deletions"": 0, ""lines"": 9}, ""src/version.c"": {""insertions"": 2, ""deletions"": 0, ""lines"": 2}}"
2021-03-22 17:22:30,e98f60a5912d30db289231aed7d3a1d74beaae20,Bram Moolenaar,13,1,14,3,"{""src/testdir/test_vim9_expr.vim"": {""insertions"": 5, ""deletions"": 0, ""lines"": 5}, ""src/userfunc.c"": {""insertions"": 6, ""deletions"": 1, ""lines"": 7}, ""src/version.c"": {""insertions"": 2, ""deletions"": 0, ""lines"": 2}}"
2021-03-22 16:30:47,2cec027af461095f96dec3bfd036c267f790b0f4,Bram Moolenaar,5,2,7,2,"{""src/testdir/test_display.vim"": {""insertions"": 3, ""deletions"": 2, ""lines"": 5}, ""src/version.c"": {""insertions"": 2, ""deletions"": 0, ""lines"": 2}}"
2021-03-22 16:11:15,f1387285e2ebe5cb3688d729fc6fd01a169a76c1,Bram Moolenaar,8,10,18,3,"{""src/evalfunc.c"": {""insertions"": 1, ""deletions"": 1, ""lines"": 2}, ""src/testdir/test_listchars.vim"": {""insertions"": 5, ""deletions"": 9, ""lines"": 14}, ""src/version.c"": {""insertions"": 2, ""deletions"": 0, ""lines"": 2}}"
2021-03-22 15:45:35,5ea79a2599d35f75e1ae8a75d2711c754c4cb7c4,Bram Moolenaar,5,1,6,2,"{""src/ui.c"": {""insertions"": 3, ""deletions"": 1, ""lines"": 4}, ""src/version.c"": {""insertions"": 2, ""deletions"": 0, ""lines"": 2}}"
2021-03-22 15:19:45,4c86830fc578bcb47a51cf0983da5388cdbfe6cc,Bram Moolenaar,54,32,86,9,"{""runtime/doc/eval.txt"": {""insertions"": 6, ""deletions"": 1, ""lines"": 7}, ""src/eval.c"": {""insertions"": 6, ""deletions"": 0, ""lines"": 6}, ""src/ex_cmdidxs.h"": {""insertions"": 23, ""deletions"": 23, ""lines"": 46}, ""src/ex_cmds.h"": {""insertions"": 3, ""deletions"": 0, ""lines"": 3}, ""src/proto/ui.pro"": {""insertions"": 2, ""deletions"": 2, ""lines"": 4}, ""src/term.c"": {""insertions"": 1, ""deletions"": 1, ""lines"": 2}, ""src/testdir/runtest.vim"": {""insertions"": 1, ""deletions"": 1, ""lines"": 2}, ""src/ui.c"": {""insertions"": 10, ""deletions"": 4, ""lines"": 14}, ""src/version.c"": {""insertions"": 2, ""deletions"": 0, ""lines"": 2}}"
2021-03-21 21:29:54,09f8b3a02200a1900a8bb41d7436f9d17ebd2d1b,Bram Moolenaar,4,1,5,2,"{""src/textprop.c"": {""insertions"": 2, ""deletions"": 1, ""lines"": 3}, ""src/version.c"": {""insertions"": 2, ""deletions"": 0, ""lines"": 2}}"
2021-03-21 21:12:34,67da21a14726b106b49744f9773eba132fedd5f2,Bram Moolenaar,26,9,35,6,"{""src/eval.c"": {""insertions"": 2, ""deletions"": 2, ""lines"": 4}, ""src/globals.h"": {""insertions"": 2, ""deletions"": 1, ""lines"": 3}, ""src/structs.h"": {""insertions"": 3, ""deletions"": 0, ""lines"": 3}, ""src/userfunc.c"": {""insertions"": 7, ""deletions"": 6, ""lines"": 13}, ""src/version.c"": {""insertions"": 2, ""deletions"": 0, ""lines"": 2}, ""src/vim9compile.c"": {""insertions"": 10, ""deletions"": 0, ""lines"": 10}}"
2021-03-21 19:53:29,7a6eaa06f98cef61d2131c25b4b47b8262cb8f59,Bram Moolenaar,660,449,1109,7,"{""src/errors.h"": {""insertions"": 4, ""deletions"": 0, ""lines"": 4}, ""src/misc2.c"": {""insertions"": 3, ""deletions"": 2, ""lines"": 5}, ""src/proto/vim9compile.pro"": {""insertions"": 1, ""deletions"": 0, ""lines"": 1}, ""src/testdir/test_vim9_expr.vim"": {""insertions"": 19, ""deletions"": 0, ""lines"": 19}, ""src/userfunc.c"": {""insertions"": 621, ""deletions"": 443, ""lines"": 1064}, ""src/version.c"": {""insertions"": 2, ""deletions"": 0, ""lines"": 2}, ""src/vim9compile.c"": {""insertions"": 10, ""deletions"": 4, ""lines"": 14}}"
2021-03-21 13:49:57,f90c855c71863296859780f7b4e0386e96f1c465,Bram Moolenaar,29,8,37,4,"{""runtime/doc/tagsrch.txt"": {""insertions"": 10, ""deletions"": 4, ""lines"": 14}, ""src/tag.c"": {""insertions"": 4, ""deletions"": 3, ""lines"": 7}, ""src/testdir/test_tagfunc.vim"": {""insertions"": 13, ""deletions"": 1, ""lines"": 14}, ""src/version.c"": {""insertions"": 2, ""deletions"": 0, ""lines"": 2}}"
2021-03-21 13:39:19,196a1f740981e878091fa124a400d1fc4bfa2bb0,Bram Moolenaar,14,1,15,3,"{""src/screen.c"": {""insertions"": 6, ""deletions"": 1, ""lines"": 7}, ""src/testdir/test_fold.vim"": {""insertions"": 6, ""deletions"": 0, ""lines"": 6}, ""src/version.c"": {""insertions"": 2, ""deletions"": 0, ""lines"": 2}}"
2021-03-20 21:16:56,c5cf369e9543ff065e2e1da91da3218c223840e2,Bram Moolenaar,25,0,25,3,"{""src/testdir/test_clientserver.vim"": {""insertions"": 8, ""deletions"": 0, ""lines"": 8}, ""src/testdir/test_startup.vim"": {""insertions"": 15, ""deletions"": 0, ""lines"": 15}, ""src/version.c"": {""insertions"": 2, ""deletions"": 0, ""lines"": 2}}"
2021-03-20 18:55:35,a0c8aea479ca055ce43ba2984a9933f6c48e6161,Bram Moolenaar,31,9,40,3,"{""src/evalwindow.c"": {""insertions"": 14, ""deletions"": 7, ""lines"": 21}, ""src/testdir/test_window_cmd.vim"": {""insertions"": 15, ""deletions"": 2, ""lines"": 17}, ""src/version.c"": {""insertions"": 2, ""deletions"": 0, ""lines"": 2}}"
2021-03-20 15:44:25,592f57f5fec1064cc276a0d7992cc543bed04fd5,Bram Moolenaar,3,1,4,2,"{""src/testdir/Makefile"": {""insertions"": 1, ""deletions"": 1, ""lines"": 2}, ""src/version.c"": {""insertions"": 2, ""deletions"": 0, ""lines"": 2}}"
2021-03-20 14:00:01,a0399efa72380115a3eb650544dd64e459476bd2,Bram Moolenaar,12,5,17,5,"{""src/errors.h"": {""insertions"": 1, ""deletions"": 1, ""lines"": 2}, ""src/ex_docmd.c"": {""insertions"": 2, ""deletions"": 1, ""lines"": 3}, ""src/testdir/test_vim9_expr.vim"": {""insertions"": 4, ""deletions"": 0, ""lines"": 4}, ""src/version.c"": {""insertions"": 2, ""deletions"": 0, ""lines"": 2}, ""src/vim9script.c"": {""insertions"": 3, ""deletions"": 3, ""lines"": 6}}"
2021-03-20 12:29:38,5c7a299c1652b28977c30e3e3a5ab93c65e7f7ed,Bram Moolenaar,15,7,22,4,"{""src/eval.c"": {""insertions"": 7, ""deletions"": 2, ""lines"": 9}, ""src/ex_docmd.c"": {""insertions"": 2, ""deletions"": 1, ""lines"": 3}, ""src/testdir/test_vim9_expr.vim"": {""insertions"": 4, ""deletions"": 4, ""lines"": 8}, ""src/version.c"": {""insertions"": 2, ""deletions"": 0, ""lines"": 2}}"
2021-03-20 11:49:15,4355894869355c185e7810e67d52802453576e81,Bram Moolenaar,2,12,14,4,"{""src/testdir/check.vim"": {""insertions"": 0, ""deletions"": 9, ""lines"": 9}, ""src/testdir/test_excmd.vim"": {""insertions"": 0, ""deletions"": 1, ""lines"": 1}, ""src/testdir/test_help.vim"": {""insertions"": 0, ""deletions"": 2, ""lines"": 2}, ""src/version.c"": {""insertions"": 2, ""deletions"": 0, ""lines"": 2}}"
2021-03-20 11:36:46,240014321b0aa5d6eb00a70865fa9935fd888d60,Bram Moolenaar,15,5,20,2,"{""src/gui_gtk_x11.c"": {""insertions"": 13, ""deletions"": 5, ""lines"": 18}, ""src/version.c"": {""insertions"": 2, ""deletions"": 0, ""lines"": 2}}"
2021-03-19 19:27:40,af125866db46405fdaf99ac4e43b630d196a4aa4,Bram Moolenaar,6,1,7,3,"{""runtime/filetype.vim"": {""insertions"": 3, ""deletions"": 0, ""lines"": 3}, ""src/testdir/test_filetype.vim"": {""insertions"": 1, ""deletions"": 1, ""lines"": 2}, ""src/version.c"": {""insertions"": 2, ""deletions"": 0, ""lines"": 2}}"
2021-03-19 19:19:12,74b99f6ab6e0265ebee4ed496845f28e0904318d,Bram Moolenaar,6,1,7,3,"{""runtime/filetype.vim"": {""insertions"": 3, ""deletions"": 0, ""lines"": 3}, ""src/testdir/test_filetype.vim"": {""insertions"": 1, ""deletions"": 1, ""lines"": 2}, ""src/version.c"": {""insertions"": 2, ""deletions"": 0, ""lines"": 2}}"
2021-03-19 13:38:12,17709e280ac5ba234b04641cde88d38e3522cedf,Bram Moolenaar,49,31,80,5,"{""src/testdir/test_edit.vim"": {""insertions"": 2, ""deletions"": 1, ""lines"": 3}, ""src/testdir/test_excmd.vim"": {""insertions"": 11, ""deletions"": 7, ""lines"": 18}, ""src/testdir/test_help.vim"": {""insertions"": 31, ""deletions"": 23, ""lines"": 54}, ""src/testdir/test_writefile.vim"": {""insertions"": 3, ""deletions"": 0, ""lines"": 3}, ""src/version.c"": {""insertions"": 2, ""deletions"": 0, ""lines"": 2}}"
2021-03-18 21:28:57,a555e6fcb6ec97b5ab30b20a340b228f4d820f14,Bram Moolenaar,85,62,147,5,"{""src/gui_beval.c"": {""insertions"": 1, ""deletions"": 1, ""lines"": 2}, ""src/gui_gtk_x11.c"": {""insertions"": 79, ""deletions"": 58, ""lines"": 137}, ""src/gui_xim.c"": {""insertions"": 1, ""deletions"": 1, ""lines"": 2}, ""src/proto/gui_gtk_x11.pro"": {""insertions"": 2, ""deletions"": 2, ""lines"": 4}, ""src/version.c"": {""insertions"": 2, ""deletions"": 0, ""lines"": 2}}"
2021-03-18 21:15:04,108cf0153c5770e343aec9e2390acdaa4a0b149a,Bram Moolenaar,33,16,49,6,"{""src/list.c"": {""insertions"": 2, ""deletions"": 2, ""lines"": 4}, ""src/proto/vim9type.pro"": {""insertions"": 1, ""deletions"": 1, ""lines"": 2}, ""src/testdir/test_vimscript.vim"": {""insertions"": 7, ""deletions"": 0, ""lines"": 7}, ""src/version.c"": {""insertions"": 2, ""deletions"": 0, ""lines"": 2}, ""src/vim9script.c"": {""insertions"": 1, ""deletions"": 1, ""lines"": 2}, ""src/vim9type.c"": {""insertions"": 20, ""deletions"": 12, ""lines"": 32}}"
2021-03-18 20:37:55,4b3e1964d85a25ac7b2202094d1abf27ab93cc23,Bram Moolenaar,43,10,53,7,"{""src/errors.h"": {""insertions"": 2, ""deletions"": 0, ""lines"": 2}, ""src/proto/vim9script.pro"": {""insertions"": 1, ""deletions"": 0, ""lines"": 1}, ""src/testdir/test_vim9_expr.vim"": {""insertions"": 4, ""deletions"": 2, ""lines"": 6}, ""src/testdir/test_vim9_script.vim"": {""insertions"": 1, ""deletions"": 1, ""lines"": 2}, ""src/version.c"": {""insertions"": 2, ""deletions"": 0, ""lines"": 2}, ""src/vim9compile.c"": {""insertions"": 14, ""deletions"": 5, ""lines"": 19}, ""src/vim9script.c"": {""insertions"": 19, ""deletions"": 2, ""lines"": 21}}"
2021-03-17 20:29:29,5f91e74bf968c9033474086b2d9cb457281c8aa6,Bram Moolenaar,17,0,17,2,"{""src/testdir/test_vim9_func.vim"": {""insertions"": 15, ""deletions"": 0, ""lines"": 15}, ""src/version.c"": {""insertions"": 2, ""deletions"": 0, ""lines"": 2}}"
2021-03-17 19:56:38,3f32788000258aabe078b426e3d71962bee9d2d1,Bram Moolenaar,14,2,16,3,"{""src/testdir/test_vim9_assign.vim"": {""insertions"": 7, ""deletions"": 0, ""lines"": 7}, ""src/version.c"": {""insertions"": 2, ""deletions"": 0, ""lines"": 2}, ""src/vim9compile.c"": {""insertions"": 5, ""deletions"": 2, ""lines"": 7}}"
2021-03-17 17:42:08,8863bda25df821fc79bebf9dc73c79776ae5f675,Bram Moolenaar,38,16,54,4,"{""src/testdir/test_vim9_disassemble.vim"": {""insertions"": 2, ""deletions"": 2, ""lines"": 4}, ""src/testdir/test_vim9_func.vim"": {""insertions"": 19, ""deletions"": 1, ""lines"": 20}, ""src/version.c"": {""insertions"": 2, ""deletions"": 0, ""lines"": 2}, ""src/vim9compile.c"": {""insertions"": 15, ""deletions"": 13, ""lines"": 28}}"
2021-03-17 16:46:00,3e1916947d5b29f67af554ce3b874b03a84c9093,Bram Moolenaar,41,4,45,4,"{""runtime/doc/vim9.txt"": {""insertions"": 3, ""deletions"": 1, ""lines"": 4}, ""src/scriptfile.c"": {""insertions"": 27, ""deletions"": 0, ""lines"": 27}, ""src/testdir/test_vim9_script.vim"": {""insertions"": 9, ""deletions"": 3, ""lines"": 12}, ""src/version.c"": {""insertions"": 2, ""deletions"": 0, ""lines"": 2}}"
2021-03-17 14:23:16,a4c81bea38d1f3e372a4191ab0bd7d664cba1428,Bram Moolenaar,3,1,4,2,"{""src/testdir/test_vim9_script.vim"": {""insertions"": 1, ""deletions"": 1, ""lines"": 2}, ""src/version.c"": {""insertions"": 2, ""deletions"": 0, ""lines"": 2}}"
2021-03-17 14:03:04,c970e4225b68ff8650ff23df09e04246c147fca3,Bram Moolenaar,65,9,74,4,"{""src/testdir/test_vim9_script.vim"": {""insertions"": 29, ""deletions"": 0, ""lines"": 29}, ""src/userfunc.c"": {""insertions"": 22, ""deletions"": 8, ""lines"": 30}, ""src/version.c"": {""insertions"": 2, ""deletions"": 0, ""lines"": 2}, ""src/vim9execute.c"": {""insertions"": 12, ""deletions"": 1, ""lines"": 13}}"
2021-03-17 12:39:33,6ccfd99b923cc3452a6e6450dfdd7e31ea602dfd,Bram Moolenaar,3,1,4,2,"{""src/testdir/test_mapping.vim"": {""insertions"": 1, ""deletions"": 1, ""lines"": 2}, ""src/version.c"": {""insertions"": 2, ""deletions"": 0, ""lines"": 2}}"
2021-03-17 12:28:05,18b7d86d7fa997bbb02a069dafacb32a0f73ca1e,Bram Moolenaar,40,0,40,3,"{""runtime/doc/map.txt"": {""insertions"": 14, ""deletions"": 0, ""lines"": 14}, ""src/testdir/test_mapping.vim"": {""insertions"": 24, ""deletions"": 0, ""lines"": 24}, ""src/version.c"": {""insertions"": 2, ""deletions"": 0, ""lines"": 2}}"
2021-03-17 11:27:23,f8c52e8d08de3fdf48db877d7d53d2d68c6ceb7b,Bram Moolenaar,36,7,43,4,"{""src/main.c"": {""insertions"": 3, ""deletions"": 0, ""lines"": 3}, ""src/testdir/check.vim"": {""insertions"": 25, ""deletions"": 0, ""lines"": 25}, ""src/testdir/test_startup.vim"": {""insertions"": 6, ""deletions"": 7, ""lines"": 13}, ""src/version.c"": {""insertions"": 2, ""deletions"": 0, ""lines"": 2}}"
2021-03-16 20:17:16,1e448465e1281eeb379f75fe848cbb47fe1be1d9,Bram Moolenaar,6,1,7,2,"{""src/testdir/test_selectmode.vim"": {""insertions"": 4, ""deletions"": 1, ""lines"": 5}, ""src/version.c"": {""insertions"": 2, ""deletions"": 0, ""lines"": 2}}"
2021-03-16 12:23:30,321481299757cdd43baeed33f4c5ba543fdfc7f7,Bram Moolenaar,5,1,6,2,"{""src/testdir/test_startup.vim"": {""insertions"": 3, ""deletions"": 1, ""lines"": 4}, ""src/version.c"": {""insertions"": 2, ""deletions"": 0, ""lines"": 2}}"
2021-03-15 17:36:20,f4fcedc59d4cc5ae6b5270a933e8377030283c1c,Bram Moolenaar,59,0,59,6,"{""src/testdir/test_functions.vim"": {""insertions"": 8, ""deletions"": 0, ""lines"": 8}, ""src/testdir/test_messages.vim"": {""insertions"": 11, ""deletions"": 0, ""lines"": 11}, ""src/testdir/test_paste.vim"": {""insertions"": 14, ""deletions"": 0, ""lines"": 14}, ""src/testdir/test_registers.vim"": {""insertions"": 10, ""deletions"": 0, ""lines"": 10}, ""src/testdir/test_undo.vim"": {""insertions"": 14, ""deletions"": 0, ""lines"": 14}, ""src/version.c"": {""insertions"": 2, ""deletions"": 0, ""lines"": 2}}"
2021-03-14 18:46:45,02b4d9b18a03549b68e364e428392b7a62766c74,Bram Moolenaar,49,13,62,4,"{""runtime/doc/eval.txt"": {""insertions"": 16, ""deletions"": 10, ""lines"": 26}, ""src/evalfunc.c"": {""insertions"": 23, ""deletions"": 3, ""lines"": 26}, ""src/testdir/test_expr_utf8.vim"": {""insertions"": 8, ""deletions"": 0, ""lines"": 8}, ""src/version.c"": {""insertions"": 2, ""deletions"": 0, ""lines"": 2}}"
2021-03-14 18:02:09,70ce8a1561c5396e4c4381f76a005cbb97646f80,Bram Moolenaar,59,15,74,5,"{""runtime/doc/eval.txt"": {""insertions"": 18, ""deletions"": 1, ""lines"": 19}, ""runtime/doc/usr_41.txt"": {""insertions"": 2, ""deletions"": 1, ""lines"": 3}, ""src/evalfunc.c"": {""insertions"": 29, ""deletions"": 12, ""lines"": 41}, ""src/testdir/test_utf8.vim"": {""insertions"": 8, ""deletions"": 1, ""lines"": 9}, ""src/version.c"": {""insertions"": 2, ""deletions"": 0, ""lines"": 2}}"
2021-03-14 17:40:19,0289a093a4d65c6280a3be118d1d3696d1aa74da,Bram Moolenaar,54,16,70,4,"{""runtime/doc/vim9.txt"": {""insertions"": 9, ""deletions"": 5, ""lines"": 14}, ""src/testdir/test_vim9_expr.vim"": {""insertions"": 29, ""deletions"": 0, ""lines"": 29}, ""src/version.c"": {""insertions"": 2, ""deletions"": 0, ""lines"": 2}, ""src/vim9execute.c"": {""insertions"": 14, ""deletions"": 11, ""lines"": 25}}"
2021-03-14 15:20:37,240309c9bfa8a0d2f154712f8e0dd33589f181d3,Bram Moolenaar,146,14,160,2,"{""src/testdir/test_startup.vim"": {""insertions"": 144, ""deletions"": 14, ""lines"": 158}, ""src/version.c"": {""insertions"": 2, ""deletions"": 0, ""lines"": 2}}"
2021-03-14 12:21:35,77b10ffad4ebad15022614be4db2745f6a90f405,Bram Moolenaar,76,29,105,7,"{""src/evalvars.c"": {""insertions"": 20, ""deletions"": 10, ""lines"": 30}, ""src/ex_docmd.c"": {""insertions"": 3, ""deletions"": 3, ""lines"": 6}, ""src/proto/evalvars.pro"": {""insertions"": 1, ""deletions"": 1, ""lines"": 2}, ""src/proto/ex_docmd.pro"": {""insertions"": 1, ""deletions"": 1, ""lines"": 2}, ""src/testdir/test_vim9_cmd.vim"": {""insertions"": 30, ""deletions"": 5, ""lines"": 35}, ""src/version.c"": {""insertions"": 2, ""deletions"": 0, ""lines"": 2}, ""src/vim9compile.c"": {""insertions"": 19, ""deletions"": 9, ""lines"": 28}}"
2021-03-14 11:13:33,2e34c34be1393027a761ecbccd8f267d52ca7bc1,Bram Moolenaar,32,3,35,3,"{""src/testdir/test_vim9_script.vim"": {""insertions"": 25, ""deletions"": 0, ""lines"": 25}, ""src/version.c"": {""insertions"": 2, ""deletions"": 0, ""lines"": 2}, ""src/vim9execute.c"": {""insertions"": 5, ""deletions"": 3, ""lines"": 8}}"
2021-03-13 21:11:51,6bce5856b5fc4d4eb8f75298382251ecda659ac3,Bram Moolenaar,4,2,6,2,"{""src/testdir/test_memory_usage.vim"": {""insertions"": 2, ""deletions"": 2, ""lines"": 4}, ""src/version.c"": {""insertions"": 2, ""deletions"": 0, ""lines"": 2}}"
2021-03-13 20:24:56,93e1cae739c32baf28954b64718bab009c6ee2ac,Bram Moolenaar,26,2,28,3,"{""src/testdir/test_vim9_builtin.vim"": {""insertions"": 20, ""deletions"": 0, ""lines"": 20}, ""src/version.c"": {""insertions"": 2, ""deletions"": 0, ""lines"": 2}, ""src/vim9type.c"": {""insertions"": 4, ""deletions"": 2, ""lines"": 6}}"
2021-03-13 20:14:18,edba70703b6eaee3365ddfd82e4ba56ee08486f8,Bram Moolenaar,4,1,5,2,"{""src/version.c"": {""insertions"": 2, ""deletions"": 0, ""lines"": 2}, ""src/vim9compile.c"": {""insertions"": 2, ""deletions"": 1, ""lines"": 3}}"
2021-03-13 20:07:21,6508880d6ca98486efb9ab947c651a2b73a6e795,Bram Moolenaar,9,0,9,4,"{""src/ex_docmd.c"": {""insertions"": 4, ""deletions"": 0, ""lines"": 4}, ""src/testdir/test_vim9_script.vim"": {""insertions"": 2, ""deletions"": 0, ""lines"": 2}, ""src/version.c"": {""insertions"": 2, ""deletions"": 0, ""lines"": 2}, ""src/vim9script.c"": {""insertions"": 1, ""deletions"": 0, ""lines"": 1}}"
2021-03-13 19:57:19,cb4e80fab9b1ee67249bde4f784526f900cda70c,Bram Moolenaar,129,23,152,10,"{""src/errors.h"": {""insertions"": 2, ""deletions"": 0, ""lines"": 2}, ""src/eval.c"": {""insertions"": 60, ""deletions"": 2, ""lines"": 62}, ""src/evalvars.c"": {""insertions"": 28, ""deletions"": 12, ""lines"": 40}, ""src/proto/evalvars.pro"": {""insertions"": 1, ""deletions"": 1, ""lines"": 2}, ""src/proto/vim9script.pro"": {""insertions"": 1, ""deletions"": 1, ""lines"": 2}, ""src/testdir/test_vim9_script.vim"": {""insertions"": 22, ""deletions"": 2, ""lines"": 24}, ""src/version.c"": {""insertions"": 2, ""deletions"": 0, ""lines"": 2}, ""src/vim.h"": {""insertions"": 5, ""deletions"": 0, ""lines"": 5}, ""src/vim9execute.c"": {""insertions"": 1, ""deletions"": 1, ""lines"": 2}, ""src/vim9script.c"": {""insertions"": 7, ""deletions"": 4, ""lines"": 11}}"
2021-03-13 14:47:56,41cd80335cf318c15c8b0139f53ab5e8a02561ef,Bram Moolenaar,27,5,32,3,"{""src/autocmd.c"": {""insertions"": 16, ""deletions"": 4, ""lines"": 20}, ""src/testdir/test_autocmd.vim"": {""insertions"": 9, ""deletions"": 1, ""lines"": 10}, ""src/version.c"": {""insertions"": 2, ""deletions"": 0, ""lines"": 2}}"
2021-03-13 13:29:05,9e813b3dea94a8952b732a224fa31beba6e85973,Bram Moolenaar,25,2,27,3,"{""src/testdir/test_options.vim"": {""insertions"": 21, ""deletions"": 0, ""lines"": 21}, ""src/version.c"": {""insertions"": 2, ""deletions"": 0, ""lines"": 2}, ""src/window.c"": {""insertions"": 2, ""deletions"": 2, ""lines"": 4}}"
2021-03-13 12:52:33,0756f757edba755b75e0c9c612ab2f7e673def84,Bram Moolenaar,18,1,19,3,"{""src/session.c"": {""insertions"": 2, ""deletions"": 1, ""lines"": 3}, ""src/testdir/test_mksession.vim"": {""insertions"": 14, ""deletions"": 0, ""lines"": 14}, ""src/version.c"": {""insertions"": 2, ""deletions"": 0, ""lines"": 2}}"
2021-03-13 12:30:03,0de8e2d6a3fae61c4d9dfdd6f16fc5040d994f6c,Bram Moolenaar,4,1,5,2,"{""Filelist"": {""insertions"": 2, ""deletions"": 1, ""lines"": 3}, ""src/version.c"": {""insertions"": 2, ""deletions"": 0, ""lines"": 2}}"
2021-03-13 12:28:13,c8cdf0f80b3cfd88a4490d80572062c1fd1a96ca,Bram Moolenaar,327,92,419,16,"{""runtime/doc/change.txt"": {""insertions"": 13, ""deletions"": 5, ""lines"": 18}, ""runtime/doc/eval.txt"": {""insertions"": 15, ""deletions"": 9, ""lines"": 24}, ""runtime/doc/filetype.txt"": {""insertions"": 8, ""deletions"": 1, ""lines"": 9}, ""runtime/doc/repeat.txt"": {""insertions"": 3, ""deletions"": 3, ""lines"": 6}, ""runtime/doc/sign.txt"": {""insertions"": 18, ""deletions"": 2, ""lines"": 20}, ""runtime/doc/syntax.txt"": {""insertions"": 4, ""deletions"": 4, ""lines"": 8}, ""runtime/doc/tags"": {""insertions"": 2, ""deletions"": 0, ""lines"": 2}, ""runtime/doc/testing.txt"": {""insertions"": 2, ""deletions"": 1, ""lines"": 3}, ""runtime/doc/todo.txt"": {""insertions"": 40, ""deletions"": 15, ""lines"": 55}, ""runtime/doc/various.txt"": {""insertions"": 2, ""deletions"": 2, ""lines"": 4}, ""runtime/doc/vim9.txt"": {""insertions"": 4, ""deletions"": 2, ""lines"": 6}, ""runtime/filetype.vim"": {""insertions"": 1, ""deletions"": 1, ""lines"": 2}, ""runtime/ftplugin/poke.vim"": {""insertions"": 32, ""deletions"": 0, ""lines"": 32}, ""runtime/syntax/html.vim"": {""insertions"": 25, ""deletions"": 44, ""lines"": 69}, ""runtime/syntax/poke.vim"": {""insertions"": 151, ""deletions"": 0, ""lines"": 151}, ""src/INSTALL"": {""insertions"": 7, ""deletions"": 3, ""lines"": 10}}"
2021-03-13 12:14:04,6fd367a97c8653a2d734a38252c7d68d4b2ebaa7,Bram Moolenaar,38,0,38,6,"{""src/testdir/test_fileformat.vim"": {""insertions"": 9, ""deletions"": 0, ""lines"": 9}, ""src/testdir/test_normal.vim"": {""insertions"": 7, ""deletions"": 0, ""lines"": 7}, ""src/testdir/test_sleep.vim"": {""insertions"": 1, ""deletions"": 0, ""lines"": 1}, ""src/testdir/test_textformat.vim"": {""insertions"": 15, ""deletions"": 0, ""lines"": 15}, ""src/testdir/test_viminfo.vim"": {""insertions"": 4, ""deletions"": 0, ""lines"": 4}, ""src/version.c"": {""insertions"": 2, ""deletions"": 0, ""lines"": 2}}"
2021-03-12 21:16:41,c80f647512b001fb6952ed10d076d56c3d4b84e0,Bram Moolenaar,6,0,6,3,"{""runtime/filetype.vim"": {""insertions"": 3, ""deletions"": 0, ""lines"": 3}, ""src/testdir/test_filetype.vim"": {""insertions"": 1, ""deletions"": 0, ""lines"": 1}, ""src/version.c"": {""insertions"": 2, ""deletions"": 0, ""lines"": 2}}"
2021-03-11 19:04:04,12bce95887f7c5f07a7bdb7b4485b53d074ccc0a,Bram Moolenaar,20,1,21,3,"{""src/testdir/test_vim9_func.vim"": {""insertions"": 8, ""deletions"": 0, ""lines"": 8}, ""src/version.c"": {""insertions"": 2, ""deletions"": 0, ""lines"": 2}, ""src/vim9compile.c"": {""insertions"": 10, ""deletions"": 1, ""lines"": 11}}"
2021-03-10 21:27:48,776b954622b45125dfdcb4a61243ca90956b0825,Bram Moolenaar,15,2,17,3,"{""src/testdir/runtest.vim"": {""insertions"": 5, ""deletions"": 0, ""lines"": 5}, ""src/testdir/test_recover.vim"": {""insertions"": 8, ""deletions"": 2, ""lines"": 10}, ""src/version.c"": {""insertions"": 2, ""deletions"": 0, ""lines"": 2}}"
2021-03-10 20:55:46,23b32a8d6bd9ec83c0c6632b7a8bfa544ac0a2f1,Bram Moolenaar,8,3,11,4,"{""src/memline.c"": {""insertions"": 5, ""deletions"": 2, ""lines"": 7}, ""src/testdir/Make_all.mak"": {""insertions"": 1, ""deletions"": 0, ""lines"": 1}, ""src/testdir/test_alot.vim"": {""insertions"": 0, ""deletions"": 1, ""lines"": 1}, ""src/version.c"": {""insertions"": 2, ""deletions"": 0, ""lines"": 2}}"
2021-03-10 20:46:39,6635ae1437e6e343c0514524a8dfb19d9525b908,Bram Moolenaar,14,3,17,3,"{""src/testdir/check.vim"": {""insertions"": 9, ""deletions"": 1, ""lines"": 10}, ""src/testdir/test_recover.vim"": {""insertions"": 3, ""deletions"": 2, ""lines"": 5}, ""src/version.c"": {""insertions"": 2, ""deletions"": 0, ""lines"": 2}}"
2021-03-10 20:26:37,f52f0606ed9ea19bcfc3a8343af9958f2d99eaf7,Bram Moolenaar,147,16,163,8,"{""src/auto/configure"": {""insertions"": 29, ""deletions"": 0, ""lines"": 29}, ""src/config.h.in"": {""insertions"": 1, ""deletions"": 0, ""lines"": 1}, ""src/configure.ac"": {""insertions"": 14, ""deletions"": 0, ""lines"": 14}, ""src/globals.h"": {""insertions"": 1, ""deletions"": 0, ""lines"": 1}, ""src/memline.c"": {""insertions"": 29, ""deletions"": 7, ""lines"": 36}, ""src/testdir/test_recover.vim"": {""insertions"": 68, ""deletions"": 9, ""lines"": 77}, ""src/testing.c"": {""insertions"": 3, ""deletions"": 0, ""lines"": 3}, ""src/version.c"": {""insertions"": 2, ""deletions"": 0, ""lines"": 2}}"
2021-03-10 18:04:07,c23555de346c53f8f6c478635c2d9e5f2992dd7f,Bram Moolenaar,3,1,4,2,"{""src/version.c"": {""insertions"": 2, ""deletions"": 0, ""lines"": 2}, ""src/vim9compile.c"": {""insertions"": 1, ""deletions"": 1, ""lines"": 2}}"
2021-03-10 17:43:09,d345fb921678613ffc66a8afc82bc0e815c72312,Bram Moolenaar,7,1,8,3,"{""src/testdir/test_vim9_expr.vim"": {""insertions"": 3, ""deletions"": 0, ""lines"": 3}, ""src/version.c"": {""insertions"": 2, ""deletions"": 0, ""lines"": 2}, ""src/vim9compile.c"": {""insertions"": 2, ""deletions"": 1, ""lines"": 3}}"
2021-03-10 15:08:26,7ad67d1150a1e48371d64e2919591c38b80e7cfc,Bram Moolenaar,16,1,17,3,"{""src/evalfunc.c"": {""insertions"": 1, ""deletions"": 1, ""lines"": 2}, ""src/testdir/test_vim9_builtin.vim"": {""insertions"": 13, ""deletions"": 0, ""lines"": 13}, ""src/version.c"": {""insertions"": 2, ""deletions"": 0, ""lines"": 2}}"
2021-03-10 13:00:18,ffb7dcdb773c250a6acf45d5670a508be9248cb6,Bram Moolenaar,19,15,34,2,"{""src/testdir/test_vim9_script.vim"": {""insertions"": 17, ""deletions"": 15, ""lines"": 32}, ""src/version.c"": {""insertions"": 2, ""deletions"": 0, ""lines"": 2}}"
2021-03-10 12:40:08,37294bd6a2afbf0fc8a1c34cbe102336b0bd0a82,Bram Moolenaar,55,9,64,8,"{""src/option.c"": {""insertions"": 7, ""deletions"": 4, ""lines"": 11}, ""src/optionstr.c"": {""insertions"": 6, ""deletions"": 3, ""lines"": 9}, ""src/scriptfile.c"": {""insertions"": 1, ""deletions"": 1, ""lines"": 2}, ""src/testdir/dumps/Test_vim9_no_redraw.dump"": {""insertions"": 6, ""deletions"": 0, ""lines"": 6}, ""src/testdir/test_vim9_script.vim"": {""insertions"": 31, ""deletions"": 0, ""lines"": 31}, ""src/version.c"": {""insertions"": 2, ""deletions"": 0, ""lines"": 2}, ""src/vim.h"": {""insertions"": 1, ""deletions"": 0, ""lines"": 1}, ""src/vim9script.c"": {""insertions"": 1, ""deletions"": 1, ""lines"": 2}}"
2021-03-08 20:47:13,e3ffcd9902efc756178900d9bd972c74a09c3fcd,Bram Moolenaar,13,2,15,3,"{""src/testdir/test_vim9_script.vim"": {""insertions"": 6, ""deletions"": 0, ""lines"": 6}, ""src/version.c"": {""insertions"": 2, ""deletions"": 0, ""lines"": 2}, ""src/vim9execute.c"": {""insertions"": 5, ""deletions"": 2, ""lines"": 7}}"
2021-03-08 19:47:14,d00a7fb81aff367c5dd5d86fb3883f1e7a58fed5,Bram Moolenaar,4,1,5,2,"{""src/evalvars.c"": {""insertions"": 2, ""deletions"": 1, ""lines"": 3}, ""src/version.c"": {""insertions"": 2, ""deletions"": 0, ""lines"": 2}}"
2021-03-08 18:50:24,86c3a2162c2e78b4f0b87b47779cc1452990ee1b,Bram Moolenaar,16,0,16,3,"{""src/if_lua.c"": {""insertions"": 5, ""deletions"": 0, ""lines"": 5}, ""src/testdir/test_lua.vim"": {""insertions"": 9, ""deletions"": 0, ""lines"": 9}, ""src/version.c"": {""insertions"": 2, ""deletions"": 0, ""lines"": 2}}"
2021-03-08 18:04:05,9355ae41497cbcce58ddd79f9125eb3e9dfe0a43,Bram Moolenaar,3,1,4,2,"{""src/drawline.c"": {""insertions"": 1, ""deletions"": 1, ""lines"": 2}, ""src/version.c"": {""insertions"": 2, ""deletions"": 0, ""lines"": 2}}"
2021-03-06 21:33:12,608d78fb45077fbaf6dc880b754a1d8a54ac9999,Bram Moolenaar,21,1,22,3,"{""src/testdir/test_vim9_func.vim"": {""insertions"": 17, ""deletions"": 0, ""lines"": 17}, ""src/userfunc.c"": {""insertions"": 2, ""deletions"": 1, ""lines"": 3}, ""src/version.c"": {""insertions"": 2, ""deletions"": 0, ""lines"": 2}}"
2021-03-06 20:01:09,6914e87d3c0387fdcbb117a39e1f6d1fac0ee2e3,Bram Moolenaar,43,3,46,3,"{""src/testdir/test_vim9_cmd.vim"": {""insertions"": 19, ""deletions"": 0, ""lines"": 19}, ""src/version.c"": {""insertions"": 2, ""deletions"": 0, ""lines"": 2}, ""src/vim9compile.c"": {""insertions"": 22, ""deletions"": 3, ""lines"": 25}}"
2021-03-06 18:26:46,04947cc6ed313b6b99889c27d008c68a373df634,Bram Moolenaar,46,0,46,3,"{""src/testdir/test_vim9_func.vim"": {""insertions"": 24, ""deletions"": 0, ""lines"": 24}, ""src/version.c"": {""insertions"": 2, ""deletions"": 0, ""lines"": 2}, ""src/vim9execute.c"": {""insertions"": 20, ""deletions"": 0, ""lines"": 20}}"
2021-03-06 17:18:19,a974953443775dd938cf9a8c195e3de9e4514f4f,Bram Moolenaar,14,1,15,3,"{""src/eval.c"": {""insertions"": 1, ""deletions"": 1, ""lines"": 2}, ""src/testdir/test_vim9_expr.vim"": {""insertions"": 11, ""deletions"": 0, ""lines"": 11}, ""src/version.c"": {""insertions"": 2, ""deletions"": 0, ""lines"": 2}}"
2021-03-05 20:35:47,18062fcad648540369db5989aac297431119e037,Bram Moolenaar,18,1,19,3,"{""src/testdir/test_vim9_func.vim"": {""insertions"": 13, ""deletions"": 0, ""lines"": 13}, ""src/version.c"": {""insertions"": 2, ""deletions"": 0, ""lines"": 2}, ""src/vim9compile.c"": {""insertions"": 3, ""deletions"": 1, ""lines"": 4}}"
2021-03-05 19:58:22,8c801b374b7d32419cd877353495b801c5e1382a,Bram Moolenaar,13,1,14,3,"{""src/testdir/test_profile.vim"": {""insertions"": 1, ""deletions"": 1, ""lines"": 2}, ""src/testdir/test_quickfix.vim"": {""insertions"": 10, ""deletions"": 0, ""lines"": 10}, ""src/version.c"": {""insertions"": 2, ""deletions"": 0, ""lines"": 2}}"
2021-03-05 19:47:44,f9a65505d1d93f3e67e5b8646bde3bbc44c70f7d,Bram Moolenaar,6,0,6,5,"{""src/testdir/test_edit.vim"": {""insertions"": 1, ""deletions"": 0, ""lines"": 1}, ""src/testdir/test_excmd.vim"": {""insertions"": 1, ""deletions"": 0, ""lines"": 1}, ""src/testdir/test_help.vim"": {""insertions"": 1, ""deletions"": 0, ""lines"": 1}, ""src/testdir/test_writefile.vim"": {""insertions"": 1, ""deletions"": 0, ""lines"": 1}, ""src/version.c"": {""insertions"": 2, ""deletions"": 0, ""lines"": 2}}"
2021-03-04 20:55:58,008bff967f7fcaa6af066f71d65bfbba5ef5c7d3,Bram Moolenaar,101,24,125,7,"{""runtime/doc/options.txt"": {""insertions"": 2, ""deletions"": 1, ""lines"": 3}, ""src/buffer.c"": {""insertions"": 20, ""deletions"": 21, ""lines"": 41}, ""src/macros.h"": {""insertions"": 1, ""deletions"": 0, ""lines"": 1}, ""src/screen.c"": {""insertions"": 1, ""deletions"": 1, ""lines"": 2}, ""src/testdir/test_fold.vim"": {""insertions"": 60, ""deletions"": 1, ""lines"": 61}, ""src/testdir/test_statusline.vim"": {""insertions"": 15, ""deletions"": 0, ""lines"": 15}, ""src/version.c"": {""insertions"": 2, ""deletions"": 0, ""lines"": 2}}"
2021-03-04 20:35:07,6057748a1af2260b4ab9630f21fe71f42f91250d,Bram Moolenaar,36,26,62,7,"{""src/tag.c"": {""insertions"": 5, ""deletions"": 0, ""lines"": 5}, ""src/testdir/dumps/Test_popupwin_previewpopup_2.dump"": {""insertions"": 6, ""deletions"": 6, ""lines"": 12}, ""src/testdir/dumps/Test_popupwin_previewpopup_3.dump"": {""insertions"": 6, ""deletions"": 6, ""lines"": 12}, ""src/testdir/dumps/Test_popupwin_previewpopup_4.dump"": {""insertions"": 7, ""deletions"": 7, ""lines"": 14}, ""src/testdir/dumps/Test_popupwin_previewpopup_5.dump"": {""insertions"": 7, ""deletions"": 7, ""lines"": 14}, ""src/testdir/test_popupwin.vim"": {""insertions"": 3, ""deletions"": 0, ""lines"": 3}, ""src/version.c"": {""insertions"": 2, ""deletions"": 0, ""lines"": 2}}"
2021-03-04 11:38:21,6c3843ca8ab105bfb85f6ea8bcec2cbc03f46e7f,Bram Moolenaar,23,1,24,3,"{""src/evalvars.c"": {""insertions"": 10, ""deletions"": 1, ""lines"": 11}, ""src/testdir/test_vim9_script.vim"": {""insertions"": 11, ""deletions"": 0, ""lines"": 11}, ""src/version.c"": {""insertions"": 2, ""deletions"": 0, ""lines"": 2}}"
2021-03-03 20:22:41,2e2d758902dc08a0e383fe6b198e11dd14f1bdf8,Bram Moolenaar,43,6,49,6,"{""src/evalvars.c"": {""insertions"": 20, ""deletions"": 3, ""lines"": 23}, ""src/ex_docmd.c"": {""insertions"": 1, ""deletions"": 1, ""lines"": 2}, ""src/proto/evalvars.pro"": {""insertions"": 1, ""deletions"": 1, ""lines"": 2}, ""src/testdir/test_vim9_cmd.vim"": {""insertions"": 18, ""deletions"": 0, ""lines"": 18}, ""src/version.c"": {""insertions"": 2, ""deletions"": 0, ""lines"": 2}, ""src/vim9script.c"": {""insertions"": 1, ""deletions"": 1, ""lines"": 2}}"
2021-03-03 16:58:16,f76ec1eeb5bba9457bf2b5564364ee90662a0156,Bram Moolenaar,45,3,48,3,"{""src/eval.c"": {""insertions"": 5, ""deletions"": 3, ""lines"": 8}, ""src/testdir/test_vim9_assign.vim"": {""insertions"": 38, ""deletions"": 0, ""lines"": 38}, ""src/version.c"": {""insertions"": 2, ""deletions"": 0, ""lines"": 2}}"
2021-03-03 14:24:28,51b477f74f0de11f6f92a65590f358e04a60a099,Bram Moolenaar,9,6,15,2,"{""src/term.c"": {""insertions"": 7, ""deletions"": 6, ""lines"": 13}, ""src/version.c"": {""insertions"": 2, ""deletions"": 0, ""lines"": 2}}"
2021-03-03 12:26:02,4fa1175765d55613302fc27d0f65e2c699452b6e,Bram Moolenaar,219,53,272,8,"{""src/drawline.c"": {""insertions"": 3, ""deletions"": 4, ""lines"": 7}, ""src/drawscreen.c"": {""insertions"": 50, ""deletions"": 24, ""lines"": 74}, ""src/macros.h"": {""insertions"": 7, ""deletions"": 0, ""lines"": 7}, ""src/proto/screen.pro"": {""insertions"": 1, ""deletions"": 1, ""lines"": 2}, ""src/screen.c"": {""insertions"": 42, ""deletions"": 24, ""lines"": 66}, ""src/testdir/test_fold.vim"": {""insertions"": 112, ""deletions"": 0, ""lines"": 112}, ""src/testdir/test_profile.vim"": {""insertions"": 2, ""deletions"": 0, ""lines"": 2}, ""src/version.c"": {""insertions"": 2, ""deletions"": 0, ""lines"": 2}}"
2021-03-02 18:04:11,37096afd3f3133a831ab49a9677f090c3c935c9d,Bram Moolenaar,10,4,14,2,"{""src/register.c"": {""insertions"": 8, ""deletions"": 4, ""lines"": 12}, ""src/version.c"": {""insertions"": 2, ""deletions"": 0, ""lines"": 2}}"
2021-03-02 12:36:47,3dc3474f00e529b014add48f7f3d1dad2ec15498,Bram Moolenaar,21,0,21,2,"{""src/testdir/test_textprop.vim"": {""insertions"": 19, ""deletions"": 0, ""lines"": 19}, ""src/version.c"": {""insertions"": 2, ""deletions"": 0, ""lines"": 2}}"
2021-03-01 20:02:46,39d4cab494248131b6fb07aba633aa4da7871a57,Bram Moolenaar,23,1,24,3,"{""src/testdir/test_options.vim"": {""insertions"": 20, ""deletions"": 0, ""lines"": 20}, ""src/version.c"": {""insertions"": 2, ""deletions"": 0, ""lines"": 2}, ""src/window.c"": {""insertions"": 1, ""deletions"": 1, ""lines"": 2}}"
2021-02-28 22:13:40,3650fd709807d5ac182e28d952cbd790c1ad0a6a,Bram Moolenaar,5,1,6,2,"{""src/testdir/test_gui.vim"": {""insertions"": 3, ""deletions"": 1, ""lines"": 4}, ""src/version.c"": {""insertions"": 2, ""deletions"": 0, ""lines"": 2}}"
2021-02-28 15:55:11,057e84afe5bd37fe272bf7cfafca629ef9da1bd3,Bram Moolenaar,80,33,113,9,"{""src/errors.h"": {""insertions"": 5, ""deletions"": 1, ""lines"": 6}, ""src/proto/vim9compile.pro"": {""insertions"": 1, ""deletions"": 1, ""lines"": 2}, ""src/testdir/test_vim9_expr.vim"": {""insertions"": 3, ""deletions"": 3, ""lines"": 6}, ""src/testdir/test_vim9_func.vim"": {""insertions"": 26, ""deletions"": 1, ""lines"": 27}, ""src/testdir/test_vim9_script.vim"": {""insertions"": 3, ""deletions"": 3, ""lines"": 6}, ""src/userfunc.c"": {""insertions"": 15, ""deletions"": 12, ""lines"": 27}, ""src/version.c"": {""insertions"": 2, ""deletions"": 0, ""lines"": 2}, ""src/vim9compile.c"": {""insertions"": 22, ""deletions"": 9, ""lines"": 31}, ""src/vim9script.c"": {""insertions"": 3, ""deletions"": 3, ""lines"": 6}}"
2021-02-27 22:39:22,087b5ff35d219f4f48a3d4854783799d0f6a1732,Bram Moolenaar,2,2,4,2,"{""src/version.c"": {""insertions"": 2, ""deletions"": 0, ""lines"": 2}, ""src/vim9script.c"": {""insertions"": 0, ""deletions"": 2, ""lines"": 2}}"
2021-02-27 21:41:19,0a84284e603e39c1288d71f8f96f66eb7eb1ca61,Bram Moolenaar,97,65,162,3,"{""src/testdir/test_vim9_script.vim"": {""insertions"": 30, ""deletions"": 0, ""lines"": 30}, ""src/version.c"": {""insertions"": 2, ""deletions"": 0, ""lines"": 2}, ""src/vim9script.c"": {""insertions"": 65, ""deletions"": 65, ""lines"": 130}}"
2021-02-27 21:36:43,3f1e9f000f761406a94366383a2e4878e2c50547,Bram Moolenaar,4,0,4,2,"{""src/testdir/test_vim9_script.vim"": {""insertions"": 2, ""deletions"": 0, ""lines"": 2}, ""src/version.c"": {""insertions"": 2, ""deletions"": 0, ""lines"": 2}}"
2021-02-27 21:33:21,0f2a5cc68b676b56694c27034690a7b9ef049feb,Bram Moolenaar,19,0,19,2,"{""src/testdir/test_vim9_script.vim"": {""insertions"": 17, ""deletions"": 0, ""lines"": 17}, ""src/version.c"": {""insertions"": 2, ""deletions"": 0, ""lines"": 2}}"
2021-02-27 15:38:07,9faec4e3d439968e21ad74e917aebb289df8f849,Bram Moolenaar,383,254,637,19,"{"".github/CODEOWNERS"": {""insertions"": 1, ""deletions"": 0, ""lines"": 1}, ""README_VIM9.md"": {""insertions"": 1, ""deletions"": 0, ""lines"": 1}, ""runtime/autoload/syntaxcomplete.vim"": {""insertions"": 9, ""deletions"": 4, ""lines"": 13}, ""runtime/compiler/sml.vim"": {""insertions"": 28, ""deletions"": 0, ""lines"": 28}, ""runtime/doc/index.txt"": {""insertions"": 3, ""deletions"": 2, ""lines"": 5}, ""runtime/doc/pattern.txt"": {""insertions"": 2, ""deletions"": 2, ""lines"": 4}, ""runtime/doc/popup.txt"": {""insertions"": 7, ""deletions"": 7, ""lines"": 14}, ""runtime/doc/repeat.txt"": {""insertions"": 2, ""deletions"": 2, ""lines"": 4}, ""runtime/doc/tags"": {""insertions"": 4, ""deletions"": 1, ""lines"": 5}, ""runtime/doc/todo.txt"": {""insertions"": 8, ""deletions"": 14, ""lines"": 22}, ""runtime/doc/usr_04.txt"": {""insertions"": 4, ""deletions"": 4, ""lines"": 8}, ""runtime/doc/vim9.txt"": {""insertions"": 14, ""deletions"": 10, ""lines"": 24}, ""runtime/ftplugin/lisp.vim"": {""insertions"": 1, ""deletions"": 3, ""lines"": 4}, ""runtime/ftplugin/vim.vim"": {""insertions"": 2, ""deletions"": 2, ""lines"": 4}, ""runtime/indent/vim.vim"": {""insertions"": 3, ""deletions"": 3, ""lines"": 6}, ""runtime/syntax/html.vim"": {""insertions"": 19, ""deletions"": 6, ""lines"": 25}, ""runtime/syntax/lhaskell.vim"": {""insertions"": 17, ""deletions"": 6, ""lines"": 23}, ""runtime/syntax/python.vim"": {""insertions"": 46, ""deletions"": 66, ""lines"": 112}, ""src/po/sr.po"": {""insertions"": 212, ""deletions"": 122, ""lines"": 334}}"
2021-02-26 21:21:23,0abc6e471ae78167bd75f95603b9bdd27ff0b38f,Bram Moolenaar,4,2,6,3,"{""src/ex_cmds.h"": {""insertions"": 1, ""deletions"": 1, ""lines"": 2}, ""src/ex_eval.c"": {""insertions"": 1, ""deletions"": 1, ""lines"": 2}, ""src/version.c"": {""insertions"": 2, ""deletions"": 0, ""lines"": 2}}"
2021-02-26 20:56:47,9f646c2e1105f27484d7b008a29da554ff2c21b6,Bram Moolenaar,3,1,4,2,"{""src/ex_cmds.h"": {""insertions"": 1, ""deletions"": 1, ""lines"": 2}, ""src/version.c"": {""insertions"": 2, ""deletions"": 0, ""lines"": 2}}"
2021-02-26 19:25:35,d0bce504ec52def729fffa35c8896979af348d32,Bram Moolenaar,4,0,4,2,"{""nsis/gvim.nsi"": {""insertions"": 2, ""deletions"": 0, ""lines"": 2}, ""src/version.c"": {""insertions"": 2, ""deletions"": 0, ""lines"": 2}}"
2021-02-25 16:17:56,0e62a6742bca186624e97e2121c98ada30e009a0,Bram Moolenaar,51,1,52,5,"{""src/auto/configure"": {""insertions"": 24, ""deletions"": 0, ""lines"": 24}, ""src/config.h.in"": {""insertions"": 3, ""deletions"": 0, ""lines"": 3}, ""src/configure.ac"": {""insertions"": 9, ""deletions"": 0, ""lines"": 9}, ""src/os_unix.c"": {""insertions"": 13, ""deletions"": 1, ""lines"": 14}, ""src/version.c"": {""insertions"": 2, ""deletions"": 0, ""lines"": 2}}"
2021-02-24 11:27:31,1bd3cb201983859d86d644eef9e98cd3e9de7261,Bram Moolenaar,9,0,9,3,"{""src/testdir/test_vim9_expr.vim"": {""insertions"": 6, ""deletions"": 0, ""lines"": 6}, ""src/version.c"": {""insertions"": 2, ""deletions"": 0, ""lines"": 2}, ""src/vim9execute.c"": {""insertions"": 1, ""deletions"": 0, ""lines"": 1}}"
2021-02-23 18:39:20,7d41410a455ba62128655beb91c35d3fba299287,Bram Moolenaar,12,0,12,2,"{""src/normal.c"": {""insertions"": 10, ""deletions"": 0, ""lines"": 10}, ""src/version.c"": {""insertions"": 2, ""deletions"": 0, ""lines"": 2}}"
2021-02-23 18:32:03,2c6553498e790604f50016d8435403523a2576d6,Bram Moolenaar,7,3,10,2,"{""src/normal.c"": {""insertions"": 5, ""deletions"": 3, ""lines"": 8}, ""src/version.c"": {""insertions"": 2, ""deletions"": 0, ""lines"": 2}}"
2021-02-23 18:19:58,21a83bd53d1fe21c780316c40fdc14d49167d08b,Bram Moolenaar,10,4,14,2,"{""src/misc2.c"": {""insertions"": 8, ""deletions"": 4, ""lines"": 12}, ""src/version.c"": {""insertions"": 2, ""deletions"": 0, ""lines"": 2}}"
2021-02-23 16:47:23,eba13e4ea28f133ff65f6b426428f49a9bd711b0,Bram Moolenaar,20,0,20,3,"{""src/terminal.c"": {""insertions"": 5, ""deletions"": 0, ""lines"": 5}, ""src/testdir/test_terminal.vim"": {""insertions"": 13, ""deletions"": 0, ""lines"": 13}, ""src/version.c"": {""insertions"": 2, ""deletions"": 0, ""lines"": 2}}"
2021-02-23 11:05:46,bc327ccc3dd408463fc74266f57b879888a13e51,Bram Moolenaar,12,1,13,3,"{""src/testdir/test_vim9_expr.vim"": {""insertions"": 8, ""deletions"": 0, ""lines"": 8}, ""src/userfunc.c"": {""insertions"": 2, ""deletions"": 1, ""lines"": 3}, ""src/version.c"": {""insertions"": 2, ""deletions"": 0, ""lines"": 2}}"
2021-02-22 21:45:10,9cb577a68277d46cc1134ef1723e90ff5f1d1b5c,Bram Moolenaar,20,4,24,3,"{""src/testdir/test_vim9_script.vim"": {""insertions"": 12, ""deletions"": 0, ""lines"": 12}, ""src/version.c"": {""insertions"": 2, ""deletions"": 0, ""lines"": 2}, ""src/vim9execute.c"": {""insertions"": 6, ""deletions"": 4, ""lines"": 10}}"
2021-02-22 21:13:49,41f0895c6e3c7b921e3c102ad42be52b1be48018,Bram Moolenaar,58,3,61,5,"{""src/match.c"": {""insertions"": 24, ""deletions"": 3, ""lines"": 27}, ""src/testdir/dumps/Test_hlsearch_1.dump"": {""insertions"": 6, ""deletions"": 0, ""lines"": 6}, ""src/testdir/dumps/Test_hlsearch_2.dump"": {""insertions"": 6, ""deletions"": 0, ""lines"": 6}, ""src/testdir/test_search.vim"": {""insertions"": 20, ""deletions"": 0, ""lines"": 20}, ""src/version.c"": {""insertions"": 2, ""deletions"": 0, ""lines"": 2}}"
2021-02-21 22:12:18,6bfc475f717aa0412d13163d47ff6210fa611fb5,Bram Moolenaar,20,10,30,3,"{""src/popupwin.c"": {""insertions"": 5, ""deletions"": 10, ""lines"": 15}, ""src/testdir/test_popupwin.vim"": {""insertions"": 13, ""deletions"": 0, ""lines"": 13}, ""src/version.c"": {""insertions"": 2, ""deletions"": 0, ""lines"": 2}}"
2021-02-21 21:20:24,b4893b84507570f24af32597716ffb67fb0ef24e,Bram Moolenaar,21,1,22,5,"{""src/proto/vim9compile.pro"": {""insertions"": 1, ""deletions"": 0, ""lines"": 1}, ""src/testdir/test_vim9_func.vim"": {""insertions"": 9, ""deletions"": 0, ""lines"": 9}, ""src/userfunc.c"": {""insertions"": 8, ""deletions"": 0, ""lines"": 8}, ""src/version.c"": {""insertions"": 2, ""deletions"": 0, ""lines"": 2}, ""src/vim9compile.c"": {""insertions"": 1, ""deletions"": 1, ""lines"": 2}}"
2021-02-21 20:32:45,7e82c5f338efe5661951675565f27f6512901a6e,Bram Moolenaar,89,38,127,6,"{""src/testdir/test_vim9_disassemble.vim"": {""insertions"": 4, ""deletions"": 3, ""lines"": 7}, ""src/testdir/test_vim9_script.vim"": {""insertions"": 10, ""deletions"": 0, ""lines"": 10}, ""src/version.c"": {""insertions"": 2, ""deletions"": 0, ""lines"": 2}, ""src/vim9.h"": {""insertions"": 8, ""deletions"": 1, ""lines"": 9}, ""src/vim9compile.c"": {""insertions"": 29, ""deletions"": 21, ""lines"": 50}, ""src/vim9execute.c"": {""insertions"": 36, ""deletions"": 13, ""lines"": 49}}"
2021-02-21 18:12:47,21578271bb717f7ab7b8728e9efa54c3b60ee7e4,Bram Moolenaar,7,0,7,3,"{""src/if_py_both.h"": {""insertions"": 2, ""deletions"": 0, ""lines"": 2}, ""src/testdir/test_python3.vim"": {""insertions"": 3, ""deletions"": 0, ""lines"": 3}, ""src/version.c"": {""insertions"": 2, ""deletions"": 0, ""lines"": 2}}"
2021-02-21 15:20:18,027c4ab4d2e3ff031b98e0fb648f5acbea180293,Bram Moolenaar,24,0,24,3,"{""src/list.c"": {""insertions"": 1, ""deletions"": 0, ""lines"": 1}, ""src/testdir/test_vim9_builtin.vim"": {""insertions"": 21, ""deletions"": 0, ""lines"": 21}, ""src/version.c"": {""insertions"": 2, ""deletions"": 0, ""lines"": 2}}"
2021-02-20 19:26:16,dc167465f87a4f03f9e085597dfcfdde39fcd2b9,Bram Moolenaar,3,1,4,2,"{""src/userfunc.c"": {""insertions"": 1, ""deletions"": 1, ""lines"": 2}, ""src/version.c"": {""insertions"": 2, ""deletions"": 0, ""lines"": 2}}"
2021-02-20 19:13:42,723ef5db980b2e69ef8bdc0dd448cb645491c464,Bram Moolenaar,12,0,12,2,"{""src/Make_mvc.mak"": {""insertions"": 10, ""deletions"": 0, ""lines"": 10}, ""src/version.c"": {""insertions"": 2, ""deletions"": 0, ""lines"": 2}}"
2021-02-20 18:21:36,a1070eae77f635f08b6f2612726b905796baaa58,Bram Moolenaar,29,17,46,4,"{""src/testdir/test_edit.vim"": {""insertions"": 20, ""deletions"": 17, ""lines"": 37}, ""src/testdir/test_maparg.vim"": {""insertions"": 2, ""deletions"": 0, ""lines"": 2}, ""src/testdir/test_terminal3.vim"": {""insertions"": 5, ""deletions"": 0, ""lines"": 5}, ""src/version.c"": {""insertions"": 2, ""deletions"": 0, ""lines"": 2}}"
2021-02-20 16:04:02,5b5ae29bd3d7b832b6f15320430f7f191e0abd1f,Bram Moolenaar,231,38,269,11,"{""src/errors.h"": {""insertions"": 4, ""deletions"": 0, ""lines"": 4}, ""src/eval.c"": {""insertions"": 1, ""deletions"": 9, ""lines"": 10}, ""src/evalvars.c"": {""insertions"": 40, ""deletions"": 21, ""lines"": 61}, ""src/list.c"": {""insertions"": 20, ""deletions"": 0, ""lines"": 20}, ""src/proto/evalvars.pro"": {""insertions"": 1, ""deletions"": 0, ""lines"": 1}, ""src/proto/list.pro"": {""insertions"": 1, ""deletions"": 0, ""lines"": 1}, ""src/testdir/test_vim9_assign.vim"": {""insertions"": 46, ""deletions"": 0, ""lines"": 46}, ""src/version.c"": {""insertions"": 2, ""deletions"": 0, ""lines"": 2}, ""src/vim9.h"": {""insertions"": 1, ""deletions"": 0, ""lines"": 1}, ""src/vim9compile.c"": {""insertions"": 43, ""deletions"": 3, ""lines"": 46}, ""src/vim9execute.c"": {""insertions"": 72, ""deletions"": 5, ""lines"": 77}}"
2021-02-20 07:16:51,ada1d870b4a818151cfba1c18962af2369b88df9,Bram Moolenaar,15,1,16,4,"{""src/testdir/test_vim9_script.vim"": {""insertions"": 5, ""deletions"": 0, ""lines"": 5}, ""src/version.c"": {""insertions"": 2, ""deletions"": 0, ""lines"": 2}, ""src/vim9compile.c"": {""insertions"": 1, ""deletions"": 0, ""lines"": 1}, ""src/vim9script.c"": {""insertions"": 7, ""deletions"": 1, ""lines"": 8}}"
2021-02-19 20:42:57,10b9421f3bb7ac971fa63bd025c4c603c98f4a49,Bram Moolenaar,40,5,45,7,"{""runtime/doc/vim9.txt"": {""insertions"": 4, ""deletions"": 3, ""lines"": 7}, ""src/ex_cmds.h"": {""insertions"": 1, ""deletions"": 1, ""lines"": 2}, ""src/ex_docmd.c"": {""insertions"": 6, ""deletions"": 1, ""lines"": 7}, ""src/testdir/test_vim9_script.vim"": {""insertions"": 25, ""deletions"": 0, ""lines"": 25}, ""src/version.c"": {""insertions"": 2, ""deletions"": 0, ""lines"": 2}, ""src/vim9compile.c"": {""insertions"": 1, ""deletions"": 0, ""lines"": 1}, ""src/vim9script.c"": {""insertions"": 1, ""deletions"": 0, ""lines"": 1}}"
2021-02-19 18:13:21,12d265315fac9e4f3436c38a87f6d9a23b9e7e2b,Bram Moolenaar,114,38,152,6,"{""src/profiler.c"": {""insertions"": 15, ""deletions"": 19, ""lines"": 34}, ""src/proto/profiler.pro"": {""insertions"": 2, ""deletions"": 2, ""lines"": 4}, ""src/testdir/test_profile.vim"": {""insertions"": 33, ""deletions"": 0, ""lines"": 33}, ""src/userfunc.c"": {""insertions"": 17, ""deletions"": 7, ""lines"": 24}, ""src/version.c"": {""insertions"": 2, ""deletions"": 0, ""lines"": 2}, ""src/vim9execute.c"": {""insertions"": 45, ""deletions"": 10, ""lines"": 55}}"
2021-02-17 20:57:03,d3f8a9ee65b249d073343e43e423bc3348dd09d0,Bram Moolenaar,52,4,56,4,"{""runtime/doc/vim9.txt"": {""insertions"": 24, ""deletions"": 3, ""lines"": 27}, ""src/ex_docmd.c"": {""insertions"": 5, ""deletions"": 1, ""lines"": 6}, ""src/testdir/test_vim9_script.vim"": {""insertions"": 21, ""deletions"": 0, ""lines"": 21}, ""src/version.c"": {""insertions"": 2, ""deletions"": 0, ""lines"": 2}}"
2021-02-17 17:49:11,c7dac8534ee7f7a49e9d7a37330397c64455cdd7,Bram Moolenaar,13,2,15,3,"{""src/eval.c"": {""insertions"": 6, ""deletions"": 2, ""lines"": 8}, ""src/testdir/test_vim9_assign.vim"": {""insertions"": 5, ""deletions"": 0, ""lines"": 5}, ""src/version.c"": {""insertions"": 2, ""deletions"": 0, ""lines"": 2}}"
2021-02-17 16:00:27,064095012c0b8e4e43e75834b337115950898fbf,Bram Moolenaar,21,4,25,5,"{""src/eval.c"": {""insertions"": 10, ""deletions"": 0, ""lines"": 10}, ""src/testdir/test_vim9_assign.vim"": {""insertions"": 3, ""deletions"": 2, ""lines"": 5}, ""src/version.c"": {""insertions"": 2, ""deletions"": 0, ""lines"": 2}, ""src/vim.h"": {""insertions"": 6, ""deletions"": 0, ""lines"": 6}, ""src/vim9.h"": {""insertions"": 0, ""deletions"": 2, ""lines"": 2}}"
2021-02-17 14:05:45,527ed38cfacc5abf32ef3e63f98966d011cd95de,Bram Moolenaar,3,2,5,3,"{""src/evalvars.c"": {""insertions"": 0, ""deletions"": 1, ""lines"": 1}, ""src/proto/evalvars.pro"": {""insertions"": 1, ""deletions"": 1, ""lines"": 2}, ""src/version.c"": {""insertions"": 2, ""deletions"": 0, ""lines"": 2}}"
2021-02-17 13:52:14,e0890d678d4d31ca1810c90f3afe2ba89dfedcfa,Bram Moolenaar,33,10,43,5,"{""src/ex_docmd.c"": {""insertions"": 4, ""deletions"": 4, ""lines"": 8}, ""src/proto/ex_docmd.pro"": {""insertions"": 2, ""deletions"": 1, ""lines"": 3}, ""src/testdir/test_vim9_cmd.vim"": {""insertions"": 10, ""deletions"": 0, ""lines"": 10}, ""src/version.c"": {""insertions"": 2, ""deletions"": 0, ""lines"": 2}, ""src/vim9compile.c"": {""insertions"": 15, ""deletions"": 5, ""lines"": 20}}"
2021-02-17 12:14:07,3aca5a6fbcfbf5f4492b9ea0c4308ac524d33606,Bram Moolenaar,78,10,88,6,"{""runtime/doc/options.txt"": {""insertions"": 3, ""deletions"": 0, ""lines"": 3}, ""src/globals.h"": {""insertions"": 3, ""deletions"": 0, ""lines"": 3}, ""src/mouse.c"": {""insertions"": 1, ""deletions"": 1, ""lines"": 2}, ""src/screen.c"": {""insertions"": 15, ""deletions"": 9, ""lines"": 24}, ""src/testdir/test_display.vim"": {""insertions"": 54, ""deletions"": 0, ""lines"": 54}, ""src/version.c"": {""insertions"": 2, ""deletions"": 0, ""lines"": 2}}"
2021-02-17 11:29:17,c0fcb6e0b10050145e7d334b68b1bdc5201fed05,Bram Moolenaar,6,0,6,3,"{""runtime/filetype.vim"": {""insertions"": 3, ""deletions"": 0, ""lines"": 3}, ""src/testdir/test_filetype.vim"": {""insertions"": 1, ""deletions"": 0, ""lines"": 1}, ""src/version.c"": {""insertions"": 2, ""deletions"": 0, ""lines"": 2}}"
2021-02-17 11:25:49,9bbd883b3528b37dcacad22ad58861105a9ae428,Bram Moolenaar,6,0,6,3,"{""runtime/filetype.vim"": {""insertions"": 3, ""deletions"": 0, ""lines"": 3}, ""src/testdir/test_filetype.vim"": {""insertions"": 1, ""deletions"": 0, ""lines"": 1}, ""src/version.c"": {""insertions"": 2, ""deletions"": 0, ""lines"": 2}}"
2021-02-16 21:22:13,333bd56422d840961c6df51d4450c884f8500994,Bram Moolenaar,23,17,40,2,"{""src/screen.c"": {""insertions"": 21, ""deletions"": 17, ""lines"": 38}, ""src/version.c"": {""insertions"": 2, ""deletions"": 0, ""lines"": 2}}"
2021-02-16 20:14:33,04ea7e9049706788179945e2a91922c0b7cb9ed0,Bram Moolenaar,22,0,22,2,"{""src/testdir/test_listchars.vim"": {""insertions"": 20, ""deletions"": 0, ""lines"": 20}, ""src/version.c"": {""insertions"": 2, ""deletions"": 0, ""lines"": 2}}"
2021-02-15 20:30:30,b8554304c3673b081e9b5996f009fd0e4307e482,Bram Moolenaar,20,3,23,3,"{""src/ex_docmd.c"": {""insertions"": 7, ""deletions"": 3, ""lines"": 10}, ""src/testdir/test_vim9_script.vim"": {""insertions"": 11, ""deletions"": 0, ""lines"": 11}, ""src/version.c"": {""insertions"": 2, ""deletions"": 0, ""lines"": 2}}"
2021-02-15 19:38:25,eed9d46293f0842aad0d50ff3a526f9a48b12421,Bram Moolenaar,302,112,414,20,"{""runtime/doc/options.txt"": {""insertions"": 1, ""deletions"": 1, ""lines"": 2}, ""src/buffer.c"": {""insertions"": 1, ""deletions"": 1, ""lines"": 2}, ""src/charset.c"": {""insertions"": 4, ""deletions"": 4, ""lines"": 8}, ""src/drawline.c"": {""insertions"": 47, ""deletions"": 37, ""lines"": 84}, ""src/drawscreen.c"": {""insertions"": 1, ""deletions"": 1, ""lines"": 2}, ""src/evalfunc.c"": {""insertions"": 2, ""deletions"": 1, ""lines"": 3}, ""src/globals.h"": {""insertions"": 0, ""deletions"": 15, ""lines"": 15}, ""src/indent.c"": {""insertions"": 3, ""deletions"": 2, ""lines"": 5}, ""src/message.c"": {""insertions"": 19, ""deletions"": 17, ""lines"": 36}, ""src/misc1.c"": {""insertions"": 3, ""deletions"": 2, ""lines"": 5}, ""src/option.c"": {""insertions"": 17, ""deletions"": 2, ""lines"": 19}, ""src/option.h"": {""insertions"": 1, ""deletions"": 0, ""lines"": 1}, ""src/optiondefs.h"": {""insertions"": 2, ""deletions"": 1, ""lines"": 3}, ""src/optionstr.c"": {""insertions"": 41, ""deletions"": 6, ""lines"": 47}, ""src/proto/screen.pro"": {""insertions"": 1, ""deletions"": 1, ""lines"": 2}, ""src/screen.c"": {""insertions"": 25, ""deletions"": 21, ""lines"": 46}, ""src/structs.h"": {""insertions"": 24, ""deletions"": 0, ""lines"": 24}, ""src/testdir/test_listchars.vim"": {""insertions"": 106, ""deletions"": 0, ""lines"": 106}, ""src/testdir/test_listlbr.vim"": {""insertions"": 2, ""deletions"": 0, ""lines"": 2}, ""src/version.c"": {""insertions"": 2, ""deletions"": 0, ""lines"": 2}}"
2021-02-14 21:40:57,7c5b3c03699a4ab31f47c24290852d441ea8c12a,Bram Moolenaar,23,0,23,2,"{""src/testdir/test_vim9_script.vim"": {""insertions"": 21, ""deletions"": 0, ""lines"": 21}, ""src/version.c"": {""insertions"": 2, ""deletions"": 0, ""lines"": 2}}"
2021-02-14 15:34:59,4afa77419fb6e9ed194f8a3cf84dac7cda70deb4,Bram Moolenaar,12,6,18,2,"{""src/version.c"": {""insertions"": 2, ""deletions"": 0, ""lines"": 2}, ""src/vim9compile.c"": {""insertions"": 10, ""deletions"": 6, ""lines"": 16}}"
2021-02-14 14:37:30,6281815eccc3ded54960f7798833ceb39561b9a0,Bram Moolenaar,18,0,18,3,"{""src/message.c"": {""insertions"": 7, ""deletions"": 0, ""lines"": 7}, ""src/message_test.c"": {""insertions"": 9, ""deletions"": 0, ""lines"": 9}, ""src/version.c"": {""insertions"": 2, ""deletions"": 0, ""lines"": 2}}"
2021-02-14 13:07:34,2379f87eb48a4ee6a1d0fc7df964e12a3efe4fd5,Bram Moolenaar,4,0,4,2,"{""src/ex_docmd.c"": {""insertions"": 2, ""deletions"": 0, ""lines"": 2}, ""src/version.c"": {""insertions"": 2, ""deletions"": 0, ""lines"": 2}}"
2021-02-14 12:30:01,9979fcd72ed671ec2c98800587c3a6996adb27d4,Bram Moolenaar,4,1,5,2,"{""src/version.c"": {""insertions"": 2, ""deletions"": 0, ""lines"": 2}, ""src/vim9script.c"": {""insertions"": 2, ""deletions"": 1, ""lines"": 3}}"
2021-02-14 12:17:22,03dfde2b5f81f06639ec8697cdd32ad50d8509fd,Bram Moolenaar,9,13,22,4,"{""src/testdir/term_util.vim"": {""insertions"": 4, ""deletions"": 0, ""lines"": 4}, ""src/testdir/test_vim9_func.vim"": {""insertions"": 2, ""deletions"": 12, ""lines"": 14}, ""src/testdir/test_vim9_script.vim"": {""insertions"": 1, ""deletions"": 1, ""lines"": 2}, ""src/version.c"": {""insertions"": 2, ""deletions"": 0, ""lines"": 2}}"
2021-02-14 11:57:36,39f3b1411068ff187b4f9f482b2d6b2c1e7a7268,Bram Moolenaar,56,18,74,15,"{""runtime/doc/repeat.txt"": {""insertions"": 3, ""deletions"": 1, ""lines"": 4}, ""runtime/doc/vim9.txt"": {""insertions"": 7, ""deletions"": 0, ""lines"": 7}, ""src/errors.h"": {""insertions"": 2, ""deletions"": 0, ""lines"": 2}, ""src/ex_cmdidxs.h"": {""insertions"": 6, ""deletions"": 6, ""lines"": 12}, ""src/ex_cmds.h"": {""insertions"": 3, ""deletions"": 0, ""lines"": 3}, ""src/ex_docmd.c"": {""insertions"": 13, ""deletions"": 2, ""lines"": 15}, ""src/structs.h"": {""insertions"": 1, ""deletions"": 0, ""lines"": 1}, ""src/testdir/dumps/Test_wildmenu_1.dump"": {""insertions"": 2, ""deletions"": 2, ""lines"": 4}, ""src/testdir/dumps/Test_wildmenu_2.dump"": {""insertions"": 2, ""deletions"": 2, ""lines"": 4}, ""src/testdir/dumps/Test_wildmenu_3.dump"": {""insertions"": 2, ""deletions"": 2, ""lines"": 4}, ""src/testdir/dumps/Test_wildmenu_4.dump"": {""insertions"": 1, ""deletions"": 1, ""lines"": 2}, ""src/testdir/test_cmdline.vim"": {""insertions"": 1, ""deletions"": 1, ""lines"": 2}, ""src/testdir/test_quickfix.vim"": {""insertions"": 1, ""deletions"": 1, ""lines"": 2}, ""src/testdir/test_vim9_cmd.vim"": {""insertions"": 10, ""deletions"": 0, ""lines"": 10}, ""src/version.c"": {""insertions"": 2, ""deletions"": 0, ""lines"": 2}}"
2021-02-13 20:31:18,10ccfb2a17e736ace054b19dc712544b4e961671,Bram Moolenaar,26,1,27,3,"{""src/popupwin.c"": {""insertions"": 5, ""deletions"": 1, ""lines"": 6}, ""src/testdir/test_popupwin.vim"": {""insertions"": 19, ""deletions"": 0, ""lines"": 19}, ""src/version.c"": {""insertions"": 2, ""deletions"": 0, ""lines"": 2}}"
2021-02-13 17:33:02,8d4be8901139f698c7919fd697d82abb1ce41911,Bram Moolenaar,4,3,7,2,"{""src/version.c"": {""insertions"": 2, ""deletions"": 0, ""lines"": 2}, ""src/vim9execute.c"": {""insertions"": 2, ""deletions"": 3, ""lines"": 5}}"
2021-02-13 17:24:23,a98f8a230596d8fb44cc68321de72980a21428cb,Bram Moolenaar,41,10,51,9,"{""runtime/doc/options.txt"": {""insertions"": 3, ""deletions"": 1, ""lines"": 4}, ""runtime/doc/todo.txt"": {""insertions"": 0, ""deletions"": 2, ""lines"": 2}, ""runtime/doc/windows.txt"": {""insertions"": 6, ""deletions"": 4, ""lines"": 10}, ""src/drawscreen.c"": {""insertions"": 2, ""deletions"": 2, ""lines"": 4}, ""src/globals.h"": {""insertions"": 1, ""deletions"": 0, ""lines"": 1}, ""src/optiondefs.h"": {""insertions"": 1, ""deletions"": 1, ""lines"": 2}, ""src/screen.c"": {""insertions"": 4, ""deletions"": 0, ""lines"": 4}, ""src/testdir/test_display.vim"": {""insertions"": 22, ""deletions"": 0, ""lines"": 22}, ""src/version.c"": {""insertions"": 2, ""deletions"": 0, ""lines"": 2}}"
2021-02-13 17:14:48,942db23c9cb7532d68048530d749eb84ca94d0cd,Bram Moolenaar,312,218,530,33,"{""runtime/autoload/clojurecomplete.vim"": {""insertions"": 9, ""deletions"": 8, ""lines"": 17}, ""runtime/autoload/phpcomplete.vim"": {""insertions"": 38, ""deletions"": 55, ""lines"": 93}, ""runtime/doc/diff.txt"": {""insertions"": 1, ""deletions"": 1, ""lines"": 2}, ""runtime/doc/eval.txt"": {""insertions"": 5, ""deletions"": 1, ""lines"": 6}, ""runtime/doc/indent.txt"": {""insertions"": 4, ""deletions"": 4, ""lines"": 8}, ""runtime/doc/index.txt"": {""insertions"": 2, ""deletions"": 1, ""lines"": 3}, ""runtime/doc/options.txt"": {""insertions"": 14, ""deletions"": 8, ""lines"": 22}, ""runtime/doc/popup.txt"": {""insertions"": 3, ""deletions"": 2, ""lines"": 5}, ""runtime/doc/quickfix.txt"": {""insertions"": 7, ""deletions"": 1, ""lines"": 8}, ""runtime/doc/starting.txt"": {""insertions"": 12, ""deletions"": 4, ""lines"": 16}, ""runtime/doc/tags"": {""insertions"": 6, ""deletions"": 0, ""lines"": 6}, ""runtime/doc/terminal.txt"": {""insertions"": 24, ""deletions"": 5, ""lines"": 29}, ""runtime/doc/todo.txt"": {""insertions"": 24, ""deletions"": 32, ""lines"": 56}, ""runtime/doc/usr_41.txt"": {""insertions"": 1, ""deletions"": 1, ""lines"": 2}, ""runtime/doc/version6.txt"": {""insertions"": 1, ""deletions"": 1, ""lines"": 2}, ""runtime/doc/vim9.txt"": {""insertions"": 1, ""deletions"": 1, ""lines"": 2}, ""runtime/doc/windows.txt"": {""insertions"": 4, ""deletions"": 2, ""lines"": 6}, ""runtime/ftplugin/clojure.vim"": {""insertions"": 8, ""deletions"": 23, ""lines"": 31}, ""runtime/ftplugin/vim.vim"": {""insertions"": 2, ""deletions"": 2, ""lines"": 4}, ""runtime/indent/clojure.vim"": {""insertions"": 55, ""deletions"": 19, ""lines"": 74}, ""runtime/indent/html.vim"": {""insertions"": 4, ""deletions"": 4, ""lines"": 8}, ""runtime/indent/ruby.vim"": {""insertions"": 15, ""deletions"": 6, ""lines"": 21}, ""runtime/indent/testdir/html.ok"": {""insertions"": 1, ""deletions"": 1, ""lines"": 2}, ""runtime/indent/testdir/vim.in"": {""insertions"": 15, ""deletions"": 0, ""lines"": 15}, ""runtime/indent/testdir/vim.ok"": {""insertions"": 15, ""deletions"": 0, ""lines"": 15}, ""runtime/indent/vim.vim"": {""insertions"": 11, ""deletions"": 5, ""lines"": 16}, ""runtime/scripts.vim"": {""insertions"": 1, ""deletions"": 1, ""lines"": 2}, ""runtime/syntax/clojure.vim"": {""insertions"": 21, ""deletions"": 23, ""lines"": 44}, ""runtime/syntax/groovy.vim"": {""insertions"": 4, ""deletions"": 3, ""lines"": 7}, ""runtime/syntax/messages.vim"": {""insertions"": 2, ""deletions"": 1, ""lines"": 3}, ""src/po/cs.cp1250.po"": {""insertions"": 1, ""deletions"": 1, ""lines"": 2}, ""src/po/cs.po"": {""insertions"": 1, ""deletions"": 1, ""lines"": 2}, ""src/po/lv.po"": {""insertions"": 0, ""deletions"": 1, ""lines"": 1}}"
2021-02-13 16:08:33,0fa09676c25a0a4a01f339887b8bf40b4673621f,Bram Moolenaar,6,4,10,2,"{"".github/workflows/ci.yml"": {""insertions"": 4, ""deletions"": 4, ""lines"": 8}, ""src/version.c"": {""insertions"": 2, ""deletions"": 0, ""lines"": 2}}"
2021-02-13 14:02:46,c150c09ec4f97636c6339f5687fdaa9f665095d2,Bram Moolenaar,190,19,209,6,"{""src/testdir/test_vim9_disassemble.vim"": {""insertions"": 57, ""deletions"": 0, ""lines"": 57}, ""src/testdir/test_vim9_script.vim"": {""insertions"": 17, ""deletions"": 0, ""lines"": 17}, ""src/version.c"": {""insertions"": 2, ""deletions"": 0, ""lines"": 2}, ""src/vim9.h"": {""insertions"": 9, ""deletions"": 1, ""lines"": 10}, ""src/vim9compile.c"": {""insertions"": 54, ""deletions"": 14, ""lines"": 68}, ""src/vim9execute.c"": {""insertions"": 51, ""deletions"": 4, ""lines"": 55}}"
2021-02-12 21:10:21,31842cd0772b557eb9584a13740430db29de8a51,Bram Moolenaar,24,0,24,3,"{""src/testdir/test_vim9_func.vim"": {""insertions"": 15, ""deletions"": 0, ""lines"": 15}, ""src/userfunc.c"": {""insertions"": 7, ""deletions"": 0, ""lines"": 7}, ""src/version.c"": {""insertions"": 2, ""deletions"": 0, ""lines"": 2}}"
2021-02-12 20:50:57,44ec21c467ddf481b422c787324ea08f375f6942,Bram Moolenaar,16,1,17,3,"{""src/testdir/test_vim9_func.vim"": {""insertions"": 12, ""deletions"": 0, ""lines"": 12}, ""src/version.c"": {""insertions"": 2, ""deletions"": 0, ""lines"": 2}, ""src/vim9compile.c"": {""insertions"": 2, ""deletions"": 1, ""lines"": 3}}"
2021-02-12 20:32:47,d9d7789b6fe5f2b4074375ee9f1c0bad3e4d3cfe,Bram Moolenaar,21,1,22,3,"{""src/testdir/test_vim9_script.vim"": {""insertions"": 10, ""deletions"": 0, ""lines"": 10}, ""src/version.c"": {""insertions"": 2, ""deletions"": 0, ""lines"": 2}, ""src/vim9execute.c"": {""insertions"": 9, ""deletions"": 1, ""lines"": 10}}"
2021-02-12 18:48:51,ca753ec862f8191f1fc5ed161753704a488ed08d,Bram Moolenaar,4,1,5,2,"{"".github/workflows/ci.yml"": {""insertions"": 2, ""deletions"": 1, ""lines"": 3}, ""src/version.c"": {""insertions"": 2, ""deletions"": 0, ""lines"": 2}}"
2021-02-11 20:19:34,f785aa1354208f6b644e891aa01f8f86d947af7e,Bram Moolenaar,146,59,205,16,"{""src/dict.c"": {""insertions"": 2, ""deletions"": 1, ""lines"": 3}, ""src/errors.h"": {""insertions"": 2, ""deletions"": 0, ""lines"": 2}, ""src/eval.c"": {""insertions"": 7, ""deletions"": 5, ""lines"": 12}, ""src/evalvars.c"": {""insertions"": 22, ""deletions"": 12, ""lines"": 34}, ""src/list.c"": {""insertions"": 11, ""deletions"": 9, ""lines"": 20}, ""src/proto/eval.pro"": {""insertions"": 1, ""deletions"": 1, ""lines"": 2}, ""src/proto/evalvars.pro"": {""insertions"": 1, ""deletions"": 1, ""lines"": 2}, ""src/proto/vim9script.pro"": {""insertions"": 1, ""deletions"": 1, ""lines"": 2}, ""src/proto/vim9type.pro"": {""insertions"": 5, ""deletions"": 3, ""lines"": 8}, ""src/structs.h"": {""insertions"": 7, ""deletions"": 0, ""lines"": 7}, ""src/testdir/test_vim9_assign.vim"": {""insertions"": 8, ""deletions"": 0, ""lines"": 8}, ""src/version.c"": {""insertions"": 2, ""deletions"": 0, ""lines"": 2}, ""src/vim9compile.c"": {""insertions"": 13, ""deletions"": 3, ""lines"": 16}, ""src/vim9execute.c"": {""insertions"": 19, ""deletions"": 5, ""lines"": 24}, ""src/vim9script.c"": {""insertions"": 8, ""deletions"": 4, ""lines"": 12}, ""src/vim9type.c"": {""insertions"": 37, ""deletions"": 14, ""lines"": 51}}"
2021-02-11 18:18:58,0bcadf14aa700c166c09f1800ed3de00b9598b39,Bram Moolenaar,4,0,4,2,"{""src/main.c"": {""insertions"": 2, ""deletions"": 0, ""lines"": 2}, ""src/version.c"": {""insertions"": 2, ""deletions"": 0, ""lines"": 2}}"
2021-02-11 18:08:05,3b678047bcd50d6f409175dcffe7839dbb74728b,Bram Moolenaar,17,0,17,3,"{""src/main.c"": {""insertions"": 1, ""deletions"": 0, ""lines"": 1}, ""src/testdir/test_version.vim"": {""insertions"": 14, ""deletions"": 0, ""lines"": 14}, ""src/version.c"": {""insertions"": 2, ""deletions"": 0, ""lines"": 2}}"
2021-02-11 17:36:30,5affc034680a95eabfbfca763bedf86ae0a79c44,Bram Moolenaar,3,0,3,2,"{""src/testdir/test_viminfo.vim"": {""insertions"": 1, ""deletions"": 0, ""lines"": 1}, ""src/version.c"": {""insertions"": 2, ""deletions"": 0, ""lines"": 2}}"
2021-02-10 21:23:41,418a29f0ffcaa0a3d778724ab6d1111db525d3cc,Bram Moolenaar,46,3,49,5,"{""src/errors.h"": {""insertions"": 2, ""deletions"": 0, ""lines"": 2}, ""src/evalfunc.c"": {""insertions"": 23, ""deletions"": 2, ""lines"": 25}, ""src/testdir/test_vim9_builtin.vim"": {""insertions"": 16, ""deletions"": 0, ""lines"": 16}, ""src/typval.c"": {""insertions"": 3, ""deletions"": 1, ""lines"": 4}, ""src/version.c"": {""insertions"": 2, ""deletions"": 0, ""lines"": 2}}"
2021-02-10 20:20:30,5202929dab58402a5f3cd9c231e09abb5c451c56,Bram Moolenaar,10,3,13,2,"{""src/testdir/test_breakindent.vim"": {""insertions"": 8, ""deletions"": 3, ""lines"": 11}, ""src/version.c"": {""insertions"": 2, ""deletions"": 0, ""lines"": 2}}"
2021-02-10 20:10:12,8f33ebfade10cd1b4296d8ec8dca815a09e8a405,Bram Moolenaar,5,3,8,3,"{""src/move.c"": {""insertions"": 2, ""deletions"": 2, ""lines"": 4}, ""src/testdir/test_breakindent.vim"": {""insertions"": 1, ""deletions"": 1, ""lines"": 2}, ""src/version.c"": {""insertions"": 2, ""deletions"": 0, ""lines"": 2}}"
2021-02-10 18:22:15,3ff656f6b43465083b58e1d2fb9b8008abc5bc17,Bram Moolenaar,14,9,23,3,"{""src/version.c"": {""insertions"": 2, ""deletions"": 0, ""lines"": 2}, ""src/vim.h"": {""insertions"": 5, ""deletions"": 4, ""lines"": 9}, ""src/viminfo.c"": {""insertions"": 7, ""deletions"": 5, ""lines"": 12}}"
2021-02-10 16:20:28,f3fa18468c0adc4fa645f7c394d7a6d14d3d4352,Bram Moolenaar,44,1,45,5,"{""src/drawline.c"": {""insertions"": 6, ""deletions"": 1, ""lines"": 7}, ""src/testdir/dumps/Test_textprop_nowrap_01.dump"": {""insertions"": 6, ""deletions"": 0, ""lines"": 6}, ""src/testdir/dumps/Test_textprop_nowrap_02.dump"": {""insertions"": 6, ""deletions"": 0, ""lines"": 6}, ""src/testdir/test_textprop.vim"": {""insertions"": 24, ""deletions"": 0, ""lines"": 24}, ""src/version.c"": {""insertions"": 2, ""deletions"": 0, ""lines"": 2}}"
2021-02-10 15:45:24,b17ec4d427f9009eff5dbc3184b26d68b0163edb,Bram Moolenaar,3,1,4,2,"{""src/ex_getln.c"": {""insertions"": 1, ""deletions"": 1, ""lines"": 2}, ""src/version.c"": {""insertions"": 2, ""deletions"": 0, ""lines"": 2}}"
2021-02-10 13:56:11,82db31c10470b0e27d7039d15c32ed7e9417cc02,Bram Moolenaar,81,0,81,6,"{""src/popupwin.c"": {""insertions"": 6, ""deletions"": 0, ""lines"": 6}, ""src/testdir/dumps/Test_popup_prop_not_visible_01.dump"": {""insertions"": 10, ""deletions"": 0, ""lines"": 10}, ""src/testdir/dumps/Test_popup_prop_not_visible_02.dump"": {""insertions"": 10, ""deletions"": 0, ""lines"": 10}, ""src/testdir/dumps/Test_popup_prop_not_visible_03.dump"": {""insertions"": 10, ""deletions"": 0, ""lines"": 10}, ""src/testdir/test_popupwin.vim"": {""insertions"": 43, ""deletions"": 0, ""lines"": 43}, ""src/version.c"": {""insertions"": 2, ""deletions"": 0, ""lines"": 2}}"
2021-02-10 12:18:17,4223d43c0fb6ead1e611e4469a1680a9228b6015,Bram Moolenaar,38,7,45,5,"{""runtime/doc/diff.txt"": {""insertions"": 2, ""deletions"": 2, ""lines"": 4}, ""runtime/doc/options.txt"": {""insertions"": 2, ""deletions"": 0, ""lines"": 2}, ""src/diff.c"": {""insertions"": 17, ""deletions"": 5, ""lines"": 22}, ""src/testdir/test_diffmode.vim"": {""insertions"": 15, ""deletions"": 0, ""lines"": 15}, ""src/version.c"": {""insertions"": 2, ""deletions"": 0, ""lines"": 2}}"
2021-02-09 19:02:55,963ffa0a5a6091655ed72b4590ec5d5a1653bce8,Bram Moolenaar,30,16,46,3,"{""src/evalbuffer.c"": {""insertions"": 17, ""deletions"": 16, ""lines"": 33}, ""src/testdir/test_bufline.vim"": {""insertions"": 11, ""deletions"": 0, ""lines"": 11}, ""src/version.c"": {""insertions"": 2, ""deletions"": 0, ""lines"": 2}}"
2021-02-08 20:53:09,a853089479b60b829bab1c4a0a737a073415f8a7,Bram Moolenaar,9,6,15,4,"{""src/errors.h"": {""insertions"": 2, ""deletions"": 0, ""lines"": 2}, ""src/json.c"": {""insertions"": 1, ""deletions"": 2, ""lines"": 3}, ""src/testdir/test_json.vim"": {""insertions"": 4, ""deletions"": 4, ""lines"": 8}, ""src/version.c"": {""insertions"": 2, ""deletions"": 0, ""lines"": 2}}"
2021-02-08 20:29:48,4549dad874244fe933b969e4ac0b41923ee70dc3,Bram Moolenaar,43,6,49,4,"{""src/libvterm/src/state.c"": {""insertions"": 2, ""deletions"": 1, ""lines"": 3}, ""src/testdir/dumps/Test_terminal_combining.dump"": {""insertions"": 9, ""deletions"": 0, ""lines"": 9}, ""src/testdir/test_terminal.vim"": {""insertions"": 30, ""deletions"": 5, ""lines"": 35}, ""src/version.c"": {""insertions"": 2, ""deletions"": 0, ""lines"": 2}}"
2021-02-07 17:06:29,ba98fb54aefada4c36390add4c7dd90b93e7e5bb,Bram Moolenaar,18,14,32,7,"{""src/dict.c"": {""insertions"": 2, ""deletions"": 2, ""lines"": 4}, ""src/errors.h"": {""insertions"": 2, ""deletions"": 2, ""lines"": 4}, ""src/list.c"": {""insertions"": 2, ""deletions"": 1, ""lines"": 3}, ""src/userfunc.c"": {""insertions"": 2, ""deletions"": 2, ""lines"": 4}, ""src/version.c"": {""insertions"": 2, ""deletions"": 0, ""lines"": 2}, ""src/vim9compile.c"": {""insertions"": 5, ""deletions"": 5, ""lines"": 10}, ""src/vim9type.c"": {""insertions"": 3, ""deletions"": 2, ""lines"": 5}}"
2021-02-07 16:17:58,0123cc1e1422003704cc6941916dd75e61fb7976,Bram Moolenaar,20,2,22,3,"{""src/scriptfile.c"": {""insertions"": 4, ""deletions"": 1, ""lines"": 5}, ""src/testdir/test_vim9_script.vim"": {""insertions"": 14, ""deletions"": 1, ""lines"": 15}, ""src/version.c"": {""insertions"": 2, ""deletions"": 0, ""lines"": 2}}"
2021-02-07 15:40:05,dee37dc733df444df1950eb922a35560e4b113d6,Bram Moolenaar,7,2,9,3,"{""src/ex_docmd.c"": {""insertions"": 1, ""deletions"": 2, ""lines"": 3}, ""src/testdir/test_vim9_script.vim"": {""insertions"": 4, ""deletions"": 0, ""lines"": 4}, ""src/version.c"": {""insertions"": 2, ""deletions"": 0, ""lines"": 2}}"
2021-02-07 15:33:35,6628b7ebff1cfcb476ce96852a7d2b095872826c,Bram Moolenaar,39,0,39,3,"{""src/testdir/test_vim9_script.vim"": {""insertions"": 22, ""deletions"": 0, ""lines"": 22}, ""src/version.c"": {""insertions"": 2, ""deletions"": 0, ""lines"": 2}, ""src/vim9compile.c"": {""insertions"": 15, ""deletions"": 0, ""lines"": 15}}"
2021-02-07 15:05:47,a5a1ec1826c0e43d0282ba4d35c155a97bab3e27,Bram Moolenaar,4,0,4,2,"{""src/errors.h"": {""insertions"": 2, ""deletions"": 0, ""lines"": 2}, ""src/version.c"": {""insertions"": 2, ""deletions"": 0, ""lines"": 2}}"
2021-02-07 14:59:49,4f53b79bf5f8b0de7c6933fd157894ba7a53f35e,Bram Moolenaar,17,0,17,3,"{""src/testdir/test_vim9_func.vim"": {""insertions"": 10, ""deletions"": 0, ""lines"": 10}, ""src/userfunc.c"": {""insertions"": 5, ""deletions"": 0, ""lines"": 5}, ""src/version.c"": {""insertions"": 2, ""deletions"": 0, ""lines"": 2}}"
2021-02-07 14:28:09,c3fc75db023f2acd0b82b7eebffd7ed89e8001ed,Bram Moolenaar,22,18,40,8,"{""src/dict.c"": {""insertions"": 2, ""deletions"": 2, ""lines"": 4}, ""src/errors.h"": {""insertions"": 2, ""deletions"": 2, ""lines"": 4}, ""src/list.c"": {""insertions"": 1, ""deletions"": 1, ""lines"": 2}, ""src/userfunc.c"": {""insertions"": 4, ""deletions"": 4, ""lines"": 8}, ""src/version.c"": {""insertions"": 2, ""deletions"": 0, ""lines"": 2}, ""src/vim9compile.c"": {""insertions"": 6, ""deletions"": 6, ""lines"": 12}, ""src/vim9script.c"": {""insertions"": 1, ""deletions"": 1, ""lines"": 2}, ""src/vim9type.c"": {""insertions"": 4, ""deletions"": 2, ""lines"": 6}}"
2021-02-07 13:31:06,00385114dbd6a3d59516baa02e1ea86a1e7ee70e,Bram Moolenaar,16,10,26,3,"{""src/testdir/test_bufline.vim"": {""insertions"": 7, ""deletions"": 5, ""lines"": 12}, ""src/testdir/test_vim9_builtin.vim"": {""insertions"": 7, ""deletions"": 5, ""lines"": 12}, ""src/version.c"": {""insertions"": 2, ""deletions"": 0, ""lines"": 2}}"
2021-02-07 13:01:35,0dc5f603e9b86da9fe5798c231d8d6170501516e,Bram Moolenaar,6,1,7,2,"{""src/filepath.c"": {""insertions"": 4, ""deletions"": 1, ""lines"": 5}, ""src/version.c"": {""insertions"": 2, ""deletions"": 0, ""lines"": 2}}"
2021-02-07 12:32:46,dd07c02232e91ee963b91a4477179d4b9548b862,Bram Moolenaar,9,1,10,2,"{""src/testdir/test_autocmd.vim"": {""insertions"": 7, ""deletions"": 1, ""lines"": 8}, ""src/version.c"": {""insertions"": 2, ""deletions"": 0, ""lines"": 2}}"
2021-02-07 11:12:43,983d83ff1cd796ff321074335fa53fbe7ac45a46,Bram Moolenaar,26,11,37,7,"{""src/buffer.c"": {""insertions"": 8, ""deletions"": 2, ""lines"": 10}, ""src/errors.h"": {""insertions"": 2, ""deletions"": 0, ""lines"": 2}, ""src/popupwin.c"": {""insertions"": 1, ""deletions"": 1, ""lines"": 2}, ""src/structs.h"": {""insertions"": 2, ""deletions"": 0, ""lines"": 2}, ""src/testdir/test_autocmd.vim"": {""insertions"": 3, ""deletions"": 6, ""lines"": 9}, ""src/version.c"": {""insertions"": 2, ""deletions"": 0, ""lines"": 2}, ""src/window.c"": {""insertions"": 8, ""deletions"": 2, ""lines"": 10}}"
2021-02-06 18:28:48,dfc3db76b9de217542cc9258301c1b4818a51cd0,Bram Moolenaar,5,0,5,2,"{""src/testdir/test_autocmd.vim"": {""insertions"": 3, ""deletions"": 0, ""lines"": 3}, ""src/version.c"": {""insertions"": 2, ""deletions"": 0, ""lines"": 2}}"
2021-02-06 18:19:42,2c7080bf1ceef4a7779644fd428b2386a0676794,Bram Moolenaar,18,0,18,3,"{""src/quickfix.c"": {""insertions"": 2, ""deletions"": 0, ""lines"": 2}, ""src/testdir/test_autocmd.vim"": {""insertions"": 14, ""deletions"": 0, ""lines"": 14}, ""src/version.c"": {""insertions"": 2, ""deletions"": 0, ""lines"": 2}}"
2021-02-06 17:08:45,8c6951fa2836a1ae3257770e7b927a9380439912,Bram Moolenaar,14,3,17,3,"{""src/ex_getln.c"": {""insertions"": 3, ""deletions"": 3, ""lines"": 6}, ""src/testdir/test_autocmd.vim"": {""insertions"": 9, ""deletions"": 0, ""lines"": 9}, ""src/version.c"": {""insertions"": 2, ""deletions"": 0, ""lines"": 2}}"
2021-02-06 16:30:31,aad5f9d79a2b71e9d2581eace3652be156102b9d,Bram Moolenaar,27,5,32,3,"{""src/ex_cmds.c"": {""insertions"": 8, ""deletions"": 3, ""lines"": 11}, ""src/testdir/test_autocmd.vim"": {""insertions"": 17, ""deletions"": 2, ""lines"": 19}, ""src/version.c"": {""insertions"": 2, ""deletions"": 0, ""lines"": 2}}"
2021-02-06 13:59:27,efa1923565f0669d5bc09714b22a3b50cde03785,Bram Moolenaar,22,1,23,3,"{""src/popupwin.c"": {""insertions"": 1, ""deletions"": 1, ""lines"": 2}, ""src/testdir/test_popupwin.vim"": {""insertions"": 19, ""deletions"": 0, ""lines"": 19}, ""src/version.c"": {""insertions"": 2, ""deletions"": 0, ""lines"": 2}}"
2021-02-06 13:22:32,650264367725af6740b94cfd24d9f5caf0e91356,Bram Moolenaar,17,1,18,3,"{""src/popupwin.c"": {""insertions"": 1, ""deletions"": 1, ""lines"": 2}, ""src/testdir/test_popupwin.vim"": {""insertions"": 14, ""deletions"": 0, ""lines"": 14}, ""src/version.c"": {""insertions"": 2, ""deletions"": 0, ""lines"": 2}}"
2021-02-06 11:58:18,f5a5116a96b1877c3f44e7bae288fd6603151eb1,Bram Moolenaar,10,0,10,3,"{""src/ex_docmd.c"": {""insertions"": 5, ""deletions"": 0, ""lines"": 5}, ""src/testdir/test_excmd.vim"": {""insertions"": 3, ""deletions"": 0, ""lines"": 3}, ""src/version.c"": {""insertions"": 2, ""deletions"": 0, ""lines"": 2}}"
2021-02-06 11:38:51,038e09ee7645731de0296d255aabb17603276443,Bram Moolenaar,86,0,86,7,"{""runtime/doc/eval.txt"": {""insertions"": 16, ""deletions"": 0, ""lines"": 16}, ""runtime/doc/usr_41.txt"": {""insertions"": 1, ""deletions"": 0, ""lines"": 1}, ""src/evalfunc.c"": {""insertions"": 2, ""deletions"": 0, ""lines"": 2}, ""src/ex_docmd.c"": {""insertions"": 27, ""deletions"": 0, ""lines"": 27}, ""src/proto/evalfunc.pro"": {""insertions"": 1, ""deletions"": 0, ""lines"": 1}, ""src/testdir/test_cmdline.vim"": {""insertions"": 37, ""deletions"": 0, ""lines"": 37}, ""src/version.c"": {""insertions"": 2, ""deletions"": 0, ""lines"": 2}}"
2021-02-05 20:55:53,139348f3e8370826a1ceb10c73f7c7bb586f8125,Bram Moolenaar,18,1,19,3,"{""src/session.c"": {""insertions"": 2, ""deletions"": 1, ""lines"": 3}, ""src/testdir/test_mksession.vim"": {""insertions"": 14, ""deletions"": 0, ""lines"": 14}, ""src/version.c"": {""insertions"": 2, ""deletions"": 0, ""lines"": 2}}"
2021-02-04 21:07:16,ab65fc77c5389f7d3f788bbdc3d931561feab131,Bram Moolenaar,18,1,19,3,"{""src/evalfunc.c"": {""insertions"": 8, ""deletions"": 1, ""lines"": 9}, ""src/testdir/test_functions.vim"": {""insertions"": 8, ""deletions"": 0, ""lines"": 8}, ""src/version.c"": {""insertions"": 2, ""deletions"": 0, ""lines"": 2}}"
2021-02-03 22:04:46,92bb83e41ca42d0d00d21753810d92485c808a50,Bram Moolenaar,29,3,32,3,"{""src/search.c"": {""insertions"": 2, ""deletions"": 0, ""lines"": 2}, ""src/testdir/test_autocmd.vim"": {""insertions"": 25, ""deletions"": 3, ""lines"": 28}, ""src/version.c"": {""insertions"": 2, ""deletions"": 0, ""lines"": 2}}"
2021-02-03 20:56:59,8ab375706e6712308f8cf7529bcae56684a6f385,Bram Moolenaar,16,1,17,3,"{""src/ex_cmds.c"": {""insertions"": 3, ""deletions"": 1, ""lines"": 4}, ""src/testdir/test_autocmd.vim"": {""insertions"": 11, ""deletions"": 0, ""lines"": 11}, ""src/version.c"": {""insertions"": 2, ""deletions"": 0, ""lines"": 2}}"
2021-02-03 20:23:29,6bcb877ec19a647443195a54eeac60cb693fd827,Bram Moolenaar,15,0,15,3,"{""src/arglist.c"": {""insertions"": 4, ""deletions"": 0, ""lines"": 4}, ""src/testdir/test_autocmd.vim"": {""insertions"": 9, ""deletions"": 0, ""lines"": 9}, ""src/version.c"": {""insertions"": 2, ""deletions"": 0, ""lines"": 2}}"
2021-02-03 19:14:23,2c363a2e95ee0b366e72063d093d20e025ef4a66,Bram Moolenaar,7,1,8,2,"{""src/spellfile.c"": {""insertions"": 5, ""deletions"": 1, ""lines"": 6}, ""src/version.c"": {""insertions"": 2, ""deletions"": 0, ""lines"": 2}}"
2021-02-03 19:01:19,fef8064b54ad0b1a7ce2f9cf024526627e6bdf57,Bram Moolenaar,4,2,6,2,"{""src/version.c"": {""insertions"": 2, ""deletions"": 0, ""lines"": 2}, ""src/vim9execute.c"": {""insertions"": 2, ""deletions"": 2, ""lines"": 4}}"
2021-02-03 18:57:00,fc1dafa91cbf7876d711e8e36171eeec78eae13b,Bram Moolenaar,2,1,3,2,"{""src/version.c"": {""insertions"": 2, ""deletions"": 0, ""lines"": 2}, ""src/vim9compile.c"": {""insertions"": 0, ""deletions"": 1, ""lines"": 1}}"
2021-02-03 18:51:18,8bead9a058907e7f10ad25893d8475d2d9dd173c,Bram Moolenaar,2,2,4,2,"{""src/eval.c"": {""insertions"": 0, ""deletions"": 2, ""lines"": 2}, ""src/version.c"": {""insertions"": 2, ""deletions"": 0, ""lines"": 2}}"
2021-02-03 18:44:25,0dcd39bad5e5aa70ba8f60cb3fbf0658585f0151,Bram Moolenaar,5,1,6,2,"{""src/indent.c"": {""insertions"": 3, ""deletions"": 1, ""lines"": 4}, ""src/version.c"": {""insertions"": 2, ""deletions"": 0, ""lines"": 2}}"
2021-02-03 18:35:13,4dba04256b8a49b201d685217d3d7abc4988f090,Bram Moolenaar,5,0,5,2,"{""src/if_cscope.c"": {""insertions"": 3, ""deletions"": 0, ""lines"": 3}, ""src/version.c"": {""insertions"": 2, ""deletions"": 0, ""lines"": 2}}"
2021-02-03 18:31:29,7b6903f02c9eeb12cd85941ea0d352d84e4dab30,Bram Moolenaar,5,1,6,2,"{""src/userfunc.c"": {""insertions"": 3, ""deletions"": 1, ""lines"": 4}, ""src/version.c"": {""insertions"": 2, ""deletions"": 0, ""lines"": 2}}"
2021-02-03 16:41:24,2e5910bfbb05957c10c9c69756dfa342557e9a8b,Bram Moolenaar,74,38,112,8,"{""runtime/doc/vim9.txt"": {""insertions"": 6, ""deletions"": 0, ""lines"": 6}, ""src/dict.c"": {""insertions"": 5, ""deletions"": 3, ""lines"": 8}, ""src/eval.c"": {""insertions"": 16, ""deletions"": 4, ""lines"": 20}, ""src/testdir/test_vim9_builtin.vim"": {""insertions"": 5, ""deletions"": 5, ""lines"": 10}, ""src/testdir/test_vim9_expr.vim"": {""insertions"": 27, ""deletions"": 15, ""lines"": 42}, ""src/testdir/test_vim9_script.vim"": {""insertions"": 2, ""deletions"": 2, ""lines"": 4}, ""src/version.c"": {""insertions"": 2, ""deletions"": 0, ""lines"": 2}, ""src/vim9compile.c"": {""insertions"": 11, ""deletions"": 9, ""lines"": 20}}"
2021-02-03 14:58:13,91478ae49a1b2dc1de63821db731a343e855dcc0,Bram Moolenaar,81,8,89,7,"{""runtime/doc/options.txt"": {""insertions"": 4, ""deletions"": 0, ""lines"": 4}, ""src/drawline.c"": {""insertions"": 20, ""deletions"": 3, ""lines"": 23}, ""src/globals.h"": {""insertions"": 1, ""deletions"": 0, ""lines"": 1}, ""src/message.c"": {""insertions"": 24, ""deletions"": 5, ""lines"": 29}, ""src/screen.c"": {""insertions"": 1, ""deletions"": 0, ""lines"": 1}, ""src/testdir/test_listchars.vim"": {""insertions"": 29, ""deletions"": 0, ""lines"": 29}, ""src/version.c"": {""insertions"": 2, ""deletions"": 0, ""lines"": 2}}"
2021-02-02 20:33:52,148be9bc1cca16ce47ad21563f5835682001f9a2,Bram Moolenaar,35,0,35,3,"{""src/ex_docmd.c"": {""insertions"": 10, ""deletions"": 0, ""lines"": 10}, ""src/testdir/test_vim9_cmd.vim"": {""insertions"": 23, ""deletions"": 0, ""lines"": 23}, ""src/version.c"": {""insertions"": 2, ""deletions"": 0, ""lines"": 2}}"
2021-02-02 20:10:01,d5e8c92816f35ea1a9298084238a08f35958baa6,Bram Moolenaar,15,1,16,4,"{""src/option.c"": {""insertions"": 6, ""deletions"": 0, ""lines"": 6}, ""src/optiondefs.h"": {""insertions"": 1, ""deletions"": 1, ""lines"": 2}, ""src/testdir/test_options.vim"": {""insertions"": 6, ""deletions"": 0, ""lines"": 6}, ""src/version.c"": {""insertions"": 2, ""deletions"": 0, ""lines"": 2}}"
2021-02-01 19:50:37,e7bebc495d4014d7bc81f863939c35268cb8e97d,Bram Moolenaar,182,0,182,2,"{""src/os_win32.c"": {""insertions"": 180, ""deletions"": 0, ""lines"": 180}, ""src/version.c"": {""insertions"": 2, ""deletions"": 0, ""lines"": 2}}"
2021-02-01 19:35:01,7781ebe50f6d4daba02be3bd7e6ca08cd459674b,Bram Moolenaar,6,6,12,2,"{""src/bufwrite.c"": {""insertions"": 4, ""deletions"": 6, ""lines"": 10}, ""src/version.c"": {""insertions"": 2, ""deletions"": 0, ""lines"": 2}}"
2021-02-01 19:14:51,3b690069730805a147d45d92eaca4dc838272d1d,Bram Moolenaar,98,14,112,10,"{""runtime/doc/eval.txt"": {""insertions"": 9, ""deletions"": 1, ""lines"": 10}, ""runtime/doc/usr_41.txt"": {""insertions"": 1, ""deletions"": 0, ""lines"": 1}, ""src/errors.h"": {""insertions"": 2, ""deletions"": 0, ""lines"": 2}, ""src/evalfunc.c"": {""insertions"": 2, ""deletions"": 0, ""lines"": 2}, ""src/list.c"": {""insertions"": 49, ""deletions"": 13, ""lines"": 62}, ""src/proto/list.pro"": {""insertions"": 1, ""deletions"": 0, ""lines"": 1}, ""src/testdir/test_flatten.vim"": {""insertions"": 9, ""deletions"": 0, ""lines"": 9}, ""src/testdir/test_vim9_builtin.vim"": {""insertions"": 17, ""deletions"": 0, ""lines"": 17}, ""src/version.c"": {""insertions"": 2, ""deletions"": 0, ""lines"": 2}, ""src/vim9compile.c"": {""insertions"": 6, ""deletions"": 0, ""lines"": 6}}"
2021-02-01 18:31:47,9d20daffc296b9eb901fb14bdd83620ea55d440a,Bram Moolenaar,9,5,14,2,"{""src/if_ruby.c"": {""insertions"": 7, ""deletions"": 5, ""lines"": 12}, ""src/version.c"": {""insertions"": 2, ""deletions"": 0, ""lines"": 2}}"
2021-02-01 18:24:55,f9547eb6ef02e305203b859d2dcfdae930b9d544,Bram Moolenaar,31,2,33,3,"{""src/fold.c"": {""insertions"": 3, ""deletions"": 2, ""lines"": 5}, ""src/testdir/test_mksession.vim"": {""insertions"": 26, ""deletions"": 0, ""lines"": 26}, ""src/version.c"": {""insertions"": 2, ""deletions"": 0, ""lines"": 2}}"
2021-02-01 17:39:47,5daa91162699e4f8b54f9d1caaaab2715038941c,Bram Moolenaar,4,4,8,3,"{""src/optionstr.c"": {""insertions"": 1, ""deletions"": 1, ""lines"": 2}, ""src/testdir/test_options.vim"": {""insertions"": 1, ""deletions"": 3, ""lines"": 4}, ""src/version.c"": {""insertions"": 2, ""deletions"": 0, ""lines"": 2}}"
2021-01-31 21:18:29,0346b799fc228a3b48967ca0747e6b23586dbaa6,Bram Moolenaar,18,1,19,4,"{""src/errors.h"": {""insertions"": 2, ""deletions"": 0, ""lines"": 2}, ""src/testdir/test_vim9_func.vim"": {""insertions"": 7, ""deletions"": 0, ""lines"": 7}, ""src/userfunc.c"": {""insertions"": 7, ""deletions"": 1, ""lines"": 8}, ""src/version.c"": {""insertions"": 2, ""deletions"": 0, ""lines"": 2}}"
2021-01-31 20:47:42,e507ff15d52653dad3054ddc0073708977621c0c,Bram Moolenaar,11,2,13,3,"{""src/testdir/test_vim9_expr.vim"": {""insertions"": 3, ""deletions"": 0, ""lines"": 3}, ""src/version.c"": {""insertions"": 2, ""deletions"": 0, ""lines"": 2}, ""src/vim9compile.c"": {""insertions"": 6, ""deletions"": 2, ""lines"": 8}}"
2021-01-31 19:48:58,80ad3e25697cf759d5af5cd13e8b124c1cd657f5,Bram Moolenaar,16,1,17,3,"{""src/evalfunc.c"": {""insertions"": 2, ""deletions"": 1, ""lines"": 3}, ""src/testdir/test_vim9_builtin.vim"": {""insertions"": 12, ""deletions"": 0, ""lines"": 12}, ""src/version.c"": {""insertions"": 2, ""deletions"": 0, ""lines"": 2}}"
2021-01-31 18:52:50,f272ae12ac064856b710046393d5bf9b1670076d,Bram Moolenaar,22,0,22,3,"{""src/auto/configure"": {""insertions"": 9, ""deletions"": 0, ""lines"": 9}, ""src/configure.ac"": {""insertions"": 11, ""deletions"": 0, ""lines"": 11}, ""src/version.c"": {""insertions"": 2, ""deletions"": 0, ""lines"": 2}}"
2021-01-31 16:48:30,c03f5c677a1fba99d2379550ccf2391eaa43e2ac,Bram Moolenaar,48,25,73,3,"{""src/list.c"": {""insertions"": 26, ""deletions"": 8, ""lines"": 34}, ""src/testdir/test_vim9_builtin.vim"": {""insertions"": 20, ""deletions"": 17, ""lines"": 37}, ""src/version.c"": {""insertions"": 2, ""deletions"": 0, ""lines"": 2}}"
2021-01-31 16:03:52,853886722c051ecaef6d818ce32a822e4f43dc2b,Bram Moolenaar,19,155,174,7,"{""runtime/doc/autocmd.txt"": {""insertions"": 3, ""deletions"": 2, ""lines"": 5}, ""runtime/doc/cmdline.txt"": {""insertions"": 1, ""deletions"": 1, ""lines"": 2}, ""runtime/doc/hangulin.txt"": {""insertions"": 1, ""deletions"": 1, ""lines"": 2}, ""runtime/doc/todo.txt"": {""insertions"": 7, ""deletions"": 147, ""lines"": 154}, ""runtime/doc/various.txt"": {""insertions"": 3, ""deletions"": 2, ""lines"": 5}, ""runtime/doc/version8.txt"": {""insertions"": 2, ""deletions"": 2, ""lines"": 4}, ""src/version.c"": {""insertions"": 2, ""deletions"": 0, ""lines"": 2}}"
2021-01-31 15:45:53,3d2bb8b6f152c0c5056f49bccb350683a9ba2e13,Bram Moolenaar,43,1,44,2,"{""src/INSTALL"": {""insertions"": 41, ""deletions"": 1, ""lines"": 42}, ""src/version.c"": {""insertions"": 2, ""deletions"": 0, ""lines"": 2}}"
2021-01-31 13:46:00,6a12e3342d84a1d754d793ed5019778bd60e7494,Bram Moolenaar,4,2,6,2,"{""src/structs.h"": {""insertions"": 2, ""deletions"": 2, ""lines"": 4}, ""src/version.c"": {""insertions"": 2, ""deletions"": 0, ""lines"": 2}}"
2021-01-31 13:36:06,4d8479b335e92a95b09fdee09309ea0df934cb9e,Bram Moolenaar,4,2,6,3,"{""src/auto/configure"": {""insertions"": 1, ""deletions"": 1, ""lines"": 2}, ""src/configure.ac"": {""insertions"": 1, ""deletions"": 1, ""lines"": 2}, ""src/version.c"": {""insertions"": 2, ""deletions"": 0, ""lines"": 2}}"
2021-01-31 13:04:44,206c2a6e19475ab664ca4cea3df8e42313d3a4c5,Bram Moolenaar,4,1,5,2,"{""src/testdir/test_vim9_script.vim"": {""insertions"": 2, ""deletions"": 1, ""lines"": 3}, ""src/version.c"": {""insertions"": 2, ""deletions"": 0, ""lines"": 2}}"
2021-01-31 12:08:38,3445320839a38b3b0c253513b125da8298ec27d6,Bram Moolenaar,96,20,116,9,"{""runtime/doc/eval.txt"": {""insertions"": 7, ""deletions"": 4, ""lines"": 11}, ""src/debugger.c"": {""insertions"": 6, ""deletions"": 6, ""lines"": 12}, ""src/evalbuffer.c"": {""insertions"": 6, ""deletions"": 3, ""lines"": 9}, ""src/proto/typval.pro"": {""insertions"": 1, ""deletions"": 1, ""lines"": 2}, ""src/testdir/test_bufline.vim"": {""insertions"": 7, ""deletions"": 0, ""lines"": 7}, ""src/testdir/test_vim9_builtin.vim"": {""insertions"": 48, ""deletions"": 0, ""lines"": 48}, ""src/typval.c"": {""insertions"": 18, ""deletions"": 5, ""lines"": 23}, ""src/version.c"": {""insertions"": 2, ""deletions"": 0, ""lines"": 2}, ""src/vim9execute.c"": {""insertions"": 1, ""deletions"": 1, ""lines"": 2}}"
2021-01-30 22:05:11,f2b26bcf8f498fed72759af4aa768fb2aab3118c,Bram Moolenaar,50,2,52,5,"{""src/evalfunc.c"": {""insertions"": 15, ""deletions"": 2, ""lines"": 17}, ""src/proto/typval.pro"": {""insertions"": 2, ""deletions"": 0, ""lines"": 2}, ""src/testdir/test_vim9_builtin.vim"": {""insertions"": 7, ""deletions"": 0, ""lines"": 7}, ""src/typval.c"": {""insertions"": 24, ""deletions"": 0, ""lines"": 24}, ""src/version.c"": {""insertions"": 2, ""deletions"": 0, ""lines"": 2}}"
2021-01-30 20:40:03,b63f3ca66db20f7b135aae706d36be538f91f8cc,Bram Moolenaar,12,0,12,3,"{""src/ex_cmds.c"": {""insertions"": 9, ""deletions"": 0, ""lines"": 9}, ""src/testdir/test_cmdline.vim"": {""insertions"": 1, ""deletions"": 0, ""lines"": 1}, ""src/version.c"": {""insertions"": 2, ""deletions"": 0, ""lines"": 2}}"
2021-01-30 19:35:28,76ab5446d530a1c81ead0ee42cb55b4a4d515bad,Bram Moolenaar,6,1,7,2,"{""src/Makefile"": {""insertions"": 4, ""deletions"": 1, ""lines"": 5}, ""src/version.c"": {""insertions"": 2, ""deletions"": 0, ""lines"": 2}}"
2021-01-30 18:33:36,ebd211c8a39871c88189c8cda9e624eb30b300b3,Bram Moolenaar,6,3,9,3,"{""src/auto/configure"": {""insertions"": 2, ""deletions"": 2, ""lines"": 4}, ""src/configure.ac"": {""insertions"": 2, ""deletions"": 1, ""lines"": 3}, ""src/version.c"": {""insertions"": 2, ""deletions"": 0, ""lines"": 2}}"
2021-01-30 17:09:06,f8c6a1718007432812184c28495e8d27ee6c0395,Bram Moolenaar,12,3,15,4,"{""src/arglist.c"": {""insertions"": 2, ""deletions"": 2, ""lines"": 4}, ""src/quickfix.c"": {""insertions"": 1, ""deletions"": 1, ""lines"": 2}, ""src/testdir/test_quickfix.vim"": {""insertions"": 7, ""deletions"": 0, ""lines"": 7}, ""src/version.c"": {""insertions"": 2, ""deletions"": 0, ""lines"": 2}}"
2021-01-30 16:16:28,59ff64079b4fcf0393a7413e3242a8b58c2ceadb,Bram Moolenaar,55,11,66,3,"{""src/memline.c"": {""insertions"": 23, ""deletions"": 11, ""lines"": 34}, ""src/testdir/test_textprop.vim"": {""insertions"": 30, ""deletions"": 0, ""lines"": 30}, ""src/version.c"": {""insertions"": 2, ""deletions"": 0, ""lines"": 2}}"
2021-01-30 14:39:47,92e5df804719d2e6cb8145c2b098aa8d6f3dd252,Bram Moolenaar,57,5,62,3,"{""src/term.c"": {""insertions"": 26, ""deletions"": 4, ""lines"": 30}, ""src/testdir/test_termcodes.vim"": {""insertions"": 29, ""deletions"": 1, ""lines"": 30}, ""src/version.c"": {""insertions"": 2, ""deletions"": 0, ""lines"": 2}}"
2021-01-29 20:47:24,3eb6bd9c2b36dcce471bfb543c8d5488f1dc17a4,Bram Moolenaar,7,24,31,4,"{""src/insexpand.c"": {""insertions"": 2, ""deletions"": 19, ""lines"": 21}, ""src/testdir/test_ins_complete.vim"": {""insertions"": 1, ""deletions"": 1, ""lines"": 2}, ""src/testdir/test_popup.vim"": {""insertions"": 2, ""deletions"": 4, ""lines"": 6}, ""src/version.c"": {""insertions"": 2, ""deletions"": 0, ""lines"": 2}}"
2021-01-29 20:07:07,28976e2accf11591c60e8a658a9e03544f0408b2,Bram Moolenaar,17,21,38,4,"{""src/insexpand.c"": {""insertions"": 6, ""deletions"": 5, ""lines"": 11}, ""src/testdir/test_ins_complete.vim"": {""insertions"": 6, ""deletions"": 13, ""lines"": 19}, ""src/testdir/test_popup.vim"": {""insertions"": 3, ""deletions"": 3, ""lines"": 6}, ""src/version.c"": {""insertions"": 2, ""deletions"": 0, ""lines"": 2}}"
2021-01-28 19:18:08,df2c2988bbaecd28b0fbec8d64327b1bbb005e19,Bram Moolenaar,9,0,9,3,"{""src/ex_cmds.c"": {""insertions"": 2, ""deletions"": 0, ""lines"": 2}, ""src/testdir/test_eval_stuff.vim"": {""insertions"": 5, ""deletions"": 0, ""lines"": 5}, ""src/version.c"": {""insertions"": 2, ""deletions"": 0, ""lines"": 2}}"
2021-01-28 17:34:35,97202d951685fc4d90085da676a90644cbf72571,Bram Moolenaar,37,20,57,5,"{""src/testdir/check.vim"": {""insertions"": 8, ""deletions"": 0, ""lines"": 8}, ""src/testdir/test_ex_mode.vim"": {""insertions"": 3, ""deletions"": 0, ""lines"": 3}, ""src/testdir/test_ins_complete.vim"": {""insertions"": 21, ""deletions"": 15, ""lines"": 36}, ""src/testdir/test_memory_usage.vim"": {""insertions"": 3, ""deletions"": 5, ""lines"": 8}, ""src/version.c"": {""insertions"": 2, ""deletions"": 0, ""lines"": 2}}"
2021-01-28 16:56:09,61015162ba834541c42da5db6f3fa0ebe1d40e87,Bram Moolenaar,4,0,4,2,"{""src/errors.h"": {""insertions"": 2, ""deletions"": 0, ""lines"": 2}, ""src/version.c"": {""insertions"": 2, ""deletions"": 0, ""lines"": 2}}"
2021-01-28 16:24:58,1d859e24218635c57c09801840ff159cb845ae6a,Bram Moolenaar,23,1,24,3,"{""src/normal.c"": {""insertions"": 5, ""deletions"": 1, ""lines"": 6}, ""src/testdir/test_ex_mode.vim"": {""insertions"": 16, ""deletions"": 0, ""lines"": 16}, ""src/version.c"": {""insertions"": 2, ""deletions"": 0, ""lines"": 2}}"
2021-01-28 13:24:55,5ed58c7b700fcb9fd03c418300145b616f4bdcdd,Bram Moolenaar,46,9,55,3,"{""src/arglist.c"": {""insertions"": 38, ""deletions"": 9, ""lines"": 47}, ""src/testdir/test_autocmd.vim"": {""insertions"": 6, ""deletions"": 0, ""lines"": 6}, ""src/version.c"": {""insertions"": 2, ""deletions"": 0, ""lines"": 2}}"
2021-01-28 12:47:59,9a046fd08bcae319d39a4dbde2be81decee19013,Bram Moolenaar,23,27,50,6,"{""src/autocmd.c"": {""insertions"": 8, ""deletions"": 5, ""lines"": 13}, ""src/errors.h"": {""insertions"": 2, ""deletions"": 0, ""lines"": 2}, ""src/testdir/test_autocmd.vim"": {""insertions"": 3, ""deletions"": 14, ""lines"": 17}, ""src/testdir/test_quickfix.vim"": {""insertions"": 6, ""deletions"": 6, ""lines"": 12}, ""src/testdir/test_window_cmd.vim"": {""insertions"": 2, ""deletions"": 2, ""lines"": 4}, ""src/version.c"": {""insertions"": 2, ""deletions"": 0, ""lines"": 2}}"
2021-01-28 11:08:35,d697ddea1466d877a79f8c56d46361dc54e9baef,Bram Moolenaar,2,9,11,2,"{""src/testdir/test_autocmd.vim"": {""insertions"": 0, ""deletions"": 9, ""lines"": 9}, ""src/version.c"": {""insertions"": 2, ""deletions"": 0, ""lines"": 2}}"
2021-01-28 10:07:44,2e6cdb91e8dea08301f31bc83188c06112eb7f57,Bram Moolenaar,6,0,6,2,"{""src/edit.c"": {""insertions"": 4, ""deletions"": 0, ""lines"": 4}, ""src/version.c"": {""insertions"": 2, ""deletions"": 0, ""lines"": 2}}"
2021-01-27 20:37:13,3e492c2d5fbd4ae395ffddfc059a3c414604b951,Bram Moolenaar,9,0,9,2,"{""src/ex_eval.c"": {""insertions"": 7, ""deletions"": 0, ""lines"": 7}, ""src/version.c"": {""insertions"": 2, ""deletions"": 0, ""lines"": 2}}"
2021-01-27 19:34:29,bed72df3e61a8908ed6324212595118f305dded0,Bram Moolenaar,12,3,15,3,"{""src/ex_getln.c"": {""insertions"": 1, ""deletions"": 0, ""lines"": 1}, ""src/testdir/test_arglist.vim"": {""insertions"": 9, ""deletions"": 3, ""lines"": 12}, ""src/version.c"": {""insertions"": 2, ""deletions"": 0, ""lines"": 2}}"
2021-01-26 21:42:21,21829c5f2c86cd525c8468121b4fc54c5d75bf6e,Bram Moolenaar,53,13,66,11,"{""runtime/doc/cmdline.txt"": {""insertions"": 1, ""deletions"": 1, ""lines"": 2}, ""src/evalfunc.c"": {""insertions"": 7, ""deletions"": 0, ""lines"": 7}, ""src/testdir/test_arglist.vim"": {""insertions"": 6, ""deletions"": 1, ""lines"": 7}, ""src/testdir/test_autocmd.vim"": {""insertions"": 2, ""deletions"": 4, ""lines"": 6}, ""src/testdir/test_cmdline.vim"": {""insertions"": 22, ""deletions"": 4, ""lines"": 26}, ""src/testdir/test_ins_complete.vim"": {""insertions"": 2, ""deletions"": 0, ""lines"": 2}, ""src/testdir/test_normal.vim"": {""insertions"": 5, ""deletions"": 3, ""lines"": 8}, ""src/testdir/test_tabpage.vim"": {""insertions"": 2, ""deletions"": 0, ""lines"": 2}, ""src/testdir/test_termcodes.vim"": {""insertions"": 2, ""deletions"": 0, ""lines"": 2}, ""src/testdir/test_window_cmd.vim"": {""insertions"": 2, ""deletions"": 0, ""lines"": 2}, ""src/version.c"": {""insertions"": 2, ""deletions"": 0, ""lines"": 2}}"
2021-01-26 21:00:52,b7e2670b6a1de02c772af5097ba24f2a15b26eec,Bram Moolenaar,8,1,9,2,"{""src/ex_getln.c"": {""insertions"": 6, ""deletions"": 1, ""lines"": 7}, ""src/version.c"": {""insertions"": 2, ""deletions"": 0, ""lines"": 2}}"
2021-01-26 20:35:08,bb4b93ed85726c3921596ca267f531c8c94d819a,Bram Moolenaar,20,1,21,4,"{""src/arglist.c"": {""insertions"": 7, ""deletions"": 0, ""lines"": 7}, ""src/ex_getln.c"": {""insertions"": 3, ""deletions"": 1, ""lines"": 4}, ""src/testdir/test_arglist.vim"": {""insertions"": 8, ""deletions"": 0, ""lines"": 8}, ""src/version.c"": {""insertions"": 2, ""deletions"": 0, ""lines"": 2}}"
2021-01-26 18:32:53,ce0370d9e67df80c62ff033aa8ca2dbe86841de9,Bram Moolenaar,3,4,7,2,"{""src/ex_docmd.c"": {""insertions"": 1, ""deletions"": 4, ""lines"": 5}, ""src/version.c"": {""insertions"": 2, ""deletions"": 0, ""lines"": 2}}"
2021-01-26 11:06:30,98989a00145cc4f5783bcc12a2968a2f716eabb9,Bram Moolenaar,8,1,9,2,"{""src/testdir/test_profile.vim"": {""insertions"": 6, ""deletions"": 1, ""lines"": 7}, ""src/version.c"": {""insertions"": 2, ""deletions"": 0, ""lines"": 2}}"
2021-01-25 22:02:38,ff0e57fe77b1a87a034191c629730b081f6fb7ad,Bram Moolenaar,3,1,4,2,"{""src/version.c"": {""insertions"": 2, ""deletions"": 0, ""lines"": 2}, ""src/vim9.h"": {""insertions"": 1, ""deletions"": 1, ""lines"": 2}}"
2021-01-25 20:14:57,e0e3917554327f2524066f89fbbef9c83c1535da,Bram Moolenaar,479,134,613,32,"{"".github/CODEOWNERS"": {""insertions"": 5, ""deletions"": 0, ""lines"": 5}, ""runtime/compiler/fbc.vim"": {""insertions"": 27, ""deletions"": 0, ""lines"": 27}, ""runtime/compiler/tidy.vim"": {""insertions"": 12, ""deletions"": 5, ""lines"": 17}, ""runtime/doc/change.txt"": {""insertions"": 20, ""deletions"": 2, ""lines"": 22}, ""runtime/doc/eval.txt"": {""insertions"": 2, ""deletions"": 2, ""lines"": 4}, ""runtime/doc/filetype.txt"": {""insertions"": 1, ""deletions"": 1, ""lines"": 2}, ""runtime/doc/popup.txt"": {""insertions"": 1, ""deletions"": 1, ""lines"": 2}, ""runtime/doc/syntax.txt"": {""insertions"": 1, ""deletions"": 1, ""lines"": 2}, ""runtime/doc/tags"": {""insertions"": 24, ""deletions"": 0, ""lines"": 24}, ""runtime/doc/todo.txt"": {""insertions"": 12, ""deletions"": 12, ""lines"": 24}, ""runtime/doc/vi_diff.txt"": {""insertions"": 1, ""deletions"": 1, ""lines"": 2}, ""runtime/doc/vim9.txt"": {""insertions"": 10, ""deletions"": 1, ""lines"": 11}, ""runtime/filetype.vim"": {""insertions"": 1, ""deletions"": 1, ""lines"": 2}, ""runtime/ftplugin/ada.vim"": {""insertions"": 35, ""deletions"": 34, ""lines"": 69}, ""runtime/ftplugin/basic.vim"": {""insertions"": 27, ""deletions"": 0, ""lines"": 27}, ""runtime/ftplugin/bzl.vim"": {""insertions"": 3, ""deletions"": 1, ""lines"": 4}, ""runtime/ftplugin/framescript.vim"": {""insertions"": 3, ""deletions"": 3, ""lines"": 6}, ""runtime/ftplugin/freebasic.vim"": {""insertions"": 13, ""deletions"": 0, ""lines"": 13}, ""runtime/ftplugin/hamster.vim"": {""insertions"": 5, ""deletions"": 2, ""lines"": 7}, ""runtime/ftplugin/ocaml.vim"": {""insertions"": 3, ""deletions"": 1, ""lines"": 4}, ""runtime/ftplugin/tidy.vim"": {""insertions"": 32, ""deletions"": 0, ""lines"": 32}, ""runtime/ftplugin/vim.vim"": {""insertions"": 7, ""deletions"": 2, ""lines"": 9}, ""runtime/indent/fortran.vim"": {""insertions"": 5, ""deletions"": 1, ""lines"": 6}, ""runtime/indent/testdir/vim.in"": {""insertions"": 5, ""deletions"": 0, ""lines"": 5}, ""runtime/indent/testdir/vim.ok"": {""insertions"": 5, ""deletions"": 0, ""lines"": 5}, ""runtime/indent/vim.vim"": {""insertions"": 8, ""deletions"": 3, ""lines"": 11}, ""runtime/indent/yaml.vim"": {""insertions"": 4, ""deletions"": 4, ""lines"": 8}, ""runtime/syntax/basic.vim"": {""insertions"": 36, ""deletions"": 26, ""lines"": 62}, ""runtime/syntax/tidy.vim"": {""insertions"": 168, ""deletions"": 27, ""lines"": 195}, ""runtime/tutor/tutor.ko"": {""insertions"": 1, ""deletions"": 1, ""lines"": 2}, ""runtime/tutor/tutor.ko.euc"": {""insertions"": 1, ""deletions"": 1, ""lines"": 2}, ""runtime/tutor/tutor.ko.utf-8"": {""insertions"": 1, ""deletions"": 1, ""lines"": 2}}"
2021-01-25 20:01:48,e5ea346a07a7750c02a89996b67716b43c767d06,Bram Moolenaar,54,26,80,5,"{""src/testdir/test_profile.vim"": {""insertions"": 18, ""deletions"": 0, ""lines"": 18}, ""src/version.c"": {""insertions"": 2, ""deletions"": 0, ""lines"": 2}, ""src/vim9.h"": {""insertions"": 10, ""deletions"": 0, ""lines"": 10}, ""src/vim9compile.c"": {""insertions"": 7, ""deletions"": 7, ""lines"": 14}, ""src/vim9execute.c"": {""insertions"": 17, ""deletions"": 19, ""lines"": 36}}"
2021-01-25 18:18:02,5c829bf229de463657e4ba1de6c4ee91899de14e,Bram Moolenaar,6,4,10,3,"{""src/GvimExt/Make_ming.mak"": {""insertions"": 2, ""deletions"": 2, ""lines"": 4}, ""src/Make_cyg_ming.mak"": {""insertions"": 2, ""deletions"": 2, ""lines"": 4}, ""src/version.c"": {""insertions"": 2, ""deletions"": 0, ""lines"": 2}}"
2021-01-25 17:44:57,ab55f11d9bc776d546794748bc62ac47d5340c2e,Bram Moolenaar,2,21,23,2,"{""src/mark.c"": {""insertions"": 0, ""deletions"": 21, ""lines"": 21}, ""src/version.c"": {""insertions"": 2, ""deletions"": 0, ""lines"": 2}}"
2021-01-24 20:30:48,c05fe07529f10fc32a2086cb44a708520c8d14ce,Bram Moolenaar,11,0,11,2,"{""src/version.c"": {""insertions"": 2, ""deletions"": 0, ""lines"": 2}, ""src/vim9compile.c"": {""insertions"": 9, ""deletions"": 0, ""lines"": 9}}"
2021-01-24 20:14:20,4efd9948291801bffebf36b4a9910d08ff981987,Bram Moolenaar,40,0,40,3,"{""src/testdir/test_vim9_func.vim"": {""insertions"": 32, ""deletions"": 0, ""lines"": 32}, ""src/userfunc.c"": {""insertions"": 6, ""deletions"": 0, ""lines"": 6}, ""src/version.c"": {""insertions"": 2, ""deletions"": 0, ""lines"": 2}}"
2021-01-24 19:52:00,107e9cecf72928b4aaaf08b73bf2d191924ab695,Bram Moolenaar,131,56,187,4,"{""src/testdir/test_profile.vim"": {""insertions"": 35, ""deletions"": 22, ""lines"": 57}, ""src/version.c"": {""insertions"": 2, ""deletions"": 0, ""lines"": 2}, ""src/vim9compile.c"": {""insertions"": 49, ""deletions"": 9, ""lines"": 58}, ""src/vim9execute.c"": {""insertions"": 45, ""deletions"": 25, ""lines"": 70}}"
2021-01-24 16:53:47,ced68a0070dac059fc978a1a99e2893edf158116,Bram Moolenaar,115,35,150,5,"{""src/testdir/test_profile.vim"": {""insertions"": 33, ""deletions"": 24, ""lines"": 57}, ""src/testdir/test_vim9_disassemble.vim"": {""insertions"": 1, ""deletions"": 1, ""lines"": 2}, ""src/testdir/test_vim9_script.vim"": {""insertions"": 1, ""deletions"": 1, ""lines"": 2}, ""src/version.c"": {""insertions"": 2, ""deletions"": 0, ""lines"": 2}, ""src/vim9compile.c"": {""insertions"": 78, ""deletions"": 9, ""lines"": 87}}"
2021-01-24 14:25:56,8323cab31c3120a7f80cf3271a506a30ec04d99e,Bram Moolenaar,21,7,28,3,"{""runtime/filetype.vim"": {""insertions"": 16, ""deletions"": 6, ""lines"": 22}, ""src/testdir/test_filetype.vim"": {""insertions"": 3, ""deletions"": 1, ""lines"": 4}, ""src/version.c"": {""insertions"": 2, ""deletions"": 0, ""lines"": 2}}"
2021-01-24 12:34:18,f002a41d127d49cfe5a59819d1498bc0ff8b594a,Bram Moolenaar,63,7,70,6,"{""src/structs.h"": {""insertions"": 5, ""deletions"": 0, ""lines"": 5}, ""src/testdir/test_vim9_disassemble.vim"": {""insertions"": 3, ""deletions"": 0, ""lines"": 3}, ""src/version.c"": {""insertions"": 2, ""deletions"": 0, ""lines"": 2}, ""src/vim9.h"": {""insertions"": 4, ""deletions"": 2, ""lines"": 6}, ""src/vim9compile.c"": {""insertions"": 25, ""deletions"": 4, ""lines"": 29}, ""src/vim9execute.c"": {""insertions"": 24, ""deletions"": 1, ""lines"": 25}}"
2021-01-24 11:53:53,b204990346ca857802b174afe8a7fbb05e4f318e,Bram Moolenaar,311,109,420,16,"{""runtime/doc/repeat.txt"": {""insertions"": 13, ""deletions"": 7, ""lines"": 20}, ""src/debugger.c"": {""insertions"": 18, ""deletions"": 10, ""lines"": 28}, ""src/ex_cmds.h"": {""insertions"": 1, ""deletions"": 1, ""lines"": 2}, ""src/ex_docmd.c"": {""insertions"": 1, ""deletions"": 1, ""lines"": 2}, ""src/profiler.c"": {""insertions"": 48, ""deletions"": 4, ""lines"": 52}, ""src/proto/profiler.pro"": {""insertions"": 3, ""deletions"": 1, ""lines"": 4}, ""src/proto/vim9compile.pro"": {""insertions"": 2, ""deletions"": 1, ""lines"": 3}, ""src/structs.h"": {""insertions"": 8, ""deletions"": 1, ""lines"": 9}, ""src/testdir/test_profile.vim"": {""insertions"": 24, ""deletions"": 15, ""lines"": 39}, ""src/testdir/test_vim9_disassemble.vim"": {""insertions"": 21, ""deletions"": 0, ""lines"": 21}, ""src/userfunc.c"": {""insertions"": 19, ""deletions"": 37, ""lines"": 56}, ""src/version.c"": {""insertions"": 2, ""deletions"": 0, ""lines"": 2}, ""src/vim9.h"": {""insertions"": 8, ""deletions"": 1, ""lines"": 9}, ""src/vim9compile.c"": {""insertions"": 96, ""deletions"": 18, ""lines"": 114}, ""src/vim9execute.c"": {""insertions"": 45, ""deletions"": 11, ""lines"": 56}, ""src/vim9type.c"": {""insertions"": 2, ""deletions"": 1, ""lines"": 3}}"
2021-01-24 11:00:01,7cf0c114d690c91ac88c92a1a6f1b1935cb6410f,Bram Moolenaar,3,1,4,2,"{""src/testdir/test_fold.vim"": {""insertions"": 1, ""deletions"": 1, ""lines"": 2}, ""src/version.c"": {""insertions"": 2, ""deletions"": 0, ""lines"": 2}}"
2021-01-23 14:27:09,40be52ba71b9d6a7f586b1e77db8e827ff4c0c42,Bram Moolenaar,6,2,8,2,"{""src/testdir/test_method.vim"": {""insertions"": 4, ""deletions"": 2, ""lines"": 6}, ""src/version.c"": {""insertions"": 2, ""deletions"": 0, ""lines"": 2}}"
2021-01-23 14:15:01,dfbc5fd879d92c2a79ced1e1d16dc89f4d55772d,Bram Moolenaar,20,4,24,3,"{""src/buffer.c"": {""insertions"": 7, ""deletions"": 4, ""lines"": 11}, ""src/testdir/test_vim9_cmd.vim"": {""insertions"": 11, ""deletions"": 0, ""lines"": 11}, ""src/version.c"": {""insertions"": 2, ""deletions"": 0, ""lines"": 2}}"
2021-01-23 13:22:16,7cebe8ba7dd9a3a955e2da74014f11c42e1c6ac3,Bram Moolenaar,24,11,35,4,"{""src/eval.c"": {""insertions"": 4, ""deletions"": 8, ""lines"": 12}, ""src/ex_docmd.c"": {""insertions"": 4, ""deletions"": 3, ""lines"": 7}, ""src/testdir/test_vim9_cmd.vim"": {""insertions"": 14, ""deletions"": 0, ""lines"": 14}, ""src/version.c"": {""insertions"": 2, ""deletions"": 0, ""lines"": 2}}"
2021-01-23 12:39:14,9a562c184d98d82bb7506caf2071cfe15a92fa43,Bram Moolenaar,11,0,11,3,"{""src/evalvars.c"": {""insertions"": 7, ""deletions"": 0, ""lines"": 7}, ""src/testdir/test_vim9_assign.vim"": {""insertions"": 2, ""deletions"": 0, ""lines"": 2}, ""src/version.c"": {""insertions"": 2, ""deletions"": 0, ""lines"": 2}}"
2021-01-22 21:31:10,9ae3705b6ebd45086ca13c0f93a93f943559bd15,Bram Moolenaar,32,2,34,3,"{""src/evalfunc.c"": {""insertions"": 2, ""deletions"": 2, ""lines"": 4}, ""src/testdir/test_vim9_builtin.vim"": {""insertions"": 28, ""deletions"": 0, ""lines"": 28}, ""src/version.c"": {""insertions"": 2, ""deletions"": 0, ""lines"": 2}}"
2021-01-22 21:06:56,4bce26bb70144633713e7e8f149ba99cac511336,Bram Moolenaar,10,1,11,3,"{""src/dict.c"": {""insertions"": 2, ""deletions"": 1, ""lines"": 3}, ""src/testdir/test_vim9_script.vim"": {""insertions"": 6, ""deletions"": 0, ""lines"": 6}, ""src/version.c"": {""insertions"": 2, ""deletions"": 0, ""lines"": 2}}"
2021-01-22 19:55:04,402115f1c2b4d0704a822206f2e6e931e721c129,Bram Moolenaar,11,0,11,4,"{""runtime/filetype.vim"": {""insertions"": 3, ""deletions"": 0, ""lines"": 3}, ""runtime/scripts.vim"": {""insertions"": 4, ""deletions"": 0, ""lines"": 4}, ""src/testdir/test_filetype.vim"": {""insertions"": 2, ""deletions"": 0, ""lines"": 2}, ""src/version.c"": {""insertions"": 2, ""deletions"": 0, ""lines"": 2}}"
2021-01-22 19:46:27,0d3de8cb590aed90be71d96eb3dbc6addf80bb11,Bram Moolenaar,45,32,77,3,"{""src/userfunc.c"": {""insertions"": 19, ""deletions"": 17, ""lines"": 36}, ""src/version.c"": {""insertions"": 2, ""deletions"": 0, ""lines"": 2}, ""src/vim9execute.c"": {""insertions"": 24, ""deletions"": 15, ""lines"": 39}}"
2021-01-22 16:51:06,b3005ce191d27fd2f234df4969d5b58fda9c1940,Bram Moolenaar,9,9,18,4,"{""src/version.c"": {""insertions"": 2, ""deletions"": 0, ""lines"": 2}, ""src/vim9.h"": {""insertions"": 2, ""deletions"": 2, ""lines"": 4}, ""src/vim9compile.c"": {""insertions"": 2, ""deletions"": 4, ""lines"": 6}, ""src/vim9execute.c"": {""insertions"": 3, ""deletions"": 3, ""lines"": 6}}"
2021-01-21 21:53:38,9b6344613eecfcf77c510d7b63fcc4b7b51aefbc,Bram Moolenaar,9,5,14,4,"{""src/version.c"": {""insertions"": 2, ""deletions"": 0, ""lines"": 2}, ""src/vim9.h"": {""insertions"": 1, ""deletions"": 1, ""lines"": 2}, ""src/vim9compile.c"": {""insertions"": 3, ""deletions"": 1, ""lines"": 4}, ""src/vim9execute.c"": {""insertions"": 3, ""deletions"": 3, ""lines"": 6}}"
2021-01-21 20:42:31,57d5a01cb45d6edb16c3835a49b42d6d8fc0163e,Bram Moolenaar,47,30,77,5,"{""runtime/doc/eval.txt"": {""insertions"": 7, ""deletions"": 1, ""lines"": 8}, ""src/evalvars.c"": {""insertions"": 4, ""deletions"": 0, ""lines"": 4}, ""src/testdir/test_eval_stuff.vim"": {""insertions"": 6, ""deletions"": 3, ""lines"": 9}, ""src/version.c"": {""insertions"": 2, ""deletions"": 0, ""lines"": 2}, ""src/vim.h"": {""insertions"": 28, ""deletions"": 26, ""lines"": 54}}"
2021-01-21 19:21:29,e32e516dfa46e9c5965d278f96aaf57573de8ac4,Bram Moolenaar,41,12,53,7,"{""src/testdir/test_vim9_builtin.vim"": {""insertions"": 1, ""deletions"": 1, ""lines"": 2}, ""src/testdir/test_vim9_disassemble.vim"": {""insertions"": 1, ""deletions"": 1, ""lines"": 2}, ""src/testdir/test_vim9_func.vim"": {""insertions"": 16, ""deletions"": 0, ""lines"": 16}, ""src/version.c"": {""insertions"": 2, ""deletions"": 0, ""lines"": 2}, ""src/vim9.h"": {""insertions"": 2, ""deletions"": 1, ""lines"": 3}, ""src/vim9compile.c"": {""insertions"": 7, ""deletions"": 5, ""lines"": 12}, ""src/vim9execute.c"": {""insertions"": 12, ""deletions"": 4, ""lines"": 16}}"
2021-01-21 18:41:16,f904133e1a5ea84a124d3ece12b1f0a7392f1ca7,Bram Moolenaar,37,0,37,3,"{""src/testdir/test_vim9_func.vim"": {""insertions"": 18, ""deletions"": 0, ""lines"": 18}, ""src/version.c"": {""insertions"": 2, ""deletions"": 0, ""lines"": 2}, ""src/vim9execute.c"": {""insertions"": 17, ""deletions"": 0, ""lines"": 17}}"
2021-01-21 16:03:07,e71996bd0865659bde5450f466bc3e53e83431b2,Bram Moolenaar,48,20,68,3,"{""src/normal.c"": {""insertions"": 11, ""deletions"": 20, ""lines"": 31}, ""src/testdir/test_fold.vim"": {""insertions"": 35, ""deletions"": 0, ""lines"": 35}, ""src/version.c"": {""insertions"": 2, ""deletions"": 0, ""lines"": 2}}"
2021-01-21 13:45:13,5e6a7aa2b26077775906eb8411952dc6259694de,Bram Moolenaar,26,2,28,3,"{""runtime/filetype.vim"": {""insertions"": 7, ""deletions"": 2, ""lines"": 9}, ""src/testdir/test_filetype.vim"": {""insertions"": 17, ""deletions"": 0, ""lines"": 17}, ""src/version.c"": {""insertions"": 2, ""deletions"": 0, ""lines"": 2}}"
2021-01-21 12:36:43,ccb47a2899d9f8076dad0f8348c057450febf32b,Bram Moolenaar,4,0,4,2,"{""src/misc2.c"": {""insertions"": 2, ""deletions"": 0, ""lines"": 2}, ""src/version.c"": {""insertions"": 2, ""deletions"": 0, ""lines"": 2}}"
2021-01-21 12:03:20,b1f2857096aabe9a11e576005d08fc4e53781698,Bram Moolenaar,8,4,12,2,"{""src/version.c"": {""insertions"": 2, ""deletions"": 0, ""lines"": 2}, ""src/vim9execute.c"": {""insertions"": 6, ""deletions"": 4, ""lines"": 10}}"
2021-01-21 11:34:14,c5f59fab23820454f060562927ddc1397f9d479a,Bram Moolenaar,77,16,93,7,"{""src/eval.c"": {""insertions"": 24, ""deletions"": 7, ""lines"": 31}, ""src/evalvars.c"": {""insertions"": 4, ""deletions"": 2, ""lines"": 6}, ""src/proto/eval.pro"": {""insertions"": 2, ""deletions"": 2, ""lines"": 4}, ""src/testdir/test_vim9_assign.vim"": {""insertions"": 24, ""deletions"": 0, ""lines"": 24}, ""src/testdir/vim9.vim"": {""insertions"": 13, ""deletions"": 0, ""lines"": 13}, ""src/version.c"": {""insertions"": 2, ""deletions"": 0, ""lines"": 2}, ""src/vim9compile.c"": {""insertions"": 8, ""deletions"": 5, ""lines"": 13}}"
2021-01-20 21:22:49,a0f7f73ebb3ab032af08699c24c465403512b7d8,Bram Moolenaar,5,0,5,2,"{""src/time.c"": {""insertions"": 3, ""deletions"": 0, ""lines"": 3}, ""src/version.c"": {""insertions"": 2, ""deletions"": 0, ""lines"": 2}}"
2021-01-20 20:42:33,77a849c4b3d73c228013a047913c90834a93b4f6,Bram Moolenaar,6,2,8,2,"{""src/spellsuggest.c"": {""insertions"": 4, ""deletions"": 2, ""lines"": 6}, ""src/version.c"": {""insertions"": 2, ""deletions"": 0, ""lines"": 2}}"
2021-01-20 20:23:14,99880f96cf444014d589fc1d99bb164deaba71ce,Bram Moolenaar,20,6,26,5,"{""src/errors.h"": {""insertions"": 2, ""deletions"": 0, ""lines"": 2}, ""src/eval.c"": {""insertions"": 5, ""deletions"": 2, ""lines"": 7}, ""src/testdir/test_vim9_expr.vim"": {""insertions"": 3, ""deletions"": 2, ""lines"": 5}, ""src/version.c"": {""insertions"": 2, ""deletions"": 0, ""lines"": 2}, ""src/vim9execute.c"": {""insertions"": 8, ""deletions"": 2, ""lines"": 10}}"
2021-01-19 21:48:09,a28639e71198238d5c09c43445dc448d7f3fb29b,Bram Moolenaar,26,16,42,3,"{""src/testdir/test_vim9_cmd.vim"": {""insertions"": 4, ""deletions"": 0, ""lines"": 4}, ""src/version.c"": {""insertions"": 2, ""deletions"": 0, ""lines"": 2}, ""src/vim9execute.c"": {""insertions"": 20, ""deletions"": 16, ""lines"": 36}}"
2021-01-19 21:16:41,e64f83cc6aba05baa61ba4a4cb8d4447b8091e5b,Bram Moolenaar,8,2,10,3,"{""src/testdir/test_vim9_expr.vim"": {""insertions"": 2, ""deletions"": 0, ""lines"": 2}, ""src/version.c"": {""insertions"": 2, ""deletions"": 0, ""lines"": 2}, ""src/vim9compile.c"": {""insertions"": 4, ""deletions"": 2, ""lines"": 6}}"
2021-01-19 16:22:58,09fbedc8dc3adc0a7adf2093916911e633cfa626,Bram Moolenaar,5,2,7,2,"{""src/testdir/test_highlight.vim"": {""insertions"": 3, ""deletions"": 2, ""lines"": 5}, ""src/version.c"": {""insertions"": 2, ""deletions"": 0, ""lines"": 2}}"
2021-01-18 18:55:44,98a29d00a48e15a50e2850e1a29b7d475c531b0c,Bram Moolenaar,150,116,266,17,"{""runtime/doc/eval.txt"": {""insertions"": 27, ""deletions"": 25, ""lines"": 52}, ""runtime/doc/filetype.txt"": {""insertions"": 1, ""deletions"": 0, ""lines"": 1}, ""runtime/doc/index.txt"": {""insertions"": 1, ""deletions"": 1, ""lines"": 2}, ""runtime/doc/options.txt"": {""insertions"": 2, ""deletions"": 2, ""lines"": 4}, ""runtime/doc/popup.txt"": {""insertions"": 0, ""deletions"": 2, ""lines"": 2}, ""runtime/doc/syntax.txt"": {""insertions"": 5, ""deletions"": 4, ""lines"": 9}, ""runtime/doc/tags"": {""insertions"": 11, ""deletions"": 4, ""lines"": 15}, ""runtime/doc/term.txt"": {""insertions"": 3, ""deletions"": 3, ""lines"": 6}, ""runtime/doc/todo.txt"": {""insertions"": 7, ""deletions"": 21, ""lines"": 28}, ""runtime/doc/usr_41.txt"": {""insertions"": 1, ""deletions"": 1, ""lines"": 2}, ""runtime/doc/various.txt"": {""insertions"": 5, ""deletions"": 2, ""lines"": 7}, ""runtime/doc/version6.txt"": {""insertions"": 1, ""deletions"": 1, ""lines"": 2}, ""runtime/doc/vi_diff.txt"": {""insertions"": 1, ""deletions"": 1, ""lines"": 2}, ""runtime/doc/vim9.txt"": {""insertions"": 65, ""deletions"": 35, ""lines"": 100}, ""runtime/ftplugin/vim.vim"": {""insertions"": 5, ""deletions"": 5, ""lines"": 10}, ""runtime/syntax/c.vim"": {""insertions"": 11, ""deletions"": 8, ""lines"": 19}, ""runtime/syntax/cpp.vim"": {""insertions"": 4, ""deletions"": 1, ""lines"": 5}}"
2021-01-17 21:04:02,82aa6e09e02b138ab7ee6b79ecac487813f117e5,Bram Moolenaar,3,1,4,2,"{""src/edit.c"": {""insertions"": 1, ""deletions"": 1, ""lines"": 2}, ""src/version.c"": {""insertions"": 2, ""deletions"": 0, ""lines"": 2}}"
2021-01-17 20:51:24,f30a14db3b26e510f193f50ee0dd8a41303e4740,Bram Moolenaar,15,7,22,3,"{""src/testdir/test_vim9_assign.vim"": {""insertions"": 11, ""deletions"": 2, ""lines"": 13}, ""src/version.c"": {""insertions"": 2, ""deletions"": 0, ""lines"": 2}, ""src/vim9compile.c"": {""insertions"": 2, ""deletions"": 5, ""lines"": 7}}"
2021-01-17 19:52:13,585587dadbc2558520c33969098db9ff49598785,Bram Moolenaar,6,3,9,2,"{""src/evalvars.c"": {""insertions"": 4, ""deletions"": 3, ""lines"": 7}, ""src/version.c"": {""insertions"": 2, ""deletions"": 0, ""lines"": 2}}"
2021-01-17 19:23:38,036d07144efe213199b1ed8de998e6f12a056499,Bram Moolenaar,19,4,23,4,"{""src/evalvars.c"": {""insertions"": 7, ""deletions"": 4, ""lines"": 11}, ""src/testdir/test_vim9_script.vim"": {""insertions"": 6, ""deletions"": 0, ""lines"": 6}, ""src/version.c"": {""insertions"": 2, ""deletions"": 0, ""lines"": 2}, ""src/vim9compile.c"": {""insertions"": 4, ""deletions"": 0, ""lines"": 4}}"
2021-01-17 18:20:32,1430ceeb2d4185a8d60fa81007fbc8b74fd68c46,Bram Moolenaar,40,0,40,3,"{""src/testdir/test_vim9_script.vim"": {""insertions"": 37, ""deletions"": 0, ""lines"": 37}, ""src/version.c"": {""insertions"": 2, ""deletions"": 0, ""lines"": 2}, ""src/vim9execute.c"": {""insertions"": 1, ""deletions"": 0, ""lines"": 1}}"
2021-01-17 15:16:23,3af15ab7888033fdfae0ae7085172aab794339a2,Bram Moolenaar,97,70,167,4,"{""src/evalfunc.c"": {""insertions"": 74, ""deletions"": 69, ""lines"": 143}, ""src/testdir/test_vim9_builtin.vim"": {""insertions"": 20, ""deletions"": 0, ""lines"": 20}, ""src/testdir/test_vim9_disassemble.vim"": {""insertions"": 1, ""deletions"": 1, ""lines"": 2}, ""src/version.c"": {""insertions"": 2, ""deletions"": 0, ""lines"": 2}}"
2021-01-17 12:48:03,85773bf32b51cbe7e971c5ac11cb9c743bb7a38a,Bram Moolenaar,20,1,21,2,"{""src/testdir/test_options.vim"": {""insertions"": 18, ""deletions"": 1, ""lines"": 19}, ""src/version.c"": {""insertions"": 2, ""deletions"": 0, ""lines"": 2}}"
2021-01-17 12:21:20,239f8d932672bcf5be6d32fc7c0bf95a2e69f5eb,Bram Moolenaar,15,13,28,5,"{""src/errors.h"": {""insertions"": 1, ""deletions"": 1, ""lines"": 2}, ""src/evalfunc.c"": {""insertions"": 6, ""deletions"": 6, ""lines"": 12}, ""src/list.c"": {""insertions"": 3, ""deletions"": 3, ""lines"": 6}, ""src/version.c"": {""insertions"": 2, ""deletions"": 0, ""lines"": 2}, ""src/vim9execute.c"": {""insertions"": 3, ""deletions"": 3, ""lines"": 6}}"
2021-01-16 19:21:23,e2edc2ed4a9a229870b1e1811b0ecf045b84e429,Bram Moolenaar,49,10,59,10,"{""runtime/doc/index.txt"": {""insertions"": 2, ""deletions"": 0, ""lines"": 2}, ""runtime/doc/various.txt"": {""insertions"": 2, ""deletions"": 2, ""lines"": 4}, ""src/ex_cmds.h"": {""insertions"": 1, ""deletions"": 1, ""lines"": 2}, ""src/ex_docmd.c"": {""insertions"": 10, ""deletions"": 3, ""lines"": 13}, ""src/normal.c"": {""insertions"": 2, ""deletions"": 2, ""lines"": 4}, ""src/proto/ex_docmd.pro"": {""insertions"": 1, ""deletions"": 1, ""lines"": 2}, ""src/term.c"": {""insertions"": 1, ""deletions"": 1, ""lines"": 2}, ""src/testdir/Make_all.mak"": {""insertions"": 2, ""deletions"": 0, ""lines"": 2}, ""src/testdir/test_sleep.vim"": {""insertions"": 26, ""deletions"": 0, ""lines"": 26}, ""src/version.c"": {""insertions"": 2, ""deletions"": 0, ""lines"": 2}}"
2021-01-16 18:01:53,70250fb4d2ffc2e92db224c6374db418f70691fd,Bram Moolenaar,80,29,109,4,"{""src/list.c"": {""insertions"": 38, ""deletions"": 7, ""lines"": 45}, ""src/testdir/test_vim9_assign.vim"": {""insertions"": 1, ""deletions"": 1, ""lines"": 2}, ""src/testdir/test_vim9_builtin.vim"": {""insertions"": 39, ""deletions"": 21, ""lines"": 60}, ""src/version.c"": {""insertions"": 2, ""deletions"": 0, ""lines"": 2}}"
2021-01-16 17:09:52,f898f7c68dc06def1a5ae02ce82a52a82af37cc4,Bram Moolenaar,30,6,36,3,"{""src/testdir/test_vim9_func.vim"": {""insertions"": 12, ""deletions"": 0, ""lines"": 12}, ""src/userfunc.c"": {""insertions"": 16, ""deletions"": 6, ""lines"": 22}, ""src/version.c"": {""insertions"": 2, ""deletions"": 0, ""lines"": 2}}"
2021-01-16 15:52:49,9ebcf231bdccc1673cc92b20f5190fc577ad29d0,Bram Moolenaar,7,1,8,3,"{""src/evalfunc.c"": {""insertions"": 2, ""deletions"": 1, ""lines"": 3}, ""src/testdir/test_cursor_func.vim"": {""insertions"": 3, ""deletions"": 0, ""lines"": 3}, ""src/version.c"": {""insertions"": 2, ""deletions"": 0, ""lines"": 2}}"
2021-01-16 15:07:01,351ead09dd365ebdee2bfa27ab22542d4920c779,Bram Moolenaar,63,44,107,8,"{""src/evalfunc.c"": {""insertions"": 28, ""deletions"": 6, ""lines"": 34}, ""src/proto/evalfunc.pro"": {""insertions"": 1, ""deletions"": 1, ""lines"": 2}, ""src/proto/vim9compile.pro"": {""insertions"": 1, ""deletions"": 0, ""lines"": 1}, ""src/proto/vim9type.pro"": {""insertions"": 0, ""deletions"": 1, ""lines"": 1}, ""src/testdir/test_vim9_builtin.vim"": {""insertions"": 3, ""deletions"": 0, ""lines"": 3}, ""src/version.c"": {""insertions"": 2, ""deletions"": 0, ""lines"": 2}, ""src/vim9compile.c"": {""insertions"": 23, ""deletions"": 21, ""lines"": 44}, ""src/vim9type.c"": {""insertions"": 5, ""deletions"": 15, ""lines"": 20}}"
2021-01-16 13:34:45,7c886db915035bc064ca307f02c34ae9d99cc733,Bram Moolenaar,7,0,7,2,"{""src/ex_cmds.c"": {""insertions"": 5, ""deletions"": 0, ""lines"": 5}, ""src/version.c"": {""insertions"": 2, ""deletions"": 0, ""lines"": 2}}"
2021-01-16 12:43:31,a3b494d6afa79aedce42fa4ecc7ef0dbae79e37e,Bram Moolenaar,3,1,4,2,"{""src/testdir/test_filetype.vim"": {""insertions"": 1, ""deletions"": 1, ""lines"": 2}, ""src/version.c"": {""insertions"": 2, ""deletions"": 0, ""lines"": 2}}"
2021-01-16 12:11:42,e2924328c165f1fc549f91bf212c93c87bb1d9ed,Bram Moolenaar,10,0,10,2,"{""src/testdir/test_autocmd.vim"": {""insertions"": 8, ""deletions"": 0, ""lines"": 8}, ""src/version.c"": {""insertions"": 2, ""deletions"": 0, ""lines"": 2}}"
2021-01-16 10:21:40,bf78974ca4a6798db7172c226cbfe7b2485b7baa,Bram Moolenaar,7,5,12,2,"{""src/term.c"": {""insertions"": 5, ""deletions"": 5, ""lines"": 10}, ""src/version.c"": {""insertions"": 2, ""deletions"": 0, ""lines"": 2}}"
2021-01-15 18:04:32,648ea76e1d8ca9a9788f88d0d96d0cf0653006bb,Bram Moolenaar,19,0,19,3,"{""src/testdir/test_vim9_func.vim"": {""insertions"": 11, ""deletions"": 0, ""lines"": 11}, ""src/userfunc.c"": {""insertions"": 6, ""deletions"": 0, ""lines"": 6}, ""src/version.c"": {""insertions"": 2, ""deletions"": 0, ""lines"": 2}}"
2021-01-15 17:04:43,883cf97f109d2ff281cf77f7b2e3bb44aced7cb3,Bram Moolenaar,47,26,73,5,"{""src/eval.c"": {""insertions"": 40, ""deletions"": 25, ""lines"": 65}, ""src/proto/eval.pro"": {""insertions"": 1, ""deletions"": 0, ""lines"": 1}, ""src/testdir/test_vim9_cmd.vim"": {""insertions"": 3, ""deletions"": 0, ""lines"": 3}, ""src/version.c"": {""insertions"": 2, ""deletions"": 0, ""lines"": 2}, ""src/vim9execute.c"": {""insertions"": 1, ""deletions"": 1, ""lines"": 2}}"
2021-01-15 15:45:21,97c6943e11516711541848e51db3cc2ace25bbb2,Bram Moolenaar,5,3,8,2,"{""src/testdir/test_autocmd.vim"": {""insertions"": 3, ""deletions"": 3, ""lines"": 6}, ""src/version.c"": {""insertions"": 2, ""deletions"": 0, ""lines"": 2}}"
2021-01-15 15:22:52,797e63b9f2baa1853e7063aac478d663cd02f207,Bram Moolenaar,46,11,57,5,"{""src/buffer.c"": {""insertions"": 12, ""deletions"": 9, ""lines"": 21}, ""src/ex_cmds.c"": {""insertions"": 11, ""deletions"": 1, ""lines"": 12}, ""src/proto/buffer.pro"": {""insertions"": 1, ""deletions"": 1, ""lines"": 2}, ""src/testdir/test_autocmd.vim"": {""insertions"": 20, ""deletions"": 0, ""lines"": 20}, ""src/version.c"": {""insertions"": 2, ""deletions"": 0, ""lines"": 2}}"
2021-01-15 12:35:30,17d015b2438e51d4d42d72720611d16c772cc4bb,Bram Moolenaar,6,0,6,3,"{""runtime/filetype.vim"": {""insertions"": 3, ""deletions"": 0, ""lines"": 3}, ""src/testdir/test_filetype.vim"": {""insertions"": 1, ""deletions"": 0, ""lines"": 1}, ""src/version.c"": {""insertions"": 2, ""deletions"": 0, ""lines"": 2}}"
2021-01-14 20:57:58,d44cc593cee84fc3c712ca1828d1574f80700383,Bram Moolenaar,16,8,24,2,"{""src/term.c"": {""insertions"": 14, ""deletions"": 8, ""lines"": 22}, ""src/version.c"": {""insertions"": 2, ""deletions"": 0, ""lines"": 2}}"
2021-01-14 20:47:06,8f81b22e8691f6e7c76153e945bbef15a8190cd9,Bram Moolenaar,26,0,26,3,"{""src/testdir/test_vim9_script.vim"": {""insertions"": 13, ""deletions"": 0, ""lines"": 13}, ""src/version.c"": {""insertions"": 2, ""deletions"": 0, ""lines"": 2}, ""src/vim9execute.c"": {""insertions"": 11, ""deletions"": 0, ""lines"": 11}}"
2021-01-14 20:40:22,033135eb8eccd00c9ee72c6c0cf4b8b9f81bd269,Bram Moolenaar,4,2,6,2,"{""src/ex_docmd.c"": {""insertions"": 2, ""deletions"": 2, ""lines"": 4}, ""src/version.c"": {""insertions"": 2, ""deletions"": 0, ""lines"": 2}}"
2021-01-14 19:35:49,2415669348c455df0d1b9bf55b17a06d2f990c19,Bram Moolenaar,25,13,38,3,"{""src/testdir/test_vim9_expr.vim"": {""insertions"": 20, ""deletions"": 12, ""lines"": 32}, ""src/version.c"": {""insertions"": 2, ""deletions"": 0, ""lines"": 2}, ""src/vim9compile.c"": {""insertions"": 3, ""deletions"": 1, ""lines"": 4}}"
2021-01-14 18:19:18,fadd55bd633b3b84d41a691e953f569bb6c21689,Bram Moolenaar,4,14,18,3,"{""src/term.c"": {""insertions"": 2, ""deletions"": 12, ""lines"": 14}, ""src/ui.c"": {""insertions"": 0, ""deletions"": 2, ""lines"": 2}, ""src/version.c"": {""insertions"": 2, ""deletions"": 0, ""lines"": 2}}"
2021-01-14 18:04:44,e1ee58ac788508585f60c91fcf6629e2251a9220,Bram Moolenaar,6,2,8,2,"{""src/term.c"": {""insertions"": 4, ""deletions"": 2, ""lines"": 6}, ""src/version.c"": {""insertions"": 2, ""deletions"": 0, ""lines"": 2}}"
2021-01-14 16:55:59,845b72854de90de13879598df53f1c388e52e1ba,Bram Moolenaar,8,0,8,3,"{""appveyor.yml => .appveyor.yml"": {""insertions"": 0, ""deletions"": 0, ""lines"": 0}, "".codecov.yml"": {""insertions"": 6, ""deletions"": 0, ""lines"": 6}, ""src/version.c"": {""insertions"": 2, ""deletions"": 0, ""lines"": 2}}"
2021-01-14 16:35:21,681fc3fa782e99fe69ed2c83c3e29109d2d61e1a,Bram Moolenaar,111,3,114,5,"{""runtime/doc/term.txt"": {""insertions"": 14, ""deletions"": 0, ""lines"": 14}, ""src/optiondefs.h"": {""insertions"": 2, ""deletions"": 0, ""lines"": 2}, ""src/term.c"": {""insertions"": 87, ""deletions"": 1, ""lines"": 88}, ""src/term.h"": {""insertions"": 6, ""deletions"": 2, ""lines"": 8}, ""src/version.c"": {""insertions"": 2, ""deletions"": 0, ""lines"": 2}}"
2021-01-13 20:47:15,6601b62943a19d4f8818c3638440663d67a17b6a,Bram Moolenaar,106,28,134,11,"{""runtime/doc/eval.txt"": {""insertions"": 20, ""deletions"": 0, ""lines"": 20}, ""runtime/doc/usr_41.txt"": {""insertions"": 3, ""deletions"": 0, ""lines"": 3}, ""src/eval.c"": {""insertions"": 34, ""deletions"": 11, ""lines"": 45}, ""src/evalfunc.c"": {""insertions"": 2, ""deletions"": 0, ""lines"": 2}, ""src/list.c"": {""insertions"": 8, ""deletions"": 5, ""lines"": 13}, ""src/proto/eval.pro"": {""insertions"": 3, ""deletions"": 2, ""lines"": 5}, ""src/proto/list.pro"": {""insertions"": 1, ""deletions"": 1, ""lines"": 2}, ""src/proto/vim9execute.pro"": {""insertions"": 1, ""deletions"": 1, ""lines"": 2}, ""src/testdir/test_vim9_builtin.vim"": {""insertions"": 23, ""deletions"": 0, ""lines"": 23}, ""src/version.c"": {""insertions"": 2, ""deletions"": 0, ""lines"": 2}, ""src/vim9execute.c"": {""insertions"": 9, ""deletions"": 8, ""lines"": 17}}"
2021-01-13 19:38:03,c423ad77ed763c11ba67729bbf63c1cf0915231f,Bram Moolenaar,74,10,84,7,"{""runtime/doc/eval.txt"": {""insertions"": 17, ""deletions"": 4, ""lines"": 21}, ""runtime/doc/usr_41.txt"": {""insertions"": 1, ""deletions"": 0, ""lines"": 1}, ""src/evalfunc.c"": {""insertions"": 3, ""deletions"": 1, ""lines"": 4}, ""src/filepath.c"": {""insertions"": 23, ""deletions"": 4, ""lines"": 27}, ""src/proto/filepath.pro"": {""insertions"": 2, ""deletions"": 1, ""lines"": 3}, ""src/testdir/test_vim9_builtin.vim"": {""insertions"": 26, ""deletions"": 0, ""lines"": 26}, ""src/version.c"": {""insertions"": 2, ""deletions"": 0, ""lines"": 2}}"
2021-01-13 19:08:38,9145846b6aa411e3ab5c0d145b37808654352877,Bram Moolenaar,91,17,108,4,"{""src/eval.c"": {""insertions"": 23, ""deletions"": 10, ""lines"": 33}, ""src/evalfunc.c"": {""insertions"": 3, ""deletions"": 3, ""lines"": 6}, ""src/testdir/test_cursor_func.vim"": {""insertions"": 63, ""deletions"": 4, ""lines"": 67}, ""src/version.c"": {""insertions"": 2, ""deletions"": 0, ""lines"": 2}}"
2021-01-13 18:48:46,1bb4de5302ba038b9c59e845b6d735e87d5681d0,Bram Moolenaar,12,1,13,5,"{""src/evalfunc.c"": {""insertions"": 4, ""deletions"": 0, ""lines"": 4}, ""src/evalvars.c"": {""insertions"": 1, ""deletions"": 1, ""lines"": 2}, ""src/proto/evalvars.pro"": {""insertions"": 1, ""deletions"": 0, ""lines"": 1}, ""src/testdir/test_cmdline.vim"": {""insertions"": 4, ""deletions"": 0, ""lines"": 4}, ""src/version.c"": {""insertions"": 2, ""deletions"": 0, ""lines"": 2}}"
2021-01-12 21:08:53,37487e16da7877129edee8d11b9b7f5c8df312c6,Bram Moolenaar,13,0,13,4,"{""src/evalwindow.c"": {""insertions"": 4, ""deletions"": 0, ""lines"": 4}, ""src/testdir/test_execute_func.vim"": {""insertions"": 2, ""deletions"": 0, ""lines"": 2}, ""src/testdir/test_vim9_builtin.vim"": {""insertions"": 5, ""deletions"": 0, ""lines"": 5}, ""src/version.c"": {""insertions"": 2, ""deletions"": 0, ""lines"": 2}}"
2021-01-12 20:49:00,a47e05f04a5a5c0369c949157c24d09cbe64ad6a,Bram Moolenaar,52,4,56,8,"{""runtime/doc/eval.txt"": {""insertions"": 10, ""deletions"": 1, ""lines"": 11}, ""runtime/doc/usr_41.txt"": {""insertions"": 2, ""deletions"": 1, ""lines"": 3}, ""src/evalfunc.c"": {""insertions"": 2, ""deletions"": 0, ""lines"": 2}, ""src/proto/vim9type.pro"": {""insertions"": 1, ""deletions"": 0, ""lines"": 1}, ""src/testdir/test_vim9_builtin.vim"": {""insertions"": 2, ""deletions"": 2, ""lines"": 4}, ""src/testdir/test_vimscript.vim"": {""insertions"": 8, ""deletions"": 0, ""lines"": 8}, ""src/version.c"": {""insertions"": 2, ""deletions"": 0, ""lines"": 2}, ""src/vim9type.c"": {""insertions"": 25, ""deletions"": 0, ""lines"": 25}}"
2021-01-12 20:22:31,64ed4d4398e92ac56a9bbd66d5ec992dd4c335f7,Bram Moolenaar,21,1,22,4,"{""src/evalfunc.c"": {""insertions"": 8, ""deletions"": 1, ""lines"": 9}, ""src/globals.h"": {""insertions"": 1, ""deletions"": 0, ""lines"": 1}, ""src/testdir/test_vim9_builtin.vim"": {""insertions"": 10, ""deletions"": 0, ""lines"": 10}, ""src/version.c"": {""insertions"": 2, ""deletions"": 0, ""lines"": 2}}"
2021-01-12 19:51:24,67876de7bbc4254268d8180d68203b965e25ed95,Bram Moolenaar,9,0,9,3,"{""src/auto/configure"": {""insertions"": 4, ""deletions"": 0, ""lines"": 4}, ""src/configure.ac"": {""insertions"": 3, ""deletions"": 0, ""lines"": 3}, ""src/version.c"": {""insertions"": 2, ""deletions"": 0, ""lines"": 2}}"
2021-01-12 19:23:40,b0e6b513648db7035046613431a4aa9d71ef4653,Bram Moolenaar,118,12,130,8,"{""runtime/doc/eval.txt"": {""insertions"": 10, ""deletions"": 0, ""lines"": 10}, ""runtime/doc/usr_41.txt"": {""insertions"": 2, ""deletions"": 0, ""lines"": 2}, ""src/evalfunc.c"": {""insertions"": 19, ""deletions"": 1, ""lines"": 20}, ""src/list.c"": {""insertions"": 62, ""deletions"": 11, ""lines"": 73}, ""src/proto/list.pro"": {""insertions"": 1, ""deletions"": 0, ""lines"": 1}, ""src/testdir/test_listdict.vim"": {""insertions"": 12, ""deletions"": 0, ""lines"": 12}, ""src/testdir/test_vim9_builtin.vim"": {""insertions"": 10, ""deletions"": 0, ""lines"": 10}, ""src/version.c"": {""insertions"": 2, ""deletions"": 0, ""lines"": 2}}"
2021-01-12 17:58:39,7cd24227c02afdb4249db406e2174eda1e6b36b4,Bram Moolenaar,22,0,22,3,"{""src/testdir/test_vim9_disassemble.vim"": {""insertions"": 15, ""deletions"": 0, ""lines"": 15}, ""src/version.c"": {""insertions"": 2, ""deletions"": 0, ""lines"": 2}, ""src/vim9compile.c"": {""insertions"": 5, ""deletions"": 0, ""lines"": 5}}"
2021-01-12 16:42:24,a0122dcd1cc9e9bb62c071a9b91426a8bce4f8d9,Bram Moolenaar,61,4,65,5,"{""runtime/autoload/dist/ft.vim"": {""insertions"": 21, ""deletions"": 2, ""lines"": 23}, ""runtime/filetype.vim"": {""insertions"": 3, ""deletions"": 1, ""lines"": 4}, ""runtime/scripts.vim"": {""insertions"": 4, ""deletions"": 0, ""lines"": 4}, ""src/testdir/test_filetype.vim"": {""insertions"": 31, ""deletions"": 1, ""lines"": 32}, ""src/version.c"": {""insertions"": 2, ""deletions"": 0, ""lines"": 2}}"
2021-01-12 16:17:01,cb6cbf29e97b7abdeb1e6cbdc5e735f5b55e97a1,Bram Moolenaar,4,2,6,2,"{""src/version.c"": {""insertions"": 2, ""deletions"": 0, ""lines"": 2}, ""src/vim9execute.c"": {""insertions"": 2, ""deletions"": 2, ""lines"": 4}}"
2021-01-11 21:16:30,9567efa1b4a41baca9b2266f5903d5dda7ad1e88,Bram Moolenaar,62,42,104,5,"{""src/scriptfile.c"": {""insertions"": 16, ""deletions"": 40, ""lines"": 56}, ""src/structs.h"": {""insertions"": 26, ""deletions"": 0, ""lines"": 26}, ""src/testdir/test_vim9_cmd.vim"": {""insertions"": 7, ""deletions"": 0, ""lines"": 7}, ""src/version.c"": {""insertions"": 2, ""deletions"": 0, ""lines"": 2}, ""src/vim9execute.c"": {""insertions"": 11, ""deletions"": 2, ""lines"": 13}}"
2021-01-11 20:20:18,082517570d1dce2faf3baa9f752ce0858355d221,Bram Moolenaar,68,18,86,7,"{""src/evalvars.c"": {""insertions"": 2, ""deletions"": 2, ""lines"": 4}, ""src/proto/vim9script.pro"": {""insertions"": 1, ""deletions"": 1, ""lines"": 2}, ""src/structs.h"": {""insertions"": 1, ""deletions"": 1, ""lines"": 2}, ""src/testdir/test_vim9_assign.vim"": {""insertions"": 16, ""deletions"": 0, ""lines"": 16}, ""src/version.c"": {""insertions"": 2, ""deletions"": 0, ""lines"": 2}, ""src/vim9compile.c"": {""insertions"": 35, ""deletions"": 10, ""lines"": 45}, ""src/vim9script.c"": {""insertions"": 11, ""deletions"": 4, ""lines"": 15}}"
2021-01-11 19:17:34,9e1d9e3473f852735ffd605a0fa4d224b81a4f0c,Bram Moolenaar,14,2,16,3,"{""src/testdir/test_vim9_script.vim"": {""insertions"": 7, ""deletions"": 1, ""lines"": 8}, ""src/version.c"": {""insertions"": 2, ""deletions"": 0, ""lines"": 2}, ""src/vim9compile.c"": {""insertions"": 5, ""deletions"": 1, ""lines"": 6}}"
2021-01-11 18:54:42,df4c9af7e73aa5d0fb5bf4c0e19a39b4e1d73517,Bram Moolenaar,78,0,78,2,"{""src/testdir/test_startup.vim"": {""insertions"": 76, ""deletions"": 0, ""lines"": 76}, ""src/version.c"": {""insertions"": 2, ""deletions"": 0, ""lines"": 2}}"
2021-01-11 18:40:15,82be4849eed0b8fbee45bc8da99b685ec89af59a,Bram Moolenaar,480,161,641,24,"{"".github/CODEOWNERS"": {""insertions"": 1, ""deletions"": 0, ""lines"": 1}, ""runtime/doc/editing.txt"": {""insertions"": 2, ""deletions"": 2, ""lines"": 4}, ""runtime/doc/options.txt"": {""insertions"": 2, ""deletions"": 2, ""lines"": 4}, ""runtime/doc/os_vms.txt"": {""insertions"": 5, ""deletions"": 3, ""lines"": 8}, ""runtime/doc/pattern.txt"": {""insertions"": 4, ""deletions"": 3, ""lines"": 7}, ""runtime/doc/tags"": {""insertions"": 11, ""deletions"": 0, ""lines"": 11}, ""runtime/doc/terminal.txt"": {""insertions"": 9, ""deletions"": 1, ""lines"": 10}, ""runtime/doc/todo.txt"": {""insertions"": 61, ""deletions"": 46, ""lines"": 107}, ""runtime/doc/usr_03.txt"": {""insertions"": 1, ""deletions"": 1, ""lines"": 2}, ""runtime/doc/usr_41.txt"": {""insertions"": 4, ""deletions"": 4, ""lines"": 8}, ""runtime/doc/vim9.txt"": {""insertions"": 51, ""deletions"": 16, ""lines"": 67}, ""runtime/ftplugin/erlang.vim"": {""insertions"": 54, ""deletions"": 58, ""lines"": 112}, ""runtime/ftplugin/fstab.vim"": {""insertions"": 2, ""deletions"": 2, ""lines"": 4}, ""runtime/ftplugin/swift.vim"": {""insertions"": 10, ""deletions"": 1, ""lines"": 11}, ""runtime/ftplugin/vim.vim"": {""insertions"": 12, ""deletions"": 7, ""lines"": 19}, ""runtime/indent/systemverilog.vim"": {""insertions"": 1, ""deletions"": 1, ""lines"": 2}, ""runtime/indent/testdir/vim.in"": {""insertions"": 19, ""deletions"": 0, ""lines"": 19}, ""runtime/indent/testdir/vim.ok"": {""insertions"": 19, ""deletions"": 0, ""lines"": 19}, ""runtime/indent/vim.vim"": {""insertions"": 44, ""deletions"": 2, ""lines"": 46}, ""runtime/lang/menu_tr.cp1254.vim"": {""insertions"": 1, ""deletions"": 1, ""lines"": 2}, ""runtime/lang/menu_tr.iso_8859-9.vim"": {""insertions"": 1, ""deletions"": 1, ""lines"": 2}, ""runtime/pack/dist/opt/termdebug/plugin/termdebug.vim"": {""insertions"": 159, ""deletions"": 3, ""lines"": 162}, ""runtime/syntax/abap.vim"": {""insertions"": 2, ""deletions"": 2, ""lines"": 4}, ""runtime/syntax/prolog.vim"": {""insertions"": 5, ""deletions"": 5, ""lines"": 10}}"
2021-01-11 17:47:00,48e11c10548782f573411b6302f77adb69c40401,Bram Moolenaar,5,2,7,3,"{""src/testdir/test_clientserver.vim"": {""insertions"": 1, ""deletions"": 0, ""lines"": 1}, ""src/testdir/test_vim9_script.vim"": {""insertions"": 2, ""deletions"": 2, ""lines"": 4}, ""src/version.c"": {""insertions"": 2, ""deletions"": 0, ""lines"": 2}}"
2021-01-10 22:58:28,16a6f91ccb42ebde639a4185322b07719d345e86,Bram Moolenaar,2,6,8,2,"{""src/version.c"": {""insertions"": 2, ""deletions"": 0, ""lines"": 2}, ""src/vim9execute.c"": {""insertions"": 0, ""deletions"": 6, ""lines"": 6}}"
2021-01-10 21:56:36,086ae06862077ba228fcae777f2a0b41416c11bb,Bram Moolenaar,3,1,4,2,"{""src/mbyte.c"": {""insertions"": 1, ""deletions"": 1, ""lines"": 2}, ""src/version.c"": {""insertions"": 2, ""deletions"": 0, ""lines"": 2}}"
2021-01-10 21:42:50,75ab91ff3403e725a79ac9c7351b78e9aff71d67,Bram Moolenaar,50,18,68,8,"{""src/evalfunc.c"": {""insertions"": 9, ""deletions"": 0, ""lines"": 9}, ""src/list.c"": {""insertions"": 7, ""deletions"": 4, ""lines"": 11}, ""src/proto/evalfunc.pro"": {""insertions"": 1, ""deletions"": 0, ""lines"": 1}, ""src/testdir/test_vim9_builtin.vim"": {""insertions"": 11, ""deletions"": 2, ""lines"": 13}, ""src/testdir/test_vim9_expr.vim"": {""insertions"": 9, ""deletions"": 9, ""lines"": 18}, ""src/testdir/test_vim9_func.vim"": {""insertions"": 3, ""deletions"": 3, ""lines"": 6}, ""src/version.c"": {""insertions"": 2, ""deletions"": 0, ""lines"": 2}, ""src/vim9compile.c"": {""insertions"": 8, ""deletions"": 0, ""lines"": 8}}"
2021-01-10 19:22:54,6f02b00bb0958f70bc15534e115b4c6dadff0e06,Bram Moolenaar,668,190,858,9,"{""runtime/doc/eval.txt"": {""insertions"": 121, ""deletions"": 29, ""lines"": 150}, ""runtime/doc/usr_41.txt"": {""insertions"": 5, ""deletions"": 0, ""lines"": 5}, ""src/eval.c"": {""insertions"": 93, ""deletions"": 7, ""lines"": 100}, ""src/evalfunc.c"": {""insertions"": 257, ""deletions"": 149, ""lines"": 406}, ""src/proto/eval.pro"": {""insertions"": 4, ""deletions"": 2, ""lines"": 6}, ""src/tag.c"": {""insertions"": 1, ""deletions"": 1, ""lines"": 2}, ""src/testdir/test_cursor_func.vim"": {""insertions"": 184, ""deletions"": 1, ""lines"": 185}, ""src/typval.c"": {""insertions"": 1, ""deletions"": 1, ""lines"": 2}, ""src/version.c"": {""insertions"": 2, ""deletions"": 0, ""lines"": 2}}"
2021-01-10 18:23:27,31a11b942a56bf75a653eec0976f365f9b389a5a,Bram Moolenaar,35,1,36,3,"{""src/testdir/test_vim9_expr.vim"": {""insertions"": 19, ""deletions"": 0, ""lines"": 19}, ""src/version.c"": {""insertions"": 2, ""deletions"": 0, ""lines"": 2}, ""src/vim9compile.c"": {""insertions"": 14, ""deletions"": 1, ""lines"": 15}}"
2021-01-10 17:33:11,0186e58639b19933d3d9188d552fe6745265eb1b,Bram Moolenaar,156,129,285,5,"{""src/structs.h"": {""insertions"": 13, ""deletions"": 7, ""lines"": 20}, ""src/testdir/test_vim9_func.vim"": {""insertions"": 7, ""deletions"": 0, ""lines"": 7}, ""src/version.c"": {""insertions"": 2, ""deletions"": 0, ""lines"": 2}, ""src/vim9.h"": {""insertions"": 8, ""deletions"": 5, ""lines"": 13}, ""src/vim9execute.c"": {""insertions"": 126, ""deletions"": 117, ""lines"": 243}}"
2021-01-10 13:02:28,ab360526ef653b139f4b007a0efbdb3410c8fb4b,Bram Moolenaar,177,43,220,7,"{""src/structs.h"": {""insertions"": 2, ""deletions"": 0, ""lines"": 2}, ""src/testdir/test_vim9_disassemble.vim"": {""insertions"": 3, ""deletions"": 3, ""lines"": 6}, ""src/testdir/test_vim9_func.vim"": {""insertions"": 10, ""deletions"": 0, ""lines"": 10}, ""src/version.c"": {""insertions"": 2, ""deletions"": 0, ""lines"": 2}, ""src/vim9.h"": {""insertions"": 9, ""deletions"": 2, ""lines"": 11}, ""src/vim9compile.c"": {""insertions"": 61, ""deletions"": 18, ""lines"": 79}, ""src/vim9execute.c"": {""insertions"": 90, ""deletions"": 20, ""lines"": 110}}"
2021-01-09 15:21:37,cff40ff98664f4f5a9631aff1a155caf762ea74b,Bram Moolenaar,40,0,40,4,"{""src/errors.h"": {""insertions"": 2, ""deletions"": 0, ""lines"": 2}, ""src/testdir/test_vim9_expr.vim"": {""insertions"": 12, ""deletions"": 0, ""lines"": 12}, ""src/typval.c"": {""insertions"": 24, ""deletions"": 0, ""lines"": 24}, ""src/version.c"": {""insertions"": 2, ""deletions"": 0, ""lines"": 2}}"
2021-01-09 14:45:23,657137ca487c60d63989236115115161def270a5,Bram Moolenaar,26,24,50,9,"{""src/eval.c"": {""insertions"": 1, ""deletions"": 1, ""lines"": 2}, ""src/proto/typval.pro"": {""insertions"": 1, ""deletions"": 1, ""lines"": 2}, ""src/proto/vim9compile.pro"": {""insertions"": 2, ""deletions"": 2, ""lines"": 4}, ""src/structs.h"": {""insertions"": 1, ""deletions"": 1, ""lines"": 2}, ""src/typval.c"": {""insertions"": 1, ""deletions"": 1, ""lines"": 2}, ""src/version.c"": {""insertions"": 2, ""deletions"": 0, ""lines"": 2}, ""src/vim9.h"": {""insertions"": 3, ""deletions"": 3, ""lines"": 6}, ""src/vim9compile.c"": {""insertions"": 13, ""deletions"": 13, ""lines"": 26}, ""src/vim9execute.c"": {""insertions"": 2, ""deletions"": 2, ""lines"": 4}}"
2021-01-09 12:20:37,e7525c552060dd04aacdbca6bb5fe6460cf4da60,Bram Moolenaar,121,101,222,7,"{""src/eval.c"": {""insertions"": 0, ""deletions"": 91, ""lines"": 91}, ""src/list.c"": {""insertions"": 1, ""deletions"": 1, ""lines"": 2}, ""src/proto/eval.pro"": {""insertions"": 0, ""deletions"": 2, ""lines"": 2}, ""src/proto/vim9execute.pro"": {""insertions"": 2, ""deletions"": 0, ""lines"": 2}, ""src/testdir/test_vim9_expr.vim"": {""insertions"": 14, ""deletions"": 7, ""lines"": 21}, ""src/version.c"": {""insertions"": 2, ""deletions"": 0, ""lines"": 2}, ""src/vim9execute.c"": {""insertions"": 102, ""deletions"": 0, ""lines"": 102}}"
2021-01-09 11:09:22,9e0f883f89c915e08ef5fd9e6bf382af57fa9eb2,Bram Moolenaar,30,19,49,3,"{""src/ex_docmd.c"": {""insertions"": 7, ""deletions"": 4, ""lines"": 11}, ""src/testdir/test_vim9_assign.vim"": {""insertions"": 21, ""deletions"": 15, ""lines"": 36}, ""src/version.c"": {""insertions"": 2, ""deletions"": 0, ""lines"": 2}}"
2021-01-08 21:24:19,b657198cb30765468451d7f68fce49b5b4000c5d,Bram Moolenaar,21,1,22,3,"{""src/testdir/test_vim9_func.vim"": {""insertions"": 10, ""deletions"": 0, ""lines"": 10}, ""src/userfunc.c"": {""insertions"": 9, ""deletions"": 1, ""lines"": 10}, ""src/version.c"": {""insertions"": 2, ""deletions"": 0, ""lines"": 2}}"
2021-01-08 20:55:26,832ea89ca90cdff019ee7cf31d5c44bfa164313a,Bram Moolenaar,14,2,16,3,"{""src/testdir/test_vim9_func.vim"": {""insertions"": 8, ""deletions"": 0, ""lines"": 8}, ""src/userfunc.c"": {""insertions"": 4, ""deletions"": 2, ""lines"": 6}, ""src/version.c"": {""insertions"": 2, ""deletions"": 0, ""lines"": 2}}"
2021-01-08 19:53:09,299f3036ec21cc9735846b2e0dfdfc5a78b26c1c,Bram Moolenaar,42,50,92,5,"{""src/testdir/test_vim9_disassemble.vim"": {""insertions"": 24, ""deletions"": 48, ""lines"": 72}, ""src/version.c"": {""insertions"": 2, ""deletions"": 0, ""lines"": 2}, ""src/vim9.h"": {""insertions"": 1, ""deletions"": 0, ""lines"": 1}, ""src/vim9compile.c"": {""insertions"": 2, ""deletions"": 2, ""lines"": 4}, ""src/vim9execute.c"": {""insertions"": 13, ""deletions"": 0, ""lines"": 13}}"
2021-01-08 19:40:45,ece0b87c0fb0e35ff4c51f9ba81389f56428e42b,Bram Moolenaar,11,1,12,3,"{""src/testdir/test_vim9_cmd.vim"": {""insertions"": 6, ""deletions"": 0, ""lines"": 6}, ""src/version.c"": {""insertions"": 2, ""deletions"": 0, ""lines"": 2}, ""src/vim9execute.c"": {""insertions"": 3, ""deletions"": 1, ""lines"": 4}}"
2021-01-08 18:31:39,467b59c2eb06f7fe6c2b5b677855cd422adbc45c,Bram Moolenaar,4,0,4,2,"{""src/if_ruby.c"": {""insertions"": 2, ""deletions"": 0, ""lines"": 2}, ""src/version.c"": {""insertions"": 2, ""deletions"": 0, ""lines"": 2}}"
2021-01-07 21:03:02,17126b13969c3b91516a8e9ff80fb6a1f6924d40,Bram Moolenaar,120,61,181,4,"{""src/ex_docmd.c"": {""insertions"": 19, ""deletions"": 0, ""lines"": 19}, ""src/testdir/test_vim9_assign.vim"": {""insertions"": 21, ""deletions"": 0, ""lines"": 21}, ""src/version.c"": {""insertions"": 2, ""deletions"": 0, ""lines"": 2}, ""src/vim9compile.c"": {""insertions"": 78, ""deletions"": 61, ""lines"": 139}}"
2021-01-07 19:23:33,43b69b39acb85a2aab2310cba5a2dbac338a4eb9,Bram Moolenaar,13,1,14,3,"{""src/evalfunc.c"": {""insertions"": 1, ""deletions"": 1, ""lines"": 2}, ""src/testdir/test_vim9_builtin.vim"": {""insertions"": 10, ""deletions"": 0, ""lines"": 10}, ""src/version.c"": {""insertions"": 2, ""deletions"": 0, ""lines"": 2}}"
2021-01-07 18:36:30,c37b655443e0a11a77a9f0707e3259ab4b8b3dda,Bram Moolenaar,11,1,12,3,"{""src/charset.c"": {""insertions"": 7, ""deletions"": 1, ""lines"": 8}, ""src/testdir/test_eval_stuff.vim"": {""insertions"": 2, ""deletions"": 0, ""lines"": 2}, ""src/version.c"": {""insertions"": 2, ""deletions"": 0, ""lines"": 2}}"
2021-01-07 18:23:08,328eac2b5d1569c57e1130ecb9f7cca733b84d78,Bram Moolenaar,16,4,20,5,"{""src/testdir/test_vim9_assign.vim"": {""insertions"": 7, ""deletions"": 0, ""lines"": 7}, ""src/testdir/test_vim9_func.vim"": {""insertions"": 1, ""deletions"": 1, ""lines"": 2}, ""src/userfunc.c"": {""insertions"": 1, ""deletions"": 1, ""lines"": 2}, ""src/version.c"": {""insertions"": 2, ""deletions"": 0, ""lines"": 2}, ""src/vim9compile.c"": {""insertions"": 5, ""deletions"": 2, ""lines"": 7}}"
2021-01-07 13:45:03,ebbf11c1198b7aec8a1a55f7231ecb4f1a432fa0,Bram Moolenaar,3,5,8,2,"{""src/ex_cmds.c"": {""insertions"": 1, ""deletions"": 5, ""lines"": 6}, ""src/version.c"": {""insertions"": 2, ""deletions"": 0, ""lines"": 2}}"
2021-01-06 20:59:39,32b3f820107139d7edf0c592bb06f090c3eb6c51,Bram Moolenaar,154,54,208,12,"{""src/eval.c"": {""insertions"": 13, ""deletions"": 7, ""lines"": 20}, ""src/evalfunc.c"": {""insertions"": 2, ""deletions"": 1, ""lines"": 3}, ""src/evalvars.c"": {""insertions"": 4, ""deletions"": 6, ""lines"": 10}, ""src/proto/userfunc.pro"": {""insertions"": 2, ""deletions"": 2, ""lines"": 4}, ""src/proto/vim9type.pro"": {""insertions"": 1, ""deletions"": 0, ""lines"": 1}, ""src/structs.h"": {""insertions"": 1, ""deletions"": 0, ""lines"": 1}, ""src/testdir/test_vim9_func.vim"": {""insertions"": 16, ""deletions"": 0, ""lines"": 16}, ""src/userfunc.c"": {""insertions"": 70, ""deletions"": 35, ""lines"": 105}, ""src/version.c"": {""insertions"": 2, ""deletions"": 0, ""lines"": 2}, ""src/vim9compile.c"": {""insertions"": 2, ""deletions"": 2, ""lines"": 4}, ""src/vim9execute.c"": {""insertions"": 1, ""deletions"": 1, ""lines"": 2}, ""src/vim9type.c"": {""insertions"": 40, ""deletions"": 0, ""lines"": 40}}"
2021-01-05 21:08:20,b23279d7a2d28de5df942924b77cf23672fc684f,Bram Moolenaar,75,23,98,5,"{""src/eval.c"": {""insertions"": 24, ""deletions"": 2, ""lines"": 26}, ""src/proto/eval.pro"": {""insertions"": 1, ""deletions"": 0, ""lines"": 1}, ""src/testdir/test_vim9_expr.vim"": {""insertions"": 46, ""deletions"": 19, ""lines"": 65}, ""src/version.c"": {""insertions"": 2, ""deletions"": 0, ""lines"": 2}, ""src/vim9compile.c"": {""insertions"": 2, ""deletions"": 2, ""lines"": 4}}"
2021-01-05 19:58:25,0acbf5ae6632b36c2d2f93406478270ef21f528b,Bram Moolenaar,44,12,56,3,"{""src/testdir/test_vim9_assign.vim"": {""insertions"": 37, ""deletions"": 12, ""lines"": 49}, ""src/version.c"": {""insertions"": 2, ""deletions"": 0, ""lines"": 2}, ""src/vim9execute.c"": {""insertions"": 5, ""deletions"": 0, ""lines"": 5}}"
2021-01-05 18:23:28,ecac591cce23919059a5d93ed2e94541b1be99b5,Bram Moolenaar,26,0,26,3,"{""src/testdir/test_vim9_cmd.vim"": {""insertions"": 17, ""deletions"": 0, ""lines"": 17}, ""src/version.c"": {""insertions"": 2, ""deletions"": 0, ""lines"": 2}, ""src/vim9compile.c"": {""insertions"": 7, ""deletions"": 0, ""lines"": 7}}"
2021-01-05 16:50:28,a79925a0a8f00577782090859eb0ef69e220d4aa,Bram Moolenaar,12,0,12,3,"{""src/testdir/test_vim9_expr.vim"": {""insertions"": 9, ""deletions"": 0, ""lines"": 9}, ""src/typval.c"": {""insertions"": 1, ""deletions"": 0, ""lines"": 1}, ""src/version.c"": {""insertions"": 2, ""deletions"": 0, ""lines"": 2}}"
2021-01-04 20:57:11,752fc692ace51459cb407ec117c147b3bbebc071,Bram Moolenaar,685,433,1118,5,"{""src/testdir/test_vim9_assign.vim"": {""insertions"": 40, ""deletions"": 7, ""lines"": 47}, ""src/version.c"": {""insertions"": 2, ""deletions"": 0, ""lines"": 2}, ""src/vim9.h"": {""insertions"": 1, ""deletions"": 0, ""lines"": 1}, ""src/vim9compile.c"": {""insertions"": 550, ""deletions"": 426, ""lines"": 976}, ""src/vim9execute.c"": {""insertions"": 92, ""deletions"": 0, ""lines"": 92}}"
2021-01-04 16:40:12,d62d87d8f3f337a25b7da72abf55fc8a4bb6100c,Bram Moolenaar,6,0,6,3,"{""src/testdir/test_vim9_expr.vim"": {""insertions"": 2, ""deletions"": 0, ""lines"": 2}, ""src/version.c"": {""insertions"": 2, ""deletions"": 0, ""lines"": 2}, ""src/vim9compile.c"": {""insertions"": 2, ""deletions"": 0, ""lines"": 2}}"
2021-01-04 15:15:58,d1510ee9469f623c872a18b6e3c3666c0fb23c58,Bram Moolenaar,40,6,46,6,"{""src/errors.h"": {""insertions"": 2, ""deletions"": 0, ""lines"": 2}, ""src/ex_docmd.c"": {""insertions"": 5, ""deletions"": 3, ""lines"": 8}, ""src/testdir/test_vim9_cmd.vim"": {""insertions"": 23, ""deletions"": 3, ""lines"": 26}, ""src/version.c"": {""insertions"": 2, ""deletions"": 0, ""lines"": 2}, ""src/vim9compile.c"": {""insertions"": 7, ""deletions"": 0, ""lines"": 7}, ""src/vim9execute.c"": {""insertions"": 1, ""deletions"": 0, ""lines"": 1}}"
2021-01-04 13:09:43,cef1270dec61efb3544f26ceea0f6a4f57e0198a,Bram Moolenaar,54,9,63,4,"{""src/proto/userfunc.pro"": {""insertions"": 0, ""deletions"": 1, ""lines"": 1}, ""src/testdir/test_vim9_func.vim"": {""insertions"": 36, ""deletions"": 0, ""lines"": 36}, ""src/userfunc.c"": {""insertions"": 16, ""deletions"": 8, ""lines"": 24}, ""src/version.c"": {""insertions"": 2, ""deletions"": 0, ""lines"": 2}}"
2021-01-04 12:37:54,0ea04408653be843e37d03ce574f5d2eae682339,Bram Moolenaar,19,2,21,3,"{""src/evalvars.c"": {""insertions"": 8, ""deletions"": 2, ""lines"": 10}, ""src/testdir/test_vim9_assign.vim"": {""insertions"": 9, ""deletions"": 0, ""lines"": 9}, ""src/version.c"": {""insertions"": 2, ""deletions"": 0, ""lines"": 2}}"
2021-01-04 12:18:30,014f698cb68ff80c49f9f5d3dbe78127df281885,Bram Moolenaar,13,4,17,4,"{""runtime/doc/popup.txt"": {""insertions"": 2, ""deletions"": 2, ""lines"": 4}, ""src/popupwin.c"": {""insertions"": 3, ""deletions"": 2, ""lines"": 5}, ""src/testdir/test_popupwin.vim"": {""insertions"": 6, ""deletions"": 0, ""lines"": 6}, ""src/version.c"": {""insertions"": 2, ""deletions"": 0, ""lines"": 2}}"
2021-01-04 11:42:13,d93a7fc1a98a58f8101ee780d4735079ad99ae35,Bram Moolenaar,125,40,165,15,"{""src/ex_cmds.c"": {""insertions"": 2, ""deletions"": 2, ""lines"": 4}, ""src/ex_docmd.c"": {""insertions"": 3, ""deletions"": 2, ""lines"": 5}, ""src/ex_getln.c"": {""insertions"": 36, ""deletions"": 12, ""lines"": 48}, ""src/globals.h"": {""insertions"": 3, ""deletions"": 4, ""lines"": 7}, ""src/option.c"": {""insertions"": 3, ""deletions"": 3, ""lines"": 6}, ""src/proto/regexp.pro"": {""insertions"": 1, ""deletions"": 1, ""lines"": 2}, ""src/regexp.c"": {""insertions"": 8, ""deletions"": 8, ""lines"": 16}, ""src/search.c"": {""insertions"": 1, ""deletions"": 1, ""lines"": 2}, ""src/structs.h"": {""insertions"": 15, ""deletions"": 3, ""lines"": 18}, ""src/tag.c"": {""insertions"": 2, ""deletions"": 2, ""lines"": 4}, ""src/testdir/dumps/Test_incsearch_sub_01.dump"": {""insertions"": 9, ""deletions"": 0, ""lines"": 9}, ""src/testdir/dumps/Test_incsearch_sub_02.dump"": {""insertions"": 9, ""deletions"": 0, ""lines"": 9}, ""src/testdir/test_search.vim"": {""insertions"": 29, ""deletions"": 0, ""lines"": 29}, ""src/version.c"": {""insertions"": 2, ""deletions"": 0, ""lines"": 2}, ""src/vim9compile.c"": {""insertions"": 2, ""deletions"": 2, ""lines"": 4}}"
2021-01-04 09:47:26,82c38fe508155c11a904e6111b5bfb6adde3fb9a,Bram Moolenaar,110,54,164,9,"{""src/Make_vms.mms"": {""insertions"": 44, ""deletions"": 17, ""lines"": 61}, ""src/fileio.c"": {""insertions"": 7, ""deletions"": 2, ""lines"": 9}, ""src/gui_xmebw.c"": {""insertions"": 24, ""deletions"": 10, ""lines"": 34}, ""src/macros.h"": {""insertions"": 0, ""deletions"": 1, ""lines"": 1}, ""src/os_unix.h"": {""insertions"": 3, ""deletions"": 2, ""lines"": 5}, ""src/os_vms.c"": {""insertions"": 11, ""deletions"": 2, ""lines"": 13}, ""src/os_vms_conf.h"": {""insertions"": 6, ""deletions"": 7, ""lines"": 13}, ""src/version.c"": {""insertions"": 2, ""deletions"": 0, ""lines"": 2}, ""src/vim9execute.c"": {""insertions"": 13, ""deletions"": 13, ""lines"": 26}}"
2021-01-03 21:12:15,bb0956fc65ebe8df1da823f9c4d6a0013d9ba5c1,Bram Moolenaar,3,1,4,2,"{""src/gui_motif.c"": {""insertions"": 1, ""deletions"": 1, ""lines"": 2}, ""src/version.c"": {""insertions"": 2, ""deletions"": 0, ""lines"": 2}}"
2021-01-03 21:05:19,5f63938447f3eebd1fc4add999ff8d5b42899178,Bram Moolenaar,10,1,11,2,"{""src/eval.c"": {""insertions"": 8, ""deletions"": 1, ""lines"": 9}, ""src/version.c"": {""insertions"": 2, ""deletions"": 0, ""lines"": 2}}"
2021-01-03 20:53:53,67977821270bd328cd37c4ace38fb97f21ad4fd5,Bram Moolenaar,28,8,36,5,"{""runtime/doc/vim9.txt"": {""insertions"": 6, ""deletions"": 6, ""lines"": 12}, ""src/evalvars.c"": {""insertions"": 1, ""deletions"": 1, ""lines"": 2}, ""src/testdir/test_vim9_expr.vim"": {""insertions"": 4, ""deletions"": 1, ""lines"": 5}, ""src/version.c"": {""insertions"": 2, ""deletions"": 0, ""lines"": 2}, ""src/vim9compile.c"": {""insertions"": 15, ""deletions"": 0, ""lines"": 15}}"
2021-01-03 19:55:26,2ef951dd31505874ae9ac35a18513ef34ae0ea3e,Bram Moolenaar,26,3,29,5,"{""src/eval.c"": {""insertions"": 2, ""deletions"": 2, ""lines"": 4}, ""src/testdir/test_vim9_assign.vim"": {""insertions"": 9, ""deletions"": 0, ""lines"": 9}, ""src/version.c"": {""insertions"": 2, ""deletions"": 0, ""lines"": 2}, ""src/vim.h"": {""insertions"": 2, ""deletions"": 0, ""lines"": 2}, ""src/vim9compile.c"": {""insertions"": 11, ""deletions"": 1, ""lines"": 12}}"
2021-01-03 18:52:05,e5a2dc87fd9d63dfd0d9c379e363ee8b8c05b14c,Bram Moolenaar,56,11,67,10,"{""src/eval.c"": {""insertions"": 7, ""deletions"": 1, ""lines"": 8}, ""src/evalbuffer.c"": {""insertions"": 1, ""deletions"": 1, ""lines"": 2}, ""src/evalfunc.c"": {""insertions"": 8, ""deletions"": 2, ""lines"": 10}, ""src/ex_eval.c"": {""insertions"": 1, ""deletions"": 1, ""lines"": 2}, ""src/gui_motif.c"": {""insertions"": 1, ""deletions"": 1, ""lines"": 2}, ""src/map.c"": {""insertions"": 1, ""deletions"": 1, ""lines"": 2}, ""src/quickfix.c"": {""insertions"": 13, ""deletions"": 2, ""lines"": 15}, ""src/syntax.c"": {""insertions"": 2, ""deletions"": 2, ""lines"": 4}, ""src/testdir/test_quickfix.vim"": {""insertions"": 20, ""deletions"": 0, ""lines"": 20}, ""src/version.c"": {""insertions"": 2, ""deletions"": 0, ""lines"": 2}}"
2021-01-03 17:33:13,5afd081cd3d0f3dfbc7f6b157a8caad0ce6394ee,Bram Moolenaar,22,23,45,3,"{""src/testdir/test_vim9_expr.vim"": {""insertions"": 10, ""deletions"": 1, ""lines"": 11}, ""src/version.c"": {""insertions"": 2, ""deletions"": 0, ""lines"": 2}, ""src/vim9compile.c"": {""insertions"": 10, ""deletions"": 22, ""lines"": 32}}"
2021-01-03 16:39:28,cec77d4530ae51ee9ffe0ab57fa7a37cced2b181,Bram Moolenaar,14,12,26,2,"{""src/testdir/test_sort.vim"": {""insertions"": 12, ""deletions"": 12, ""lines"": 24}, ""src/version.c"": {""insertions"": 2, ""deletions"": 0, ""lines"": 2}}"
2021-01-03 15:18:04,fefa6c347e2c7f01ed2b095084f4aa694ff72149,Bram Moolenaar,111,55,166,2,"{""src/testdir/test_sort.vim"": {""insertions"": 109, ""deletions"": 55, ""lines"": 164}, ""src/version.c"": {""insertions"": 2, ""deletions"": 0, ""lines"": 2}}"
2021-01-03 14:55:10,b0d8182fa39f2c9403f5f9a0663589fcab43a6c8,Bram Moolenaar,13,3,16,3,"{""src/evalvars.c"": {""insertions"": 9, ""deletions"": 3, ""lines"": 12}, ""src/testdir/test_vim9_builtin.vim"": {""insertions"": 2, ""deletions"": 0, ""lines"": 2}, ""src/version.c"": {""insertions"": 2, ""deletions"": 0, ""lines"": 2}}"
2021-01-03 13:47:25,31a201a04aa95708af5d62070d2d397a201cc1a5,Bram Moolenaar,13,1,14,3,"{""src/evalvars.c"": {""insertions"": 3, ""deletions"": 1, ""lines"": 4}, ""src/testdir/test_vim9_builtin.vim"": {""insertions"": 8, ""deletions"": 0, ""lines"": 8}, ""src/version.c"": {""insertions"": 2, ""deletions"": 0, ""lines"": 2}}"
2021-01-03 12:09:51,e68b02a1c40388bbb85e7b825bc538298963e1e1,Bram Moolenaar,17,2,19,3,"{""src/testdir/test_vim9_func.vim"": {""insertions"": 12, ""deletions"": 0, ""lines"": 12}, ""src/version.c"": {""insertions"": 2, ""deletions"": 0, ""lines"": 2}, ""src/vim9type.c"": {""insertions"": 3, ""deletions"": 2, ""lines"": 5}}"
2021-01-02 19:14:23,339c1bdbdfb823c4ea36242f0a4f083cbc010b84,Bram Moolenaar,6,6,12,2,"{""src/ui.c"": {""insertions"": 4, ""deletions"": 6, ""lines"": 10}, ""src/version.c"": {""insertions"": 2, ""deletions"": 0, ""lines"": 2}}"
2021-01-02 18:44:56,a11919fa44fb43e947ef7871f31096a79429ec8a,Bram Moolenaar,26,0,26,3,"{""src/testdir/test_vim9_cmd.vim"": {""insertions"": 10, ""deletions"": 0, ""lines"": 10}, ""src/version.c"": {""insertions"": 2, ""deletions"": 0, ""lines"": 2}, ""src/vim9compile.c"": {""insertions"": 14, ""deletions"": 0, ""lines"": 14}}"
2021-01-02 17:31:32,9d19e4f4ba55f8bef18d4991abdf740ff6472dba,Bram Moolenaar,79,58,137,4,"{""runtime/doc/eval.txt"": {""insertions"": 8, ""deletions"": 8, ""lines"": 16}, ""src/search.c"": {""insertions"": 25, ""deletions"": 6, ""lines"": 31}, ""src/testdir/test_matchfuzzy.vim"": {""insertions"": 44, ""deletions"": 44, ""lines"": 88}, ""src/version.c"": {""insertions"": 2, ""deletions"": 0, ""lines"": 2}}"
2021-01-02 17:17:26,508b5618ec0bc6d1edff71e04d99280a2a51df9d,Bram Moolenaar,7,1,8,2,"{""src/version.c"": {""insertions"": 2, ""deletions"": 0, ""lines"": 2}, ""src/vim9compile.c"": {""insertions"": 5, ""deletions"": 1, ""lines"": 6}}"
2021-01-02 16:43:49,66c50c565321d4d49d8d5620912e5e8fe4825644,Bram Moolenaar,73,3,76,4,"{""src/regexp.c"": {""insertions"": 8, ""deletions"": 1, ""lines"": 9}, ""src/regexp_nfa.c"": {""insertions"": 17, ""deletions"": 2, ""lines"": 19}, ""src/testdir/test_regexp_utf8.vim"": {""insertions"": 46, ""deletions"": 0, ""lines"": 46}, ""src/version.c"": {""insertions"": 2, ""deletions"": 0, ""lines"": 2}}"
2021-01-02 16:06:16,9281c6cae4e1cec2c661487d761d407bad7c6ad6,Bram Moolenaar,3,1,4,2,"{""Filelist"": {""insertions"": 1, ""deletions"": 1, ""lines"": 2}, ""src/version.c"": {""insertions"": 2, ""deletions"": 0, ""lines"": 2}}"
2021-01-02 15:53:13,a72514945bc3edd4fc4d745004e37c5d5487c98d,Bram Moolenaar,18,15,33,8,"{""Filelist"": {""insertions"": 9, ""deletions"": 6, ""lines"": 15}, ""src/clipboard.c"": {""insertions"": 2, ""deletions"": 0, ""lines"": 2}, ""src/fileio.c"": {""insertions"": 1, ""deletions"": 0, ""lines"": 1}, ""src/option.c"": {""insertions"": 1, ""deletions"": 1, ""lines"": 2}, ""src/screen.c"": {""insertions"": 0, ""deletions"": 1, ""lines"": 1}, ""src/testdir/Make_vms.mms"": {""insertions"": 1, ""deletions"": 1, ""lines"": 2}, ""src/testdir/test_signals.vim"": {""insertions"": 2, ""deletions"": 6, ""lines"": 8}, ""src/version.c"": {""insertions"": 2, ""deletions"": 0, ""lines"": 2}}"
2021-01-02 15:39:53,7e6a515ed14e204fafb3dd6e98f2fb543e64aedd,Bram Moolenaar,1730,692,2422,33,"{"".github/CODEOWNERS"": {""insertions"": 0, ""deletions"": 1, ""lines"": 1}, ""runtime/compiler/ocaml.vim"": {""insertions"": 4, ""deletions"": 2, ""lines"": 6}, ""runtime/doc/cmdline.txt"": {""insertions"": 11, ""deletions"": 1, ""lines"": 12}, ""runtime/doc/eval.txt"": {""insertions"": 4, ""deletions"": 4, ""lines"": 8}, ""runtime/doc/helphelp.txt"": {""insertions"": 4, ""deletions"": 1, ""lines"": 5}, ""runtime/doc/intro.txt"": {""insertions"": 3, ""deletions"": 3, ""lines"": 6}, ""runtime/doc/message.txt"": {""insertions"": 4, ""deletions"": 1, ""lines"": 5}, ""runtime/doc/os_vms.txt"": {""insertions"": 9, ""deletions"": 2, ""lines"": 11}, ""runtime/doc/pattern.txt"": {""insertions"": 22, ""deletions"": 20, ""lines"": 42}, ""runtime/doc/repeat.txt"": {""insertions"": 9, ""deletions"": 1, ""lines"": 10}, ""runtime/doc/tags"": {""insertions"": 17, ""deletions"": 3, ""lines"": 20}, ""runtime/doc/term.txt"": {""insertions"": 1, ""deletions"": 1, ""lines"": 2}, ""runtime/doc/terminal.txt"": {""insertions"": 4, ""deletions"": 1, ""lines"": 5}, ""runtime/doc/tips.txt"": {""insertions"": 26, ""deletions"": 1, ""lines"": 27}, ""runtime/doc/todo.txt"": {""insertions"": 56, ""deletions"": 46, ""lines"": 102}, ""runtime/doc/version8.txt"": {""insertions"": 7, ""deletions"": 7, ""lines"": 14}, ""runtime/doc/vim9.txt"": {""insertions"": 17, ""deletions"": 7, ""lines"": 24}, ""runtime/filetype.vim"": {""insertions"": 1, ""deletions"": 1, ""lines"": 2}, ""runtime/ftplugin/dune.vim"": {""insertions"": 1, ""deletions"": 1, ""lines"": 2}, ""runtime/ftplugin/fstab.vim"": {""insertions"": 19, ""deletions"": 0, ""lines"": 19}, ""runtime/ftplugin/ocaml.vim"": {""insertions"": 7, ""deletions"": 6, ""lines"": 13}, ""runtime/ftplugin/sexplib.vim"": {""insertions"": 15, ""deletions"": 0, ""lines"": 15}, ""runtime/indent/dune.vim"": {""insertions"": 13, ""deletions"": 0, ""lines"": 13}, ""runtime/indent/ocaml.vim"": {""insertions"": 3, ""deletions"": 2, ""lines"": 5}, ""runtime/syntax/diff.vim"": {""insertions"": 11, ""deletions"": 6, ""lines"": 17}, ""runtime/syntax/dune.vim"": {""insertions"": 3, ""deletions"": 2, ""lines"": 5}, ""runtime/syntax/fstab.vim"": {""insertions"": 2, ""deletions"": 2, ""lines"": 4}, ""runtime/syntax/gift.vim"": {""insertions"": 216, ""deletions"": 0, ""lines"": 216}, ""runtime/syntax/ocaml.vim"": {""insertions"": 42, ""deletions"": 19, ""lines"": 61}, ""runtime/syntax/opam.vim"": {""insertions"": 38, ""deletions"": 0, ""lines"": 38}, ""runtime/syntax/sexplib.vim"": {""insertions"": 88, ""deletions"": 0, ""lines"": 88}, ""runtime/syntax/sml.vim"": {""insertions"": 47, ""deletions"": 44, ""lines"": 91}, ""src/po/fr.po"": {""insertions"": 1026, ""deletions"": 507, ""lines"": 1533}}"
2021-01-02 15:17:18,02faa944c69ea22a7a5338135b686dac2c946ca1,Bram Moolenaar,7,2,9,2,"{""src/ui.c"": {""insertions"": 5, ""deletions"": 2, ""lines"": 7}, ""src/version.c"": {""insertions"": 2, ""deletions"": 0, ""lines"": 2}}"
2021-01-02 15:06:44,2f91e2f8da572123e53ae7579dde57c750137def,Bram Moolenaar,3,1,4,2,"{""README.md"": {""insertions"": 1, ""deletions"": 1, ""lines"": 2}, ""src/version.c"": {""insertions"": 2, ""deletions"": 0, ""lines"": 2}}"
2021-01-02 14:49:28,628c102d128b4e376916ba38b883eb9ae9f41f31,Bram Moolenaar,4,1,5,2,"{""src/version.c"": {""insertions"": 2, ""deletions"": 0, ""lines"": 2}, ""src/vim9.h"": {""insertions"": 2, ""deletions"": 1, ""lines"": 3}}"
2021-01-02 14:41:03,aa210a3aeccc33c6051978017959126b037f94af,Bram Moolenaar,149,13,162,11,"{""src/dict.c"": {""insertions"": 13, ""deletions"": 0, ""lines"": 13}, ""src/evalvars.c"": {""insertions"": 12, ""deletions"": 4, ""lines"": 16}, ""src/list.c"": {""insertions"": 7, ""deletions"": 2, ""lines"": 9}, ""src/proto/vim9script.pro"": {""insertions"": 1, ""deletions"": 1, ""lines"": 2}, ""src/structs.h"": {""insertions"": 2, ""deletions"": 0, ""lines"": 2}, ""src/testdir/test_vim9_builtin.vim"": {""insertions"": 51, ""deletions"": 0, ""lines"": 51}, ""src/testdir/test_vim9_disassemble.vim"": {""insertions"": 5, ""deletions"": 0, ""lines"": 5}, ""src/version.c"": {""insertions"": 2, ""deletions"": 0, ""lines"": 2}, ""src/vim9compile.c"": {""insertions"": 24, ""deletions"": 0, ""lines"": 24}, ""src/vim9execute.c"": {""insertions"": 27, ""deletions"": 0, ""lines"": 27}, ""src/vim9script.c"": {""insertions"": 5, ""deletions"": 6, ""lines"": 11}}"
2021-01-02 12:53:59,3e0107ea16349b354e0e9712e95b09ef019e99e5,Bram Moolenaar,41,0,41,3,"{""src/evalbuffer.c"": {""insertions"": 6, ""deletions"": 0, ""lines"": 6}, ""src/testdir/test_python3.vim"": {""insertions"": 33, ""deletions"": 0, ""lines"": 33}, ""src/version.c"": {""insertions"": 2, ""deletions"": 0, ""lines"": 2}}"
2021-01-02 11:45:45,38a434f7ba89ab2602019476219780e07fd8251f,Bram Moolenaar,3,1,4,2,"{""src/version.c"": {""insertions"": 2, ""deletions"": 0, ""lines"": 2}, ""src/vim9execute.c"": {""insertions"": 1, ""deletions"": 1, ""lines"": 2}}"
2021-01-01 20:34:37,edc10b541b468f5f5aa2e2d5ef58a3e17e043bff,Bram Moolenaar,17,8,25,2,"{""src/testdir/test_hardcopy.vim"": {""insertions"": 15, ""deletions"": 8, ""lines"": 23}, ""src/version.c"": {""insertions"": 2, ""deletions"": 0, ""lines"": 2}}"
2021-01-01 20:05:55,3862ea3f620f02569c2d816ca9ceeeac3a0ad901,Bram Moolenaar,54,15,69,7,"{""src/eval.c"": {""insertions"": 1, ""deletions"": 1, ""lines"": 2}, ""src/evalvars.c"": {""insertions"": 17, ""deletions"": 9, ""lines"": 26}, ""src/testdir/test_vim9_assign.vim"": {""insertions"": 26, ""deletions"": 4, ""lines"": 30}, ""src/version.c"": {""insertions"": 2, ""deletions"": 0, ""lines"": 2}, ""src/vim.h"": {""insertions"": 1, ""deletions"": 0, ""lines"": 1}, ""src/vim9compile.c"": {""insertions"": 6, ""deletions"": 0, ""lines"": 6}, ""src/vim9execute.c"": {""insertions"": 1, ""deletions"": 1, ""lines"": 2}}"
2021-01-01 18:40:02,c368957b1904bfaa2b0b52bbcade51b20173f3ed,Bram Moolenaar,35,13,48,3,"{""src/evalvars.c"": {""insertions"": 1, ""deletions"": 1, ""lines"": 2}, ""src/testdir/test_vim9_assign.vim"": {""insertions"": 32, ""deletions"": 12, ""lines"": 44}, ""src/version.c"": {""insertions"": 2, ""deletions"": 0, ""lines"": 2}}"
2021-01-01 18:17:55,e7a73e07625b64a40671a0007ad38a34cbe9d1ee,Bram Moolenaar,35,24,59,7,"{""src/errors.h"": {""insertions"": 2, ""deletions"": 2, ""lines"": 4}, ""src/eval.c"": {""insertions"": 4, ""deletions"": 2, ""lines"": 6}, ""src/evalvars.c"": {""insertions"": 2, ""deletions"": 1, ""lines"": 3}, ""src/testdir/test_vim9_expr.vim"": {""insertions"": 12, ""deletions"": 10, ""lines"": 22}, ""src/userfunc.c"": {""insertions"": 2, ""deletions"": 2, ""lines"": 4}, ""src/version.c"": {""insertions"": 2, ""deletions"": 0, ""lines"": 2}, ""src/vim9compile.c"": {""insertions"": 11, ""deletions"": 7, ""lines"": 18}}"
2021-01-01 17:54:34,b8ba9b919708f44b718c17f1fec85b1df8050a17,Bram Moolenaar,22,0,22,3,"{""src/testdir/test_vim9_func.vim"": {""insertions"": 18, ""deletions"": 0, ""lines"": 18}, ""src/userfunc.c"": {""insertions"": 2, ""deletions"": 0, ""lines"": 2}, ""src/version.c"": {""insertions"": 2, ""deletions"": 0, ""lines"": 2}}"
2021-01-01 17:43:51,5178b1b02fc96f42d62199a4be9184c2aea8a49a,Bram Moolenaar,63,22,85,4,"{""src/errors.h"": {""insertions"": 4, ""deletions"": 0, ""lines"": 4}, ""src/testdir/test_vim9_func.vim"": {""insertions"": 19, ""deletions"": 0, ""lines"": 19}, ""src/userfunc.c"": {""insertions"": 38, ""deletions"": 22, ""lines"": 60}, ""src/version.c"": {""insertions"": 2, ""deletions"": 0, ""lines"": 2}}"
2021-01-01 15:10:46,69f7050cebb0f069d6e39571961b9bbe8531c69a,Bram Moolenaar,78,37,115,3,"{""src/testdir/test_vim9_script.vim"": {""insertions"": 29, ""deletions"": 0, ""lines"": 29}, ""src/version.c"": {""insertions"": 2, ""deletions"": 0, ""lines"": 2}, ""src/vim9compile.c"": {""insertions"": 47, ""deletions"": 37, ""lines"": 84}}"
2021-01-01 14:11:04,a8b8af19e48e1803e20a129e9aebab1aac544956,Bram Moolenaar,13,6,19,4,"{""src/evalvars.c"": {""insertions"": 2, ""deletions"": 2, ""lines"": 4}, ""src/testdir/test_vim9_disassemble.vim"": {""insertions"": 2, ""deletions"": 2, ""lines"": 4}, ""src/testdir/test_vim9_expr.vim"": {""insertions"": 7, ""deletions"": 2, ""lines"": 9}, ""src/version.c"": {""insertions"": 2, ""deletions"": 0, ""lines"": 2}}"
2021-01-01 13:49:15,d5ea8f08f78d20fde8773663894de5e8c023bd83,Bram Moolenaar,10,2,12,3,"{""src/testdir/test_vim9_expr.vim"": {""insertions"": 5, ""deletions"": 0, ""lines"": 5}, ""src/version.c"": {""insertions"": 2, ""deletions"": 0, ""lines"": 2}, ""src/vim9compile.c"": {""insertions"": 3, ""deletions"": 2, ""lines"": 5}}"
2021-01-01 13:31:34,5efe0e5d16db070f0ab0b944686139e597afe166,Bram Moolenaar,3,1,4,2,"{""src/testdir/test_window_cmd.vim"": {""insertions"": 1, ""deletions"": 1, ""lines"": 2}, ""src/version.c"": {""insertions"": 2, ""deletions"": 0, ""lines"": 2}}"
2021-01-01 13:20:44,a387083b2f65c2c14b19087c7d7f94ca23de1d48,Bram Moolenaar,9,1,10,2,"{""src/testdir/test_functions.vim"": {""insertions"": 7, ""deletions"": 1, ""lines"": 8}, ""src/version.c"": {""insertions"": 2, ""deletions"": 0, ""lines"": 2}}"
2021-01-01 12:54:00,beef4eeda5c6865fcfe46db43ae71429a2025b58,Bram Moolenaar,17,3,20,3,"{""runtime/filetype.vim"": {""insertions"": 11, ""deletions"": 2, ""lines"": 13}, ""src/testdir/test_filetype.vim"": {""insertions"": 4, ""deletions"": 1, ""lines"": 5}, ""src/version.c"": {""insertions"": 2, ""deletions"": 0, ""lines"": 2}}"
2020-12-31 20:28:47,2949cfdbe4335b9abcfeda1be4dfc52090ee1df6,Bram Moolenaar,137,173,310,10,"{""src/eval.c"": {""insertions"": 24, ""deletions"": 4, ""lines"": 28}, ""src/testdir/test_vim9_assign.vim"": {""insertions"": 4, ""deletions"": 4, ""lines"": 8}, ""src/testdir/test_vim9_builtin.vim"": {""insertions"": 14, ""deletions"": 14, ""lines"": 28}, ""src/testdir/test_vim9_cmd.vim"": {""insertions"": 2, ""deletions"": 2, ""lines"": 4}, ""src/testdir/test_vim9_disassemble.vim"": {""insertions"": 8, ""deletions"": 8, ""lines"": 16}, ""src/testdir/test_vim9_expr.vim"": {""insertions"": 45, ""deletions"": 46, ""lines"": 91}, ""src/testdir/test_vim9_func.vim"": {""insertions"": 29, ""deletions"": 29, ""lines"": 58}, ""src/testdir/test_vim9_script.vim"": {""insertions"": 2, ""deletions"": 2, ""lines"": 4}, ""src/version.c"": {""insertions"": 2, ""deletions"": 0, ""lines"": 2}, ""src/vim9compile.c"": {""insertions"": 7, ""deletions"": 64, ""lines"": 71}}"
2020-12-31 17:28:18,adc8e4464563a2952c10362d396bb4a9f28cd12d,Bram Moolenaar,29,1,30,3,"{""src/testdir/test_vim9_func.vim"": {""insertions"": 5, ""deletions"": 0, ""lines"": 5}, ""src/userfunc.c"": {""insertions"": 22, ""deletions"": 1, ""lines"": 23}, ""src/version.c"": {""insertions"": 2, ""deletions"": 0, ""lines"": 2}}"
2020-12-31 17:11:16,1779ff48427931736998a6e5621b5cbe4d99c3e3,Bram Moolenaar,21,16,37,2,"{""src/if_tcl.c"": {""insertions"": 19, ""deletions"": 16, ""lines"": 35}, ""src/version.c"": {""insertions"": 2, ""deletions"": 0, ""lines"": 2}}"
2020-12-31 16:41:01,dd1f426bd617ac6a775f2e7795ff0b159e3fa315,Bram Moolenaar,104,56,160,12,"{""src/evalvars.c"": {""insertions"": 14, ""deletions"": 7, ""lines"": 21}, ""src/if_mzsch.c"": {""insertions"": 10, ""deletions"": 7, ""lines"": 17}, ""src/if_ruby.c"": {""insertions"": 2, ""deletions"": 6, ""lines"": 8}, ""src/option.c"": {""insertions"": 18, ""deletions"": 14, ""lines"": 32}, ""src/option.h"": {""insertions"": 11, ""deletions"": 0, ""lines"": 11}, ""src/proto/option.pro"": {""insertions"": 1, ""deletions"": 1, ""lines"": 2}, ""src/spell.c"": {""insertions"": 1, ""deletions"": 1, ""lines"": 2}, ""src/testdir/test_vim9_assign.vim"": {""insertions"": 5, ""deletions"": 0, ""lines"": 5}, ""src/testdir/test_vim9_cmd.vim"": {""insertions"": 1, ""deletions"": 1, ""lines"": 2}, ""src/typval.c"": {""insertions"": 20, ""deletions"": 9, ""lines"": 29}, ""src/version.c"": {""insertions"": 2, ""deletions"": 0, ""lines"": 2}, ""src/vim9compile.c"": {""insertions"": 19, ""deletions"": 10, ""lines"": 29}}"
2020-12-31 12:39:54,ca2f7e7af32d51c2be378a5298bc85958c877653,Bram Moolenaar,4,0,4,2,"{""src/userfunc.c"": {""insertions"": 2, ""deletions"": 0, ""lines"": 2}, ""src/version.c"": {""insertions"": 2, ""deletions"": 0, ""lines"": 2}}"
2020-12-31 12:31:23,6b55377303968e1624339cd95053201d5acdcaa2,Bram Moolenaar,12,2,14,4,"{""src/testdir/test_vim9_expr.vim"": {""insertions"": 4, ""deletions"": 0, ""lines"": 4}, ""src/version.c"": {""insertions"": 2, ""deletions"": 0, ""lines"": 2}, ""src/vim9compile.c"": {""insertions"": 2, ""deletions"": 1, ""lines"": 3}, ""src/vim9type.c"": {""insertions"": 4, ""deletions"": 1, ""lines"": 5}}"
2020-12-30 20:16:37,a04d447d3aaddb5b978dd9a0e0186007fde8e09e,Bram Moolenaar,3,1,4,2,"{""src/eval.c"": {""insertions"": 1, ""deletions"": 1, ""lines"": 2}, ""src/version.c"": {""insertions"": 2, ""deletions"": 0, ""lines"": 2}}"
2020-12-30 19:39:21,de4f95b04134f6dfd10f60051a5078fd903a297d,Bram Moolenaar,113,74,187,5,"{""src/eval.c"": {""insertions"": 16, ""deletions"": 1, ""lines"": 17}, ""src/testdir/test_vim9_disassemble.vim"": {""insertions"": 6, ""deletions"": 6, ""lines"": 12}, ""src/testdir/test_vim9_expr.vim"": {""insertions"": 74, ""deletions"": 65, ""lines"": 139}, ""src/version.c"": {""insertions"": 2, ""deletions"": 0, ""lines"": 2}, ""src/vim9compile.c"": {""insertions"": 15, ""deletions"": 2, ""lines"": 17}}"
2020-12-30 13:59:23,2a5c61a0196d2d67313f5b3189974211e6f33562,Bram Moolenaar,6,1,7,2,"{""src/testdir/test_termcodes.vim"": {""insertions"": 4, ""deletions"": 1, ""lines"": 5}, ""src/version.c"": {""insertions"": 2, ""deletions"": 0, ""lines"": 2}}"
2020-12-30 13:08:35,2808da39f9aad674d25df784da636e42372b78e3,Bram Moolenaar,6,3,9,2,"{""src/term.c"": {""insertions"": 4, ""deletions"": 3, ""lines"": 7}, ""src/version.c"": {""insertions"": 2, ""deletions"": 0, ""lines"": 2}}"
2020-12-30 12:14:45,467676d468cb10db78d79d5bd2139ded9f70d26f,Bram Moolenaar,56,32,88,9,"{""src/Make_vms.mms"": {""insertions"": 20, ""deletions"": 6, ""lines"": 26}, ""src/gui.h"": {""insertions"": 2, ""deletions"": 1, ""lines"": 3}, ""src/gui_gtk_vms.h"": {""insertions"": 1, ""deletions"": 11, ""lines"": 12}, ""src/gui_x11.c"": {""insertions"": 9, ""deletions"": 7, ""lines"": 16}, ""src/macros.h"": {""insertions"": 2, ""deletions"": 2, ""lines"": 4}, ""src/os_unix.h"": {""insertions"": 4, ""deletions"": 3, ""lines"": 7}, ""src/os_vms_conf.h"": {""insertions"": 15, ""deletions"": 1, ""lines"": 16}, ""src/term.c"": {""insertions"": 1, ""deletions"": 1, ""lines"": 2}, ""src/version.c"": {""insertions"": 2, ""deletions"": 0, ""lines"": 2}}"
2020-12-29 19:53:33,4d8c96d4668ac965d4e84b9676fba6d7efe62a32,Bram Moolenaar,33,12,45,4,"{""runtime/doc/term.txt"": {""insertions"": 4, ""deletions"": 0, ""lines"": 4}, ""src/term.c"": {""insertions"": 21, ""deletions"": 7, ""lines"": 28}, ""src/testdir/test_terminal3.vim"": {""insertions"": 6, ""deletions"": 5, ""lines"": 11}, ""src/version.c"": {""insertions"": 2, ""deletions"": 0, ""lines"": 2}}"
2020-12-29 19:25:19,285b15fce164ade8b1537b884cc15aebaa60e9ef,Bram Moolenaar,14,2,16,3,"{""src/evalwindow.c"": {""insertions"": 2, ""deletions"": 2, ""lines"": 4}, ""src/testdir/test_vim9_builtin.vim"": {""insertions"": 10, ""deletions"": 0, ""lines"": 10}, ""src/version.c"": {""insertions"": 2, ""deletions"": 0, ""lines"": 2}}"
2020-12-29 11:46:51,89015a675990bd7d70e041c5d890edb803b5c6b7,Bram Moolenaar,12,0,12,3,"{""src/testdir/test_window_cmd.vim"": {""insertions"": 8, ""deletions"": 0, ""lines"": 8}, ""src/version.c"": {""insertions"": 2, ""deletions"": 0, ""lines"": 2}, ""src/window.c"": {""insertions"": 2, ""deletions"": 0, ""lines"": 2}}"
2020-12-29 10:57:46,4012d262072a3ac95878c9d061fa985301720ec2,Bram Moolenaar,16,2,18,3,"{""src/popupwin.c"": {""insertions"": 10, ""deletions"": 2, ""lines"": 12}, ""src/testdir/test_popupwin.vim"": {""insertions"": 4, ""deletions"": 0, ""lines"": 4}, ""src/version.c"": {""insertions"": 2, ""deletions"": 0, ""lines"": 2}}"
2020-12-29 10:15:01,8242ebbdba64cfa5c504c9d8dfb802076d99c602,Bram Moolenaar,43,27,70,6,"{""src/ex_docmd.c"": {""insertions"": 2, ""deletions"": 1, ""lines"": 3}, ""src/scriptfile.c"": {""insertions"": 4, ""deletions"": 4, ""lines"": 8}, ""src/structs.h"": {""insertions"": 2, ""deletions"": 2, ""lines"": 4}, ""src/testdir/test_vim9_cmd.vim"": {""insertions"": 31, ""deletions"": 18, ""lines"": 49}, ""src/userfunc.c"": {""insertions"": 2, ""deletions"": 2, ""lines"": 4}, ""src/version.c"": {""insertions"": 2, ""deletions"": 0, ""lines"": 2}}"
2020-12-28 20:36:56,864a28b6a6ae4f1a56e230be26bc6d13e3f8b3d9,Bram Moolenaar,9,1,10,4,"{""ci/config.mk.clang.sed"": {""insertions"": 1, ""deletions"": 1, ""lines"": 2}, ""src/auto/configure"": {""insertions"": 3, ""deletions"": 0, ""lines"": 3}, ""src/configure.ac"": {""insertions"": 3, ""deletions"": 0, ""lines"": 3}, ""src/version.c"": {""insertions"": 2, ""deletions"": 0, ""lines"": 2}}"
2020-12-28 20:15:16,41a834d1e3dbf9c8759737bcd6524159a9b93d2a,Bram Moolenaar,5,3,8,2,"{""src/testdir/test_clientserver.vim"": {""insertions"": 3, ""deletions"": 3, ""lines"": 6}, ""src/version.c"": {""insertions"": 2, ""deletions"": 0, ""lines"": 2}}"
2020-12-28 19:53:21,dcc58e031ded8b846a39146112b9b075cbb977d9,Bram Moolenaar,86,41,127,10,"{""runtime/doc/vim9.txt"": {""insertions"": 23, ""deletions"": 12, ""lines"": 35}, ""src/proto/vim9compile.pro"": {""insertions"": 1, ""deletions"": 2, ""lines"": 3}, ""src/proto/vim9script.pro"": {""insertions"": 1, ""deletions"": 0, ""lines"": 1}, ""src/scriptfile.c"": {""insertions"": 23, ""deletions"": 15, ""lines"": 38}, ""src/structs.h"": {""insertions"": 2, ""deletions"": 1, ""lines"": 3}, ""src/testdir/test_vim9_cmd.vim"": {""insertions"": 20, ""deletions"": 0, ""lines"": 20}, ""src/userfunc.c"": {""insertions"": 5, ""deletions"": 2, ""lines"": 7}, ""src/version.c"": {""insertions"": 2, ""deletions"": 0, ""lines"": 2}, ""src/vim9compile.c"": {""insertions"": 0, ""deletions"": 9, ""lines"": 9}, ""src/vim9script.c"": {""insertions"": 9, ""deletions"": 0, ""lines"": 9}}"
2020-12-28 17:26:00,9b8d62267f583d5dc042920adb1de046959ad11d,Bram Moolenaar,63,65,128,13,"{""src/autocmd.c"": {""insertions"": 4, ""deletions"": 8, ""lines"": 12}, ""src/buffer.c"": {""insertions"": 5, ""deletions"": 6, ""lines"": 11}, ""src/errors.h"": {""insertions"": 6, ""deletions"": 2, ""lines"": 8}, ""src/ex_docmd.c"": {""insertions"": 1, ""deletions"": 5, ""lines"": 6}, ""src/globals.h"": {""insertions"": 8, ""deletions"": 3, ""lines"": 11}, ""src/main.c"": {""insertions"": 4, ""deletions"": 6, ""lines"": 10}, ""src/menu.c"": {""insertions"": 2, ""deletions"": 10, ""lines"": 12}, ""src/proto.h"": {""insertions"": 1, ""deletions"": 1, ""lines"": 2}, ""src/scriptfile.c"": {""insertions"": 8, ""deletions"": 7, ""lines"": 15}, ""src/structs.h"": {""insertions"": 7, ""deletions"": 5, ""lines"": 12}, ""src/usercmd.c"": {""insertions"": 3, ""deletions"": 7, ""lines"": 10}, ""src/version.c"": {""insertions"": 2, ""deletions"": 0, ""lines"": 2}, ""src/vim9script.c"": {""insertions"": 12, ""deletions"": 5, ""lines"": 17}}"
2020-12-28 14:46:47,ed1e4c9a70aaa7de56bac23e75a846e874a32a56,Bram Moolenaar,3,1,4,2,"{"".github/workflows/ci.yml"": {""insertions"": 1, ""deletions"": 1, ""lines"": 2}, ""src/version.c"": {""insertions"": 2, ""deletions"": 0, ""lines"": 2}}"
2020-12-28 14:41:41,746670604a60cb0356b56c112ffb6d297c679099,Bram Moolenaar,39,1,40,6,"{""runtime/doc/options.txt"": {""insertions"": 3, ""deletions"": 1, ""lines"": 4}, ""src/scriptfile.c"": {""insertions"": 3, ""deletions"": 0, ""lines"": 3}, ""src/testdir/test_options.vim"": {""insertions"": 18, ""deletions"": 0, ""lines"": 18}, ""src/version.c"": {""insertions"": 2, ""deletions"": 0, ""lines"": 2}, ""src/vim.h"": {""insertions"": 1, ""deletions"": 0, ""lines"": 1}, ""src/window.c"": {""insertions"": 12, ""deletions"": 0, ""lines"": 12}}"
2020-12-28 14:07:45,dace9f785fca6cc802b2fb7f11a5ee4fab896432,Bram Moolenaar,92,55,147,3,"{""ci/config.mk.clang.sed"": {""insertions"": 1, ""deletions"": 1, ""lines"": 2}, ""src/if_ruby.c"": {""insertions"": 89, ""deletions"": 54, ""lines"": 143}, ""src/version.c"": {""insertions"": 2, ""deletions"": 0, ""lines"": 2}}"
2020-12-28 12:41:53,3e112acc220dcacb58d77edca71910a532fffd0f,Bram Moolenaar,17,12,29,2,"{""src/testdir/test_cmdline.vim"": {""insertions"": 15, ""deletions"": 12, ""lines"": 27}, ""src/version.c"": {""insertions"": 2, ""deletions"": 0, ""lines"": 2}}"
2020-12-28 11:56:58,17793ef23aae0bc94539390ccfe5e63b0ad39ff2,Bram Moolenaar,109,0,109,5,"{""runtime/doc/eval.txt"": {""insertions"": 27, ""deletions"": 0, ""lines"": 27}, ""runtime/doc/usr_41.txt"": {""insertions"": 1, ""deletions"": 0, ""lines"": 1}, ""src/evalfunc.c"": {""insertions"": 54, ""deletions"": 0, ""lines"": 54}, ""src/testdir/test_functions.vim"": {""insertions"": 25, ""deletions"": 0, ""lines"": 25}, ""src/version.c"": {""insertions"": 2, ""deletions"": 0, ""lines"": 2}}"
2020-12-27 18:18:03,9618a25b9c054f0ee4e267d2db96b6e7c113ed7a,Bram Moolenaar,3,2,5,2,"{""src/ex_docmd.c"": {""insertions"": 1, ""deletions"": 2, ""lines"": 3}, ""src/version.c"": {""insertions"": 2, ""deletions"": 0, ""lines"": 2}}"
2020-12-27 18:00:24,e4862a0fe62261754daf476866ef2aa8586b716c,Bram Moolenaar,20,0,20,3,"{""src/ex_cmds.c"": {""insertions"": 9, ""deletions"": 0, ""lines"": 9}, ""src/testdir/test_clientserver.vim"": {""insertions"": 9, ""deletions"": 0, ""lines"": 9}, ""src/version.c"": {""insertions"": 2, ""deletions"": 0, ""lines"": 2}}"
2020-12-27 17:03:22,179eb567b15a2ed5cf25b45d95d06c7a729d50bc,Bram Moolenaar,22,1,23,3,"{""src/insexpand.c"": {""insertions"": 1, ""deletions"": 1, ""lines"": 2}, ""src/testdir/test_vim9_cmd.vim"": {""insertions"": 19, ""deletions"": 0, ""lines"": 19}, ""src/version.c"": {""insertions"": 2, ""deletions"": 0, ""lines"": 2}}"
2020-12-27 16:35:18,39cb2dab18e85fc60f116a4543e433616872b690,Bram Moolenaar,6,0,6,2,"{""src/ex_docmd.c"": {""insertions"": 4, ""deletions"": 0, ""lines"": 4}, ""src/version.c"": {""insertions"": 2, ""deletions"": 0, ""lines"": 2}}"
2020-12-27 15:55:11,4389f9cd00632adc0216d5ead13d859b186bcbf8,Bram Moolenaar,91,31,122,3,"{""src/ex_docmd.c"": {""insertions"": 42, ""deletions"": 31, ""lines"": 73}, ""src/testdir/test_vim9_cmd.vim"": {""insertions"": 47, ""deletions"": 0, ""lines"": 47}, ""src/version.c"": {""insertions"": 2, ""deletions"": 0, ""lines"": 2}}"
2020-12-27 13:43:30,e462f52db3cab656485a71e4322b6cb18d564a06,Bram Moolenaar,25,59,84,4,"{""src/testdir/test_vim9_expr.vim"": {""insertions"": 7, ""deletions"": 11, ""lines"": 18}, ""src/userfunc.c"": {""insertions"": 1, ""deletions"": 1, ""lines"": 2}, ""src/version.c"": {""insertions"": 2, ""deletions"": 0, ""lines"": 2}, ""src/vim9compile.c"": {""insertions"": 15, ""deletions"": 47, ""lines"": 62}}"
2020-12-27 13:02:27,7e3ee7823ffc55b37e9718720263637ed7232646,Bram Moolenaar,4,0,4,2,"{""src/scriptfile.c"": {""insertions"": 2, ""deletions"": 0, ""lines"": 2}, ""src/version.c"": {""insertions"": 2, ""deletions"": 0, ""lines"": 2}}"
2020-12-27 12:39:50,a6294955308fac1d14b9a8481e7f8581146c706c,Bram Moolenaar,116,43,159,7,"{""src/evalvars.c"": {""insertions"": 1, ""deletions"": 1, ""lines"": 2}, ""src/proto/vim9script.pro"": {""insertions"": 1, ""deletions"": 0, ""lines"": 1}, ""src/structs.h"": {""insertions"": 6, ""deletions"": 4, ""lines"": 10}, ""src/testdir/test_vim9_script.vim"": {""insertions"": 32, ""deletions"": 16, ""lines"": 48}, ""src/version.c"": {""insertions"": 2, ""deletions"": 0, ""lines"": 2}, ""src/vim9compile.c"": {""insertions"": 1, ""deletions"": 1, ""lines"": 2}, ""src/vim9script.c"": {""insertions"": 73, ""deletions"": 21, ""lines"": 94}}"
2020-12-26 19:09:15,07a65d26e7d76ad22d6ef23b50c0faa25e435e02,Bram Moolenaar,105,47,152,11,"{""src/errors.h"": {""insertions"": 2, ""deletions"": 0, ""lines"": 2}, ""src/evalvars.c"": {""insertions"": 9, ""deletions"": 2, ""lines"": 11}, ""src/proto/vim9script.pro"": {""insertions"": 1, ""deletions"": 1, ""lines"": 2}, ""src/proto/vim9type.pro"": {""insertions"": 1, ""deletions"": 0, ""lines"": 1}, ""src/testdir/test_vim9_script.vim"": {""insertions"": 26, ""deletions"": 0, ""lines"": 26}, ""src/version.c"": {""insertions"": 2, ""deletions"": 0, ""lines"": 2}, ""src/vim9.h"": {""insertions"": 1, ""deletions"": 0, ""lines"": 1}, ""src/vim9compile.c"": {""insertions"": 1, ""deletions"": 0, ""lines"": 1}, ""src/vim9execute.c"": {""insertions"": 31, ""deletions"": 25, ""lines"": 56}, ""src/vim9script.c"": {""insertions"": 30, ""deletions"": 18, ""lines"": 48}, ""src/vim9type.c"": {""insertions"": 1, ""deletions"": 1, ""lines"": 2}}"
2020-12-26 16:43:08,cdc40c43f1008bda2f173d3a13606236679e8067,Bram Moolenaar,18,38,56,5,"{""runtime/doc/vim9.txt"": {""insertions"": 0, ""deletions"": 17, ""lines"": 17}, ""src/testdir/test_vim9_script.vim"": {""insertions"": 4, ""deletions"": 11, ""lines"": 15}, ""src/userfunc.c"": {""insertions"": 1, ""deletions"": 3, ""lines"": 4}, ""src/version.c"": {""insertions"": 2, ""deletions"": 0, ""lines"": 2}, ""src/vim9compile.c"": {""insertions"": 11, ""deletions"": 7, ""lines"": 18}}"
2020-12-26 14:39:31,2b32700dabf392566d8e9fef76e0d587a891ee3e,Bram Moolenaar,161,48,209,8,"{""runtime/doc/vim9.txt"": {""insertions"": 60, ""deletions"": 10, ""lines"": 70}, ""src/ex_cmds.h"": {""insertions"": 1, ""deletions"": 1, ""lines"": 2}, ""src/ex_docmd.c"": {""insertions"": 1, ""deletions"": 1, ""lines"": 2}, ""src/scriptfile.c"": {""insertions"": 18, ""deletions"": 32, ""lines"": 50}, ""src/structs.h"": {""insertions"": 5, ""deletions"": 1, ""lines"": 6}, ""src/testdir/test_vim9_script.vim"": {""insertions"": 47, ""deletions"": 0, ""lines"": 47}, ""src/version.c"": {""insertions"": 2, ""deletions"": 0, ""lines"": 2}, ""src/vim9script.c"": {""insertions"": 27, ""deletions"": 3, ""lines"": 30}}"
2020-12-26 11:06:54,b0ac4ea5e1c5f0ff4e951978c32ccfffe46916f8,Bram Moolenaar,21,0,21,3,"{""src/cmdexpand.c"": {""insertions"": 6, ""deletions"": 0, ""lines"": 6}, ""src/testdir/test_cmdline.vim"": {""insertions"": 13, ""deletions"": 0, ""lines"": 13}, ""src/version.c"": {""insertions"": 2, ""deletions"": 0, ""lines"": 2}}"
2020-12-25 21:30:16,e5730bdcea0d4b574835f94b9813f80316590db9,Bram Moolenaar,3,0,3,2,"{""src/userfunc.c"": {""insertions"": 1, ""deletions"": 0, ""lines"": 1}, ""src/version.c"": {""insertions"": 2, ""deletions"": 0, ""lines"": 2}}"
2020-12-25 20:56:57,7e3682068bebc53a5d1e9eaaba61bb4fa9c612da,Bram Moolenaar,120,61,181,3,"{""src/testdir/test_vim9_expr.vim"": {""insertions"": 33, ""deletions"": 27, ""lines"": 60}, ""src/version.c"": {""insertions"": 2, ""deletions"": 0, ""lines"": 2}, ""src/vim9compile.c"": {""insertions"": 85, ""deletions"": 34, ""lines"": 119}}"
2020-12-25 19:24:51,fc0e8f5c3ef51c86cfa4a51f92b264ef79962b9d,Bram Moolenaar,12,2,14,3,"{""src/testdir/test_vim9_builtin.vim"": {""insertions"": 5, ""deletions"": 0, ""lines"": 5}, ""src/version.c"": {""insertions"": 2, ""deletions"": 0, ""lines"": 2}, ""src/vim9execute.c"": {""insertions"": 5, ""deletions"": 2, ""lines"": 7}}"
2020-12-25 18:47:24,20a762987eaa7e6034e9f75df0eb87eedb85d71f,Bram Moolenaar,16,0,16,3,"{""src/testdir/test_vim9_cmd.vim"": {""insertions"": 7, ""deletions"": 0, ""lines"": 7}, ""src/version.c"": {""insertions"": 2, ""deletions"": 0, ""lines"": 2}, ""src/vim9execute.c"": {""insertions"": 7, ""deletions"": 0, ""lines"": 7}}"
2020-12-25 18:25:45,6e2c2c50bada4e3f5c7234902c0bdd64f66619ac,Bram Moolenaar,7,5,12,5,"{""src/errors.h"": {""insertions"": 2, ""deletions"": 2, ""lines"": 4}, ""src/ex_docmd.c"": {""insertions"": 1, ""deletions"": 1, ""lines"": 2}, ""src/testdir/test_vim9_cmd.vim"": {""insertions"": 1, ""deletions"": 1, ""lines"": 2}, ""src/version.c"": {""insertions"": 2, ""deletions"": 0, ""lines"": 2}, ""src/vim9compile.c"": {""insertions"": 1, ""deletions"": 1, ""lines"": 2}}"
2020-12-25 17:35:29,56ce9ea3ea46529cac2fdf3151abfa0e1ae49bad,Bram Moolenaar,25,1,26,3,"{""src/testdir/test_vim9_cmd.vim"": {""insertions"": 9, ""deletions"": 0, ""lines"": 9}, ""src/version.c"": {""insertions"": 2, ""deletions"": 0, ""lines"": 2}, ""src/vim9compile.c"": {""insertions"": 14, ""deletions"": 1, ""lines"": 15}}"
2020-12-25 16:36:27,f8103f274e828bdc2dcbc4d857f166f25e0a855e,Bram Moolenaar,22,15,37,3,"{""src/ex_docmd.c"": {""insertions"": 1, ""deletions"": 1, ""lines"": 2}, ""src/testdir/test_vim9_script.vim"": {""insertions"": 19, ""deletions"": 14, ""lines"": 33}, ""src/version.c"": {""insertions"": 2, ""deletions"": 0, ""lines"": 2}}"
2020-12-25 15:11:53,7cfcd0c99c485a973d8cbff939531e430ad77f55,Bram Moolenaar,3,1,4,2,"{""src/userfunc.c"": {""insertions"": 1, ""deletions"": 1, ""lines"": 2}, ""src/version.c"": {""insertions"": 2, ""deletions"": 0, ""lines"": 2}}"
2020-12-25 14:24:23,c754b4cc98253e1935d3ea5790bc60869c7bc091,Bram Moolenaar,56,16,72,6,"{""src/eval.c"": {""insertions"": 6, ""deletions"": 1, ""lines"": 7}, ""src/testdir/test_vim9_assign.vim"": {""insertions"": 3, ""deletions"": 3, ""lines"": 6}, ""src/testdir/test_vim9_expr.vim"": {""insertions"": 13, ""deletions"": 5, ""lines"": 18}, ""src/userfunc.c"": {""insertions"": 30, ""deletions"": 7, ""lines"": 37}, ""src/version.c"": {""insertions"": 2, ""deletions"": 0, ""lines"": 2}, ""src/vim9type.c"": {""insertions"": 2, ""deletions"": 0, ""lines"": 2}}"
2020-12-25 12:52:37,b2f9e0e2c537bcde16dab3b62687a17e17849ce1,Bram Moolenaar,75,0,75,2,"{""src/if_python3.c"": {""insertions"": 73, ""deletions"": 0, ""lines"": 73}, ""src/version.c"": {""insertions"": 2, ""deletions"": 0, ""lines"": 2}}"
2020-12-25 12:20:41,3868f59466ed5ff1c5624f40b93c0034ce62cb82,Bram Moolenaar,7,22,29,4,"{""src/globals.h"": {""insertions"": 1, ""deletions"": 0, ""lines"": 1}, ""src/version.c"": {""insertions"": 2, ""deletions"": 0, ""lines"": 2}, ""src/vim9compile.c"": {""insertions"": 1, ""deletions"": 10, ""lines"": 11}, ""src/vim9type.c"": {""insertions"": 3, ""deletions"": 12, ""lines"": 15}}"
2020-12-25 11:38:04,9e68c32563d8c9ffe1ac04ecd4ccd730af66b97c,Bram Moolenaar,125,69,194,8,"{""src/eval.c"": {""insertions"": 3, ""deletions"": 1, ""lines"": 4}, ""src/proto/vim9type.pro"": {""insertions"": 1, ""deletions"": 1, ""lines"": 2}, ""src/testdir/test_vim9_expr.vim"": {""insertions"": 10, ""deletions"": 5, ""lines"": 15}, ""src/userfunc.c"": {""insertions"": 32, ""deletions"": 15, ""lines"": 47}, ""src/version.c"": {""insertions"": 2, ""deletions"": 0, ""lines"": 2}, ""src/vim9compile.c"": {""insertions"": 15, ""deletions"": 12, ""lines"": 27}, ""src/vim9script.c"": {""insertions"": 2, ""deletions"": 3, ""lines"": 5}, ""src/vim9type.c"": {""insertions"": 60, ""deletions"": 32, ""lines"": 92}}"
2020-12-24 20:56:41,4aab88d919168ce2ddf4845482f4cff9efa52b5b,Bram Moolenaar,131,25,156,8,"{""src/errors.h"": {""insertions"": 2, ""deletions"": 0, ""lines"": 2}, ""src/scriptfile.c"": {""insertions"": 1, ""deletions"": 0, ""lines"": 1}, ""src/structs.h"": {""insertions"": 2, ""deletions"": 3, ""lines"": 5}, ""src/testdir/test_vim9_script.vim"": {""insertions"": 61, ""deletions"": 0, ""lines"": 61}, ""src/version.c"": {""insertions"": 2, ""deletions"": 0, ""lines"": 2}, ""src/vim9.h"": {""insertions"": 9, ""deletions"": 2, ""lines"": 11}, ""src/vim9compile.c"": {""insertions"": 18, ""deletions"": 4, ""lines"": 22}, ""src/vim9execute.c"": {""insertions"": 36, ""deletions"": 16, ""lines"": 52}}"
2020-12-24 17:39:02,38455a921395a56690790c8c1d28c1c43ca04c8a,Bram Moolenaar,83,4,87,5,"{""src/popupmenu.c"": {""insertions"": 15, ""deletions"": 2, ""lines"": 17}, ""src/testdir/dumps/Test_popup_command_04.dump"": {""insertions"": 20, ""deletions"": 0, ""lines"": 20}, ""src/testdir/dumps/Test_popup_command_05.dump"": {""insertions"": 20, ""deletions"": 0, ""lines"": 20}, ""src/testdir/test_popup.vim"": {""insertions"": 26, ""deletions"": 2, ""lines"": 28}, ""src/version.c"": {""insertions"": 2, ""deletions"": 0, ""lines"": 2}}"
2020-12-24 16:41:12,0261a1aeeb4ccec4ef75cc8e0685c78f5622dbf5,Bram Moolenaar,2,3,5,1,"{""README.md"": {""insertions"": 2, ""deletions"": 3, ""lines"": 5}}"
2020-12-24 16:35:41,c139aa8a2bf3de9fb524344e632eb323e0093fd2,Bram Moolenaar,2,14,16,1,"{""README.md"": {""insertions"": 2, ""deletions"": 14, ""lines"": 16}}"
2020-12-24 16:25:06,b04ddb5b04fbb220a680780928242f9e4eda9f62,Bram Moolenaar,2,2,4,1,"{""README.md"": {""insertions"": 2, ""deletions"": 2, ""lines"": 4}}"
2020-12-24 16:20:24,b54f1202b3cd9e5e0510b546d8a9a4f2e7b6b451,Bram Moolenaar,18,4,22,1,"{""README.md"": {""insertions"": 18, ""deletions"": 4, ""lines"": 22}}"
2020-12-24 16:15:53,4941b5effd7f6a26583a949c92ee50276a3b43f9,Bram Moolenaar,31,0,31,3,"{""src/eval.c"": {""insertions"": 18, ""deletions"": 0, ""lines"": 18}, ""src/testdir/test_cmdline.vim"": {""insertions"": 11, ""deletions"": 0, ""lines"": 11}, ""src/version.c"": {""insertions"": 2, ""deletions"": 0, ""lines"": 2}}"
2020-12-24 15:06:00,6dd41b1d575e8859238144899600e3cbb412c79b,Bram Moolenaar,10,0,10,2,"{""src/userfunc.c"": {""insertions"": 8, ""deletions"": 0, ""lines"": 8}, ""src/version.c"": {""insertions"": 2, ""deletions"": 0, ""lines"": 2}}"
2020-12-24 14:14:01,65c4415276394c871c7a8711c7633c19ec9235b1,Bram Moolenaar,246,44,290,5,"{""runtime/doc/vim9.txt"": {""insertions"": 36, ""deletions"": 10, ""lines"": 46}, ""src/testdir/test_vim9_expr.vim"": {""insertions"": 94, ""deletions"": 0, ""lines"": 94}, ""src/userfunc.c"": {""insertions"": 54, ""deletions"": 12, ""lines"": 66}, ""src/version.c"": {""insertions"": 2, ""deletions"": 0, ""lines"": 2}, ""src/vim9compile.c"": {""insertions"": 60, ""deletions"": 22, ""lines"": 82}}"
2020-12-24 12:33:46,b34f33747223d9cba4b32a27aee70c1705b36ed9,Bram Moolenaar,6,0,6,3,"{""runtime/filetype.vim"": {""insertions"": 3, ""deletions"": 0, ""lines"": 3}, ""src/testdir/test_filetype.vim"": {""insertions"": 1, ""deletions"": 0, ""lines"": 1}, ""src/version.c"": {""insertions"": 2, ""deletions"": 0, ""lines"": 2}}"
2020-12-23 21:40:11,16204962c7ad7380a40f0855443303ad16114e2b,Bram Moolenaar,4,2,6,2,"{""src/testdir/test_writefile.vim"": {""insertions"": 2, ""deletions"": 2, ""lines"": 4}, ""src/version.c"": {""insertions"": 2, ""deletions"": 0, ""lines"": 2}}"
2020-12-23 19:55:15,bd318559cf8dea210e943100536011473f25bf68,Bram Moolenaar,5,1,6,2,"{""src/testdir/test_writefile.vim"": {""insertions"": 3, ""deletions"": 1, ""lines"": 4}, ""src/version.c"": {""insertions"": 2, ""deletions"": 0, ""lines"": 2}}"
2020-12-23 19:27:31,27bf7af9d042b396c412fcad7bac59849a4a420f,Bram Moolenaar,20,9,29,4,"{""src/testdir/test_vim9_disassemble.vim"": {""insertions"": 4, ""deletions"": 4, ""lines"": 8}, ""src/testdir/test_vim9_expr.vim"": {""insertions"": 5, ""deletions"": 1, ""lines"": 6}, ""src/version.c"": {""insertions"": 2, ""deletions"": 0, ""lines"": 2}, ""src/vim9compile.c"": {""insertions"": 9, ""deletions"": 4, ""lines"": 13}}"
2020-12-23 17:54:57,b3c8b1d25414f2e24ad03551cdf125b3e2c142b1,Bram Moolenaar,21,1,22,3,"{""src/bufwrite.c"": {""insertions"": 1, ""deletions"": 1, ""lines"": 2}, ""src/testdir/test_writefile.vim"": {""insertions"": 18, ""deletions"": 0, ""lines"": 18}, ""src/version.c"": {""insertions"": 2, ""deletions"": 0, ""lines"": 2}}"
2020-12-23 13:36:00,23999d799cfe844b604f193183f8f84052c8e746,Bram Moolenaar,37,3,40,5,"{""src/move.c"": {""insertions"": 13, ""deletions"": 2, ""lines"": 15}, ""src/proto/move.pro"": {""insertions"": 1, ""deletions"": 0, ""lines"": 1}, ""src/testdir/test_textprop.vim"": {""insertions"": 20, ""deletions"": 0, ""lines"": 20}, ""src/textprop.c"": {""insertions"": 1, ""deletions"": 1, ""lines"": 2}, ""src/version.c"": {""insertions"": 2, ""deletions"": 0, ""lines"": 2}}"
2020-12-23 12:56:35,4072ba571babd733d1800c082416fe8fe3c28ed7,Bram Moolenaar,266,160,426,29,"{"".github/CODEOWNERS"": {""insertions"": 20, ""deletions"": 4, ""lines"": 24}, ""README.md"": {""insertions"": 4, ""deletions"": 13, ""lines"": 17}, ""runtime/doc/autocmd.txt"": {""insertions"": 3, ""deletions"": 1, ""lines"": 4}, ""runtime/doc/editing.txt"": {""insertions"": 4, ""deletions"": 4, ""lines"": 8}, ""runtime/doc/eval.txt"": {""insertions"": 9, ""deletions"": 3, ""lines"": 12}, ""runtime/doc/helphelp.txt"": {""insertions"": 3, ""deletions"": 3, ""lines"": 6}, ""runtime/doc/intro.txt"": {""insertions"": 2, ""deletions"": 2, ""lines"": 4}, ""runtime/doc/options.txt"": {""insertions"": 6, ""deletions"": 2, ""lines"": 8}, ""runtime/doc/starting.txt"": {""insertions"": 2, ""deletions"": 2, ""lines"": 4}, ""runtime/doc/syntax.txt"": {""insertions"": 3, ""deletions"": 3, ""lines"": 6}, ""runtime/doc/tags"": {""insertions"": 3, ""deletions"": 1, ""lines"": 4}, ""runtime/doc/tagsrch.txt"": {""insertions"": 2, ""deletions"": 2, ""lines"": 4}, ""runtime/doc/testing.txt"": {""insertions"": 6, ""deletions"": 3, ""lines"": 9}, ""runtime/doc/todo.txt"": {""insertions"": 14, ""deletions"": 6, ""lines"": 20}, ""runtime/doc/usr_23.txt"": {""insertions"": 9, ""deletions"": 9, ""lines"": 18}, ""runtime/doc/usr_41.txt"": {""insertions"": 2, ""deletions"": 2, ""lines"": 4}, ""runtime/doc/version5.txt"": {""insertions"": 2, ""deletions"": 2, ""lines"": 4}, ""runtime/doc/vim9.txt"": {""insertions"": 32, ""deletions"": 8, ""lines"": 40}, ""runtime/doc/windows.txt"": {""insertions"": 6, ""deletions"": 6, ""lines"": 12}, ""runtime/ftplugin/css.vim"": {""insertions"": 3, ""deletions"": 2, ""lines"": 5}, ""runtime/ftplugin/spec.vim"": {""insertions"": 18, ""deletions"": 18, ""lines"": 36}, ""runtime/indent/html.vim"": {""insertions"": 2, ""deletions"": 2, ""lines"": 4}, ""runtime/macros/less.vim"": {""insertions"": 11, ""deletions"": 3, ""lines"": 14}, ""runtime/syntax/doxygen.vim"": {""insertions"": 20, ""deletions"": 14, ""lines"": 34}, ""runtime/syntax/php.vim"": {""insertions"": 37, ""deletions"": 16, ""lines"": 53}, ""runtime/syntax/sil.vim"": {""insertions"": 1, ""deletions"": 0, ""lines"": 1}, ""runtime/syntax/swift.vim"": {""insertions"": 13, ""deletions"": 4, ""lines"": 17}, ""runtime/syntax/vim.vim"": {""insertions"": 28, ""deletions"": 24, ""lines"": 52}, ""src/INSTALLmac.txt"": {""insertions"": 1, ""deletions"": 1, ""lines"": 2}}"
2020-12-23 11:50:20,9f63a65f22b6a899925ba15adbb711e86251114e,Bram Moolenaar,4,2,6,2,"{""src/testdir/test_registers.vim"": {""insertions"": 2, ""deletions"": 2, ""lines"": 4}, ""src/version.c"": {""insertions"": 2, ""deletions"": 0, ""lines"": 2}}"
2020-12-23 11:33:42,abcbb0e9ad43fc25077e1681528e72ddcbeed300,Bram Moolenaar,6,4,10,3,"{""src/auto/configure"": {""insertions"": 2, ""deletions"": 2, ""lines"": 4}, ""src/configure.ac"": {""insertions"": 2, ""deletions"": 2, ""lines"": 4}, ""src/version.c"": {""insertions"": 2, ""deletions"": 0, ""lines"": 2}}"
2020-12-22 21:07:30,1dcf55d4f1aa34b6d22001038d43f3e46407fa2e,Bram Moolenaar,8,8,16,4,"{""src/eval.c"": {""insertions"": 3, ""deletions"": 3, ""lines"": 6}, ""src/evalvars.c"": {""insertions"": 2, ""deletions"": 4, ""lines"": 6}, ""src/testdir/test_vim9_func.vim"": {""insertions"": 1, ""deletions"": 1, ""lines"": 2}, ""src/version.c"": {""insertions"": 2, ""deletions"": 0, ""lines"": 2}}"
2020-12-22 20:19:39,89b474dd4f0de878b4c48eeb9e223f0c22ee1442,Bram Moolenaar,70,15,85,5,"{""src/evalvars.c"": {""insertions"": 20, ""deletions"": 13, ""lines"": 33}, ""src/testdir/test_vim9_assign.vim"": {""insertions"": 46, ""deletions"": 0, ""lines"": 46}, ""src/testdir/test_vim9_func.vim"": {""insertions"": 1, ""deletions"": 1, ""lines"": 2}, ""src/version.c"": {""insertions"": 2, ""deletions"": 0, ""lines"": 2}, ""src/vim.h"": {""insertions"": 1, ""deletions"": 1, ""lines"": 2}}"
2020-12-22 19:35:40,3bdc90b7dfab314768a8f56454ea62929524f05c,Bram Moolenaar,39,10,49,5,"{""src/evalvars.c"": {""insertions"": 17, ""deletions"": 7, ""lines"": 24}, ""src/proto/evalvars.pro"": {""insertions"": 1, ""deletions"": 0, ""lines"": 1}, ""src/testdir/test_vim9_func.vim"": {""insertions"": 11, ""deletions"": 0, ""lines"": 11}, ""src/version.c"": {""insertions"": 2, ""deletions"": 0, ""lines"": 2}, ""src/vim9execute.c"": {""insertions"": 8, ""deletions"": 3, ""lines"": 11}}"
2020-12-22 18:05:33,e5492609b3a153c631f1d600ecdef1af1c913bef,Bram Moolenaar,6,6,12,3,"{"".github/workflows/ci.yml"": {""insertions"": 3, ""deletions"": 5, ""lines"": 8}, ""Filelist"": {""insertions"": 1, ""deletions"": 1, ""lines"": 2}, ""src/version.c"": {""insertions"": 2, ""deletions"": 0, ""lines"": 2}}"
2020-12-22 17:56:55,58a52f215a568b32c8a3aec0ccdb383f1a76dba0,Bram Moolenaar,46,13,59,3,"{""src/testdir/test_vim9_func.vim"": {""insertions"": 13, ""deletions"": 0, ""lines"": 13}, ""src/version.c"": {""insertions"": 2, ""deletions"": 0, ""lines"": 2}, ""src/vim9compile.c"": {""insertions"": 31, ""deletions"": 13, ""lines"": 44}}"
2020-12-22 17:33:27,077a42318c20ec9e71250edd8c4346edef72281b,Bram Moolenaar,27,2,29,3,"{""src/testdir/test_vim9_func.vim"": {""insertions"": 22, ""deletions"": 0, ""lines"": 22}, ""src/version.c"": {""insertions"": 2, ""deletions"": 0, ""lines"": 2}, ""src/vim9compile.c"": {""insertions"": 3, ""deletions"": 2, ""lines"": 5}}"
2020-12-22 16:59:35,032a2d050b82b146d70d6ff714838ee62c07d8ad,Bram Moolenaar,22,2,24,4,"{""src/ops.c"": {""insertions"": 1, ""deletions"": 1, ""lines"": 2}, ""src/register.c"": {""insertions"": 8, ""deletions"": 1, ""lines"": 9}, ""src/testdir/test_registers.vim"": {""insertions"": 11, ""deletions"": 0, ""lines"": 11}, ""src/version.c"": {""insertions"": 2, ""deletions"": 0, ""lines"": 2}}"
2020-12-22 16:35:54,cd45ed03bfdd7fac53d562ad402df74bd26e7754,Bram Moolenaar,143,91,234,10,"{""src/proto/userfunc.pro"": {""insertions"": 1, ""deletions"": 1, ""lines"": 2}, ""src/proto/vim9compile.pro"": {""insertions"": 1, ""deletions"": 1, ""lines"": 2}, ""src/proto/vim9execute.pro"": {""insertions"": 1, ""deletions"": 0, ""lines"": 1}, ""src/structs.h"": {""insertions"": 1, ""deletions"": 0, ""lines"": 1}, ""src/testdir/test_vim9_func.vim"": {""insertions"": 20, ""deletions"": 0, ""lines"": 20}, ""src/userfunc.c"": {""insertions"": 78, ""deletions"": 56, ""lines"": 134}, ""src/version.c"": {""insertions"": 2, ""deletions"": 0, ""lines"": 2}, ""src/vim9.h"": {""insertions"": 2, ""deletions"": 0, ""lines"": 2}, ""src/vim9compile.c"": {""insertions"": 22, ""deletions"": 12, ""lines"": 34}, ""src/vim9execute.c"": {""insertions"": 15, ""deletions"": 21, ""lines"": 36}}"
2020-12-22 11:50:10,07761a3b965ec3be0c8d52aae9b6dc09c2127d27,Bram Moolenaar,8,5,13,2,"{""src/testdir/test_python3.vim"": {""insertions"": 6, ""deletions"": 5, ""lines"": 11}, ""src/version.c"": {""insertions"": 2, ""deletions"": 0, ""lines"": 2}}"
2020-12-22 11:20:08,5b3d1bb0f5180266c4de4d815b3ea856a2fb3519,Bram Moolenaar,39,5,44,5,"{""src/eval.c"": {""insertions"": 20, ""deletions"": 4, ""lines"": 24}, ""src/ops.c"": {""insertions"": 1, ""deletions"": 1, ""lines"": 2}, ""src/proto/eval.pro"": {""insertions"": 1, ""deletions"": 0, ""lines"": 1}, ""src/testdir/test_vim9_func.vim"": {""insertions"": 15, ""deletions"": 0, ""lines"": 15}, ""src/version.c"": {""insertions"": 2, ""deletions"": 0, ""lines"": 2}}"
2020-12-22 11:18:11,c882e4d169fd5e0364bc91642040337efe7327a6,Bram Moolenaar,2,0,2,1,"{""src/version.c"": {""insertions"": 2, ""deletions"": 0, ""lines"": 2}}"
2020-12-22 10:40:45,1cfb9bb5c06c07f14475f39c4eb57fea1f0dfb69,Bram Moolenaar,108,85,193,2,"{""src/quickfix.c"": {""insertions"": 1, ""deletions"": 1, ""lines"": 2}, ""src/testdir/test_autocmd.vim"": {""insertions"": 107, ""deletions"": 84, ""lines"": 191}}"
2020-12-21 20:58:46,9a963377b4811e4e0419ec8825856ff4b01331ac,Bram Moolenaar,21,3,24,5,"{""src/evalfunc.c"": {""insertions"": 2, ""deletions"": 0, ""lines"": 2}, ""src/testdir/test_cursor_func.vim"": {""insertions"": 1, ""deletions"": 1, ""lines"": 2}, ""src/testdir/test_vim9_builtin.vim"": {""insertions"": 14, ""deletions"": 0, ""lines"": 14}, ""src/typval.c"": {""insertions"": 2, ""deletions"": 2, ""lines"": 4}, ""src/version.c"": {""insertions"": 2, ""deletions"": 0, ""lines"": 2}}"
2020-12-21 19:32:43,60f63100b9bc1d24b7b80c81f43cf2fc3da95987,Bram Moolenaar,24,0,24,3,"{""src/ex_cmds.c"": {""insertions"": 9, ""deletions"": 0, ""lines"": 9}, ""src/testdir/test_vim9_cmd.vim"": {""insertions"": 13, ""deletions"": 0, ""lines"": 13}, ""src/version.c"": {""insertions"": 2, ""deletions"": 0, ""lines"": 2}}"
2020-12-21 18:59:08,f4e2099e39ed4d71aed0f9a9579455aed5ec6cc2,Bram Moolenaar,98,42,140,17,"{""src/arglist.c"": {""insertions"": 1, ""deletions"": 1, ""lines"": 2}, ""src/buffer.c"": {""insertions"": 1, ""deletions"": 1, ""lines"": 2}, ""src/cmdexpand.c"": {""insertions"": 3, ""deletions"": 3, ""lines"": 6}, ""src/ex_cmds.c"": {""insertions"": 7, ""deletions"": 6, ""lines"": 13}, ""src/ex_cmds.h"": {""insertions"": 2, ""deletions"": 2, ""lines"": 4}, ""src/ex_docmd.c"": {""insertions"": 7, ""deletions"": 7, ""lines"": 14}, ""src/ex_getln.c"": {""insertions"": 7, ""deletions"": 7, ""lines"": 14}, ""src/globals.h"": {""insertions"": 5, ""deletions"": 0, ""lines"": 5}, ""src/insexpand.c"": {""insertions"": 2, ""deletions"": 2, ""lines"": 4}, ""src/normal.c"": {""insertions"": 2, ""deletions"": 2, ""lines"": 4}, ""src/option.c"": {""insertions"": 19, ""deletions"": 0, ""lines"": 19}, ""src/proto/option.pro"": {""insertions"": 1, ""deletions"": 0, ""lines"": 1}, ""src/search.c"": {""insertions"": 8, ""deletions"": 5, ""lines"": 13}, ""src/structs.h"": {""insertions"": 6, ""deletions"": 0, ""lines"": 6}, ""src/tag.c"": {""insertions"": 7, ""deletions"": 6, ""lines"": 13}, ""src/testdir/test_vim9_cmd.vim"": {""insertions"": 18, ""deletions"": 0, ""lines"": 18}, ""src/version.c"": {""insertions"": 2, ""deletions"": 0, ""lines"": 2}}"
2020-12-21 17:24:00,a3d10a508c404a32485adc86284725e0bdc5b602,Bram Moolenaar,32,24,56,3,"{""src/regexp_bt.c"": {""insertions"": 15, ""deletions"": 12, ""lines"": 27}, ""src/regexp_nfa.c"": {""insertions"": 15, ""deletions"": 12, ""lines"": 27}, ""src/version.c"": {""insertions"": 2, ""deletions"": 0, ""lines"": 2}}"
2020-12-21 17:11:24,6f17a3f0237302b82cc31fb889d9094b51856948,Bram Moolenaar,6,1,7,2,"{""src/testdir/test_vim9_script.vim"": {""insertions"": 4, ""deletions"": 1, ""lines"": 5}, ""src/version.c"": {""insertions"": 2, ""deletions"": 0, ""lines"": 2}}"
2020-12-21 16:30:50,4f5e39775616795ac7d1c01bf15a1bd316feb387,Bram Moolenaar,232,129,361,7,"{""src/errors.h"": {""insertions"": 4, ""deletions"": 0, ""lines"": 4}, ""src/testdir/test_vim9_assign.vim"": {""insertions"": 28, ""deletions"": 2, ""lines"": 30}, ""src/testdir/test_vim9_disassemble.vim"": {""insertions"": 24, ""deletions"": 0, ""lines"": 24}, ""src/version.c"": {""insertions"": 2, ""deletions"": 0, ""lines"": 2}, ""src/vim9.h"": {""insertions"": 3, ""deletions"": 2, ""lines"": 5}, ""src/vim9compile.c"": {""insertions"": 21, ""deletions"": 27, ""lines"": 48}, ""src/vim9execute.c"": {""insertions"": 150, ""deletions"": 98, ""lines"": 248}}"
2020-12-21 15:03:02,2e2f52a4a0fd560d37a11a7383a4d52b63ca6cfc,Bram Moolenaar,34,9,43,6,"{""src/if_py_both.h"": {""insertions"": 7, ""deletions"": 5, ""lines"": 12}, ""src/if_python.c"": {""insertions"": 4, ""deletions"": 0, ""lines"": 4}, ""src/if_python3.c"": {""insertions"": 7, ""deletions"": 4, ""lines"": 11}, ""src/testdir/test_python2.vim"": {""insertions"": 7, ""deletions"": 0, ""lines"": 7}, ""src/testdir/test_python3.vim"": {""insertions"": 7, ""deletions"": 0, ""lines"": 7}, ""src/version.c"": {""insertions"": 2, ""deletions"": 0, ""lines"": 2}}"
2020-12-21 13:54:32,ef2dff52de52c17fe1bd7c06cbb32d8955901f5a,Bram Moolenaar,18,3,21,3,"{""src/regexp_nfa.c"": {""insertions"": 5, ""deletions"": 3, ""lines"": 8}, ""src/testdir/test_regexp_utf8.vim"": {""insertions"": 11, ""deletions"": 0, ""lines"": 11}, ""src/version.c"": {""insertions"": 2, ""deletions"": 0, ""lines"": 2}}"
2020-12-21 13:01:41,6a78f328442073c32d58eafc13ce5a1ca7729eeb,Bram Moolenaar,10,1,11,3,"{""src/fold.c"": {""insertions"": 1, ""deletions"": 1, ""lines"": 2}, ""src/testdir/test_fold.vim"": {""insertions"": 7, ""deletions"": 0, ""lines"": 7}, ""src/version.c"": {""insertions"": 2, ""deletions"": 0, ""lines"": 2}}"
2020-12-21 12:37:28,9aff970204234193045cfee205d51e2393e93bfd,Bram Moolenaar,18,13,31,2,"{"".github/workflows/ci.yml"": {""insertions"": 16, ""deletions"": 13, ""lines"": 29}, ""src/version.c"": {""insertions"": 2, ""deletions"": 0, ""lines"": 2}}"
2020-12-21 12:05:57,8c9d98a8af5351a3ac98cf11dede9f0268461511,Bram Moolenaar,7,0,7,1,"{""src/version.c"": {""insertions"": 7, ""deletions"": 0, ""lines"": 7}}"
2020-12-20 20:43:35,52c124d3303d3cc3e4504708881906d17d6d6c55,Bram Moolenaar,19,4,23,5,"{""src/errors.h"": {""insertions"": 2, ""deletions"": 0, ""lines"": 2}, ""src/testdir/test_vim9_cmd.vim"": {""insertions"": 11, ""deletions"": 0, ""lines"": 11}, ""src/version.c"": {""insertions"": 2, ""deletions"": 0, ""lines"": 2}, ""src/vim9compile.c"": {""insertions"": 3, ""deletions"": 2, ""lines"": 5}, ""src/vim9execute.c"": {""insertions"": 1, ""deletions"": 2, ""lines"": 3}}"
2020-12-20 20:10:17,5082471f91dd42ed8c35e0f649d0a6572e6fe3fc,Bram Moolenaar,55,8,63,6,"{""src/proto/userfunc.pro"": {""insertions"": 1, ""deletions"": 0, ""lines"": 1}, ""src/testdir/test_vim9_func.vim"": {""insertions"": 19, ""deletions"": 0, ""lines"": 19}, ""src/testdir/test_vim9_script.vim"": {""insertions"": 2, ""deletions"": 2, ""lines"": 4}, ""src/userfunc.c"": {""insertions"": 20, ""deletions"": 6, ""lines"": 26}, ""src/version.c"": {""insertions"": 2, ""deletions"": 0, ""lines"": 2}, ""src/vim9execute.c"": {""insertions"": 11, ""deletions"": 0, ""lines"": 11}}"
2020-12-20 16:59:53,61e07b2394e12f757160cac421ec5c45dc4c074d,Bram Moolenaar,3,1,4,2,"{""src/regexp_nfa.c"": {""insertions"": 1, ""deletions"": 1, ""lines"": 2}, ""src/version.c"": {""insertions"": 2, ""deletions"": 0, ""lines"": 2}}"
2020-12-20 16:47:52,f112f30a82f17114d8b08a0fb90928cd19440581,Bram Moolenaar,114,45,159,6,"{""src/proto/userfunc.pro"": {""insertions"": 1, ""deletions"": 1, ""lines"": 2}, ""src/structs.h"": {""insertions"": 3, ""deletions"": 0, ""lines"": 3}, ""src/testdir/test_vim9_func.vim"": {""insertions"": 23, ""deletions"": 0, ""lines"": 23}, ""src/userfunc.c"": {""insertions"": 10, ""deletions"": 5, ""lines"": 15}, ""src/version.c"": {""insertions"": 2, ""deletions"": 0, ""lines"": 2}, ""src/vim9execute.c"": {""insertions"": 75, ""deletions"": 39, ""lines"": 114}}"
2020-12-20 14:43:31,090728ad4d54287c911894ef42bfe92844ce0fa5,Bram Moolenaar,50,22,72,3,"{""src/testdir/test_vim9_script.vim"": {""insertions"": 2, ""deletions"": 1, ""lines"": 3}, ""src/testdir/vim9.vim"": {""insertions"": 46, ""deletions"": 21, ""lines"": 67}, ""src/version.c"": {""insertions"": 2, ""deletions"": 0, ""lines"": 2}}"
2020-12-20 14:20:56,d24602f43cf1f3c37136fe275b83153c26a406e7,Bram Moolenaar,15,5,20,3,"{""src/testdir/test_vim9_assign.vim"": {""insertions"": 6, ""deletions"": 0, ""lines"": 6}, ""src/version.c"": {""insertions"": 2, ""deletions"": 0, ""lines"": 2}, ""src/vim9compile.c"": {""insertions"": 7, ""deletions"": 5, ""lines"": 12}}"
2020-12-20 13:49:42,d88dc4d4e950d937b44c523b9965d485f3fae4be,Bram Moolenaar,17,1,18,2,"{""src/testdir/test_vim9_assign.vim"": {""insertions"": 15, ""deletions"": 1, ""lines"": 16}, ""src/version.c"": {""insertions"": 2, ""deletions"": 0, ""lines"": 2}}"
2020-12-20 12:07:48,d0a1dee3f197d41434df4cf0271066b6aeb690fc,Bram Moolenaar,15,0,15,3,"{""src/ops.c"": {""insertions"": 1, ""deletions"": 0, ""lines"": 1}, ""src/testdir/test_textformat.vim"": {""insertions"": 12, ""deletions"": 0, ""lines"": 12}, ""src/version.c"": {""insertions"": 2, ""deletions"": 0, ""lines"": 2}}"
2020-12-19 21:10:13,8f22f5c3aa0aa96e3843a57f29405625d8514c74,Bram Moolenaar,20,6,26,5,"{""src/eval.c"": {""insertions"": 7, ""deletions"": 0, ""lines"": 7}, ""src/evalvars.c"": {""insertions"": 2, ""deletions"": 1, ""lines"": 3}, ""src/ex_docmd.c"": {""insertions"": 2, ""deletions"": 0, ""lines"": 2}, ""src/version.c"": {""insertions"": 2, ""deletions"": 0, ""lines"": 2}, ""src/vim.h"": {""insertions"": 7, ""deletions"": 5, ""lines"": 12}}"
2020-12-19 20:23:42,17f700ac8b55f27ddb519ecaa8acaa43fc1ae60a,Bram Moolenaar,23,1,24,3,"{""src/testdir/test_vim9_script.vim"": {""insertions"": 10, ""deletions"": 0, ""lines"": 10}, ""src/userfunc.c"": {""insertions"": 11, ""deletions"": 1, ""lines"": 12}, ""src/version.c"": {""insertions"": 2, ""deletions"": 0, ""lines"": 2}}"
2020-12-19 16:55:54,13656f02e457fb68cd7e72412fc24ccac02fb06e,Bram Moolenaar,6,5,11,2,"{""src/ex_eval.c"": {""insertions"": 4, ""deletions"": 5, ""lines"": 9}, ""src/version.c"": {""insertions"": 2, ""deletions"": 0, ""lines"": 2}}"
2020-12-19 15:30:44,03290b8444b69c6d7307755770467bc488384e1a,Bram Moolenaar,106,15,121,10,"{""src/dict.c"": {""insertions"": 1, ""deletions"": 1, ""lines"": 2}, ""src/eval.c"": {""insertions"": 1, ""deletions"": 1, ""lines"": 2}, ""src/evalvars.c"": {""insertions"": 7, ""deletions"": 5, ""lines"": 12}, ""src/proto/evalvars.pro"": {""insertions"": 1, ""deletions"": 1, ""lines"": 2}, ""src/testdir/test_vim9_disassemble.vim"": {""insertions"": 12, ""deletions"": 2, ""lines"": 14}, ""src/testdir/test_vim9_script.vim"": {""insertions"": 31, ""deletions"": 1, ""lines"": 32}, ""src/version.c"": {""insertions"": 2, ""deletions"": 0, ""lines"": 2}, ""src/vim9.h"": {""insertions"": 2, ""deletions"": 0, ""lines"": 2}, ""src/vim9compile.c"": {""insertions"": 20, ""deletions"": 4, ""lines"": 24}, ""src/vim9execute.c"": {""insertions"": 29, ""deletions"": 0, ""lines"": 29}}"
2020-12-19 12:32:07,1f33e0a7c4cd278158b37f91a2aa44f0bcd1f21a,Bram Moolenaar,49,0,49,2,"{""src/testdir/test_startup.vim"": {""insertions"": 47, ""deletions"": 0, ""lines"": 47}, ""src/version.c"": {""insertions"": 2, ""deletions"": 0, ""lines"": 2}}"
2020-12-18 18:49:56,8e7d6223f630690b72b387eaed704bf01f3f29d2,Bram Moolenaar,54,51,105,39,"{""src/bufwrite.c"": {""insertions"": 1, ""deletions"": 1, ""lines"": 2}, ""src/cindent.c"": {""insertions"": 1, ""deletions"": 1, ""lines"": 2}, ""src/cmdexpand.c"": {""insertions"": 1, ""deletions"": 1, ""lines"": 2}, ""src/eval.c"": {""insertions"": 1, ""deletions"": 1, ""lines"": 2}, ""src/ex_cmds.c"": {""insertions"": 1, ""deletions"": 1, ""lines"": 2}, ""src/feature.h"": {""insertions"": 1, ""deletions"": 1, ""lines"": 2}, ""src/getchar.c"": {""insertions"": 1, ""deletions"": 1, ""lines"": 2}, ""src/gui_haiku.cc"": {""insertions"": 1, ""deletions"": 1, ""lines"": 2}, ""src/gui_xmdlg.c"": {""insertions"": 1, ""deletions"": 1, ""lines"": 2}, ""src/help.c"": {""insertions"": 3, ""deletions"": 1, ""lines"": 4}, ""src/if_ole.cpp"": {""insertions"": 1, ""deletions"": 1, ""lines"": 2}, ""src/insexpand.c"": {""insertions"": 1, ""deletions"": 1, ""lines"": 2}, ""src/list.c"": {""insertions"": 1, ""deletions"": 1, ""lines"": 2}, ""src/map.c"": {""insertions"": 1, ""deletions"": 1, ""lines"": 2}, ""src/memline.c"": {""insertions"": 1, ""deletions"": 1, ""lines"": 2}, ""src/normal.c"": {""insertions"": 1, ""deletions"": 1, ""lines"": 2}, ""src/os_win32.c"": {""insertions"": 6, ""deletions"": 7, ""lines"": 13}, ""src/search.c"": {""insertions"": 1, ""deletions"": 1, ""lines"": 2}, ""src/term.c"": {""insertions"": 2, ""deletions"": 2, ""lines"": 4}, ""src/testdir/test_arglist.vim"": {""insertions"": 1, ""deletions"": 1, ""lines"": 2}, ""src/testdir/test_autocmd.vim"": {""insertions"": 1, ""deletions"": 1, ""lines"": 2}, ""src/testdir/test_debugger.vim"": {""insertions"": 1, ""deletions"": 1, ""lines"": 2}, ""src/testdir/test_increment.vim"": {""insertions"": 1, ""deletions"": 1, ""lines"": 2}, ""src/testdir/test_menu.vim"": {""insertions"": 1, ""deletions"": 1, ""lines"": 2}, ""src/testdir/test_netbeans.vim"": {""insertions"": 1, ""deletions"": 1, ""lines"": 2}, ""src/testdir/test_popupwin.vim"": {""insertions"": 1, ""deletions"": 1, ""lines"": 2}, ""src/testdir/test_python2.vim"": {""insertions"": 1, ""deletions"": 1, ""lines"": 2}, ""src/testdir/test_python3.vim"": {""insertions"": 1, ""deletions"": 1, ""lines"": 2}, ""src/testdir/test_sort.vim"": {""insertions"": 1, ""deletions"": 1, ""lines"": 2}, ""src/testdir/test_terminal2.vim"": {""insertions"": 2, ""deletions"": 2, ""lines"": 4}, ""src/testdir/test_terminal3.vim"": {""insertions"": 1, ""deletions"": 1, ""lines"": 2}, ""src/testdir/test_vartabs.vim"": {""insertions"": 1, ""deletions"": 1, ""lines"": 2}, ""src/testdir/test_vimscript.vim"": {""insertions"": 1, ""deletions"": 1, ""lines"": 2}, ""src/textprop.c"": {""insertions"": 2, ""deletions"": 2, ""lines"": 4}, ""src/userfunc.c"": {""insertions"": 1, ""deletions"": 1, ""lines"": 2}, ""src/version.c"": {""insertions"": 2, ""deletions"": 0, ""lines"": 2}, ""src/vim9.h"": {""insertions"": 1, ""deletions"": 1, ""lines"": 2}, ""src/vim9compile.c"": {""insertions"": 5, ""deletions"": 5, ""lines"": 10}, ""src/vim9execute.c"": {""insertions"": 1, ""deletions"": 1, ""lines"": 2}}"
2020-12-18 16:23:14,3beaf9cd8efa3ba83e07187215004d140b89d529,Bram Moolenaar,35,1,36,3,"{""src/testdir/test_vim9_assign.vim"": {""insertions"": 12, ""deletions"": 1, ""lines"": 13}, ""src/version.c"": {""insertions"": 2, ""deletions"": 0, ""lines"": 2}, ""src/vim9execute.c"": {""insertions"": 21, ""deletions"": 0, ""lines"": 21}}"
2020-12-18 15:29:25,6e562fcc07c71ad1437c89c3d3cc423efb691f0a,Bram Moolenaar,5,1,6,3,"{"".cirrus.yml"": {""insertions"": 2, ""deletions"": 0, ""lines"": 2}, "".github/workflows/ci.yml"": {""insertions"": 1, ""deletions"": 1, ""lines"": 2}, ""src/version.c"": {""insertions"": 2, ""deletions"": 0, ""lines"": 2}}"
2020-12-18 14:38:00,9aed729fe9e62536236875a42fb170d2c8fb3046,Bram Moolenaar,20,0,20,3,"{""src/evalvars.c"": {""insertions"": 10, ""deletions"": 0, ""lines"": 10}, ""src/testdir/test_vim9_assign.vim"": {""insertions"": 8, ""deletions"": 0, ""lines"": 8}, ""src/version.c"": {""insertions"": 2, ""deletions"": 0, ""lines"": 2}}"
2020-12-18 12:31:31,b5b77378bc35cb268c384e98c59f2bf8cb406270,Bram Moolenaar,13,9,22,3,"{"".github/workflows/ci.yml"": {""insertions"": 11, ""deletions"": 5, ""lines"": 16}, "".github/workflows/codeql-analysis.yml"": {""insertions"": 0, ""deletions"": 4, ""lines"": 4}, ""src/version.c"": {""insertions"": 2, ""deletions"": 0, ""lines"": 2}}"
2020-12-18 12:15:20,18f69229c581a0f738145cdec70df66723a518fc,Bram Moolenaar,2,5,7,2,"{"".github/workflows/codeql-analysis.yml"": {""insertions"": 0, ""deletions"": 5, ""lines"": 5}, ""src/version.c"": {""insertions"": 2, ""deletions"": 0, ""lines"": 2}}"
2020-12-17 21:27:38,0353f56ddb379e7f1a68172fa4743355e04df21e,Bram Moolenaar,6,3,9,2,"{""src/testdir/test_popupwin.vim"": {""insertions"": 4, ""deletions"": 3, ""lines"": 7}, ""src/version.c"": {""insertions"": 2, ""deletions"": 0, ""lines"": 2}}"
2020-12-17 20:56:09,b125b535bb0456ab43c10683307a4bc359442d44,Bram Moolenaar,6,0,6,2,"{""src/testdir/test_popupwin.vim"": {""insertions"": 4, ""deletions"": 0, ""lines"": 4}, ""src/version.c"": {""insertions"": 2, ""deletions"": 0, ""lines"": 2}}"
2020-12-17 20:35:29,8dd46e72cfb13b8de793c808ee009c45e881903a,Bram Moolenaar,8,1,9,3,"{""src/move.c"": {""insertions"": 1, ""deletions"": 1, ""lines"": 2}, ""src/testdir/test_cursor_func.vim"": {""insertions"": 5, ""deletions"": 0, ""lines"": 5}, ""src/version.c"": {""insertions"": 2, ""deletions"": 0, ""lines"": 2}}"
2020-12-17 19:50:25,a79a8944dade9115ccaa5a06a076dfb257e56c62,Bram Moolenaar,4,2,6,3,"{""src/auto/configure"": {""insertions"": 1, ""deletions"": 1, ""lines"": 2}, ""src/configure.ac"": {""insertions"": 1, ""deletions"": 1, ""lines"": 2}, ""src/version.c"": {""insertions"": 2, ""deletions"": 0, ""lines"": 2}}"
2020-12-17 19:27:26,8ea05de6aa1d133cba3381bcc36adf1736b08e00,Bram Moolenaar,660,331,991,8,"{"".coveralls.yml"": {""insertions"": 1, ""deletions"": 0, ""lines"": 1}, "".github/workflows/ci-windows.yaml"": {""insertions"": 0, ""deletions"": 230, ""lines"": 230}, "".github/workflows/ci.yml"": {""insertions"": 519, ""deletions"": 0, ""lines"": 519}, "".travis.yml"": {""insertions"": 100, ""deletions"": 100, ""lines"": 200}, ""README.md"": {""insertions"": 2, ""deletions"": 1, ""lines"": 3}, ""ci/build-snd-dummy.sh"": {""insertions"": 19, ""deletions"": 0, ""lines"": 19}, ""ci/setup-xvfb.sh"": {""insertions"": 17, ""deletions"": 0, ""lines"": 17}, ""src/version.c"": {""insertions"": 2, ""deletions"": 0, ""lines"": 2}}"
2020-12-17 16:45:59,4c5bdb99ad632d703e94fffafba11b91861fea48,Bram Moolenaar,5,0,5,2,"{""src/testdir/test_popupwin.vim"": {""insertions"": 3, ""deletions"": 0, ""lines"": 3}, ""src/version.c"": {""insertions"": 2, ""deletions"": 0, ""lines"": 2}}"
2020-12-16 20:43:54,1c0aa97827f30e3051ee50a0690555c2c23c0ceb,Bram Moolenaar,12,1,13,3,"{""src/ex_docmd.c"": {""insertions"": 1, ""deletions"": 1, ""lines"": 2}, ""src/testdir/test_vim9_cmd.vim"": {""insertions"": 9, ""deletions"": 0, ""lines"": 9}, ""src/version.c"": {""insertions"": 2, ""deletions"": 0, ""lines"": 2}}"
2020-12-16 20:02:56,530bed993e41bda6f717a8ddd0acb39464f95336,Bram Moolenaar,38,7,45,3,"{""src/quickfix.c"": {""insertions"": 12, ""deletions"": 7, ""lines"": 19}, ""src/testdir/test_quickfix.vim"": {""insertions"": 24, ""deletions"": 0, ""lines"": 24}, ""src/version.c"": {""insertions"": 2, ""deletions"": 0, ""lines"": 2}}"
2020-12-15 20:41:56,9987fb0b4b591e6450fb1dfbe8f615f365057f2a,Bram Moolenaar,15,0,15,3,"{""src/dict.c"": {""insertions"": 5, ""deletions"": 0, ""lines"": 5}, ""src/testdir/test_vim9_expr.vim"": {""insertions"": 8, ""deletions"": 0, ""lines"": 8}, ""src/version.c"": {""insertions"": 2, ""deletions"": 0, ""lines"": 2}}"
2020-12-15 20:28:57,399ea8108c8da3fcdf5d738a0f8eae67155b4b10,Bram Moolenaar,35,6,41,3,"{""src/testdir/test_vim9_expr.vim"": {""insertions"": 17, ""deletions"": 0, ""lines"": 17}, ""src/version.c"": {""insertions"": 2, ""deletions"": 0, ""lines"": 2}, ""src/vim9compile.c"": {""insertions"": 16, ""deletions"": 6, ""lines"": 22}}"
2020-12-14 17:31:27,025cb1ca8605055383c53bf2c823d7093cf29b82,Bram Moolenaar,27,12,39,3,"{""src/testdir/test_vim9_cmd.vim"": {""insertions"": 17, ""deletions"": 0, ""lines"": 17}, ""src/testdir/test_vim9_script.vim"": {""insertions"": 8, ""deletions"": 12, ""lines"": 20}, ""src/version.c"": {""insertions"": 2, ""deletions"": 0, ""lines"": 2}}"
2020-12-13 20:26:56,ec792290eb902e01c9edfc0cb71e5235833df56a,Bram Moolenaar,3,7,10,2,"{""src/version.c"": {""insertions"": 2, ""deletions"": 0, ""lines"": 2}, ""src/vim9compile.c"": {""insertions"": 1, ""deletions"": 7, ""lines"": 8}}"
2020-12-13 20:16:55,fffdf4754f4fd789c64596bdd9ea069725e63784,Bram Moolenaar,3,0,3,2,"{""src/userfunc.c"": {""insertions"": 1, ""deletions"": 0, ""lines"": 1}, ""src/version.c"": {""insertions"": 2, ""deletions"": 0, ""lines"": 2}}"
2020-12-13 19:26:29,8143a53c533bc7776c57e5db063d185bdd5750f3,Bram Moolenaar,34,4,38,4,"{""src/eval.c"": {""insertions"": 4, ""deletions"": 1, ""lines"": 5}, ""src/testdir/test_trycatch.vim"": {""insertions"": 25, ""deletions"": 0, ""lines"": 25}, ""src/testdir/test_vimscript.vim"": {""insertions"": 3, ""deletions"": 3, ""lines"": 6}, ""src/version.c"": {""insertions"": 2, ""deletions"": 0, ""lines"": 2}}"
2020-12-13 18:22:27,2a3cd3af455973d678f70303ebdd486f3478bc0d,Bram Moolenaar,4,0,4,2,"{""src/ex_docmd.c"": {""insertions"": 2, ""deletions"": 0, ""lines"": 2}, ""src/version.c"": {""insertions"": 2, ""deletions"": 0, ""lines"": 2}}"
2020-12-13 17:44:43,acbae18df528b6aee72ecfd66e344dc8be7b3775,Bram Moolenaar,14,4,18,3,"{""src/testdir/test_vim9_assign.vim"": {""insertions"": 12, ""deletions"": 0, ""lines"": 12}, ""src/version.c"": {""insertions"": 2, ""deletions"": 0, ""lines"": 2}, ""src/vim9compile.c"": {""insertions"": 0, ""deletions"": 4, ""lines"": 4}}"
2020-12-13 16:50:20,b5b9480ee936ef4cd0e350c468ef8c5f42fa398b,Bram Moolenaar,59,18,77,8,"{""src/errors.h"": {""insertions"": 5, ""deletions"": 1, ""lines"": 6}, ""src/ex_cmds.h"": {""insertions"": 9, ""deletions"": 8, ""lines"": 17}, ""src/ex_docmd.c"": {""insertions"": 9, ""deletions"": 1, ""lines"": 10}, ""src/testdir/test_let.vim"": {""insertions"": 2, ""deletions"": 2, ""lines"": 4}, ""src/testdir/test_vim9_assign.vim"": {""insertions"": 12, ""deletions"": 1, ""lines"": 13}, ""src/testdir/test_vim9_script.vim"": {""insertions"": 8, ""deletions"": 1, ""lines"": 9}, ""src/userfunc.c"": {""insertions"": 12, ""deletions"": 4, ""lines"": 16}, ""src/version.c"": {""insertions"": 2, ""deletions"": 0, ""lines"": 2}}"
2020-12-13 13:19:25,e4984290870565a2413cca660b0131f4702b7665,Bram Moolenaar,51,26,77,5,"{""src/errors.h"": {""insertions"": 3, ""deletions"": 1, ""lines"": 4}, ""src/testdir/test_vim9_disassemble.vim"": {""insertions"": 22, ""deletions"": 8, ""lines"": 30}, ""src/testdir/test_vim9_script.vim"": {""insertions"": 6, ""deletions"": 5, ""lines"": 11}, ""src/version.c"": {""insertions"": 2, ""deletions"": 0, ""lines"": 2}, ""src/vim9compile.c"": {""insertions"": 18, ""deletions"": 12, ""lines"": 30}}"
2020-12-13 11:25:35,c530852315517a44354edbbd6c3375355bbec37e,Bram Moolenaar,7,4,11,2,"{""src/filepath.c"": {""insertions"": 5, ""deletions"": 4, ""lines"": 9}, ""src/version.c"": {""insertions"": 2, ""deletions"": 0, ""lines"": 2}}"
2020-12-12 20:25:56,93f82cbee515e13b564f51ddcd5e3d6694358ba4,Bram Moolenaar,17,2,19,3,"{""src/ex_docmd.c"": {""insertions"": 1, ""deletions"": 2, ""lines"": 3}, ""src/testdir/test_vim9_script.vim"": {""insertions"": 14, ""deletions"": 0, ""lines"": 14}, ""src/version.c"": {""insertions"": 2, ""deletions"": 0, ""lines"": 2}}"
2020-12-12 19:42:19,57f799e6a4a56f41570c752c66dc2f692b1f2c2f,Bram Moolenaar,23,1,24,3,"{""src/testdir/test_vim9_func.vim"": {""insertions"": 20, ""deletions"": 0, ""lines"": 20}, ""src/version.c"": {""insertions"": 2, ""deletions"": 0, ""lines"": 2}, ""src/vim9execute.c"": {""insertions"": 1, ""deletions"": 1, ""lines"": 2}}"
2020-12-12 17:58:40,2a9d5d386bea8455b37c1accebc45683ec51d6fb,Bram Moolenaar,59,24,83,6,"{""src/errors.h"": {""insertions"": 2, ""deletions"": 0, ""lines"": 2}, ""src/filepath.c"": {""insertions"": 4, ""deletions"": 4, ""lines"": 8}, ""src/proto/typval.pro"": {""insertions"": 1, ""deletions"": 0, ""lines"": 1}, ""src/testdir/test_vim9_builtin.vim"": {""insertions"": 32, ""deletions"": 16, ""lines"": 48}, ""src/typval.c"": {""insertions"": 18, ""deletions"": 4, ""lines"": 22}, ""src/version.c"": {""insertions"": 2, ""deletions"": 0, ""lines"": 2}}"
2020-12-12 17:18:06,3ae50c775c00b098cdfc9e90b17c4cc07f00e08d,Bram Moolenaar,39,8,47,5,"{""src/popupwin.c"": {""insertions"": 7, ""deletions"": 8, ""lines"": 15}, ""src/testdir/dumps/Test_popupwin_longtitle_3.dump"": {""insertions"": 10, ""deletions"": 0, ""lines"": 10}, ""src/testdir/dumps/Test_popupwin_longtitle_4.dump"": {""insertions"": 10, ""deletions"": 0, ""lines"": 10}, ""src/testdir/test_popupwin.vim"": {""insertions"": 10, ""deletions"": 0, ""lines"": 10}, ""src/version.c"": {""insertions"": 2, ""deletions"": 0, ""lines"": 2}}"
2020-12-12 13:33:41,709664cca0b59b69caa1ed40ebfcf00b2c672693,Bram Moolenaar,66,47,113,7,"{""src/evalvars.c"": {""insertions"": 14, ""deletions"": 11, ""lines"": 25}, ""src/ex_docmd.c"": {""insertions"": 2, ""deletions"": 2, ""lines"": 4}, ""src/proto/evalvars.pro"": {""insertions"": 1, ""deletions"": 1, ""lines"": 2}, ""src/proto/ex_docmd.pro"": {""insertions"": 1, ""deletions"": 1, ""lines"": 2}, ""src/testdir/test_vim9_func.vim"": {""insertions"": 6, ""deletions"": 0, ""lines"": 6}, ""src/version.c"": {""insertions"": 2, ""deletions"": 0, ""lines"": 2}, ""src/vim9compile.c"": {""insertions"": 40, ""deletions"": 32, ""lines"": 72}}"
2020-12-12 12:32:07,cc2335896ba707bf0d8cf03cca2de7c66fab62a0,Bram Moolenaar,24,1,25,3,"{""src/insexpand.c"": {""insertions"": 9, ""deletions"": 0, ""lines"": 9}, ""src/testdir/test_ins_complete.vim"": {""insertions"": 13, ""deletions"": 1, ""lines"": 14}, ""src/version.c"": {""insertions"": 2, ""deletions"": 0, ""lines"": 2}}"
2020-12-11 19:10:50,0ea7421ae6618fe8efe9e3afc8fdcf7a4d89739a,Bram Moolenaar,9,15,24,2,"{""src/os_mswin.c"": {""insertions"": 7, ""deletions"": 15, ""lines"": 22}, ""src/version.c"": {""insertions"": 2, ""deletions"": 0, ""lines"": 2}}"
2020-12-11 18:30:34,100118c73ac068137cd298d22953896242752523,Bram Moolenaar,67,1,68,7,"{""runtime/doc/autocmd.txt"": {""insertions"": 14, ""deletions"": 0, ""lines"": 14}, ""src/autocmd.c"": {""insertions"": 2, ""deletions"": 0, ""lines"": 2}, ""src/ex_docmd.c"": {""insertions"": 2, ""deletions"": 0, ""lines"": 2}, ""src/normal.c"": {""insertions"": 1, ""deletions"": 1, ""lines"": 2}, ""src/testdir/test_suspend.vim"": {""insertions"": 44, ""deletions"": 0, ""lines"": 44}, ""src/version.c"": {""insertions"": 2, ""deletions"": 0, ""lines"": 2}, ""src/vim.h"": {""insertions"": 2, ""deletions"": 0, ""lines"": 2}}"
2020-12-10 20:11:27,1b884a0053982335f644eec6c71027706bf3c522,Bram Moolenaar,1744,213,1957,20,"{"".github/CODEOWNERS"": {""insertions"": 24, ""deletions"": 0, ""lines"": 24}, ""runtime/doc/autocmd.txt"": {""insertions"": 3, ""deletions"": 2, ""lines"": 5}, ""runtime/doc/eval.txt"": {""insertions"": 12, ""deletions"": 11, ""lines"": 23}, ""runtime/doc/helphelp.txt"": {""insertions"": 20, ""deletions"": 1, ""lines"": 21}, ""runtime/doc/map.txt"": {""insertions"": 20, ""deletions"": 15, ""lines"": 35}, ""runtime/doc/pattern.txt"": {""insertions"": 12, ""deletions"": 11, ""lines"": 23}, ""runtime/doc/syntax.txt"": {""insertions"": 19, ""deletions"": 1, ""lines"": 20}, ""runtime/doc/tags"": {""insertions"": 6, ""deletions"": 0, ""lines"": 6}, ""runtime/doc/todo.txt"": {""insertions"": 21, ""deletions"": 28, ""lines"": 49}, ""runtime/doc/undo.txt"": {""insertions"": 5, ""deletions"": 5, ""lines"": 10}, ""runtime/doc/vim9.txt"": {""insertions"": 6, ""deletions"": 5, ""lines"": 11}, ""runtime/filetype.vim"": {""insertions"": 1, ""deletions"": 1, ""lines"": 2}, ""runtime/pack/dist/opt/termdebug/plugin/termdebug.vim"": {""insertions"": 7, ""deletions"": 3, ""lines"": 10}, ""runtime/syntax/aidl.vim"": {""insertions"": 2, ""deletions"": 2, ""lines"": 4}, ""runtime/syntax/diff.vim"": {""insertions"": 4, ""deletions"": 2, ""lines"": 6}, ""runtime/tools/emoji_list.vim"": {""insertions"": 2, ""deletions"": 2, ""lines"": 4}, ""runtime/tutor/tutor.fr"": {""insertions"": 3, ""deletions"": 3, ""lines"": 6}, ""runtime/tutor/tutor.fr.utf-8"": {""insertions"": 3, ""deletions"": 3, ""lines"": 6}, ""src/INSTALLx.txt"": {""insertions"": 0, ""deletions"": 9, ""lines"": 9}, ""src/po/tr.po"": {""insertions"": 1574, ""deletions"": 109, ""lines"": 1683}}"
2020-12-10 20:01:30,70249ee831df357c1a5475473fc84c40d101a67d,Bram Moolenaar,23,0,23,2,"{""src/testdir/test_vim9_script.vim"": {""insertions"": 21, ""deletions"": 0, ""lines"": 21}, ""src/version.c"": {""insertions"": 2, ""deletions"": 0, ""lines"": 2}}"
2020-12-10 19:50:34,0e12140550a63bb1e45771edb89b941959440cfe,Bram Moolenaar,6,0,6,2,"{""src/if_ruby.c"": {""insertions"": 4, ""deletions"": 0, ""lines"": 4}, ""src/version.c"": {""insertions"": 2, ""deletions"": 0, ""lines"": 2}}"
2020-12-10 19:21:24,8f1bf2ef785e48a4ca08e014b7713fdee2824631,Bram Moolenaar,3,1,4,2,"{""src/scriptfile.c"": {""insertions"": 1, ""deletions"": 1, ""lines"": 2}, ""src/version.c"": {""insertions"": 2, ""deletions"": 0, ""lines"": 2}}"
2020-12-10 18:43:40,08597875b2a1e7d118b0346c652a96e7527e7d8b,Bram Moolenaar,128,12,140,6,"{""src/testdir/test_vim9_cmd.vim"": {""insertions"": 11, ""deletions"": 0, ""lines"": 11}, ""src/testdir/test_vim9_disassemble.vim"": {""insertions"": 15, ""deletions"": 0, ""lines"": 15}, ""src/version.c"": {""insertions"": 2, ""deletions"": 0, ""lines"": 2}, ""src/vim9.h"": {""insertions"": 6, ""deletions"": 0, ""lines"": 6}, ""src/vim9compile.c"": {""insertions"": 53, ""deletions"": 10, ""lines"": 63}, ""src/vim9execute.c"": {""insertions"": 41, ""deletions"": 2, ""lines"": 43}}"
2020-12-09 17:13:44,d356fc65d273959efa9b05bfa0f07ce1c9ff85a4,Bram Moolenaar,6,0,6,3,"{""src/popupmenu.c"": {""insertions"": 1, ""deletions"": 0, ""lines"": 1}, ""src/testdir/test_popupwin.vim"": {""insertions"": 3, ""deletions"": 0, ""lines"": 3}, ""src/version.c"": {""insertions"": 2, ""deletions"": 0, ""lines"": 2}}"
2020-12-09 16:16:59,9ec7026f24e9ac51654300e32afd2b7540cab5f8,Bram Moolenaar,14,2,16,3,"{""src/scriptfile.c"": {""insertions"": 1, ""deletions"": 2, ""lines"": 3}, ""src/testdir/test_vim9_script.vim"": {""insertions"": 11, ""deletions"": 0, ""lines"": 11}, ""src/version.c"": {""insertions"": 2, ""deletions"": 0, ""lines"": 2}}"
2020-12-09 15:36:04,a7a691cc142439e266f4ceb1f208bb952b57aa71,Bram Moolenaar,43,0,43,4,"{""src/regexp_bt.c"": {""insertions"": 17, ""deletions"": 0, ""lines"": 17}, ""src/regexp_nfa.c"": {""insertions"": 17, ""deletions"": 0, ""lines"": 17}, ""src/testdir/test_regexp_latin.vim"": {""insertions"": 7, ""deletions"": 0, ""lines"": 7}, ""src/version.c"": {""insertions"": 2, ""deletions"": 0, ""lines"": 2}}"
2020-12-09 15:05:45,730677a0dafe6f2e72888ef59f74f66f2d0a573e,Bram Moolenaar,21,2,23,2,"{""src/testdir/test_perl.vim"": {""insertions"": 19, ""deletions"": 2, ""lines"": 21}, ""src/version.c"": {""insertions"": 2, ""deletions"": 0, ""lines"": 2}}"
2020-12-09 14:53:27,7988a6f0e9999d1103271024ab4ed26e5599de17,Bram Moolenaar,10,5,15,2,"{""src/gui_gtk_x11.c"": {""insertions"": 8, ""deletions"": 5, ""lines"": 13}, ""src/version.c"": {""insertions"": 2, ""deletions"": 0, ""lines"": 2}}"
2020-12-09 12:16:13,f46bf5204c3c55d23921b501db21a906d526eb45,Bram Moolenaar,8,3,11,2,"{""src/job.c"": {""insertions"": 6, ""deletions"": 3, ""lines"": 9}, ""src/version.c"": {""insertions"": 2, ""deletions"": 0, ""lines"": 2}}"
2020-12-09 11:41:50,7bb4e74c38642682cfdd0cb4052adfa5efdd7dd1,Bram Moolenaar,113,13,126,7,"{""src/filepath.c"": {""insertions"": 23, ""deletions"": 6, ""lines"": 29}, ""src/mbyte.c"": {""insertions"": 1, ""deletions"": 6, ""lines"": 7}, ""src/proto/typval.pro"": {""insertions"": 1, ""deletions"": 0, ""lines"": 1}, ""src/testdir/test_vim9_builtin.vim"": {""insertions"": 69, ""deletions"": 0, ""lines"": 69}, ""src/testdir/test_vim9_expr.vim"": {""insertions"": 1, ""deletions"": 1, ""lines"": 2}, ""src/typval.c"": {""insertions"": 16, ""deletions"": 0, ""lines"": 16}, ""src/version.c"": {""insertions"": 2, ""deletions"": 0, ""lines"": 2}}"
2020-12-09 11:01:03,2c78a772fdb5f6a16d16a47e7f218051c4dcb845,Bram Moolenaar,12,5,17,2,"{""src/testdir/test_gui.vim"": {""insertions"": 10, ""deletions"": 5, ""lines"": 15}, ""src/version.c"": {""insertions"": 2, ""deletions"": 0, ""lines"": 2}}"
2020-12-08 21:08:51,7257af477bc5f33153f8f700b643551525f1105b,Bram Moolenaar,9,5,14,3,"{""src/testdir/test_vim9_assign.vim"": {""insertions"": 7, ""deletions"": 0, ""lines"": 7}, ""src/version.c"": {""insertions"": 2, ""deletions"": 0, ""lines"": 2}, ""src/vim9compile.c"": {""insertions"": 0, ""deletions"": 5, ""lines"": 5}}"
2020-12-08 20:53:28,61265b4000b172ce891b3ded221bc0f624d9b55b,Bram Moolenaar,2,10,12,2,"{""src/version.c"": {""insertions"": 2, ""deletions"": 0, ""lines"": 2}, ""src/vim9compile.c"": {""insertions"": 0, ""deletions"": 10, ""lines"": 10}}"
2020-12-08 20:12:40,1b3e0727ce86ca4cfa47f8b5421d82ed47a9bec1,Bram Moolenaar,11,1,12,3,"{""src/gui_dwrite.cpp"": {""insertions"": 2, ""deletions"": 1, ""lines"": 3}, ""src/testdir/test_gui.vim"": {""insertions"": 7, ""deletions"": 0, ""lines"": 7}, ""src/version.c"": {""insertions"": 2, ""deletions"": 0, ""lines"": 2}}"
2020-12-08 19:39:15,ac665c24c97582a64ae2d151a812eca92c1ff2d6,Bram Moolenaar,9,6,15,4,"{""src/testdir/test_filetype.vim"": {""insertions"": 1, ""deletions"": 1, ""lines"": 2}, ""src/testdir/test_messages.vim"": {""insertions"": 1, ""deletions"": 1, ""lines"": 2}, ""src/testdir/test_mksession.vim"": {""insertions"": 5, ""deletions"": 4, ""lines"": 9}, ""src/version.c"": {""insertions"": 2, ""deletions"": 0, ""lines"": 2}}"
2020-12-08 19:31:16,023fd5d21323fe6dffa080bd20c4d39e1212d353,Bram Moolenaar,9,7,16,2,"{""src/gui_gtk_x11.c"": {""insertions"": 7, ""deletions"": 7, ""lines"": 14}, ""src/version.c"": {""insertions"": 2, ""deletions"": 0, ""lines"": 2}}"
2020-12-08 18:36:21,8e1cbb55c389bdc4eade7a67309d5042fbcdca7d,Bram Moolenaar,10,1,11,2,"{""src/main.c"": {""insertions"": 8, ""deletions"": 1, ""lines"": 9}, ""src/version.c"": {""insertions"": 2, ""deletions"": 0, ""lines"": 2}}"
2020-12-08 18:18:37,8a3da6a368ca7e761939366e355528bccb6dffa3,Bram Moolenaar,9,3,12,2,"{""src/os_unix.c"": {""insertions"": 7, ""deletions"": 3, ""lines"": 10}, ""src/version.c"": {""insertions"": 2, ""deletions"": 0, ""lines"": 2}}"
2020-12-08 10:29:40,083966f671475ae1b67f746f0b3f5309a45dfd8f,Bram Moolenaar,12,6,18,2,"{""src/testdir/test_vim9_assign.vim"": {""insertions"": 10, ""deletions"": 6, ""lines"": 16}, ""src/version.c"": {""insertions"": 2, ""deletions"": 0, ""lines"": 2}}"
2020-12-07 20:49:52,8ff16e0183e0b07f34c0db8160cf6a472c427eb8,Bram Moolenaar,56,14,70,4,"{""src/testdir/test_vim9_assign.vim"": {""insertions"": 40, ""deletions"": 1, ""lines"": 41}, ""src/testdir/test_vim9_expr.vim"": {""insertions"": 12, ""deletions"": 12, ""lines"": 24}, ""src/version.c"": {""insertions"": 2, ""deletions"": 0, ""lines"": 2}, ""src/vim9compile.c"": {""insertions"": 2, ""deletions"": 1, ""lines"": 3}}"
2020-12-07 17:05:02,b237ae7b837a31922d31c3a27b7c66e63468b8a8,Bram Moolenaar,6,0,6,3,"{""runtime/filetype.vim"": {""insertions"": 3, ""deletions"": 0, ""lines"": 3}, ""src/testdir/test_filetype.vim"": {""insertions"": 1, ""deletions"": 0, ""lines"": 1}, ""src/version.c"": {""insertions"": 2, ""deletions"": 0, ""lines"": 2}}"
2020-12-06 20:43:44,7b130b9738c3d3975721ce9b84f91320e8d4857c,Bram Moolenaar,10,9,19,2,"{""src/testdir/test_sound.vim"": {""insertions"": 8, ""deletions"": 9, ""lines"": 17}, ""src/version.c"": {""insertions"": 2, ""deletions"": 0, ""lines"": 2}}"
2020-12-06 20:11:31,d5a986f460019a924627d79350552f446505cffb,Bram Moolenaar,24,12,36,4,"{""src/auto/configure"": {""insertions"": 1, ""deletions"": 2, ""lines"": 3}, ""src/configure.ac"": {""insertions"": 1, ""deletions"": 2, ""lines"": 3}, ""src/if_ruby.c"": {""insertions"": 20, ""deletions"": 8, ""lines"": 28}, ""src/version.c"": {""insertions"": 2, ""deletions"": 0, ""lines"": 2}}"
2020-12-06 19:12:43,41d6196e302af5f1a99aeeac587b5c662c410166,Bram Moolenaar,4,12,16,2,"{""src/version.c"": {""insertions"": 2, ""deletions"": 0, ""lines"": 2}, ""src/vim9compile.c"": {""insertions"": 2, ""deletions"": 12, ""lines"": 14}}"
2020-12-06 17:50:36,5402175815a9b9b05772f339efa3ec9f73bdae09,Bram Moolenaar,52,16,68,2,"{""src/testdir/test_vim9_func.vim"": {""insertions"": 50, ""deletions"": 16, ""lines"": 66}, ""src/version.c"": {""insertions"": 2, ""deletions"": 0, ""lines"": 2}}"
2020-12-06 15:03:55,8bb0f5472c740458708fd3edabbb8d5193a96241,Bram Moolenaar,6,0,6,3,"{""src/dict.c"": {""insertions"": 1, ""deletions"": 0, ""lines"": 1}, ""src/version.c"": {""insertions"": 2, ""deletions"": 0, ""lines"": 2}, ""src/vim9compile.c"": {""insertions"": 3, ""deletions"": 0, ""lines"": 3}}"
2020-12-06 14:03:19,67322bf74a106b6476b093e75da87d61e2181b76,Bram Moolenaar,41,2,43,5,"{""src/testdir/test_functions.vim"": {""insertions"": 1, ""deletions"": 0, ""lines"": 1}, ""src/testdir/test_lambda.vim"": {""insertions"": 5, ""deletions"": 0, ""lines"": 5}, ""src/testdir/test_signals.vim"": {""insertions"": 1, ""deletions"": 2, ""lines"": 3}, ""src/testdir/test_user_func.vim"": {""insertions"": 32, ""deletions"": 0, ""lines"": 32}, ""src/version.c"": {""insertions"": 2, ""deletions"": 0, ""lines"": 2}}"
2020-12-06 13:37:08,918a4249176a8ccec3a34c9c7ef7bf4163676a63,Bram Moolenaar,94,7,101,4,"{""src/testdir/test_vim9_expr.vim"": {""insertions"": 72, ""deletions"": 0, ""lines"": 72}, ""src/testdir/test_vim9_script.vim"": {""insertions"": 12, ""deletions"": 0, ""lines"": 12}, ""src/version.c"": {""insertions"": 2, ""deletions"": 0, ""lines"": 2}, ""src/vim9compile.c"": {""insertions"": 8, ""deletions"": 7, ""lines"": 15}}"
2020-12-05 20:47:06,08cf0c0d82c7edfcbfe60db34f92759b7fee939a,Bram Moolenaar,26,2,28,2,"{""src/testdir/test_vim9_builtin.vim"": {""insertions"": 24, ""deletions"": 2, ""lines"": 26}, ""src/version.c"": {""insertions"": 2, ""deletions"": 0, ""lines"": 2}}"
2020-12-05 20:22:08,56602ba153af7130b76daf83933922aaea3e2646,Bram Moolenaar,43,2,45,5,"{""src/globals.h"": {""insertions"": 6, ""deletions"": 0, ""lines"": 6}, ""src/message.c"": {""insertions"": 6, ""deletions"": 0, ""lines"": 6}, ""src/testdir/test_vim9_func.vim"": {""insertions"": 16, ""deletions"": 0, ""lines"": 16}, ""src/version.c"": {""insertions"": 2, ""deletions"": 0, ""lines"": 2}, ""src/vim9execute.c"": {""insertions"": 13, ""deletions"": 2, ""lines"": 15}}"
2020-12-05 18:17:16,f665e97ffa06817975810cb511b13dbaa83ec630,Bram Moolenaar,50,12,62,4,"{""src/testdir/test_vim9_func.vim"": {""insertions"": 42, ""deletions"": 1, ""lines"": 43}, ""src/version.c"": {""insertions"": 2, ""deletions"": 0, ""lines"": 2}, ""src/vim9compile.c"": {""insertions"": 5, ""deletions"": 11, ""lines"": 16}, ""src/vim9execute.c"": {""insertions"": 1, ""deletions"": 0, ""lines"": 1}}"
2020-12-05 17:13:27,4029cabbe7c68a304ab8becb495bd6d91c6e97b1,Bram Moolenaar,30,0,30,3,"{""src/testdir/test_vim9_func.vim"": {""insertions"": 19, ""deletions"": 0, ""lines"": 19}, ""src/version.c"": {""insertions"": 2, ""deletions"": 0, ""lines"": 2}, ""src/vim9execute.c"": {""insertions"": 9, ""deletions"": 0, ""lines"": 9}}"
2020-12-05 16:11:12,d0fe620cbbf5f5e00446efa89893036265c5c302,Bram Moolenaar,19,1,20,3,"{""src/eval.c"": {""insertions"": 4, ""deletions"": 1, ""lines"": 5}, ""src/testdir/test_vim9_cmd.vim"": {""insertions"": 13, ""deletions"": 0, ""lines"": 13}, ""src/version.c"": {""insertions"": 2, ""deletions"": 0, ""lines"": 2}}"
2020-12-05 13:44:37,c0913d023b8bb728e9832727fe1657dbddf685d0,Bram Moolenaar,5,1,6,2,"{""src/version.c"": {""insertions"": 2, ""deletions"": 0, ""lines"": 2}, ""src/vim9script.c"": {""insertions"": 3, ""deletions"": 1, ""lines"": 4}}"
2020-12-05 12:41:01,2d870f8d9ebad22d32799d0d0ee30943d0a0e49d,Bram Moolenaar,61,21,82,6,"{""src/testdir/test_quickfix.vim"": {""insertions"": 1, ""deletions"": 1, ""lines"": 2}, ""src/testdir/test_vim9_assign.vim"": {""insertions"": 1, ""deletions"": 0, ""lines"": 1}, ""src/testdir/test_vim9_func.vim"": {""insertions"": 16, ""deletions"": 0, ""lines"": 16}, ""src/testdir/test_vim9_script.vim"": {""insertions"": 5, ""deletions"": 0, ""lines"": 5}, ""src/testdir/vim9.vim"": {""insertions"": 36, ""deletions"": 20, ""lines"": 56}, ""src/version.c"": {""insertions"": 2, ""deletions"": 0, ""lines"": 2}}"
2020-12-04 18:42:52,29d2f45c8855fd98897c5db92d896c161e95d0f1,Bram Moolenaar,12,1,13,3,"{""src/message.c"": {""insertions"": 1, ""deletions"": 1, ""lines"": 2}, ""src/os_win32.c"": {""insertions"": 9, ""deletions"": 0, ""lines"": 9}, ""src/version.c"": {""insertions"": 2, ""deletions"": 0, ""lines"": 2}}"
2020-12-04 18:12:14,c5e6a7179d7dee4315b412b56e172bb1ff092d3e,Bram Moolenaar,83,29,112,6,"{""runtime/doc/vim9.txt"": {""insertions"": 14, ""deletions"": 8, ""lines"": 22}, ""src/dict.c"": {""insertions"": 51, ""deletions"": 3, ""lines"": 54}, ""src/proto/dict.pro"": {""insertions"": 1, ""deletions"": 0, ""lines"": 1}, ""src/testdir/test_vim9_expr.vim"": {""insertions"": 2, ""deletions"": 1, ""lines"": 3}, ""src/version.c"": {""insertions"": 2, ""deletions"": 0, ""lines"": 2}, ""src/vim9compile.c"": {""insertions"": 13, ""deletions"": 17, ""lines"": 30}}"
2020-12-04 17:09:54,6cd42db9dc1251b052b97d47bafc063eacac1b3e,Bram Moolenaar,8,0,8,3,"{""src/auto/configure"": {""insertions"": 2, ""deletions"": 0, ""lines"": 2}, ""src/configure.ac"": {""insertions"": 4, ""deletions"": 0, ""lines"": 4}, ""src/version.c"": {""insertions"": 2, ""deletions"": 0, ""lines"": 2}}"
2020-12-04 16:38:00,f6c177ab3acda131d693f2cab0796df16da5b732,Bram Moolenaar,3,0,3,2,"{""src/testdir/test_vim9_script.vim"": {""insertions"": 1, ""deletions"": 0, ""lines"": 1}, ""src/version.c"": {""insertions"": 2, ""deletions"": 0, ""lines"": 2}}"
2020-12-04 11:43:29,21e51221f2c4f301912a5d59c748351b02c3df9e,Bram Moolenaar,6,0,6,2,"{""src/version.c"": {""insertions"": 2, ""deletions"": 0, ""lines"": 2}, ""src/vim9compile.c"": {""insertions"": 4, ""deletions"": 0, ""lines"": 4}}"
2020-12-03 20:24:07,476268c387a05cfda9feaca8d1a5eeb535ed9f49,Bram Moolenaar,7,9,16,5,"{"".travis.yml"": {""insertions"": 0, ""deletions"": 2, ""lines"": 2}, ""src/Makefile"": {""insertions"": 3, ""deletions"": 4, ""lines"": 7}, ""src/libvterm/Makefile"": {""insertions"": 1, ""deletions"": 1, ""lines"": 2}, ""src/libvterm/t/run-test.pl"": {""insertions"": 1, ""deletions"": 2, ""lines"": 3}, ""src/version.c"": {""insertions"": 2, ""deletions"": 0, ""lines"": 2}}"
2020-12-03 20:08:37,c0d670ce16d0e148b7d39ac354571b3d284a0b53,Bram Moolenaar,26,3,29,3,"{""runtime/filetype.vim"": {""insertions"": 7, ""deletions"": 2, ""lines"": 9}, ""src/testdir/test_filetype.vim"": {""insertions"": 17, ""deletions"": 1, ""lines"": 18}, ""src/version.c"": {""insertions"": 2, ""deletions"": 0, ""lines"": 2}}"
2020-12-03 18:54:42,0684e36a7ee0743f2889698fb8e0e14f7acae423,Bram Moolenaar,35,30,65,7,"{""src/edit.c"": {""insertions"": 10, ""deletions"": 10, ""lines"": 20}, ""src/ex_getln.c"": {""insertions"": 6, ""deletions"": 12, ""lines"": 18}, ""src/getchar.c"": {""insertions"": 4, ""deletions"": 5, ""lines"": 9}, ""src/normal.c"": {""insertions"": 2, ""deletions"": 2, ""lines"": 4}, ""src/proto/edit.pro"": {""insertions"": 1, ""deletions"": 1, ""lines"": 2}, ""src/testdir/test_termcodes.vim"": {""insertions"": 10, ""deletions"": 0, ""lines"": 10}, ""src/version.c"": {""insertions"": 2, ""deletions"": 0, ""lines"": 2}}"
2020-12-02 19:51:22,af0df47a7671a39f2cde950587ba48800188bfb9,Bram Moolenaar,22,4,26,3,"{""src/testdir/test_vim9_func.vim"": {""insertions"": 14, ""deletions"": 0, ""lines"": 14}, ""src/version.c"": {""insertions"": 2, ""deletions"": 0, ""lines"": 2}, ""src/vim9execute.c"": {""insertions"": 6, ""deletions"": 4, ""lines"": 10}}"
2020-12-02 16:36:54,e0de171ecd2ff7acd56deda2cf81f0d13a69c803,Bram Moolenaar,260,272,532,14,"{""src/dict.c"": {""insertions"": 18, ""deletions"": 9, ""lines"": 27}, ""src/eval.c"": {""insertions"": 1, ""deletions"": 1, ""lines"": 2}, ""src/proto/dict.pro"": {""insertions"": 1, ""deletions"": 0, ""lines"": 1}, ""src/testdir/test_popupwin.vim"": {""insertions"": 2, ""deletions"": 2, ""lines"": 4}, ""src/testdir/test_textprop.vim"": {""insertions"": 6, ""deletions"": 6, ""lines"": 12}, ""src/testdir/test_vim9_assign.vim"": {""insertions"": 28, ""deletions"": 28, ""lines"": 56}, ""src/testdir/test_vim9_builtin.vim"": {""insertions"": 22, ""deletions"": 22, ""lines"": 44}, ""src/testdir/test_vim9_cmd.vim"": {""insertions"": 7, ""deletions"": 7, ""lines"": 14}, ""src/testdir/test_vim9_disassemble.vim"": {""insertions"": 9, ""deletions"": 9, ""lines"": 18}, ""src/testdir/test_vim9_expr.vim"": {""insertions"": 105, ""deletions"": 96, ""lines"": 201}, ""src/testdir/test_vim9_func.vim"": {""insertions"": 18, ""deletions"": 18, ""lines"": 36}, ""src/testdir/test_vim9_script.vim"": {""insertions"": 20, ""deletions"": 20, ""lines"": 40}, ""src/version.c"": {""insertions"": 2, ""deletions"": 0, ""lines"": 2}, ""src/vim9compile.c"": {""insertions"": 21, ""deletions"": 54, ""lines"": 75}}"
2020-12-02 14:11:18,7f76494aac512b1d603d9be4132184241f43872c,Bram Moolenaar,23,3,26,4,"{""src/testdir/test_vim9_assign.vim"": {""insertions"": 15, ""deletions"": 0, ""lines"": 15}, ""src/testdir/test_vim9_expr.vim"": {""insertions"": 0, ""deletions"": 1, ""lines"": 1}, ""src/version.c"": {""insertions"": 2, ""deletions"": 0, ""lines"": 2}, ""src/vim9compile.c"": {""insertions"": 6, ""deletions"": 2, ""lines"": 8}}"
2020-12-02 13:24:30,ea87069d7814497181483877651aef6d97182120,Bram Moolenaar,29,0,29,3,"{""src/testdir/test_vim9_script.vim"": {""insertions"": 21, ""deletions"": 0, ""lines"": 21}, ""src/version.c"": {""insertions"": 2, ""deletions"": 0, ""lines"": 2}, ""src/vim9compile.c"": {""insertions"": 6, ""deletions"": 0, ""lines"": 6}}"
2020-12-02 12:23:36,38bd8de551225bfca133805f21cee2592f0c759d,Bram Moolenaar,33,2,35,3,"{""src/testdir/test_vim9_script.vim"": {""insertions"": 22, ""deletions"": 0, ""lines"": 22}, ""src/version.c"": {""insertions"": 2, ""deletions"": 0, ""lines"": 2}, ""src/vim9compile.c"": {""insertions"": 9, ""deletions"": 2, ""lines"": 11}}"
2020-12-02 11:37:37,1cbfc9914db1cb06aaa092fa42eb7a2fc3dc7ad7,Bram Moolenaar,16,1,17,3,"{""src/message.c"": {""insertions"": 5, ""deletions"": 1, ""lines"": 6}, ""src/testdir/test_utf8.vim"": {""insertions"": 9, ""deletions"": 0, ""lines"": 9}, ""src/version.c"": {""insertions"": 2, ""deletions"": 0, ""lines"": 2}}"
2020-12-01 20:47:59,a452b808b4da2d272ca4a50865eb8ca89a58f239,Bram Moolenaar,9,1,10,3,"{""src/ex_docmd.c"": {""insertions"": 5, ""deletions"": 1, ""lines"": 6}, ""src/structs.h"": {""insertions"": 2, ""deletions"": 0, ""lines"": 2}, ""src/version.c"": {""insertions"": 2, ""deletions"": 0, ""lines"": 2}}"
2020-12-01 20:27:51,c478ee3d83fab0dba46740f2023c35f743f88316,Bram Moolenaar,9,19,28,2,"{""src/os_win32.c"": {""insertions"": 7, ""deletions"": 19, ""lines"": 26}, ""src/version.c"": {""insertions"": 2, ""deletions"": 0, ""lines"": 2}}"
2020-12-01 20:08:05,57cf4973a283941c92744554474b2c52ce892fd1,Bram Moolenaar,11,3,14,3,"{""src/list.c"": {""insertions"": 3, ""deletions"": 3, ""lines"": 6}, ""src/testdir/test_filter_map.vim"": {""insertions"": 6, ""deletions"": 0, ""lines"": 6}, ""src/version.c"": {""insertions"": 2, ""deletions"": 0, ""lines"": 2}}"
2020-12-01 19:12:24,4324d87a4432721d9dbc72c1e336350bc6b7ebc3,Bram Moolenaar,22,3,25,4,"{""src/ex_docmd.c"": {""insertions"": 6, ""deletions"": 3, ""lines"": 9}, ""src/structs.h"": {""insertions"": 1, ""deletions"": 0, ""lines"": 1}, ""src/testdir/test_vim9_script.vim"": {""insertions"": 13, ""deletions"": 0, ""lines"": 13}, ""src/version.c"": {""insertions"": 2, ""deletions"": 0, ""lines"": 2}}"
2020-12-01 15:30:44,4b8a065145bb53762b869cd6b8e55b7ad7341761,Bram Moolenaar,322,230,552,3,"{""src/testdir/test_vim9_script.vim"": {""insertions"": 41, ""deletions"": 14, ""lines"": 55}, ""src/version.c"": {""insertions"": 2, ""deletions"": 0, ""lines"": 2}, ""src/vim9compile.c"": {""insertions"": 279, ""deletions"": 216, ""lines"": 495}}"
2020-11-30 20:40:03,004d9b00ba600a167746ad7af88e0baa77c95d8f,Bram Moolenaar,28,2,30,3,"{""src/testdir/test_vim9_assign.vim"": {""insertions"": 18, ""deletions"": 0, ""lines"": 18}, ""src/version.c"": {""insertions"": 2, ""deletions"": 0, ""lines"": 2}, ""src/vim9compile.c"": {""insertions"": 8, ""deletions"": 2, ""lines"": 10}}"
2020-11-30 20:12:19,da7c20c9531739bdefa9d4418e6765fb181066e9,Bram Moolenaar,37,25,62,3,"{""src/ex_docmd.c"": {""insertions"": 8, ""deletions"": 1, ""lines"": 9}, ""src/testdir/test_vim9_assign.vim"": {""insertions"": 27, ""deletions"": 24, ""lines"": 51}, ""src/version.c"": {""insertions"": 2, ""deletions"": 0, ""lines"": 2}}"
2020-11-30 16:42:10,f0068c5154a99b86b2c4515a4b93c003b2445cf4,Bram Moolenaar,49,2,51,7,"{""runtime/doc/autocmd.txt"": {""insertions"": 2, ""deletions"": 0, ""lines"": 2}, ""runtime/doc/eval.txt"": {""insertions"": 7, ""deletions"": 0, ""lines"": 7}, ""src/evalvars.c"": {""insertions"": 2, ""deletions"": 0, ""lines"": 2}, ""src/main.c"": {""insertions"": 7, ""deletions"": 1, ""lines"": 8}, ""src/testdir/test_exit.vim"": {""insertions"": 27, ""deletions"": 0, ""lines"": 27}, ""src/version.c"": {""insertions"": 2, ""deletions"": 0, ""lines"": 2}, ""src/vim.h"": {""insertions"": 2, ""deletions"": 1, ""lines"": 3}}"
