date,hexsha,author,insertions,deletions,lines,files,files_json
2020-10-17 20:58:21,335e67132265b068f39f3671e5dff2aecd1bf403,Bram Moolenaar,3,0,3,2,"{""src/version.c"": {""insertions"": 2, ""deletions"": 0, ""lines"": 2}, ""src/vim9execute.c"": {""insertions"": 1, ""deletions"": 0, ""lines"": 1}}"
2020-10-17 20:04:08,352134bbfbff4831a3f6a3383d9e2d8660016243,Bram Moolenaar,47,0,47,4,"{""src/testdir/test_vim9_assign.vim"": {""insertions"": 3, ""deletions"": 0, ""lines"": 3}, ""src/testdir/test_vim9_script.vim"": {""insertions"": 22, ""deletions"": 0, ""lines"": 22}, ""src/version.c"": {""insertions"": 2, ""deletions"": 0, ""lines"": 2}, ""src/vim9execute.c"": {""insertions"": 20, ""deletions"": 0, ""lines"": 20}}"
2020-10-17 17:29:51,403dc31f5a03b5858f62e72c3407ffaf827b3005,Bram Moolenaar,27,4,31,4,"{""src/evalfunc.c"": {""insertions"": 7, ""deletions"": 2, ""lines"": 9}, ""src/popupwin.c"": {""insertions"": 4, ""deletions"": 2, ""lines"": 6}, ""src/testdir/test_vim9_func.vim"": {""insertions"": 14, ""deletions"": 0, ""lines"": 14}, ""src/version.c"": {""insertions"": 2, ""deletions"": 0, ""lines"": 2}}"
2020-10-17 16:51:52,218450ad5ea1f9f033b06754a29502d86100ff65,Bram Moolenaar,19,4,23,3,"{""src/job.c"": {""insertions"": 13, ""deletions"": 4, ""lines"": 17}, ""src/testdir/test_vim9_assign.vim"": {""insertions"": 4, ""deletions"": 0, ""lines"": 4}, ""src/version.c"": {""insertions"": 2, ""deletions"": 0, ""lines"": 2}}"
2020-10-17 15:39:55,9668cc57a1e70c99163f90f58202e206d12f40c8,Bram Moolenaar,8,2,10,3,"{""src/ex_docmd.c"": {""insertions"": 2, ""deletions"": 2, ""lines"": 4}, ""src/testdir/test_window_cmd.vim"": {""insertions"": 4, ""deletions"": 0, ""lines"": 4}, ""src/version.c"": {""insertions"": 2, ""deletions"": 0, ""lines"": 2}}"
2020-10-16 21:16:47,e13bdec6b90b3a0fce4f021e3ee986e731cea3b5,Bram Moolenaar,9,5,14,4,"{""src/errors.h"": {""insertions"": 1, ""deletions"": 1, ""lines"": 2}, ""src/version.c"": {""insertions"": 2, ""deletions"": 0, ""lines"": 2}, ""src/vim9compile.c"": {""insertions"": 4, ""deletions"": 2, ""lines"": 6}, ""src/vim9execute.c"": {""insertions"": 2, ""deletions"": 2, ""lines"": 4}}"
2020-10-16 18:25:23,1e021e63c565bbb30783a557b4e883cc27f56403,Bram Moolenaar,28,0,28,4,"{""src/errors.h"": {""insertions"": 2, ""deletions"": 0, ""lines"": 2}, ""src/testdir/test_vim9_script.vim"": {""insertions"": 15, ""deletions"": 0, ""lines"": 15}, ""src/version.c"": {""insertions"": 2, ""deletions"": 0, ""lines"": 2}, ""src/vim9execute.c"": {""insertions"": 9, ""deletions"": 0, ""lines"": 9}}"
2020-10-16 17:56:12,7a66a17190f2f64688a697ea29d58388612122ce,Bram Moolenaar,7,2,9,3,"{""src/ex_docmd.c"": {""insertions"": 1, ""deletions"": 1, ""lines"": 2}, ""src/testdir/test_vim9_assign.vim"": {""insertions"": 4, ""deletions"": 1, ""lines"": 5}, ""src/version.c"": {""insertions"": 2, ""deletions"": 0, ""lines"": 2}}"
2020-10-15 20:29:17,ffdf8adfa8108d4765fdc68abbd2fe49a4292b25,Bram Moolenaar,10,6,16,4,"{""src/list.c"": {""insertions"": 3, ""deletions"": 2, ""lines"": 5}, ""src/testdir/test_blob.vim"": {""insertions"": 1, ""deletions"": 0, ""lines"": 1}, ""src/testdir/test_filter_map.vim"": {""insertions"": 4, ""deletions"": 4, ""lines"": 8}, ""src/version.c"": {""insertions"": 2, ""deletions"": 0, ""lines"": 2}}"
2020-10-15 19:54:56,27491cd3ef86c10a2b64bcb657f29e1d0fccb183,Bram Moolenaar,28,6,34,4,"{""src/eval.c"": {""insertions"": 4, ""deletions"": 0, ""lines"": 4}, ""src/testdir/test_vim9_expr.vim"": {""insertions"": 17, ""deletions"": 2, ""lines"": 19}, ""src/version.c"": {""insertions"": 2, ""deletions"": 0, ""lines"": 2}, ""src/vim9compile.c"": {""insertions"": 5, ""deletions"": 4, ""lines"": 9}}"
2020-10-15 19:23:28,a604ccc959c3bff88d3d5bc3c965819fc326d239,Bram Moolenaar,16,2,18,3,"{""src/testdir/test_textobjects.vim"": {""insertions"": 12, ""deletions"": 0, ""lines"": 12}, ""src/textobject.c"": {""insertions"": 2, ""deletions"": 2, ""lines"": 4}, ""src/version.c"": {""insertions"": 2, ""deletions"": 0, ""lines"": 2}}"
2020-10-15 18:42:20,ed234f24f3a6d697ba9b786d0bc74d4682bfdf47,Bram Moolenaar,41,11,52,3,"{""src/evalvars.c"": {""insertions"": 14, ""deletions"": 2, ""lines"": 16}, ""src/testdir/test_vim9_script.vim"": {""insertions"": 25, ""deletions"": 9, ""lines"": 34}, ""src/version.c"": {""insertions"": 2, ""deletions"": 0, ""lines"": 2}}"
2020-10-15 17:10:56,74f8eece5e481220e3c0767487c0bb59fa916ed6,Bram Moolenaar,16,2,18,3,"{""src/popupwin.c"": {""insertions"": 4, ""deletions"": 2, ""lines"": 6}, ""src/testdir/test_popupwin.vim"": {""insertions"": 10, ""deletions"": 0, ""lines"": 10}, ""src/version.c"": {""insertions"": 2, ""deletions"": 0, ""lines"": 2}}"
2020-10-15 11:57:56,209f0208f7831c6ab8f3f1cab473cb21e7985fc3,Bram Moolenaar,3,1,4,2,"{""src/version.c"": {""insertions"": 2, ""deletions"": 0, ""lines"": 2}, ""src/vim9compile.c"": {""insertions"": 1, ""deletions"": 1, ""lines"": 2}}"
2020-10-15 10:46:44,fbbcd00367e1a4fafd047d42ffce0e5dce88925c,Bram Moolenaar,239,65,304,11,"{""src/ex_eval.c"": {""insertions"": 8, ""deletions"": 2, ""lines"": 10}, ""src/proto/userfunc.pro"": {""insertions"": 1, ""deletions"": 1, ""lines"": 2}, ""src/proto/vim9compile.pro"": {""insertions"": 1, ""deletions"": 1, ""lines"": 2}, ""src/proto/vim9script.pro"": {""insertions"": 2, ""deletions"": 2, ""lines"": 4}, ""src/structs.h"": {""insertions"": 4, ""deletions"": 1, ""lines"": 5}, ""src/testdir/test_vim9_script.vim"": {""insertions"": 40, ""deletions"": 9, ""lines"": 49}, ""src/userfunc.c"": {""insertions"": 19, ""deletions"": 3, ""lines"": 22}, ""src/version.c"": {""insertions"": 2, ""deletions"": 0, ""lines"": 2}, ""src/vim9compile.c"": {""insertions"": 130, ""deletions"": 33, ""lines"": 163}, ""src/vim9execute.c"": {""insertions"": 8, ""deletions"": 4, ""lines"": 12}, ""src/vim9script.c"": {""insertions"": 24, ""deletions"": 9, ""lines"": 33}}"
2020-10-14 17:39:19,8d739de43b84ef7817b3b5b826d1cbfe7572a62a,Bram Moolenaar,209,61,270,7,"{""src/evalvars.c"": {""insertions"": 4, ""deletions"": 24, ""lines"": 28}, ""src/ex_eval.c"": {""insertions"": 18, ""deletions"": 24, ""lines"": 42}, ""src/proto/vim9script.pro"": {""insertions"": 4, ""deletions"": 1, ""lines"": 5}, ""src/scriptfile.c"": {""insertions"": 4, ""deletions"": 3, ""lines"": 7}, ""src/structs.h"": {""insertions"": 52, ""deletions"": 7, ""lines"": 59}, ""src/version.c"": {""insertions"": 2, ""deletions"": 0, ""lines"": 2}, ""src/vim9script.c"": {""insertions"": 125, ""deletions"": 2, ""lines"": 127}}"
2020-10-13 20:15:56,3d30af8783bf43fbfece641ec81ad8d2f01b3735,Bram Moolenaar,33,2,35,4,"{""src/message.c"": {""insertions"": 8, ""deletions"": 2, ""lines"": 10}, ""src/testdir/dumps/Test_quit_long_message.dump"": {""insertions"": 6, ""deletions"": 0, ""lines"": 6}, ""src/testdir/test_messages.vim"": {""insertions"": 17, ""deletions"": 0, ""lines"": 17}, ""src/version.c"": {""insertions"": 2, ""deletions"": 0, ""lines"": 2}}"
2020-10-13 19:11:13,b9616af23f31fc18721a92643c21f42b69854efe,Bram Moolenaar,12,2,14,2,"{""src/netbeans.c"": {""insertions"": 10, ""deletions"": 2, ""lines"": 12}, ""src/version.c"": {""insertions"": 2, ""deletions"": 0, ""lines"": 2}}"
2020-10-13 17:08:24,21cbe175eece17fad21d7403b00422445b587138,Bram Moolenaar,24,2,26,4,"{""src/ex_cmds.c"": {""insertions"": 2, ""deletions"": 1, ""lines"": 3}, ""src/ex_docmd.c"": {""insertions"": 2, ""deletions"": 1, ""lines"": 3}, ""src/testdir/test_edit.vim"": {""insertions"": 18, ""deletions"": 0, ""lines"": 18}, ""src/version.c"": {""insertions"": 2, ""deletions"": 0, ""lines"": 2}}"
2020-10-13 16:38:11,2b9b17ea5daaaa693d0891e9a999d711f0e0f743,Bram Moolenaar,8,2,10,2,"{""src/testdir/test_vim9_func.vim"": {""insertions"": 6, ""deletions"": 2, ""lines"": 8}, ""src/version.c"": {""insertions"": 2, ""deletions"": 0, ""lines"": 2}}"
2020-10-12 20:07:13,f4e8cdd3d2156ab52aea1c7a392df66b7210e5eb,Bram Moolenaar,46,1,47,5,"{""src/globals.h"": {""insertions"": 3, ""deletions"": 0, ""lines"": 3}, ""src/message.c"": {""insertions"": 6, ""deletions"": 1, ""lines"": 7}, ""src/testdir/test_vim9_func.vim"": {""insertions"": 32, ""deletions"": 0, ""lines"": 32}, ""src/version.c"": {""insertions"": 2, ""deletions"": 0, ""lines"": 2}, ""src/vim9compile.c"": {""insertions"": 3, ""deletions"": 0, ""lines"": 3}}"
2020-10-12 18:31:26,fc8aa6d02d85b0df703e0a790137891c91503c9e,Bram Moolenaar,18,7,25,4,"{""src/testdir/Make_all.mak"": {""insertions"": 2, ""deletions"": 0, ""lines"": 2}, ""src/testdir/test_vim9_assign.vim"": {""insertions"": 4, ""deletions"": 7, ""lines"": 11}, ""src/testdir/test_vim9_fails.vim"": {""insertions"": 10, ""deletions"": 0, ""lines"": 10}, ""src/version.c"": {""insertions"": 2, ""deletions"": 0, ""lines"": 2}}"
2020-10-11 19:34:41,93be1644db2848659b0610477968c83f53619da1,Bram Moolenaar,107,1,108,3,"{""src/eval.c"": {""insertions"": 24, ""deletions"": 1, ""lines"": 25}, ""src/testdir/test_vim9_expr.vim"": {""insertions"": 81, ""deletions"": 0, ""lines"": 81}, ""src/version.c"": {""insertions"": 2, ""deletions"": 0, ""lines"": 2}}"
2020-10-11 18:44:15,c07b7f701fb30d26112051e4ec737c7e3db72357,Bram Moolenaar,38,3,41,3,"{""src/search.c"": {""insertions"": 20, ""deletions"": 3, ""lines"": 23}, ""src/testdir/test_gn.vim"": {""insertions"": 16, ""deletions"": 0, ""lines"": 16}, ""src/version.c"": {""insertions"": 2, ""deletions"": 0, ""lines"": 2}}"
2020-10-11 18:08:44,62cd26a2294b7a5eead7c145e9bbc7c75f3bb801,Bram Moolenaar,10,3,13,2,"{""src/testdir/test_autocmd.vim"": {""insertions"": 8, ""deletions"": 3, ""lines"": 11}, ""src/version.c"": {""insertions"": 2, ""deletions"": 0, ""lines"": 2}}"
2020-10-11 17:08:33,6eb36ade9883f54c84c739c6a3504ddfa3343063,Bram Moolenaar,64,28,92,3,"{""src/help.c"": {""insertions"": 52, ""deletions"": 28, ""lines"": 80}, ""src/testdir/test_help_tagjump.vim"": {""insertions"": 10, ""deletions"": 0, ""lines"": 10}, ""src/version.c"": {""insertions"": 2, ""deletions"": 0, ""lines"": 2}}"
2020-10-11 16:05:02,efc0d94afc48a03b07955e91315e7e67945cd079,Bram Moolenaar,17,14,31,3,"{""src/if_py_both.h"": {""insertions"": 4, ""deletions"": 4, ""lines"": 8}, ""src/if_python3.c"": {""insertions"": 11, ""deletions"": 10, ""lines"": 21}, ""src/version.c"": {""insertions"": 2, ""deletions"": 0, ""lines"": 2}}"
2020-10-11 12:58:46,204ade6bcb85f48f56e52e040d1ebf40548d92be,Bram Moolenaar,7,10,17,2,"{""src/main.c"": {""insertions"": 5, ""deletions"": 10, ""lines"": 15}, ""src/version.c"": {""insertions"": 2, ""deletions"": 0, ""lines"": 2}}"
2020-10-11 12:28:11,aab9fada4a9b9725ff42dffe9c7daff20f0fd85f,Bram Moolenaar,6,2,8,3,"{""src/fileio.c"": {""insertions"": 2, ""deletions"": 2, ""lines"": 4}, ""src/testdir/test_functions.vim"": {""insertions"": 2, ""deletions"": 0, ""lines"": 2}, ""src/version.c"": {""insertions"": 2, ""deletions"": 0, ""lines"": 2}}"
2020-10-11 12:22:22,ef16c90423ae579927e6294c1ccfd17c5a1c113c,Bram Moolenaar,3,0,3,2,"{""Filelist"": {""insertions"": 1, ""deletions"": 0, ""lines"": 1}, ""src/version.c"": {""insertions"": 2, ""deletions"": 0, ""lines"": 2}}"
2020-10-11 11:57:40,4f4d51a942cc2c6b3e936ee0f93f00c2d000065c,Bram Moolenaar,287,233,520,30,"{"".github/CODEOWNERS"": {""insertions"": 2, ""deletions"": 0, ""lines"": 2}, ""README_VIM9.md"": {""insertions"": 1, ""deletions"": 1, ""lines"": 2}, ""runtime/autoload/python3complete.vim"": {""insertions"": 4, ""deletions"": 3, ""lines"": 7}, ""runtime/autoload/pythoncomplete.vim"": {""insertions"": 4, ""deletions"": 3, ""lines"": 7}, ""runtime/colors/README.txt"": {""insertions"": 1, ""deletions"": 1, ""lines"": 2}, ""runtime/defaults.vim"": {""insertions"": 1, ""deletions"": 1, ""lines"": 2}, ""runtime/doc/eval.txt"": {""insertions"": 3, ""deletions"": 3, ""lines"": 6}, ""runtime/doc/index.txt"": {""insertions"": 5, ""deletions"": 3, ""lines"": 8}, ""runtime/doc/map.txt"": {""insertions"": 12, ""deletions"": 1, ""lines"": 13}, ""runtime/doc/options.txt"": {""insertions"": 3, ""deletions"": 3, ""lines"": 6}, ""runtime/doc/repeat.txt"": {""insertions"": 4, ""deletions"": 1, ""lines"": 5}, ""runtime/doc/tags"": {""insertions"": 6, ""deletions"": 0, ""lines"": 6}, ""runtime/doc/todo.txt"": {""insertions"": 64, ""deletions"": 57, ""lines"": 121}, ""runtime/doc/version8.txt"": {""insertions"": 1, ""deletions"": 1, ""lines"": 2}, ""runtime/doc/vim9.txt"": {""insertions"": 33, ""deletions"": 17, ""lines"": 50}, ""runtime/filetype.vim"": {""insertions"": 1, ""deletions"": 1, ""lines"": 2}, ""runtime/ftplugin/falcon.vim"": {""insertions"": 2, ""deletions"": 1, ""lines"": 3}, ""runtime/ftplugin/fortran.vim"": {""insertions"": 6, ""deletions"": 6, ""lines"": 12}, ""runtime/ftplugin/python.vim"": {""insertions"": 13, ""deletions"": 29, ""lines"": 42}, ""runtime/indent/fortran.vim"": {""insertions"": 6, ""deletions"": 6, ""lines"": 12}, ""runtime/syntax/apache.vim"": {""insertions"": 3, ""deletions"": 1, ""lines"": 4}, ""runtime/syntax/asterisk.vim"": {""insertions"": 2, ""deletions"": 2, ""lines"": 4}, ""runtime/syntax/cabal.vim"": {""insertions"": 5, ""deletions"": 2, ""lines"": 7}, ""runtime/syntax/css.vim"": {""insertions"": 2, ""deletions"": 2, ""lines"": 4}, ""runtime/syntax/fortran.vim"": {""insertions"": 19, ""deletions"": 11, ""lines"": 30}, ""runtime/syntax/haskell.vim"": {""insertions"": 49, ""deletions"": 40, ""lines"": 89}, ""runtime/syntax/ia64.vim"": {""insertions"": 19, ""deletions"": 20, ""lines"": 39}, ""runtime/syntax/less.vim"": {""insertions"": 1, ""deletions"": 2, ""lines"": 3}, ""runtime/syntax/vim.vim"": {""insertions"": 14, ""deletions"": 14, ""lines"": 28}, ""runtime/syntax/xkb.vim"": {""insertions"": 1, ""deletions"": 1, ""lines"": 2}}"
2020-10-10 21:26:28,c6ed254d9fda0ff54cdedce5597ff3e0d0218d18,Bram Moolenaar,27,9,36,2,"{""src/if_python3.c"": {""insertions"": 25, ""deletions"": 9, ""lines"": 34}, ""src/version.c"": {""insertions"": 2, ""deletions"": 0, ""lines"": 2}}"
2020-10-10 20:34:36,bd6428b9e79ed85b54ea7eaa11871fa09d63ab6f,Bram Moolenaar,4,2,6,2,"{"".github/workflows/ci-windows.yaml"": {""insertions"": 2, ""deletions"": 2, ""lines"": 4}, ""src/version.c"": {""insertions"": 2, ""deletions"": 0, ""lines"": 2}}"
2020-10-10 20:26:52,1b1e9df78b9ff98cc5ccff359bead37ce5c54d6b,Bram Moolenaar,4,0,4,2,"{""src/ex_docmd.c"": {""insertions"": 2, ""deletions"": 0, ""lines"": 2}, ""src/version.c"": {""insertions"": 2, ""deletions"": 0, ""lines"": 2}}"
2020-10-10 19:50:25,10a1a534d1ae1d798bb695f9a521052ebbf1e289,Bram Moolenaar,107,96,203,3,"{""runtime/filetype.vim"": {""insertions"": 0, ""deletions"": 7, ""lines"": 7}, ""src/testdir/test_filetype.vim"": {""insertions"": 105, ""deletions"": 89, ""lines"": 194}, ""src/version.c"": {""insertions"": 2, ""deletions"": 0, ""lines"": 2}}"
2020-10-10 19:33:48,9becdf2b98e56d5eb193f3413d706ea433269216,Bram Moolenaar,76,5,81,9,"{""src/errors.h"": {""insertions"": 2, ""deletions"": 0, ""lines"": 2}, ""src/ex_cmdidxs.h"": {""insertions"": 1, ""deletions"": 1, ""lines"": 2}, ""src/ex_cmds.h"": {""insertions"": 6, ""deletions"": 0, ""lines"": 6}, ""src/ex_docmd.c"": {""insertions"": 8, ""deletions"": 2, ""lines"": 10}, ""src/ex_eval.c"": {""insertions"": 33, ""deletions"": 2, ""lines"": 35}, ""src/proto/ex_eval.pro"": {""insertions"": 2, ""deletions"": 0, ""lines"": 2}, ""src/structs.h"": {""insertions"": 1, ""deletions"": 0, ""lines"": 1}, ""src/testdir/test_vim9_script.vim"": {""insertions"": 21, ""deletions"": 0, ""lines"": 21}, ""src/version.c"": {""insertions"": 2, ""deletions"": 0, ""lines"": 2}}"
2020-10-10 18:31:37,d747548c664815bb6e8520afa90b6108e1997591,Bram Moolenaar,21,13,34,2,"{""src/ex_eval.c"": {""insertions"": 19, ""deletions"": 13, ""lines"": 32}, ""src/version.c"": {""insertions"": 2, ""deletions"": 0, ""lines"": 2}}"
2020-10-10 17:07:09,fcdc5d83fbfd7ddce634769ea902e58c87f27f20,Bram Moolenaar,112,14,126,6,"{""src/evalvars.c"": {""insertions"": 1, ""deletions"": 2, ""lines"": 3}, ""src/ex_eval.c"": {""insertions"": 56, ""deletions"": 12, ""lines"": 68}, ""src/proto/evalvars.pro"": {""insertions"": 1, ""deletions"": 0, ""lines"": 1}, ""src/structs.h"": {""insertions"": 2, ""deletions"": 0, ""lines"": 2}, ""src/testdir/test_vim9_script.vim"": {""insertions"": 50, ""deletions"": 0, ""lines"": 50}, ""src/version.c"": {""insertions"": 2, ""deletions"": 0, ""lines"": 2}}"
2020-10-10 14:45:25,28f224b2c1bd2fcdee7b4fe2c64826e1cff08f39,Bram Moolenaar,13,2,15,3,"{""src/search.c"": {""insertions"": 1, ""deletions"": 1, ""lines"": 2}, ""src/testdir/test_gn.vim"": {""insertions"": 10, ""deletions"": 1, ""lines"": 11}, ""src/version.c"": {""insertions"": 2, ""deletions"": 0, ""lines"": 2}}"
2020-10-10 14:42:39,f57497276bc616d3856eeff9824c080941faa51b,Bram Moolenaar,6,2,8,2,"{""src/testdir/test_listdict.vim"": {""insertions"": 4, ""deletions"": 2, ""lines"": 6}, ""src/version.c"": {""insertions"": 2, ""deletions"": 0, ""lines"": 2}}"
2020-10-10 13:37:58,1a73923705744ab8297dd856d194e20297563456,Bram Moolenaar,27,6,33,3,"{""src/list.c"": {""insertions"": 13, ""deletions"": 6, ""lines"": 19}, ""src/testdir/test_vim9_assign.vim"": {""insertions"": 12, ""deletions"": 0, ""lines"": 12}, ""src/version.c"": {""insertions"": 2, ""deletions"": 0, ""lines"": 2}}"
2020-10-10 13:05:23,820d55a50bbc8c0ad0505b7e4302a734896b6bab,Bram Moolenaar,6,0,6,2,"{""src/ex_docmd.c"": {""insertions"": 4, ""deletions"": 0, ""lines"": 4}, ""src/version.c"": {""insertions"": 2, ""deletions"": 0, ""lines"": 2}}"
2020-10-10 12:13:01,85d5e2b723e6fc233e53252dd5c523944146fbc2,Bram Moolenaar,143,110,253,7,"{""src/eval.c"": {""insertions"": 14, ""deletions"": 15, ""lines"": 29}, ""src/proto/vim9execute.pro"": {""insertions"": 1, ""deletions"": 0, ""lines"": 1}, ""src/structs.h"": {""insertions"": 3, ""deletions"": 0, ""lines"": 3}, ""src/testdir/test_vim9_disassemble.vim"": {""insertions"": 36, ""deletions"": 36, ""lines"": 72}, ""src/testdir/test_vim9_func.vim"": {""insertions"": 38, ""deletions"": 40, ""lines"": 78}, ""src/version.c"": {""insertions"": 2, ""deletions"": 0, ""lines"": 2}, ""src/vim9execute.c"": {""insertions"": 49, ""deletions"": 19, ""lines"": 68}}"
2020-10-09 21:04:47,8956023920bb1b6f9c381739e59b9ddab4bf7798,Bram Moolenaar,6,2,8,2,"{""src/os_unix.c"": {""insertions"": 4, ""deletions"": 2, ""lines"": 6}, ""src/version.c"": {""insertions"": 2, ""deletions"": 0, ""lines"": 2}}"
2020-10-09 20:04:29,e8211a33dcb0ac6e29aad6699160fdc2e5fa2024,Bram Moolenaar,29,3,32,3,"{""src/testdir/test_vim9_func.vim"": {""insertions"": 18, ""deletions"": 0, ""lines"": 18}, ""src/version.c"": {""insertions"": 2, ""deletions"": 0, ""lines"": 2}, ""src/vim9compile.c"": {""insertions"": 9, ""deletions"": 3, ""lines"": 12}}"
2020-10-09 08:20:53,11416321ff45e2bf3d456f332dc9d1836a8d171a,Bram Moolenaar,42,38,80,2,"{""src/testdir/test_vim9_func.vim"": {""insertions"": 40, ""deletions"": 38, ""lines"": 78}, ""src/version.c"": {""insertions"": 2, ""deletions"": 0, ""lines"": 2}}"
2020-10-08 21:21:21,6a61421f646961b7d719432c02382f0a70702a80,Bram Moolenaar,38,35,73,2,"{""src/testdir/test_vim9_disassemble.vim"": {""insertions"": 36, ""deletions"": 35, ""lines"": 71}, ""src/version.c"": {""insertions"": 2, ""deletions"": 0, ""lines"": 2}}"
2020-10-08 19:30:40,922acbda3d4e250c8683db223f444d0ec8c6fd03,Bram Moolenaar,3,1,4,2,"{""src/evalvars.c"": {""insertions"": 1, ""deletions"": 1, ""lines"": 2}, ""src/version.c"": {""insertions"": 2, ""deletions"": 0, ""lines"": 2}}"
2020-10-08 19:16:42,10c65860f83589e0ca2498393d3cfef1115b7fe8,Bram Moolenaar,75,23,98,7,"{""src/eval.c"": {""insertions"": 24, ""deletions"": 0, ""lines"": 24}, ""src/proto/evalvars.pro"": {""insertions"": 1, ""deletions"": 0, ""lines"": 1}, ""src/proto/vim9script.pro"": {""insertions"": 1, ""deletions"": 0, ""lines"": 1}, ""src/structs.h"": {""insertions"": 1, ""deletions"": 0, ""lines"": 1}, ""src/testdir/test_vim9_script.vim"": {""insertions"": 9, ""deletions"": 0, ""lines"": 9}, ""src/version.c"": {""insertions"": 2, ""deletions"": 0, ""lines"": 2}, ""src/vim9script.c"": {""insertions"": 37, ""deletions"": 23, ""lines"": 60}}"
2020-10-07 17:08:04,0876c78527469ddf50c23244566dd5bc35004307,Bram Moolenaar,20,2,22,3,"{""src/testdir/test_vim9_func.vim"": {""insertions"": 14, ""deletions"": 0, ""lines"": 14}, ""src/version.c"": {""insertions"": 2, ""deletions"": 0, ""lines"": 2}, ""src/vim9execute.c"": {""insertions"": 4, ""deletions"": 2, ""lines"": 6}}"
2020-10-07 15:29:48,9a033d7b18651acbb7eda4b7f39a27c01748fb70,Bram Moolenaar,36,3,39,4,"{""runtime/doc/map.txt"": {""insertions"": 9, ""deletions"": 2, ""lines"": 11}, ""src/misc2.c"": {""insertions"": 7, ""deletions"": 1, ""lines"": 8}, ""src/testdir/test_termcodes.vim"": {""insertions"": 18, ""deletions"": 0, ""lines"": 18}, ""src/version.c"": {""insertions"": 2, ""deletions"": 0, ""lines"": 2}}"
2020-10-07 14:54:52,d7e5e9430ae192c76f1f03c3ac53fae823d94c33,Bram Moolenaar,99,2,101,3,"{""src/testdir/test_charsearch.vim"": {""insertions"": 29, ""deletions"": 2, ""lines"": 31}, ""src/testdir/test_normal.vim"": {""insertions"": 68, ""deletions"": 0, ""lines"": 68}, ""src/version.c"": {""insertions"": 2, ""deletions"": 0, ""lines"": 2}}"
2020-10-07 14:12:37,4e2114e988f5d8635f2ad748be3cafcc44289138,Bram Moolenaar,56,10,66,7,"{""src/gui_gtk_x11.c"": {""insertions"": 3, ""deletions"": 4, ""lines"": 7}, ""src/gui_x11.c"": {""insertions"": 3, ""deletions"": 0, ""lines"": 3}, ""src/misc2.c"": {""insertions"": 26, ""deletions"": 0, ""lines"": 26}, ""src/proto/misc2.pro"": {""insertions"": 1, ""deletions"": 0, ""lines"": 1}, ""src/term.c"": {""insertions"": 3, ""deletions"": 6, ""lines"": 9}, ""src/testdir/test_termcodes.vim"": {""insertions"": 18, ""deletions"": 0, ""lines"": 18}, ""src/version.c"": {""insertions"": 2, ""deletions"": 0, ""lines"": 2}}"
2020-10-07 10:58:44,f12f0022e6698831681f0931a4e7e5298f6ef0d8,Bram Moolenaar,40,0,40,2,"{""src/testdir/test_spell.vim"": {""insertions"": 38, ""deletions"": 0, ""lines"": 38}, ""src/version.c"": {""insertions"": 2, ""deletions"": 0, ""lines"": 2}}"
2020-10-06 18:46:49,349f609f8990a3aca9a4b8faa0585d75e03116db,Bram Moolenaar,11,0,11,3,"{""src/help.c"": {""insertions"": 3, ""deletions"": 0, ""lines"": 3}, ""src/testdir/test_popupwin.vim"": {""insertions"": 6, ""deletions"": 0, ""lines"": 6}, ""src/version.c"": {""insertions"": 2, ""deletions"": 0, ""lines"": 2}}"
2020-10-06 17:59:06,253b16a4abdad1df350b9ddd9a709520b063934c,Bram Moolenaar,11,6,17,2,"{""src/if_python3.c"": {""insertions"": 9, ""deletions"": 6, ""lines"": 15}, ""src/version.c"": {""insertions"": 2, ""deletions"": 0, ""lines"": 2}}"
2020-10-05 19:39:25,80361a5f2b134c88597d60b3d363b52084e712a1,Bram Moolenaar,10,4,14,2,"{""src/os_unix.c"": {""insertions"": 8, ""deletions"": 4, ""lines"": 12}, ""src/version.c"": {""insertions"": 2, ""deletions"": 0, ""lines"": 2}}"
2020-10-05 18:38:06,50c4e9e08fb0981892e33afb9fe3751aa6df1fa4,Bram Moolenaar,5,1,6,3,"{""src/filepath.c"": {""insertions"": 1, ""deletions"": 1, ""lines"": 2}, ""src/testdir/test_functions.vim"": {""insertions"": 2, ""deletions"": 0, ""lines"": 2}, ""src/version.c"": {""insertions"": 2, ""deletions"": 0, ""lines"": 2}}"
2020-10-05 18:07:18,afe8cf617013fd8c3f0189f1e1fa7a2a6a8f7511,Bram Moolenaar,15,2,17,5,"{""src/testdir/test_arglist.vim"": {""insertions"": 6, ""deletions"": 2, ""lines"": 8}, ""src/testdir/test_cmdline.vim"": {""insertions"": 4, ""deletions"": 0, ""lines"": 4}, ""src/testdir/test_json.vim"": {""insertions"": 1, ""deletions"": 0, ""lines"": 1}, ""src/testdir/test_listdict.vim"": {""insertions"": 2, ""deletions"": 0, ""lines"": 2}, ""src/version.c"": {""insertions"": 2, ""deletions"": 0, ""lines"": 2}}"
2020-10-05 17:23:59,44aefffaad067886d266999cd17cf852b2a7e0b9,Bram Moolenaar,7,0,7,3,"{""src/testdir/test_vim9_expr.vim"": {""insertions"": 2, ""deletions"": 0, ""lines"": 2}, ""src/version.c"": {""insertions"": 2, ""deletions"": 0, ""lines"": 2}, ""src/vim9compile.c"": {""insertions"": 3, ""deletions"": 0, ""lines"": 3}}"
2020-10-04 17:56:39,55b419b871dd35f5b05dd2aed65f14461b493ba9,Bram Moolenaar,27,2,29,3,"{""src/ex_cmds.c"": {""insertions"": 5, ""deletions"": 2, ""lines"": 7}, ""src/testdir/test_undo.vim"": {""insertions"": 20, ""deletions"": 0, ""lines"": 20}, ""src/version.c"": {""insertions"": 2, ""deletions"": 0, ""lines"": 2}}"
2020-10-04 15:24:29,dda749ce85cc07000faa86bfd2ceaecd8e4805fc,Bram Moolenaar,3,1,4,2,"{""src/version.c"": {""insertions"": 2, ""deletions"": 0, ""lines"": 2}, ""src/vim9compile.c"": {""insertions"": 1, ""deletions"": 1, ""lines"": 2}}"
2020-10-04 14:16:54,d1ad99b65470d3e754f6a0588a6b0dc2214a1eab,Bram Moolenaar,122,24,146,8,"{""src/testdir/test_gf.vim"": {""insertions"": 15, ""deletions"": 0, ""lines"": 15}, ""src/testdir/test_goto.vim"": {""insertions"": 18, ""deletions"": 0, ""lines"": 18}, ""src/testdir/test_normal.vim"": {""insertions"": 40, ""deletions"": 1, ""lines"": 41}, ""src/testdir/test_registers.vim"": {""insertions"": 3, ""deletions"": 0, ""lines"": 3}, ""src/testdir/test_startup.vim"": {""insertions"": 0, ""deletions"": 2, ""lines"": 2}, ""src/testdir/test_tabpage.vim"": {""insertions"": 10, ""deletions"": 6, ""lines"": 16}, ""src/testdir/test_visual.vim"": {""insertions"": 34, ""deletions"": 15, ""lines"": 49}, ""src/version.c"": {""insertions"": 2, ""deletions"": 0, ""lines"": 2}}"
2020-10-04 14:06:05,1310660557470a669cc64b359e20666b116e5dbd,Bram Moolenaar,216,37,253,10,"{""runtime/doc/vim9.txt"": {""insertions"": 30, ""deletions"": 15, ""lines"": 45}, ""src/eval.c"": {""insertions"": 9, ""deletions"": 6, ""lines"": 15}, ""src/testdir/test_expr.vim"": {""insertions"": 10, ""deletions"": 0, ""lines"": 10}, ""src/testdir/test_vim9_cmd.vim"": {""insertions"": 68, ""deletions"": 0, ""lines"": 68}, ""src/testdir/test_vim9_expr.vim"": {""insertions"": 38, ""deletions"": 11, ""lines"": 49}, ""src/testdir/test_vim9_script.vim"": {""insertions"": 1, ""deletions"": 1, ""lines"": 2}, ""src/testdir/vim9.vim"": {""insertions"": 7, ""deletions"": 0, ""lines"": 7}, ""src/version.c"": {""insertions"": 2, ""deletions"": 0, ""lines"": 2}, ""src/vim9compile.c"": {""insertions"": 49, ""deletions"": 3, ""lines"": 52}, ""src/vim9execute.c"": {""insertions"": 2, ""deletions"": 1, ""lines"": 3}}"
2020-10-04 12:17:32,6abd3dc257cf56a8262db38eb15c7cc754e8e002,Bram Moolenaar,23,0,23,2,"{""src/testdir/test_vim9_func.vim"": {""insertions"": 21, ""deletions"": 0, ""lines"": 21}, ""src/version.c"": {""insertions"": 2, ""deletions"": 0, ""lines"": 2}}"
2020-10-04 11:42:34,7b5d5442696d86daab062592d5c86c829757c352,Bram Moolenaar,36,1,37,3,"{""src/testdir/test_vim9_func.vim"": {""insertions"": 26, ""deletions"": 0, ""lines"": 26}, ""src/userfunc.c"": {""insertions"": 8, ""deletions"": 1, ""lines"": 9}, ""src/version.c"": {""insertions"": 2, ""deletions"": 0, ""lines"": 2}}"
2020-10-03 20:52:39,2bb2658bef9fb25b320f87147261b7154494a86f,Bram Moolenaar,255,217,472,12,"{""runtime/doc/vim9.txt"": {""insertions"": 32, ""deletions"": 28, ""lines"": 60}, ""src/eval.c"": {""insertions"": 43, ""deletions"": 59, ""lines"": 102}, ""src/structs.h"": {""insertions"": 1, ""deletions"": 2, ""lines"": 3}, ""src/testdir/test_vim9_assign.vim"": {""insertions"": 5, ""deletions"": 5, ""lines"": 10}, ""src/testdir/test_vim9_cmd.vim"": {""insertions"": 2, ""deletions"": 2, ""lines"": 4}, ""src/testdir/test_vim9_disassemble.vim"": {""insertions"": 13, ""deletions"": 12, ""lines"": 25}, ""src/testdir/test_vim9_expr.vim"": {""insertions"": 75, ""deletions"": 74, ""lines"": 149}, ""src/version.c"": {""insertions"": 2, ""deletions"": 0, ""lines"": 2}, ""src/vim9.h"": {""insertions"": 6, ""deletions"": 3, ""lines"": 9}, ""src/vim9compile.c"": {""insertions"": 36, ""deletions"": 20, ""lines"": 56}, ""src/vim9execute.c"": {""insertions"": 35, ""deletions"": 5, ""lines"": 40}, ""src/vim9type.c"": {""insertions"": 5, ""deletions"": 7, ""lines"": 12}}"
2020-10-03 18:17:30,92f26c256e06277ff2ec4ce7adea1eb58c85abe0,Bram Moolenaar,257,97,354,8,"{""runtime/doc/eval.txt"": {""insertions"": 43, ""deletions"": 3, ""lines"": 46}, ""src/eval.c"": {""insertions"": 54, ""deletions"": 44, ""lines"": 98}, ""src/testdir/test_expr.vim"": {""insertions"": 22, ""deletions"": 0, ""lines"": 22}, ""src/testdir/test_vim9_disassemble.vim"": {""insertions"": 27, ""deletions"": 0, ""lines"": 27}, ""src/testdir/test_vim9_expr.vim"": {""insertions"": 31, ""deletions"": 3, ""lines"": 34}, ""src/version.c"": {""insertions"": 2, ""deletions"": 0, ""lines"": 2}, ""src/vim9compile.c"": {""insertions"": 74, ""deletions"": 47, ""lines"": 121}, ""src/vim9type.c"": {""insertions"": 4, ""deletions"": 0, ""lines"": 4}}"
2020-10-03 15:04:37,c8fe645c198e2ca55c4e3446efbbdb9b995c63ce,Bram Moolenaar,45,10,55,3,"{""src/fileio.c"": {""insertions"": 18, ""deletions"": 10, ""lines"": 28}, ""src/testdir/test_edit.vim"": {""insertions"": 25, ""deletions"": 0, ""lines"": 25}, ""src/version.c"": {""insertions"": 2, ""deletions"": 0, ""lines"": 2}}"
2020-10-03 12:24:19,588d241d44fc25ad4c5a635ee4fdeafdfcee0fde,Bram Moolenaar,8,0,8,3,"{""src/auto/configure"": {""insertions"": 3, ""deletions"": 0, ""lines"": 3}, ""src/configure.ac"": {""insertions"": 3, ""deletions"": 0, ""lines"": 3}, ""src/version.c"": {""insertions"": 2, ""deletions"": 0, ""lines"": 2}}"
2020-10-03 12:14:56,1bdae4032359081325578cc74739a0a097e008ff,Bram Moolenaar,3,1,4,2,"{""src/testdir/test_debugger.vim"": {""insertions"": 1, ""deletions"": 1, ""lines"": 2}, ""src/version.c"": {""insertions"": 2, ""deletions"": 0, ""lines"": 2}}"
2020-10-03 11:57:13,794771cfd83af2a0d1926bed301e784447e7290b,Bram Moolenaar,6,4,10,2,"{""src/if_python3.c"": {""insertions"": 4, ""deletions"": 4, ""lines"": 8}, ""src/version.c"": {""insertions"": 2, ""deletions"": 0, ""lines"": 2}}"
2020-10-03 11:41:53,c1f0066b642fb62e37b300033223ff3ee4aafcd6,Bram Moolenaar,18,1,19,4,"{""src/errors.h"": {""insertions"": 2, ""deletions"": 0, ""lines"": 2}, ""src/testdir/test_vim9_expr.vim"": {""insertions"": 10, ""deletions"": 0, ""lines"": 10}, ""src/version.c"": {""insertions"": 2, ""deletions"": 0, ""lines"": 2}, ""src/vim9compile.c"": {""insertions"": 4, ""deletions"": 1, ""lines"": 5}}"
2020-10-03 10:57:27,016faaa1b2fe242022725b29e1353c42105d045c,Bram Moolenaar,7,5,12,3,"{""src/evalvars.c"": {""insertions"": 5, ""deletions"": 2, ""lines"": 7}, ""src/testdir/runtest.vim"": {""insertions"": 0, ""deletions"": 3, ""lines"": 3}, ""src/version.c"": {""insertions"": 2, ""deletions"": 0, ""lines"": 2}}"
2020-10-02 18:36:01,795aaa1e84d76a6fe066694de9876b8a21cbe40c,Bram Moolenaar,31,1,32,3,"{""src/search.c"": {""insertions"": 15, ""deletions"": 1, ""lines"": 16}, ""src/testdir/test_search.vim"": {""insertions"": 14, ""deletions"": 0, ""lines"": 14}, ""src/version.c"": {""insertions"": 2, ""deletions"": 0, ""lines"": 2}}"
2020-10-02 16:48:07,8a9bc95eaec53f4e0c951ff8f2686ae5113a5709,Bram Moolenaar,208,30,238,7,"{""src/testdir/test_normal.vim"": {""insertions"": 149, ""deletions"": 19, ""lines"": 168}, ""src/testdir/test_regexp_utf8.vim"": {""insertions"": 2, ""deletions"": 2, ""lines"": 4}, ""src/testdir/test_registers.vim"": {""insertions"": 6, ""deletions"": 0, ""lines"": 6}, ""src/testdir/test_spellfile.vim"": {""insertions"": 12, ""deletions"": 0, ""lines"": 12}, ""src/testdir/test_tagjump.vim"": {""insertions"": 12, ""deletions"": 1, ""lines"": 13}, ""src/testdir/test_visual.vim"": {""insertions"": 25, ""deletions"": 8, ""lines"": 33}, ""src/version.c"": {""insertions"": 2, ""deletions"": 0, ""lines"": 2}}"
2020-10-02 16:11:56,3f974ff45e0ea4b85fea7d8768f005d8a2c7941e,Bram Moolenaar,5,2,7,2,"{""src/dict.c"": {""insertions"": 3, ""deletions"": 2, ""lines"": 5}, ""src/version.c"": {""insertions"": 2, ""deletions"": 0, ""lines"": 2}}"
2020-10-02 08:29:45,fa79be6b10e1d34fd697a56e85f6c0ce101f3d62,Bram Moolenaar,73,0,73,2,"{"".github/workflows/codeql-analysis.yml"": {""insertions"": 71, ""deletions"": 0, ""lines"": 71}, ""src/version.c"": {""insertions"": 2, ""deletions"": 0, ""lines"": 2}}"
2020-10-01 20:37:40,bdf931c25b4fe78877106ca529baee7899d0f6a4,Bram Moolenaar,16,4,20,5,"{""src/autocmd.c"": {""insertions"": 7, ""deletions"": 3, ""lines"": 10}, ""src/proto/window.pro"": {""insertions"": 1, ""deletions"": 0, ""lines"": 1}, ""src/testdir/runtest.vim"": {""insertions"": 5, ""deletions"": 0, ""lines"": 5}, ""src/version.c"": {""insertions"": 2, ""deletions"": 0, ""lines"": 2}, ""src/window.c"": {""insertions"": 1, ""deletions"": 1, ""lines"": 2}}"
2020-10-01 19:37:21,74273e66914e46eb5814c13a1b888e45358859b6,Bram Moolenaar,11,1,12,3,"{""src/map.c"": {""insertions"": 1, ""deletions"": 1, ""lines"": 2}, ""src/testdir/test_vim9_func.vim"": {""insertions"": 8, ""deletions"": 0, ""lines"": 8}, ""src/version.c"": {""insertions"": 2, ""deletions"": 0, ""lines"": 2}}"
2020-10-01 18:03:04,4537bcc88956f86267c25edf8008e0dbde598652,Bram Moolenaar,36,1,37,3,"{""src/autocmd.c"": {""insertions"": 1, ""deletions"": 1, ""lines"": 2}, ""src/testdir/test_prompt_buffer.vim"": {""insertions"": 33, ""deletions"": 0, ""lines"": 33}, ""src/version.c"": {""insertions"": 2, ""deletions"": 0, ""lines"": 2}}"
2020-10-01 17:06:35,668008be66326ed9e5b1122abede34ed3d2de2d8,Bram Moolenaar,22,5,27,3,"{""src/testdir/test_statusline.vim"": {""insertions"": 17, ""deletions"": 0, ""lines"": 17}, ""src/version.c"": {""insertions"": 2, ""deletions"": 0, ""lines"": 2}, ""src/window.c"": {""insertions"": 3, ""deletions"": 5, ""lines"": 8}}"
2020-10-01 14:54:07,0022675aa362da0969666e48ced252b57ca1f79e,Bram Moolenaar,4,1,5,3,"{""runtime/filetype.vim"": {""insertions"": 1, ""deletions"": 1, ""lines"": 2}, ""src/testdir/test_filetype.vim"": {""insertions"": 1, ""deletions"": 0, ""lines"": 1}, ""src/version.c"": {""insertions"": 2, ""deletions"": 0, ""lines"": 2}}"
2020-10-01 11:01:34,5366e1aecfff4546df6af86cf98013f23ed5c3bd,Bram Moolenaar,31,6,37,4,"{""src/testdir/test_vim9_func.vim"": {""insertions"": 15, ""deletions"": 0, ""lines"": 15}, ""src/version.c"": {""insertions"": 2, ""deletions"": 0, ""lines"": 2}, ""src/vim9.h"": {""insertions"": 6, ""deletions"": 4, ""lines"": 10}, ""src/vim9execute.c"": {""insertions"": 8, ""deletions"": 2, ""lines"": 10}}"
2020-09-30 20:59:42,55759b522814995af36803823d342d51d68c0b67,Bram Moolenaar,197,194,391,3,"{""src/testdir/test_vim9_assign.vim"": {""insertions"": 195, ""deletions"": 0, ""lines"": 195}, ""src/testdir/test_vim9_script.vim"": {""insertions"": 0, ""deletions"": 194, ""lines"": 194}, ""src/version.c"": {""insertions"": 2, ""deletions"": 0, ""lines"": 2}}"
2020-09-30 20:45:39,17bb4d4607a95e13e913519af106f1bf8b26c178,Bram Moolenaar,13,11,24,2,"{""runtime/defaults.vim"": {""insertions"": 11, ""deletions"": 11, ""lines"": 22}, ""src/version.c"": {""insertions"": 2, ""deletions"": 0, ""lines"": 2}}"
2020-09-29 20:47:03,8ec92c977976d9e9225183e36a80e6b0cdbf1f51,Bram Moolenaar,24,4,28,3,"{""src/quickfix.c"": {""insertions"": 10, ""deletions"": 4, ""lines"": 14}, ""src/testdir/test_quickfix.vim"": {""insertions"": 12, ""deletions"": 0, ""lines"": 12}, ""src/version.c"": {""insertions"": 2, ""deletions"": 0, ""lines"": 2}}"
2020-09-29 20:16:09,32fbc4f247a31e35ade0939542e11aa033a2554f,Bram Moolenaar,7,2,9,2,"{""src/gui_gtk_x11.c"": {""insertions"": 5, ""deletions"": 2, ""lines"": 7}, ""src/version.c"": {""insertions"": 2, ""deletions"": 0, ""lines"": 2}}"
2020-09-29 19:45:41,1b9129809d8269acb8e7c79d8fc99c7976b4f76e,Bram Moolenaar,6,0,6,3,"{""src/map.c"": {""insertions"": 2, ""deletions"": 0, ""lines"": 2}, ""src/testdir/test_maparg.vim"": {""insertions"": 2, ""deletions"": 0, ""lines"": 2}, ""src/version.c"": {""insertions"": 2, ""deletions"": 0, ""lines"": 2}}"
2020-09-29 19:23:25,f43e7ac4eee22dbb26fc069ec9a3d1598ec8dfe9,Bram Moolenaar,22,2,24,3,"{""src/terminal.c"": {""insertions"": 3, ""deletions"": 2, ""lines"": 5}, ""src/testdir/test_terminal.vim"": {""insertions"": 17, ""deletions"": 0, ""lines"": 17}, ""src/version.c"": {""insertions"": 2, ""deletions"": 0, ""lines"": 2}}"
2020-09-29 18:59:17,391c36279415d0b8c5dba1ba11b668add04be963,Bram Moolenaar,15,3,18,5,"{""runtime/doc/eval.txt"": {""insertions"": 3, ""deletions"": 1, ""lines"": 4}, ""src/evalfunc.c"": {""insertions"": 3, ""deletions"": 1, ""lines"": 4}, ""src/highlight.c"": {""insertions"": 6, ""deletions"": 1, ""lines"": 7}, ""src/testdir/test_highlight.vim"": {""insertions"": 1, ""deletions"": 0, ""lines"": 1}, ""src/version.c"": {""insertions"": 2, ""deletions"": 0, ""lines"": 2}}"
2020-09-28 21:13:15,d569a9e74684cd17f9cea63e804281388728e513,Bram Moolenaar,26,1,27,3,"{""src/spell.c"": {""insertions"": 1, ""deletions"": 1, ""lines"": 2}, ""src/testdir/test_spell.vim"": {""insertions"": 23, ""deletions"": 0, ""lines"": 23}, ""src/version.c"": {""insertions"": 2, ""deletions"": 0, ""lines"": 2}}"
2020-09-28 20:29:58,4934ad0e448bfa03ba19c7c5b411c457a9910442,Bram Moolenaar,27,31,58,9,"{""runtime/doc/popup.txt"": {""insertions"": 6, ""deletions"": 1, ""lines"": 7}, ""src/evalfunc.c"": {""insertions"": 4, ""deletions"": 4, ""lines"": 8}, ""src/ex_docmd.c"": {""insertions"": 0, ""deletions"": 4, ""lines"": 4}, ""src/getchar.c"": {""insertions"": 3, ""deletions"": 4, ""lines"": 7}, ""src/globals.h"": {""insertions"": 3, ""deletions"": 6, ""lines"": 9}, ""src/menu.c"": {""insertions"": 0, ""deletions"": 4, ""lines"": 4}, ""src/testdir/dumps/Test_popupwin_normal_cmd.dump"": {""insertions"": 5, ""deletions"": 5, ""lines"": 10}, ""src/testdir/test_popupwin.vim"": {""insertions"": 4, ""deletions"": 3, ""lines"": 7}, ""src/version.c"": {""insertions"": 2, ""deletions"": 0, ""lines"": 2}}"
2020-09-28 19:48:16,d58a3bf7dac8d53faf42e13cc1152b110f12c404,Bram Moolenaar,218,73,291,16,"{""runtime/compiler/shellcheck.vim"": {""insertions"": 25, ""deletions"": 0, ""lines"": 25}, ""runtime/doc/autocmd.txt"": {""insertions"": 2, ""deletions"": 2, ""lines"": 4}, ""runtime/doc/eval.txt"": {""insertions"": 2, ""deletions"": 2, ""lines"": 4}, ""runtime/doc/filetype.txt"": {""insertions"": 8, ""deletions"": 1, ""lines"": 9}, ""runtime/doc/gui.txt"": {""insertions"": 26, ""deletions"": 18, ""lines"": 44}, ""runtime/doc/popup.txt"": {""insertions"": 2, ""deletions"": 2, ""lines"": 4}, ""runtime/doc/starting.txt"": {""insertions"": 3, ""deletions"": 1, ""lines"": 4}, ""runtime/doc/tags"": {""insertions"": 4, ""deletions"": 0, ""lines"": 4}, ""runtime/doc/todo.txt"": {""insertions"": 22, ""deletions"": 9, ""lines"": 31}, ""runtime/doc/vim9.txt"": {""insertions"": 29, ""deletions"": 0, ""lines"": 29}, ""runtime/filetype.vim"": {""insertions"": 2, ""deletions"": 2, ""lines"": 4}, ""runtime/ftplugin/awk.vim"": {""insertions"": 39, ""deletions"": 2, ""lines"": 41}, ""runtime/indent/vim.vim"": {""insertions"": 4, ""deletions"": 4, ""lines"": 8}, ""runtime/syntax/man.vim"": {""insertions"": 3, ""deletions"": 3, ""lines"": 6}, ""runtime/syntax/sh.vim"": {""insertions"": 34, ""deletions"": 18, ""lines"": 52}, ""runtime/syntax/vim.vim"": {""insertions"": 13, ""deletions"": 9, ""lines"": 22}}"
2020-09-28 19:41:49,b45cd36bd90f71e4a35b1ef1f75a3bedef6d8bac,Bram Moolenaar,21,1,22,3,"{""runtime/menu.vim"": {""insertions"": 16, ""deletions"": 1, ""lines"": 17}, ""src/testdir/test_gui.vim"": {""insertions"": 3, ""deletions"": 0, ""lines"": 3}, ""src/version.c"": {""insertions"": 2, ""deletions"": 0, ""lines"": 2}}"
2020-09-27 21:33:59,727345ebea07284ada118590d805329e6dbee014,Bram Moolenaar,3,1,4,2,"{""src/testdir/test_vim9_func.vim"": {""insertions"": 1, ""deletions"": 1, ""lines"": 2}, ""src/version.c"": {""insertions"": 2, ""deletions"": 0, ""lines"": 2}}"
2020-09-27 20:47:05,7a9cbca00a8ec53306f8a5852e332feb79091793,Bram Moolenaar,177,187,364,11,"{""src/testdir/runtest.vim"": {""insertions"": 3, ""deletions"": 0, ""lines"": 3}, ""src/testdir/test_maparg.vim"": {""insertions"": 4, ""deletions"": 4, ""lines"": 8}, ""src/testdir/test_popupwin.vim"": {""insertions"": 1, ""deletions"": 1, ""lines"": 2}, ""src/testdir/test_textprop.vim"": {""insertions"": 2, ""deletions"": 2, ""lines"": 4}, ""src/testdir/test_vim9_assign.vim"": {""insertions"": 0, ""deletions"": 3, ""lines"": 3}, ""src/testdir/test_vim9_cmd.vim"": {""insertions"": 0, ""deletions"": 3, ""lines"": 3}, ""src/testdir/test_vim9_disassemble.vim"": {""insertions"": 0, ""deletions"": 3, ""lines"": 3}, ""src/testdir/test_vim9_expr.vim"": {""insertions"": 0, ""deletions"": 3, ""lines"": 3}, ""src/testdir/test_vim9_func.vim"": {""insertions"": 165, ""deletions"": 165, ""lines"": 330}, ""src/testdir/test_vim9_script.vim"": {""insertions"": 0, ""deletions"": 3, ""lines"": 3}, ""src/version.c"": {""insertions"": 2, ""deletions"": 0, ""lines"": 2}}"
2020-09-27 19:58:45,9830938e77b0d36d65b0c31eadf09f7b9d394c29,Bram Moolenaar,76,74,150,3,"{""src/testdir/test_vim9_assign.vim"": {""insertions"": 27, ""deletions"": 27, ""lines"": 54}, ""src/testdir/test_vim9_expr.vim"": {""insertions"": 47, ""deletions"": 47, ""lines"": 94}, ""src/version.c"": {""insertions"": 2, ""deletions"": 0, ""lines"": 2}}"
2020-09-27 19:27:40,06f9c6940a88d132c85eb2a1b5034fa7653518ce,Bram Moolenaar,13,1,14,3,"{""src/testdir/test_vim9_assign.vim"": {""insertions"": 10, ""deletions"": 0, ""lines"": 10}, ""src/version.c"": {""insertions"": 2, ""deletions"": 0, ""lines"": 2}, ""src/vim9compile.c"": {""insertions"": 1, ""deletions"": 1, ""lines"": 2}}"
2020-09-27 19:16:45,6c542f77eba73a95447f285149b3fcb011aa9675,Bram Moolenaar,21,15,36,3,"{""src/popupwin.c"": {""insertions"": 3, ""deletions"": 3, ""lines"": 6}, ""src/testdir/test_popupwin.vim"": {""insertions"": 16, ""deletions"": 12, ""lines"": 28}, ""src/version.c"": {""insertions"": 2, ""deletions"": 0, ""lines"": 2}}"
2020-09-27 18:13:03,d0e1b7103c14eb0d175c6b245b4b6ed93a204da9,Bram Moolenaar,39,0,39,4,"{""src/edit.c"": {""insertions"": 3, ""deletions"": 0, ""lines"": 3}, ""src/testdir/dumps/Test_pum_stopped_by_timer.dump"": {""insertions"": 12, ""deletions"": 0, ""lines"": 12}, ""src/testdir/test_ins_complete.vim"": {""insertions"": 22, ""deletions"": 0, ""lines"": 22}, ""src/version.c"": {""insertions"": 2, ""deletions"": 0, ""lines"": 2}}"
2020-09-27 17:05:33,ac564082f118ccdca828980c5f10b65a40bffb4d,Bram Moolenaar,209,198,407,4,"{""src/testdir/test_vim9_assign.vim"": {""insertions"": 3, ""deletions"": 0, ""lines"": 3}, ""src/testdir/test_vim9_cmd.vim"": {""insertions"": 28, ""deletions"": 25, ""lines"": 53}, ""src/testdir/test_vim9_disassemble.vim"": {""insertions"": 176, ""deletions"": 173, ""lines"": 349}, ""src/version.c"": {""insertions"": 2, ""deletions"": 0, ""lines"": 2}}"
2020-09-27 16:24:03,2914a20abc78d4ace94d48d6e6ab9f0da894dd7e,Bram Moolenaar,19,1,20,3,"{""src/testdir/test_vim9_assign.vim"": {""insertions"": 16, ""deletions"": 0, ""lines"": 16}, ""src/version.c"": {""insertions"": 2, ""deletions"": 0, ""lines"": 2}, ""src/vim9compile.c"": {""insertions"": 1, ""deletions"": 1, ""lines"": 2}}"
2020-09-27 15:57:43,37ce6d3a6ab7c7864de6788feb67377e8bbffa63,Bram Moolenaar,375,371,746,2,"{""src/testdir/test_vim9_expr.vim"": {""insertions"": 373, ""deletions"": 371, ""lines"": 744}, ""src/version.c"": {""insertions"": 2, ""deletions"": 0, ""lines"": 2}}"
2020-09-27 15:45:03,5597ba046790e5ffd76dfc327d7898c56df65d3f,Bram Moolenaar,13,5,18,3,"{""src/testdir/test_vim9_expr.vim"": {""insertions"": 4, ""deletions"": 0, ""lines"": 4}, ""src/version.c"": {""insertions"": 2, ""deletions"": 0, ""lines"": 2}, ""src/vim9type.c"": {""insertions"": 7, ""deletions"": 5, ""lines"": 12}}"
2020-09-27 14:03:15,a5fe91e6dc610bc823bc3201e2c88179989b13fb,Bram Moolenaar,30,2,32,3,"{""src/os_mac_conv.c"": {""insertions"": 7, ""deletions"": 2, ""lines"": 9}, ""src/testdir/test_environ.vim"": {""insertions"": 21, ""deletions"": 0, ""lines"": 21}, ""src/version.c"": {""insertions"": 2, ""deletions"": 0, ""lines"": 2}}"
2020-09-27 13:19:27,cfcd011fcd8021da52fba62dabf7a2497f1879b7,Bram Moolenaar,240,213,453,7,"{""src/errors.h"": {""insertions"": 2, ""deletions"": 0, ""lines"": 2}, ""src/evalvars.c"": {""insertions"": 7, ""deletions"": 0, ""lines"": 7}, ""src/testdir/test_vim9_script.vim"": {""insertions"": 213, ""deletions"": 205, ""lines"": 418}, ""src/userfunc.c"": {""insertions"": 8, ""deletions"": 7, ""lines"": 15}, ""src/version.c"": {""insertions"": 2, ""deletions"": 0, ""lines"": 2}, ""src/vim.h"": {""insertions"": 2, ""deletions"": 1, ""lines"": 3}, ""src/vim9compile.c"": {""insertions"": 6, ""deletions"": 0, ""lines"": 6}}"
2020-09-27 12:22:48,c0e29010f68a0ebe439f9bd78493799c60b7bfd3,Bram Moolenaar,17,2,19,4,"{""src/evalvars.c"": {""insertions"": 3, ""deletions"": 2, ""lines"": 5}, ""src/testdir/test_vim9_assign.vim"": {""insertions"": 10, ""deletions"": 0, ""lines"": 10}, ""src/version.c"": {""insertions"": 2, ""deletions"": 0, ""lines"": 2}, ""src/vim9compile.c"": {""insertions"": 2, ""deletions"": 0, ""lines"": 2}}"
2020-09-27 11:58:38,8c7ad3631af570f68b2da2658cf966a9a19cb6c4,Bram Moolenaar,39,0,39,2,"{""src/testdir/test_spell.vim"": {""insertions"": 37, ""deletions"": 0, ""lines"": 37}, ""src/version.c"": {""insertions"": 2, ""deletions"": 0, ""lines"": 2}}"
2020-09-27 11:51:14,f6a44f714a383a69db05cb47e26abffd966cd6a5,Bram Moolenaar,7,0,7,2,"{""src/evalvars.c"": {""insertions"": 5, ""deletions"": 0, ""lines"": 5}, ""src/version.c"": {""insertions"": 2, ""deletions"": 0, ""lines"": 2}}"
2020-09-27 11:16:46,daff0fb73851ef368ede180dbb3b772e55304ba7,Bram Moolenaar,22,6,28,5,"{""src/gui_w32.c"": {""insertions"": 1, ""deletions"": 2, ""lines"": 3}, ""src/gui_x11.c"": {""insertions"": 1, ""deletions"": 2, ""lines"": 3}, ""src/misc2.c"": {""insertions"": 4, ""deletions"": 2, ""lines"": 6}, ""src/testdir/test_termcodes.vim"": {""insertions"": 14, ""deletions"": 0, ""lines"": 14}, ""src/version.c"": {""insertions"": 2, ""deletions"": 0, ""lines"": 2}}"
2020-09-26 20:39:24,bade44e5cad1b08c85d4a8ba08d94a30458dddfb,Bram Moolenaar,10,5,15,5,"{""src/evalfunc.c"": {""insertions"": 2, ""deletions"": 2, ""lines"": 4}, ""src/testdir/test_search.vim"": {""insertions"": 3, ""deletions"": 0, ""lines"": 3}, ""src/testdir/test_terminal2.vim"": {""insertions"": 2, ""deletions"": 2, ""lines"": 4}, ""src/typval.c"": {""insertions"": 1, ""deletions"": 1, ""lines"": 2}, ""src/version.c"": {""insertions"": 2, ""deletions"": 0, ""lines"": 2}}"
2020-09-26 20:03:00,3697c9bbae755831d3cf2f11179aaff29e343f51,Bram Moolenaar,102,24,126,8,"{""src/move.c"": {""insertions"": 4, ""deletions"": 0, ""lines"": 4}, ""src/popupwin.c"": {""insertions"": 32, ""deletions"": 21, ""lines"": 53}, ""src/proto/popupwin.pro"": {""insertions"": 1, ""deletions"": 0, ""lines"": 1}, ""src/testdir/dumps/Test_popupwin_set_firstline_1.dump"": {""insertions"": 16, ""deletions"": 0, ""lines"": 16}, ""src/testdir/dumps/Test_popupwin_set_firstline_2.dump"": {""insertions"": 16, ""deletions"": 0, ""lines"": 16}, ""src/testdir/dumps/Test_popupwin_win_execute_cursorline.dump"": {""insertions"": 3, ""deletions"": 3, ""lines"": 6}, ""src/testdir/test_popupwin.vim"": {""insertions"": 28, ""deletions"": 0, ""lines"": 28}, ""src/version.c"": {""insertions"": 2, ""deletions"": 0, ""lines"": 2}}"
2020-09-26 17:59:38,c70bdab0b8a8262a3784084aa1e6271fee8452f1,Bram Moolenaar,25,6,31,3,"{""src/testdir/test_vim9_func.vim"": {""insertions"": 14, ""deletions"": 0, ""lines"": 14}, ""src/version.c"": {""insertions"": 2, ""deletions"": 0, ""lines"": 2}, ""src/vim9execute.c"": {""insertions"": 9, ""deletions"": 6, ""lines"": 15}}"
2020-09-26 17:11:39,f3c51bbff1256a52bdd9ede7887f40062be2628c,Bram Moolenaar,24,5,29,3,"{""src/testdir/test_winbuf_close.vim"": {""insertions"": 17, ""deletions"": 1, ""lines"": 18}, ""src/version.c"": {""insertions"": 2, ""deletions"": 0, ""lines"": 2}, ""src/window.c"": {""insertions"": 5, ""deletions"": 4, ""lines"": 9}}"
2020-09-26 16:47:11,8f187fc6304222956f94a700758a490cc8c0af99,Bram Moolenaar,26,2,28,3,"{""src/evalfunc.c"": {""insertions"": 9, ""deletions"": 0, ""lines"": 9}, ""src/testdir/test_ins_complete.vim"": {""insertions"": 15, ""deletions"": 2, ""lines"": 17}, ""src/version.c"": {""insertions"": 2, ""deletions"": 0, ""lines"": 2}}"
2020-09-26 15:20:53,373863ed48c02b5df52574aa7d50aeecb1037d40,Bram Moolenaar,12,5,17,4,"{""src/ex_docmd.c"": {""insertions"": 4, ""deletions"": 0, ""lines"": 4}, ""src/testdir/test_trycatch.vim"": {""insertions"": 4, ""deletions"": 3, ""lines"": 7}, ""src/testdir/test_vim9_script.vim"": {""insertions"": 2, ""deletions"": 2, ""lines"": 4}, ""src/version.c"": {""insertions"": 2, ""deletions"": 0, ""lines"": 2}}"
2020-09-26 13:20:42,d47f50b3312af2b8baf37505b7a589daf3f7d942,Bram Moolenaar,3,0,3,2,"{""src/ex_docmd.c"": {""insertions"": 1, ""deletions"": 0, ""lines"": 1}, ""src/version.c"": {""insertions"": 2, ""deletions"": 0, ""lines"": 2}}"
2020-09-26 13:09:30,30fd8204cecb317d842b964d624d492088d6d15f,Bram Moolenaar,515,385,900,16,"{""runtime/doc/vim9.txt"": {""insertions"": 187, ""deletions"": 128, ""lines"": 315}, ""src/cmdexpand.c"": {""insertions"": 2, ""deletions"": 0, ""lines"": 2}, ""src/errors.h"": {""insertions"": 4, ""deletions"": 0, ""lines"": 4}, ""src/eval.c"": {""insertions"": 11, ""deletions"": 11, ""lines"": 22}, ""src/evalvars.c"": {""insertions"": 50, ""deletions"": 20, ""lines"": 70}, ""src/ex_cmdidxs.h"": {""insertions"": 23, ""deletions"": 23, ""lines"": 46}, ""src/ex_cmds.h"": {""insertions"": 6, ""deletions"": 0, ""lines"": 6}, ""src/ex_docmd.c"": {""insertions"": 6, ""deletions"": 4, ""lines"": 10}, ""src/proto/evalvars.pro"": {""insertions"": 1, ""deletions"": 0, ""lines"": 1}, ""src/testdir/test_vim9_assign.vim"": {""insertions"": 171, ""deletions"": 170, ""lines"": 341}, ""src/testdir/test_vim9_script.vim"": {""insertions"": 20, ""deletions"": 14, ""lines"": 34}, ""src/version.c"": {""insertions"": 2, ""deletions"": 0, ""lines"": 2}, ""src/vim.h"": {""insertions"": 3, ""deletions"": 3, ""lines"": 6}, ""src/vim9compile.c"": {""insertions"": 21, ""deletions"": 9, ""lines"": 30}, ""src/vim9execute.c"": {""insertions"": 1, ""deletions"": 1, ""lines"": 2}, ""src/vim9script.c"": {""insertions"": 7, ""deletions"": 2, ""lines"": 9}}"
2020-09-25 21:49:01,273af497cac345897cf6369baa87a070876a5815,Bram Moolenaar,65,63,128,2,"{""src/filepath.c"": {""insertions"": 63, ""deletions"": 63, ""lines"": 126}, ""src/version.c"": {""insertions"": 2, ""deletions"": 0, ""lines"": 2}}"
2020-09-25 21:12:51,7e9210ea5320e0c3fd9fd93e3f3f1a59e029cf46,Bram Moolenaar,8,1,9,2,"{""src/testdir/test_vim9_script.vim"": {""insertions"": 6, ""deletions"": 1, ""lines"": 7}, ""src/version.c"": {""insertions"": 2, ""deletions"": 0, ""lines"": 2}}"
2020-09-25 20:42:48,6a33ef0deb5c75c003a9f3bd1c57f3ca5e77327e,Bram Moolenaar,103,48,151,6,"{""runtime/doc/eval.txt"": {""insertions"": 8, ""deletions"": 4, ""lines"": 12}, ""src/evalfunc.c"": {""insertions"": 1, ""deletions"": 1, ""lines"": 2}, ""src/filepath.c"": {""insertions"": 73, ""deletions"": 42, ""lines"": 115}, ""src/proto/filepath.pro"": {""insertions"": 1, ""deletions"": 1, ""lines"": 2}, ""src/testdir/test_functions.vim"": {""insertions"": 18, ""deletions"": 0, ""lines"": 18}, ""src/version.c"": {""insertions"": 2, ""deletions"": 0, ""lines"": 2}}"
2020-09-25 20:13:05,58dbef330c42511f9d7d3b3990c73387041f3f3f,Bram Moolenaar,4,0,4,2,"{""src/testdir/test_vim9_script.vim"": {""insertions"": 2, ""deletions"": 0, ""lines"": 2}, ""src/version.c"": {""insertions"": 2, ""deletions"": 0, ""lines"": 2}}"
2020-09-25 19:47:28,9c4f55204fdf8909f4e3515a32a542044bf9f943,Bram Moolenaar,29,3,32,3,"{""src/testdir/test_vim9_script.vim"": {""insertions"": 23, ""deletions"": 2, ""lines"": 25}, ""src/version.c"": {""insertions"": 2, ""deletions"": 0, ""lines"": 2}, ""src/vim9compile.c"": {""insertions"": 4, ""deletions"": 1, ""lines"": 5}}"
2020-09-24 21:08:19,509f8031b2b347c033327ef33f3e5573a0595dbc,Bram Moolenaar,6,0,6,2,"{""src/os_mac_conv.c"": {""insertions"": 4, ""deletions"": 0, ""lines"": 4}, ""src/version.c"": {""insertions"": 2, ""deletions"": 0, ""lines"": 2}}"
2020-09-24 20:57:31,10476521f51d5902d191f2189307781fc48a3a16,Bram Moolenaar,50,4,54,4,"{""src/popupwin.c"": {""insertions"": 5, ""deletions"": 0, ""lines"": 5}, ""src/testdir/dumps/Test_popupwin_win_execute_cursorline.dump"": {""insertions"": 14, ""deletions"": 0, ""lines"": 14}, ""src/testdir/test_popupwin.vim"": {""insertions"": 29, ""deletions"": 4, ""lines"": 33}, ""src/version.c"": {""insertions"": 2, ""deletions"": 0, ""lines"": 2}}"
2020-09-23 20:38:05,531be47ac5522807b265c6287021a01c9b895ac9,Bram Moolenaar,47,1,48,18,"{""src/testdir/gen_opt_test.vim"": {""insertions"": 1, ""deletions"": 1, ""lines"": 2}, ""src/testdir/test_arglist.vim"": {""insertions"": 1, ""deletions"": 0, ""lines"": 1}, ""src/testdir/test_autocmd.vim"": {""insertions"": 1, ""deletions"": 0, ""lines"": 1}, ""src/testdir/test_buffer.vim"": {""insertions"": 1, ""deletions"": 0, ""lines"": 1}, ""src/testdir/test_checkpath.vim"": {""insertions"": 15, ""deletions"": 0, ""lines"": 15}, ""src/testdir/test_cmdline.vim"": {""insertions"": 2, ""deletions"": 0, ""lines"": 2}, ""src/testdir/test_debugger.vim"": {""insertions"": 1, ""deletions"": 0, ""lines"": 1}, ""src/testdir/test_functions.vim"": {""insertions"": 1, ""deletions"": 0, ""lines"": 1}, ""src/testdir/test_history.vim"": {""insertions"": 1, ""deletions"": 0, ""lines"": 1}, ""src/testdir/test_listdict.vim"": {""insertions"": 1, ""deletions"": 0, ""lines"": 1}, ""src/testdir/test_options.vim"": {""insertions"": 1, ""deletions"": 0, ""lines"": 1}, ""src/testdir/test_search_stat.vim"": {""insertions"": 8, ""deletions"": 0, ""lines"": 8}, ""src/testdir/test_sort.vim"": {""insertions"": 1, ""deletions"": 0, ""lines"": 1}, ""src/testdir/test_substitute.vim"": {""insertions"": 1, ""deletions"": 0, ""lines"": 1}, ""src/testdir/test_syntax.vim"": {""insertions"": 2, ""deletions"": 0, ""lines"": 2}, ""src/testdir/test_tagjump.vim"": {""insertions"": 4, ""deletions"": 0, ""lines"": 4}, ""src/testdir/test_user_func.vim"": {""insertions"": 3, ""deletions"": 0, ""lines"": 3}, ""src/version.c"": {""insertions"": 2, ""deletions"": 0, ""lines"": 2}}"
2020-09-23 20:27:22,851d108313317a062371a6750e6c6bf370a9bafa,Bram Moolenaar,4,2,6,2,"{"".github/workflows/ci-windows.yaml"": {""insertions"": 2, ""deletions"": 2, ""lines"": 4}, ""src/version.c"": {""insertions"": 2, ""deletions"": 0, ""lines"": 2}}"
2020-09-23 19:57:23,148ce7ae62e92ecf6487a4ba5902ddb7e699074b,Bram Moolenaar,93,64,157,6,"{""src/testdir/test_vim9_disassemble.vim"": {""insertions"": 1, ""deletions"": 1, ""lines"": 2}, ""src/testdir/test_vim9_func.vim"": {""insertions"": 1, ""deletions"": 1, ""lines"": 2}, ""src/version.c"": {""insertions"": 2, ""deletions"": 0, ""lines"": 2}, ""src/vim9.h"": {""insertions"": 1, ""deletions"": 2, ""lines"": 3}, ""src/vim9compile.c"": {""insertions"": 6, ""deletions"": 5, ""lines"": 11}, ""src/vim9execute.c"": {""insertions"": 82, ""deletions"": 55, ""lines"": 137}}"
2020-09-23 16:51:11,4ee711f21389066fa157961feed17692fc16bf8e,Bram Moolenaar,5,0,5,2,"{""src/version.c"": {""insertions"": 2, ""deletions"": 0, ""lines"": 2}, ""src/vim9compile.c"": {""insertions"": 3, ""deletions"": 0, ""lines"": 3}}"
2020-09-23 15:41:26,6bf1b52ba2816dffdbd0d994320abfb1586bf666,Bram Moolenaar,59,4,63,5,"{""src/popupwin.c"": {""insertions"": 20, ""deletions"": 4, ""lines"": 24}, ""src/testdir/dumps/Test_popupwin_win_execute.dump"": {""insertions"": 10, ""deletions"": 0, ""lines"": 10}, ""src/testdir/term_util.vim"": {""insertions"": 3, ""deletions"": 0, ""lines"": 3}, ""src/testdir/test_popupwin.vim"": {""insertions"": 24, ""deletions"": 0, ""lines"": 24}, ""src/version.c"": {""insertions"": 2, ""deletions"": 0, ""lines"": 2}}"
2020-09-23 13:56:50,81ed4960482f8baabdd7f95b4d5e39744be88ae7,Bram Moolenaar,40,4,44,3,"{""src/eval.c"": {""insertions"": 24, ""deletions"": 4, ""lines"": 28}, ""src/testdir/test_vim9_assign.vim"": {""insertions"": 14, ""deletions"": 0, ""lines"": 14}, ""src/version.c"": {""insertions"": 2, ""deletions"": 0, ""lines"": 2}}"
2020-09-23 11:25:32,04bdd573d0a48e789eb92ed2a81e0dd732761391,Bram Moolenaar,32,1,33,3,"{""src/testdir/test_vim9_assign.vim"": {""insertions"": 27, ""deletions"": 0, ""lines"": 27}, ""src/version.c"": {""insertions"": 2, ""deletions"": 0, ""lines"": 2}, ""src/vim9compile.c"": {""insertions"": 3, ""deletions"": 1, ""lines"": 4}}"
2020-09-23 10:29:11,189832bf661168df7ebd428e4088737718775fbd,Bram Moolenaar,53,1,54,8,"{""src/evalfunc.c"": {""insertions"": 6, ""deletions"": 0, ""lines"": 6}, ""src/ex_docmd.c"": {""insertions"": 4, ""deletions"": 0, ""lines"": 4}, ""src/getchar.c"": {""insertions"": 5, ""deletions"": 1, ""lines"": 6}, ""src/globals.h"": {""insertions"": 5, ""deletions"": 0, ""lines"": 5}, ""src/menu.c"": {""insertions"": 4, ""deletions"": 0, ""lines"": 4}, ""src/testdir/dumps/Test_popupwin_normal_cmd.dump"": {""insertions"": 10, ""deletions"": 0, ""lines"": 10}, ""src/testdir/test_popupwin.vim"": {""insertions"": 17, ""deletions"": 0, ""lines"": 17}, ""src/version.c"": {""insertions"": 2, ""deletions"": 0, ""lines"": 2}}"
2020-09-22 20:08:32,c53e9c57a9846655c2d3169788f4beefa6d22d90,Bram Moolenaar,3,1,4,2,"{""src/search.c"": {""insertions"": 1, ""deletions"": 1, ""lines"": 2}, ""src/version.c"": {""insertions"": 2, ""deletions"": 0, ""lines"": 2}}"
2020-09-22 19:55:41,99ca9c4868bb1669706b9e3de9a9218bd11cc459,Bram Moolenaar,89,14,103,7,"{""runtime/doc/eval.txt"": {""insertions"": 13, ""deletions"": 5, ""lines"": 18}, ""src/evalfunc.c"": {""insertions"": 18, ""deletions"": 7, ""lines"": 25}, ""src/evalwindow.c"": {""insertions"": 16, ""deletions"": 0, ""lines"": 16}, ""src/popupwin.c"": {""insertions"": 15, ""deletions"": 2, ""lines"": 17}, ""src/testdir/test_functions.vim"": {""insertions"": 12, ""deletions"": 0, ""lines"": 12}, ""src/testdir/test_popupwin.vim"": {""insertions"": 13, ""deletions"": 0, ""lines"": 13}, ""src/version.c"": {""insertions"": 2, ""deletions"": 0, ""lines"": 2}}"
2020-09-22 18:33:50,4f73b8e9cc83f647b34002554a8bdf9abec0a82f,Bram Moolenaar,629,167,796,9,"{""runtime/doc/eval.txt"": {""insertions"": 48, ""deletions"": 7, ""lines"": 55}, ""runtime/doc/usr_41.txt"": {""insertions"": 1, ""deletions"": 0, ""lines"": 1}, ""src/evalfunc.c"": {""insertions"": 2, ""deletions"": 1, ""lines"": 3}, ""src/proto/search.pro"": {""insertions"": 1, ""deletions"": 0, ""lines"": 1}, ""src/search.c"": {""insertions"": 385, ""deletions"": 135, ""lines"": 520}, ""src/testdir/Make_all.mak"": {""insertions"": 2, ""deletions"": 0, ""lines"": 2}, ""src/testdir/test_functions.vim"": {""insertions"": 0, ""deletions"": 24, ""lines"": 24}, ""src/testdir/test_matchfuzzy.vim"": {""insertions"": 188, ""deletions"": 0, ""lines"": 188}, ""src/version.c"": {""insertions"": 2, ""deletions"": 0, ""lines"": 2}}"
2020-09-22 17:15:31,44aaf5416e0121500dd52b7cab306d7618b4fe53,Bram Moolenaar,8,6,14,3,"{""runtime/filetype.vim"": {""insertions"": 4, ""deletions"": 4, ""lines"": 8}, ""src/testdir/test_filetype.vim"": {""insertions"": 2, ""deletions"": 2, ""lines"": 4}, ""src/version.c"": {""insertions"": 2, ""deletions"": 0, ""lines"": 2}}"
2020-09-21 20:21:42,971caf53b81b7d1b6fb0bdf32990632975d54631,Bram Moolenaar,697,680,1377,6,"{""src/testdir/Make_all.mak"": {""insertions"": 2, ""deletions"": 0, ""lines"": 2}, ""src/testdir/test_vim9_assign.vim"": {""insertions"": 693, ""deletions"": 0, ""lines"": 693}, ""src/testdir/test_vim9_cmd.vim"": {""insertions"": 0, ""deletions"": 34, ""lines"": 34}, ""src/testdir/test_vim9_expr.vim"": {""insertions"": 0, ""deletions"": 12, ""lines"": 12}, ""src/testdir/test_vim9_script.vim"": {""insertions"": 0, ""deletions"": 634, ""lines"": 634}, ""src/version.c"": {""insertions"": 2, ""deletions"": 0, ""lines"": 2}}"
2020-09-21 20:02:49,280227270c1c54794a6d88a305fac56d4b0c92a5,Bram Moolenaar,12,1,13,3,"{""src/testdir/test_vim9_func.vim"": {""insertions"": 9, ""deletions"": 0, ""lines"": 9}, ""src/userfunc.c"": {""insertions"": 1, ""deletions"": 1, ""lines"": 2}, ""src/version.c"": {""insertions"": 2, ""deletions"": 0, ""lines"": 2}}"
2020-09-21 19:48:21,dbd759309b4b6abea96b18d61770e100cf4264b5,Bram Moolenaar,19,1,20,3,"{""src/testdir/test_vim9_expr.vim"": {""insertions"": 12, ""deletions"": 0, ""lines"": 12}, ""src/version.c"": {""insertions"": 2, ""deletions"": 0, ""lines"": 2}, ""src/vim9type.c"": {""insertions"": 5, ""deletions"": 1, ""lines"": 6}}"
2020-09-21 19:29:57,7f9c9c51a3680f120e1c3f2bb7239c9fa115b27f,Bram Moolenaar,3,1,4,2,"{""nsis/lang/russian.nsi"": {""insertions"": 1, ""deletions"": 1, ""lines"": 2}, ""src/version.c"": {""insertions"": 2, ""deletions"": 0, ""lines"": 2}}"
2020-09-21 18:35:55,078269bdce7e75d5693c7313d92a229786bb95ee,Bram Moolenaar,20,7,27,3,"{""src/testdir/test_vim9_script.vim"": {""insertions"": 8, ""deletions"": 0, ""lines"": 8}, ""src/version.c"": {""insertions"": 2, ""deletions"": 0, ""lines"": 2}, ""src/vim9compile.c"": {""insertions"": 10, ""deletions"": 7, ""lines"": 17}}"
2020-09-20 20:43:52,10e4f12bf4cd08328618bbf4e57a15435296e586,Bram Moolenaar,13,0,13,4,"{""src/errors.h"": {""insertions"": 2, ""deletions"": 0, ""lines"": 2}, ""src/testdir/test_vim9_expr.vim"": {""insertions"": 1, ""deletions"": 0, ""lines"": 1}, ""src/version.c"": {""insertions"": 2, ""deletions"": 0, ""lines"": 2}, ""src/vim9compile.c"": {""insertions"": 8, ""deletions"": 0, ""lines"": 8}}"
2020-09-20 20:04:00,b816dae16dbeec91ccb6fd1c0289b86b4ad5d7b3,Bram Moolenaar,14,2,16,3,"{""src/testdir/test_vim9_func.vim"": {""insertions"": 9, ""deletions"": 0, ""lines"": 9}, ""src/userfunc.c"": {""insertions"": 3, ""deletions"": 2, ""lines"": 5}, ""src/version.c"": {""insertions"": 2, ""deletions"": 0, ""lines"": 2}}"
2020-09-20 19:43:03,809fcecddce59ccb59384d63f5e0505c89f69209,Bram Moolenaar,290,0,290,3,"{""nsis/gvim.nsi"": {""insertions"": 1, ""deletions"": 0, ""lines"": 1}, ""nsis/lang/russian.nsi"": {""insertions"": 287, ""deletions"": 0, ""lines"": 287}, ""src/version.c"": {""insertions"": 2, ""deletions"": 0, ""lines"": 2}}"
2020-09-20 19:32:03,b5cfff0b34d1be87f7d0458e4b9addd71c5d5b1d,Bram Moolenaar,19,16,35,2,"{""runtime/optwin.vim"": {""insertions"": 17, ""deletions"": 16, ""lines"": 33}, ""src/version.c"": {""insertions"": 2, ""deletions"": 0, ""lines"": 2}}"
2020-09-20 19:13:27,26cd3063b2e2084cfd17989e7584c64f278aaaef,Bram Moolenaar,4,2,6,2,"{""src/gui_motif.c"": {""insertions"": 2, ""deletions"": 2, ""lines"": 4}, ""src/version.c"": {""insertions"": 2, ""deletions"": 0, ""lines"": 2}}"
2020-09-20 19:04:35,8902b31f1b31c117915defc23ac45cdc1f5c671b,Bram Moolenaar,19,0,19,3,"{""src/testdir/test_textprop.vim"": {""insertions"": 13, ""deletions"": 0, ""lines"": 13}, ""src/textprop.c"": {""insertions"": 4, ""deletions"": 0, ""lines"": 4}, ""src/version.c"": {""insertions"": 2, ""deletions"": 0, ""lines"": 2}}"
2020-09-20 17:57:15,7795bfea6d30c85f2c05d986a0cfe4019df4d74d,Bram Moolenaar,6,0,6,2,"{""src/gui_motif.c"": {""insertions"": 4, ""deletions"": 0, ""lines"": 4}, ""src/version.c"": {""insertions"": 2, ""deletions"": 0, ""lines"": 2}}"
2020-09-19 16:50:13,1d59aa1fdfb191d9872ff87eb94652acd374b293,Bram Moolenaar,557,201,758,19,"{"".github/CODEOWNERS"": {""insertions"": 80, ""deletions"": 20, ""lines"": 100}, ""nsis/lang/italian.nsi"": {""insertions"": 3, ""deletions"": 3, ""lines"": 6}, ""runtime/autoload/netrw.vim"": {""insertions"": 89, ""deletions"": 37, ""lines"": 126}, ""runtime/autoload/netrwFileHandlers.vim"": {""insertions"": 3, ""deletions"": 3, ""lines"": 6}, ""runtime/doc/cmdline.txt"": {""insertions"": 17, ""deletions"": 8, ""lines"": 25}, ""runtime/doc/eval.txt"": {""insertions"": 4, ""deletions"": 2, ""lines"": 6}, ""runtime/doc/insert.txt"": {""insertions"": 3, ""deletions"": 1, ""lines"": 4}, ""runtime/doc/map.txt"": {""insertions"": 2, ""deletions"": 2, ""lines"": 4}, ""runtime/doc/options.txt"": {""insertions"": 7, ""deletions"": 4, ""lines"": 11}, ""runtime/doc/pi_netrw.txt"": {""insertions"": 65, ""deletions"": 15, ""lines"": 80}, ""runtime/doc/popup.txt"": {""insertions"": 7, ""deletions"": 1, ""lines"": 8}, ""runtime/doc/tags"": {""insertions"": 8, ""deletions"": 1, ""lines"": 9}, ""runtime/doc/todo.txt"": {""insertions"": 28, ""deletions"": 31, ""lines"": 59}, ""runtime/doc/version8.txt"": {""insertions"": 2, ""deletions"": 2, ""lines"": 4}, ""runtime/doc/vim9.txt"": {""insertions"": 114, ""deletions"": 39, ""lines"": 153}, ""runtime/indent/erlang.vim"": {""insertions"": 120, ""deletions"": 27, ""lines"": 147}, ""runtime/plugin/netrwPlugin.vim"": {""insertions"": 1, ""deletions"": 1, ""lines"": 2}, ""runtime/syntax/erlang.vim"": {""insertions"": 3, ""deletions"": 3, ""lines"": 6}, ""runtime/syntax/netrw.vim"": {""insertions"": 1, ""deletions"": 1, ""lines"": 2}}"
2020-09-19 16:19:19,a05e524f3aa8eadc2dbd0ad8ff6db9407ac7ac7e,Bram Moolenaar,31,10,41,4,"{""src/proto/userfunc.pro"": {""insertions"": 1, ""deletions"": 0, ""lines"": 1}, ""src/userfunc.c"": {""insertions"": 12, ""deletions"": 5, ""lines"": 17}, ""src/version.c"": {""insertions"": 2, ""deletions"": 0, ""lines"": 2}, ""src/vim9compile.c"": {""insertions"": 16, ""deletions"": 5, ""lines"": 21}}"
2020-09-19 13:16:50,fdeab65db60929e28640fd740c333f9bcfea0e15,Bram Moolenaar,45,17,62,5,"{""src/proto/vim9compile.pro"": {""insertions"": 1, ""deletions"": 0, ""lines"": 1}, ""src/userfunc.c"": {""insertions"": 19, ""deletions"": 15, ""lines"": 34}, ""src/version.c"": {""insertions"": 2, ""deletions"": 0, ""lines"": 2}, ""src/vim9compile.c"": {""insertions"": 15, ""deletions"": 0, ""lines"": 15}, ""src/vim9execute.c"": {""insertions"": 8, ""deletions"": 2, ""lines"": 10}}"
2020-09-19 12:12:34,77b20977dc31ecf753dddad7a7c7b8f7b6e0c244,Bram Moolenaar,28,1,29,3,"{""src/testdir/test_vim9_expr.vim"": {""insertions"": 12, ""deletions"": 0, ""lines"": 12}, ""src/version.c"": {""insertions"": 2, ""deletions"": 0, ""lines"": 2}, ""src/vim9type.c"": {""insertions"": 14, ""deletions"": 1, ""lines"": 15}}"
2020-09-18 21:11:10,dec07510bbdf335a2de3d63591231a90ef3e4c80,Bram Moolenaar,3,0,3,2,"{""src/version.c"": {""insertions"": 2, ""deletions"": 0, ""lines"": 2}, ""src/vim9execute.c"": {""insertions"": 1, ""deletions"": 0, ""lines"": 1}}"
2020-09-18 20:42:00,b185a4074515f576b420cfc7a5a07f840cf6b51f,Bram Moolenaar,48,2,50,3,"{""src/testdir/test_vim9_func.vim"": {""insertions"": 44, ""deletions"": 0, ""lines"": 44}, ""src/version.c"": {""insertions"": 2, ""deletions"": 0, ""lines"": 2}, ""src/vim9compile.c"": {""insertions"": 2, ""deletions"": 2, ""lines"": 4}}"
2020-09-18 19:55:26,2bbada811625ee53c7bcdf689dbf409e9975ea8f,Bram Moolenaar,4,2,6,2,"{""src/testdir/test_highlight.vim"": {""insertions"": 2, ""deletions"": 2, ""lines"": 4}, ""src/version.c"": {""insertions"": 2, ""deletions"": 0, ""lines"": 2}}"
2020-09-18 19:25:32,7cbfaa51de7b225effdc79a008c71a5551883c38,Bram Moolenaar,23,7,30,3,"{""src/testdir/test_vim9_func.vim"": {""insertions"": 14, ""deletions"": 0, ""lines"": 14}, ""src/version.c"": {""insertions"": 2, ""deletions"": 0, ""lines"": 2}, ""src/vim9execute.c"": {""insertions"": 7, ""deletions"": 7, ""lines"": 14}}"
2020-09-18 17:40:45,e8df0104985af58ee501a6fbac8ac9f886e84e5a,Bram Moolenaar,48,9,57,3,"{""src/highlight.c"": {""insertions"": 12, ""deletions"": 9, ""lines"": 21}, ""src/testdir/test_highlight.vim"": {""insertions"": 34, ""deletions"": 0, ""lines"": 34}, ""src/version.c"": {""insertions"": 2, ""deletions"": 0, ""lines"": 2}}"
2020-09-17 19:29:03,77e5dcc36a82da040072d74e3ced410d15c42757,Bram Moolenaar,50,1,51,3,"{""src/testdir/test_vim9_script.vim"": {""insertions"": 39, ""deletions"": 0, ""lines"": 39}, ""src/version.c"": {""insertions"": 2, ""deletions"": 0, ""lines"": 2}, ""src/vim9execute.c"": {""insertions"": 9, ""deletions"": 1, ""lines"": 10}}"
2020-09-17 17:59:26,213da551dec465e193619684b260bf9d5a8d6afc,Bram Moolenaar,66,19,85,4,"{""runtime/doc/syntax.txt"": {""insertions"": 1, ""deletions"": 0, ""lines"": 1}, ""src/highlight.c"": {""insertions"": 20, ""deletions"": 10, ""lines"": 30}, ""src/testdir/test_highlight.vim"": {""insertions"": 43, ""deletions"": 9, ""lines"": 52}, ""src/version.c"": {""insertions"": 2, ""deletions"": 0, ""lines"": 2}}"
2020-09-17 17:36:04,da697645d5917eb3d4168c06c3442bef9fb746bf,Bram Moolenaar,23,2,25,3,"{""src/fold.c"": {""insertions"": 2, ""deletions"": 2, ""lines"": 4}, ""src/testdir/test_fold.vim"": {""insertions"": 19, ""deletions"": 0, ""lines"": 19}, ""src/version.c"": {""insertions"": 2, ""deletions"": 0, ""lines"": 2}}"
2020-09-16 21:23:36,08e51f446bd4bf1a0342c471163b1ed083e9eedb,Bram Moolenaar,24,10,34,3,"{""src/list.c"": {""insertions"": 17, ""deletions"": 10, ""lines"": 27}, ""src/testdir/test_vim9_func.vim"": {""insertions"": 5, ""deletions"": 0, ""lines"": 5}, ""src/version.c"": {""insertions"": 2, ""deletions"": 0, ""lines"": 2}}"
2020-09-16 20:29:52,9939f57b7f1c17a0142ebfe4f9e0b634158593e1,Bram Moolenaar,23,0,23,3,"{""src/testdir/test_vim9_script.vim"": {""insertions"": 20, ""deletions"": 0, ""lines"": 20}, ""src/version.c"": {""insertions"": 2, ""deletions"": 0, ""lines"": 2}, ""src/vim9execute.c"": {""insertions"": 1, ""deletions"": 0, ""lines"": 1}}"
2020-09-16 19:41:53,916911f598718bc76bc6b87ed703d2805fa49c53,Bram Moolenaar,4,0,4,2,"{""src/errors.h"": {""insertions"": 2, ""deletions"": 0, ""lines"": 2}, ""src/version.c"": {""insertions"": 2, ""deletions"": 0, ""lines"": 2}}"
2020-09-16 19:08:28,a187c43cfe8863d48b2159d695fedcb71f8525c1,Bram Moolenaar,93,44,137,11,"{""runtime/doc/eval.txt"": {""insertions"": 13, ""deletions"": 2, ""lines"": 15}, ""src/dict.c"": {""insertions"": 2, ""deletions"": 2, ""lines"": 4}, ""src/eval.c"": {""insertions"": 5, ""deletions"": 4, ""lines"": 9}, ""src/evalvars.c"": {""insertions"": 36, ""deletions"": 13, ""lines"": 49}, ""src/list.c"": {""insertions"": 13, ""deletions"": 13, ""lines"": 26}, ""src/proto/evalvars.pro"": {""insertions"": 2, ""deletions"": 1, ""lines"": 3}, ""src/testdir/test_const.vim"": {""insertions"": 8, ""deletions"": 0, ""lines"": 8}, ""src/testdir/test_listdict.vim"": {""insertions"": 8, ""deletions"": 5, ""lines"": 13}, ""src/typval.c"": {""insertions"": 2, ""deletions"": 2, ""lines"": 4}, ""src/userfunc.c"": {""insertions"": 2, ""deletions"": 2, ""lines"": 4}, ""src/version.c"": {""insertions"": 2, ""deletions"": 0, ""lines"": 2}}"
2020-09-16 15:55:40,7707228aace9aff16434edf5377a354c6ad07316,Bram Moolenaar,69,67,136,6,"{""src/errors.h"": {""insertions"": 36, ""deletions"": 36, ""lines"": 72}, ""src/testdir/test_assert.vim"": {""insertions"": 5, ""deletions"": 5, ""lines"": 10}, ""src/testdir/test_vim9_expr.vim"": {""insertions"": 15, ""deletions"": 15, ""lines"": 30}, ""src/testdir/test_vim9_func.vim"": {""insertions"": 10, ""deletions"": 10, ""lines"": 20}, ""src/testdir/test_vim9_script.vim"": {""insertions"": 1, ""deletions"": 1, ""lines"": 2}, ""src/version.c"": {""insertions"": 2, ""deletions"": 0, ""lines"": 2}}"
2020-09-16 15:30:27,2c12f890551bbdf5605472a4d711d48a273685d7,Bram Moolenaar,2,4,6,2,"{""src/spell.c"": {""insertions"": 0, ""deletions"": 4, ""lines"": 4}, ""src/version.c"": {""insertions"": 2, ""deletions"": 0, ""lines"": 2}}"
2020-09-16 15:22:59,2f8cbc4b225ba707c3926070a3f133eb0473aed2,Bram Moolenaar,14,2,16,4,"{""src/testdir/test_vim9_func.vim"": {""insertions"": 9, ""deletions"": 0, ""lines"": 9}, ""src/version.c"": {""insertions"": 2, ""deletions"": 0, ""lines"": 2}, ""src/vim9compile.c"": {""insertions"": 2, ""deletions"": 2, ""lines"": 4}, ""src/vim9execute.c"": {""insertions"": 1, ""deletions"": 0, ""lines"": 1}}"
2020-09-16 13:46:08,573545a55afb5d42614cdb69f356abb32409270b,Bram Moolenaar,4,1,5,2,"{""src/ops.c"": {""insertions"": 2, ""deletions"": 1, ""lines"": 3}, ""src/version.c"": {""insertions"": 2, ""deletions"": 0, ""lines"": 2}}"
2020-09-16 13:43:21,05eb5b9cae123b138bbd23cc77e50657ece6b4ad,Bram Moolenaar,38,2,40,3,"{""src/highlight.c"": {""insertions"": 4, ""deletions"": 2, ""lines"": 6}, ""src/testdir/test_highlight.vim"": {""insertions"": 32, ""deletions"": 0, ""lines"": 32}, ""src/version.c"": {""insertions"": 2, ""deletions"": 0, ""lines"": 2}}"
2020-09-16 13:41:09,fb489af2ec1b181d212a8aa8151d7784b260d01b,Bram Moolenaar,3,0,3,2,"{""src/structs.h"": {""insertions"": 1, ""deletions"": 0, ""lines"": 1}, ""src/version.c"": {""insertions"": 2, ""deletions"": 0, ""lines"": 2}}"
2020-09-16 13:22:00,5e654230777ad21363a929dce3cfe0387da031a7,Bram Moolenaar,258,154,412,13,"{""src/errors.h"": {""insertions"": 1, ""deletions"": 1, ""lines"": 2}, ""src/evalfunc.c"": {""insertions"": 9, ""deletions"": 6, ""lines"": 15}, ""src/globals.h"": {""insertions"": 35, ""deletions"": 36, ""lines"": 71}, ""src/proto/vim9type.pro"": {""insertions"": 3, ""deletions"": 1, ""lines"": 4}, ""src/testdir/test_vim9_disassemble.vim"": {""insertions"": 3, ""deletions"": 3, ""lines"": 6}, ""src/testdir/test_vim9_expr.vim"": {""insertions"": 16, ""deletions"": 13, ""lines"": 29}, ""src/testdir/test_vim9_func.vim"": {""insertions"": 20, ""deletions"": 20, ""lines"": 40}, ""src/testdir/test_vim9_script.vim"": {""insertions"": 24, ""deletions"": 6, ""lines"": 30}, ""src/version.c"": {""insertions"": 2, ""deletions"": 0, ""lines"": 2}, ""src/vim9.h"": {""insertions"": 1, ""deletions"": 1, ""lines"": 2}, ""src/vim9compile.c"": {""insertions"": 36, ""deletions"": 19, ""lines"": 55}, ""src/vim9execute.c"": {""insertions"": 21, ""deletions"": 26, ""lines"": 47}, ""src/vim9type.c"": {""insertions"": 87, ""deletions"": 22, ""lines"": 109}}"
2020-09-15 19:34:18,8b51b7f0f17af149a8ce76e805050977857f9e50,Bram Moolenaar,42,2,44,5,"{""src/change.c"": {""insertions"": 1, ""deletions"": 1, ""lines"": 2}, ""src/ops.c"": {""insertions"": 7, ""deletions"": 1, ""lines"": 8}, ""src/proto/change.pro"": {""insertions"": 1, ""deletions"": 0, ""lines"": 1}, ""src/testdir/test_textprop.vim"": {""insertions"": 31, ""deletions"": 0, ""lines"": 31}, ""src/version.c"": {""insertions"": 2, ""deletions"": 0, ""lines"": 2}}"
2020-09-15 18:52:26,ad5e5631c5dc93a50bbe637be254c5e9968848ea,Bram Moolenaar,63,1,64,5,"{""src/drawline.c"": {""insertions"": 5, ""deletions"": 1, ""lines"": 6}, ""src/testdir/dumps/Test_colorcolumn_2.dump"": {""insertions"": 10, ""deletions"": 0, ""lines"": 10}, ""src/testdir/dumps/Test_colorcolumn_3.dump"": {""insertions"": 10, ""deletions"": 0, ""lines"": 10}, ""src/testdir/test_highlight.vim"": {""insertions"": 36, ""deletions"": 0, ""lines"": 36}, ""src/version.c"": {""insertions"": 2, ""deletions"": 0, ""lines"": 2}}"
2020-09-15 18:34:10,c8f12c9856df58c760fe54d81b2ec5ed4dcaffd6,Bram Moolenaar,55,5,60,3,"{""src/ops.c"": {""insertions"": 32, ""deletions"": 4, ""lines"": 36}, ""src/testdir/test_textprop.vim"": {""insertions"": 21, ""deletions"": 1, ""lines"": 22}, ""src/version.c"": {""insertions"": 2, ""deletions"": 0, ""lines"": 2}}"
2020-09-14 20:39:11,9b123d859053ad1fb91d38334726b9f24da39930,Bram Moolenaar,4,1,5,2,"{""src/version.c"": {""insertions"": 2, ""deletions"": 0, ""lines"": 2}, ""src/vim9compile.c"": {""insertions"": 2, ""deletions"": 1, ""lines"": 3}}"
2020-09-14 20:28:30,71abe4828974af495602ffaff63cf643a16de84b,Bram Moolenaar,23,2,25,3,"{""src/testdir/test_vim9_script.vim"": {""insertions"": 18, ""deletions"": 0, ""lines"": 18}, ""src/version.c"": {""insertions"": 2, ""deletions"": 0, ""lines"": 2}, ""src/vim9compile.c"": {""insertions"": 3, ""deletions"": 2, ""lines"": 5}}"
2020-09-14 19:39:44,0b4c66c67a083f25816b9cdb8e76a41e02d9f560,Bram Moolenaar,204,38,242,12,"{""runtime/doc/vim9.txt"": {""insertions"": 67, ""deletions"": 15, ""lines"": 82}, ""src/errors.h"": {""insertions"": 8, ""deletions"": 0, ""lines"": 8}, ""src/eval.c"": {""insertions"": 1, ""deletions"": 1, ""lines"": 2}, ""src/evalvars.c"": {""insertions"": 8, ""deletions"": 7, ""lines"": 15}, ""src/ex_cmds.h"": {""insertions"": 1, ""deletions"": 1, ""lines"": 2}, ""src/proto/evalvars.pro"": {""insertions"": 2, ""deletions"": 1, ""lines"": 3}, ""src/testdir/test_vim9_script.vim"": {""insertions"": 40, ""deletions"": 0, ""lines"": 40}, ""src/version.c"": {""insertions"": 2, ""deletions"": 0, ""lines"": 2}, ""src/vim.h"": {""insertions"": 2, ""deletions"": 1, ""lines"": 3}, ""src/vim9.h"": {""insertions"": 2, ""deletions"": 0, ""lines"": 2}, ""src/vim9compile.c"": {""insertions"": 35, ""deletions"": 10, ""lines"": 45}, ""src/vim9execute.c"": {""insertions"": 36, ""deletions"": 2, ""lines"": 38}}"
2020-09-14 17:11:45,efd5d8a967ba80f9e2826c35be98344d8f00af77,Bram Moolenaar,29,1,30,3,"{""src/findfile.c"": {""insertions"": 7, ""deletions"": 0, ""lines"": 7}, ""src/testdir/test_gf.vim"": {""insertions"": 20, ""deletions"": 1, ""lines"": 21}, ""src/version.c"": {""insertions"": 2, ""deletions"": 0, ""lines"": 2}}"
2020-09-14 16:35:18,2b22b113c6aedf2a1295cf7e6f2f2a5d463b3868,Bram Moolenaar,23,7,30,2,"{""src/ex_docmd.c"": {""insertions"": 21, ""deletions"": 7, ""lines"": 28}, ""src/version.c"": {""insertions"": 2, ""deletions"": 0, ""lines"": 2}}"
2020-09-14 16:15:09,dbeecb2b6bc5bf90b7345807e0a313fe890a7c7b,Bram Moolenaar,20,9,29,4,"{""src/evalvars.c"": {""insertions"": 6, ""deletions"": 4, ""lines"": 10}, ""src/testdir/test_vim9_script.vim"": {""insertions"": 7, ""deletions"": 0, ""lines"": 7}, ""src/version.c"": {""insertions"": 2, ""deletions"": 0, ""lines"": 2}, ""src/vim9compile.c"": {""insertions"": 5, ""deletions"": 5, ""lines"": 10}}"
2020-09-14 15:04:31,08052228a72074cdb0165e65f01b2fa8fce867ea,Bram Moolenaar,47,46,93,3,"{""src/testdir/test_vim9_func.vim"": {""insertions"": 5, ""deletions"": 5, ""lines"": 10}, ""src/testdir/test_vim9_script.vim"": {""insertions"": 40, ""deletions"": 41, ""lines"": 81}, ""src/version.c"": {""insertions"": 2, ""deletions"": 0, ""lines"": 2}}"
2020-09-14 14:50:05,eb26f4331f607b1639bf01f4f35ad3ce7d20cb10,Bram Moolenaar,4,0,4,3,"{""src/testdir/test_vim9_expr.vim"": {""insertions"": 1, ""deletions"": 0, ""lines"": 1}, ""src/version.c"": {""insertions"": 2, ""deletions"": 0, ""lines"": 2}, ""src/vim9execute.c"": {""insertions"": 1, ""deletions"": 0, ""lines"": 1}}"
2020-09-14 14:37:34,3bd8de40b484d3617a19092d3cc036f8b4f3d51c,Bram Moolenaar,33,13,46,8,"{""src/cmdexpand.c"": {""insertions"": 1, ""deletions"": 1, ""lines"": 2}, ""src/ex_docmd.c"": {""insertions"": 8, ""deletions"": 5, ""lines"": 13}, ""src/ex_getln.c"": {""insertions"": 7, ""deletions"": 3, ""lines"": 10}, ""src/proto/ex_docmd.pro"": {""insertions"": 1, ""deletions"": 1, ""lines"": 2}, ""src/testdir/test_vim9_cmd.vim"": {""insertions"": 11, ""deletions"": 0, ""lines"": 11}, ""src/userfunc.c"": {""insertions"": 1, ""deletions"": 1, ""lines"": 2}, ""src/version.c"": {""insertions"": 2, ""deletions"": 0, ""lines"": 2}, ""src/vim9compile.c"": {""insertions"": 2, ""deletions"": 2, ""lines"": 4}}"
2020-09-13 20:37:34,d1f76afaf963be706697279ab0570ffcb8a1f2fc,Bram Moolenaar,8,0,8,3,"{""src/syntax.c"": {""insertions"": 2, ""deletions"": 0, ""lines"": 2}, ""src/testdir/test_syntax.vim"": {""insertions"": 4, ""deletions"": 0, ""lines"": 4}, ""src/version.c"": {""insertions"": 2, ""deletions"": 0, ""lines"": 2}}"
2020-09-13 20:21:22,4d170af0a9379da64d67dc3fa7cc7297956c6f52,Bram Moolenaar,62,5,67,3,"{""src/quickfix.c"": {""insertions"": 36, ""deletions"": 5, ""lines"": 41}, ""src/testdir/test_quickfix.vim"": {""insertions"": 24, ""deletions"": 0, ""lines"": 24}, ""src/version.c"": {""insertions"": 2, ""deletions"": 0, ""lines"": 2}}"
2020-09-13 20:00:12,a4224860a498eb870280130e00fe6f376b7a2e6b,Bram Moolenaar,4,2,6,2,"{""src/os_unix.c"": {""insertions"": 2, ""deletions"": 2, ""lines"": 4}, ""src/version.c"": {""insertions"": 2, ""deletions"": 0, ""lines"": 2}}"
2020-09-13 19:01:22,05c1acd5e1564ea4dbc7d4be26908af6909f43f6,Bram Moolenaar,3,1,4,2,"{""src/testdir/Make_ming.mak"": {""insertions"": 1, ""deletions"": 1, ""lines"": 2}, ""src/version.c"": {""insertions"": 2, ""deletions"": 0, ""lines"": 2}}"
2020-09-13 16:57:47,f0afd9e18227d3459c888584d0658a1837d2aaf8,Bram Moolenaar,15,1,16,3,"{""src/testdir/test_vim9_script.vim"": {""insertions"": 8, ""deletions"": 0, ""lines"": 8}, ""src/version.c"": {""insertions"": 2, ""deletions"": 0, ""lines"": 2}, ""src/vim9script.c"": {""insertions"": 5, ""deletions"": 1, ""lines"": 6}}"
2020-09-12 20:52:57,b806aa5bd910dba94fbde586f6019b4825813d28,Bram Moolenaar,21,0,21,3,"{""src/insexpand.c"": {""insertions"": 1, ""deletions"": 0, ""lines"": 1}, ""src/testdir/test_ins_complete.vim"": {""insertions"": 18, ""deletions"": 0, ""lines"": 18}, ""src/version.c"": {""insertions"": 2, ""deletions"": 0, ""lines"": 2}}"
2020-09-12 20:10:00,4a091b9978122428e7d9154d034c640c9c8d8c13,Bram Moolenaar,4,0,4,2,"{""src/eval.c"": {""insertions"": 2, ""deletions"": 0, ""lines"": 2}, ""src/version.c"": {""insertions"": 2, ""deletions"": 0, ""lines"": 2}}"
2020-09-12 19:27:03,c6e57b74fa1e6090a27f886e2b3830fd1fa15708,Bram Moolenaar,13,1,14,3,"{""src/eval.c"": {""insertions"": 1, ""deletions"": 1, ""lines"": 2}, ""src/testdir/test_vim9_expr.vim"": {""insertions"": 10, ""deletions"": 0, ""lines"": 10}, ""src/version.c"": {""insertions"": 2, ""deletions"": 0, ""lines"": 2}}"
2020-09-12 19:04:23,8f13d82fa6ac6faa1a91076e99000a8f02180e8e,Bram Moolenaar,4,2,6,3,"{""src/memline.c"": {""insertions"": 1, ""deletions"": 1, ""lines"": 2}, ""src/option.c"": {""insertions"": 1, ""deletions"": 1, ""lines"": 2}, ""src/version.c"": {""insertions"": 2, ""deletions"": 0, ""lines"": 2}}"
2020-09-12 17:51:42,b0fa5e17c587d9c71596bd10836918af713ffff6,Bram Moolenaar,20,14,34,2,"{""src/evalvars.c"": {""insertions"": 18, ""deletions"": 14, ""lines"": 32}, ""src/version.c"": {""insertions"": 2, ""deletions"": 0, ""lines"": 2}}"
2020-09-12 17:11:23,dadaddd59f3b53c41e92dc42219ab006deb14109,Bram Moolenaar,22,5,27,3,"{""src/testdir/test_vim9_expr.vim"": {""insertions"": 3, ""deletions"": 0, ""lines"": 3}, ""src/version.c"": {""insertions"": 2, ""deletions"": 0, ""lines"": 2}, ""src/vim9execute.c"": {""insertions"": 17, ""deletions"": 5, ""lines"": 22}}"
2020-09-12 16:32:34,0f769815c82bf93812842e1ad56fcc52c10ff3e5,Bram Moolenaar,82,19,101,5,"{""src/proto/userfunc.pro"": {""insertions"": 1, ""deletions"": 0, ""lines"": 1}, ""src/testdir/test_vim9_func.vim"": {""insertions"": 30, ""deletions"": 0, ""lines"": 30}, ""src/userfunc.c"": {""insertions"": 10, ""deletions"": 1, ""lines"": 11}, ""src/version.c"": {""insertions"": 2, ""deletions"": 0, ""lines"": 2}, ""src/vim9compile.c"": {""insertions"": 39, ""deletions"": 18, ""lines"": 57}}"
2020-09-12 12:53:53,b00ef0508b22905379953a164bdb4300015d3705,Bram Moolenaar,92,31,123,3,"{""src/option.c"": {""insertions"": 60, ""deletions"": 31, ""lines"": 91}, ""src/testdir/test_options.vim"": {""insertions"": 30, ""deletions"": 0, ""lines"": 30}, ""src/version.c"": {""insertions"": 2, ""deletions"": 0, ""lines"": 2}}"
2020-09-11 20:25:15,635414dd2f3ae7d4d972d79b806348a6516cb91a,Bram Moolenaar,393,0,393,7,"{""runtime/doc/eval.txt"": {""insertions"": 24, ""deletions"": 0, ""lines"": 24}, ""runtime/doc/usr_41.txt"": {""insertions"": 1, ""deletions"": 0, ""lines"": 1}, ""src/evalfunc.c"": {""insertions"": 1, ""deletions"": 0, ""lines"": 1}, ""src/proto/search.pro"": {""insertions"": 1, ""deletions"": 0, ""lines"": 1}, ""src/search.c"": {""insertions"": 340, ""deletions"": 0, ""lines"": 340}, ""src/testdir/test_functions.vim"": {""insertions"": 24, ""deletions"": 0, ""lines"": 24}, ""src/version.c"": {""insertions"": 2, ""deletions"": 0, ""lines"": 2}}"
2020-09-11 20:10:22,c2c820563441499892359da949db3c8f7f16d109,Bram Moolenaar,40,25,65,4,"{""src/session.c"": {""insertions"": 12, ""deletions"": 20, ""lines"": 32}, ""src/terminal.c"": {""insertions"": 2, ""deletions"": 2, ""lines"": 4}, ""src/testdir/test_mksession.vim"": {""insertions"": 24, ""deletions"": 3, ""lines"": 27}, ""src/version.c"": {""insertions"": 2, ""deletions"": 0, ""lines"": 2}}"
2020-09-11 18:51:26,14944c04bd15f3bc67a6665d7234e44bd77b495d,Bram Moolenaar,442,448,890,2,"{""runtime/optwin.vim"": {""insertions"": 440, ""deletions"": 448, ""lines"": 888}, ""src/version.c"": {""insertions"": 2, ""deletions"": 0, ""lines"": 2}}"
2020-09-11 18:36:36,0e655111e9dbdbdf69fee1b199f2b9c355bf4a10,Bram Moolenaar,141,53,194,6,"{""src/hashtab.c"": {""insertions"": 1, ""deletions"": 1, ""lines"": 2}, ""src/proto/terminal.pro"": {""insertions"": 1, ""deletions"": 1, ""lines"": 2}, ""src/session.c"": {""insertions"": 75, ""deletions"": 49, ""lines"": 124}, ""src/terminal.c"": {""insertions"": 36, ""deletions"": 2, ""lines"": 38}, ""src/testdir/test_mksession.vim"": {""insertions"": 26, ""deletions"": 0, ""lines"": 26}, ""src/version.c"": {""insertions"": 2, ""deletions"": 0, ""lines"": 2}}"
2020-09-11 17:28:19,c6a67c92bcbf4ef09063814af0c65d3e0585ada0,Bram Moolenaar,4,2,6,2,"{""src/channel.c"": {""insertions"": 2, ""deletions"": 2, ""lines"": 4}, ""src/version.c"": {""insertions"": 2, ""deletions"": 0, ""lines"": 2}}"
2020-09-11 17:09:48,c0c71e9d9813f025c5fc1ce84eae309843395199,Bram Moolenaar,203,202,405,2,"{""src/testdir/test_vim9_func.vim"": {""insertions"": 201, ""deletions"": 202, ""lines"": 403}, ""src/version.c"": {""insertions"": 2, ""deletions"": 0, ""lines"": 2}}"
2020-09-11 16:11:50,96fdf4348a50cdbe6b8f18ccb4806ba5b190989e,Bram Moolenaar,34,0,34,3,"{""src/testdir/test_spell.vim"": {""insertions"": 1, ""deletions"": 0, ""lines"": 1}, ""src/testdir/test_spellfile.vim"": {""insertions"": 31, ""deletions"": 0, ""lines"": 31}, ""src/version.c"": {""insertions"": 2, ""deletions"": 0, ""lines"": 2}}"
2020-09-11 15:59:23,a810db3f17d477e057059c72062c08fd97bcea43,Bram Moolenaar,9,6,15,3,"{""src/scriptfile.c"": {""insertions"": 6, ""deletions"": 5, ""lines"": 11}, ""src/testdir/test_expand_func.vim"": {""insertions"": 1, ""deletions"": 1, ""lines"": 2}, ""src/version.c"": {""insertions"": 2, ""deletions"": 0, ""lines"": 2}}"
2020-09-10 20:28:01,8b848cafb0a88f8d8e8f46caa8d67431b4faa374,Bram Moolenaar,27,0,27,4,"{""src/errors.h"": {""insertions"": 2, ""deletions"": 0, ""lines"": 2}, ""src/testdir/test_vim9_func.vim"": {""insertions"": 17, ""deletions"": 0, ""lines"": 17}, ""src/version.c"": {""insertions"": 2, ""deletions"": 0, ""lines"": 2}, ""src/vim9compile.c"": {""insertions"": 6, ""deletions"": 0, ""lines"": 6}}"
2020-09-10 20:05:08,dfa3d5524e816c1ff7f603f9f3b7703a53a0f822,Bram Moolenaar,23,0,23,3,"{""src/testdir/test_vim9_func.vim"": {""insertions"": 20, ""deletions"": 0, ""lines"": 20}, ""src/version.c"": {""insertions"": 2, ""deletions"": 0, ""lines"": 2}, ""src/vim9execute.c"": {""insertions"": 1, ""deletions"": 0, ""lines"": 1}}"
2020-09-10 19:36:11,895a7a472d2eb4413e63cdad3213cb1ef1633458,Bram Moolenaar,11,0,11,2,"{""src/if_perl.xs"": {""insertions"": 9, ""deletions"": 0, ""lines"": 9}, ""src/version.c"": {""insertions"": 2, ""deletions"": 0, ""lines"": 2}}"
2020-09-10 19:25:45,ad9ec5e79916d206fd7677b77e36485c47ae534f,Bram Moolenaar,11,9,20,2,"{""src/channel.c"": {""insertions"": 9, ""deletions"": 9, ""lines"": 18}, ""src/version.c"": {""insertions"": 2, ""deletions"": 0, ""lines"": 2}}"
2020-09-10 17:25:05,4f25b1aba050b85fa97ca2316aa04dd4b0b22530,Bram Moolenaar,40,22,62,10,"{""src/debugger.c"": {""insertions"": 3, ""deletions"": 3, ""lines"": 6}, ""src/ex_docmd.c"": {""insertions"": 3, ""deletions"": 1, ""lines"": 4}, ""src/ex_eval.c"": {""insertions"": 2, ""deletions"": 2, ""lines"": 4}, ""src/message.c"": {""insertions"": 1, ""deletions"": 1, ""lines"": 2}, ""src/proto/scriptfile.pro"": {""insertions"": 1, ""deletions"": 1, ""lines"": 2}, ""src/scriptfile.c"": {""insertions"": 14, ""deletions"": 7, ""lines"": 21}, ""src/testdir/test_expand_func.vim"": {""insertions"": 5, ""deletions"": 4, ""lines"": 9}, ""src/testing.c"": {""insertions"": 1, ""deletions"": 1, ""lines"": 2}, ""src/version.c"": {""insertions"": 2, ""deletions"": 0, ""lines"": 2}, ""src/vim.h"": {""insertions"": 8, ""deletions"": 2, ""lines"": 10}}"
2020-09-10 12:25:25,a953b5cf4f291875b805262eebd361e502de8c92,Bram Moolenaar,38,28,66,2,"{""runtime/optwin.vim"": {""insertions"": 36, ""deletions"": 28, ""lines"": 64}, ""src/version.c"": {""insertions"": 2, ""deletions"": 0, ""lines"": 2}}"
2020-09-09 20:43:19,64e2db6dc6d7a013ff94ce302af8958cbd2704af,Bram Moolenaar,68,0,68,2,"{""src/testdir/test_spellfile.vim"": {""insertions"": 66, ""deletions"": 0, ""lines"": 66}, ""src/version.c"": {""insertions"": 2, ""deletions"": 0, ""lines"": 2}}"
2020-09-09 20:27:58,c1ec0422e43720d2e96627605532ee9806c0789f,Bram Moolenaar,92,29,121,8,"{""src/eval.c"": {""insertions"": 7, ""deletions"": 0, ""lines"": 7}, ""src/evalvars.c"": {""insertions"": 14, ""deletions"": 3, ""lines"": 17}, ""src/proto/vim9type.pro"": {""insertions"": 1, ""deletions"": 0, ""lines"": 1}, ""src/structs.h"": {""insertions"": 4, ""deletions"": 3, ""lines"": 7}, ""src/testdir/test_vim9_script.vim"": {""insertions"": 6, ""deletions"": 6, ""lines"": 12}, ""src/version.c"": {""insertions"": 2, ""deletions"": 0, ""lines"": 2}, ""src/vim9script.c"": {""insertions"": 14, ""deletions"": 1, ""lines"": 15}, ""src/vim9type.c"": {""insertions"": 44, ""deletions"": 16, ""lines"": 60}}"
2020-09-09 18:58:55,3e4cc9671c5551b73f0176cab40e676ed72a1716,Bram Moolenaar,29,6,35,2,"{""src/gui_gtk.c"": {""insertions"": 27, ""deletions"": 6, ""lines"": 33}, ""src/version.c"": {""insertions"": 2, ""deletions"": 0, ""lines"": 2}}"
2020-09-09 18:41:40,a62372be1f73b69f9d4c9413ec816d773a16a0f5,Bram Moolenaar,212,156,368,5,"{""Filelist"": {""insertions"": 1, ""deletions"": 1, ""lines"": 2}, ""src/INSTALLami.txt"": {""insertions"": 8, ""deletions"": 23, ""lines"": 31}, ""src/Make_ami.mak"": {""insertions"": 201, ""deletions"": 0, ""lines"": 201}, ""src/Make_morph.mak"": {""insertions"": 0, ""deletions"": 132, ""lines"": 132}, ""src/version.c"": {""insertions"": 2, ""deletions"": 0, ""lines"": 2}}"
2020-09-09 18:03:46,4ed124cc6c0c55385c3b2fed9f9357baf42edbcc,Bram Moolenaar,66,2,68,4,"{""src/testdir/test_vim9_disassemble.vim"": {""insertions"": 23, ""deletions"": 0, ""lines"": 23}, ""src/testdir/test_vim9_script.vim"": {""insertions"": 16, ""deletions"": 2, ""lines"": 18}, ""src/version.c"": {""insertions"": 2, ""deletions"": 0, ""lines"": 2}, ""src/vim9compile.c"": {""insertions"": 25, ""deletions"": 0, ""lines"": 25}}"
2020-09-09 17:25:09,33e3346322e40b2877f63f2f37398832c7017e2f,Bram Moolenaar,2,4,6,1,"{""src/version.c"": {""insertions"": 2, ""deletions"": 4, ""lines"": 6}}"
2020-09-09 17:05:13,81a4cf469a0f5c1603ac3130af9f011053854180,Bram Moolenaar,8,4,12,2,"{""src/gui_gtk_x11.c"": {""insertions"": 6, ""deletions"": 4, ""lines"": 10}, ""src/version.c"": {""insertions"": 2, ""deletions"": 0, ""lines"": 2}}"
2020-09-09 16:54:42,ba7c0d7b4ce03336b4aebe1959c1a8342fa6dbd4,Bram Moolenaar,43,11,54,5,"{""src/testdir/test_vim9_expr.vim"": {""insertions"": 1, ""deletions"": 1, ""lines"": 2}, ""src/testdir/test_vim9_script.vim"": {""insertions"": 21, ""deletions"": 3, ""lines"": 24}, ""src/testdir/vim9.vim"": {""insertions"": 1, ""deletions"": 1, ""lines"": 2}, ""src/version.c"": {""insertions"": 2, ""deletions"": 0, ""lines"": 2}, ""src/vim9type.c"": {""insertions"": 18, ""deletions"": 6, ""lines"": 24}}"
2020-09-09 15:08:51,96f8f499ce51ea791d9b044c266f84380fa54848,Bram Moolenaar,6,2,8,2,"{""src/userfunc.c"": {""insertions"": 4, ""deletions"": 2, ""lines"": 6}, ""src/version.c"": {""insertions"": 2, ""deletions"": 0, ""lines"": 2}}"
2020-09-09 13:10:52,4507f6ada590fb6274b21c416190dfecb23dcf1b,Bram Moolenaar,3,1,4,2,"{""runtime/optwin.vim"": {""insertions"": 1, ""deletions"": 1, ""lines"": 2}, ""src/version.c"": {""insertions"": 2, ""deletions"": 0, ""lines"": 2}}"
2020-09-09 12:55:31,29a86ffee794bc1a0efde215c203cf9529047252,Bram Moolenaar,27,1,28,6,"{""src/proto/vim9type.pro"": {""insertions"": 1, ""deletions"": 0, ""lines"": 1}, ""src/structs.h"": {""insertions"": 1, ""deletions"": 0, ""lines"": 1}, ""src/testdir/test_vim9_script.vim"": {""insertions"": 5, ""deletions"": 0, ""lines"": 5}, ""src/version.c"": {""insertions"": 2, ""deletions"": 0, ""lines"": 2}, ""src/vim9compile.c"": {""insertions"": 13, ""deletions"": 0, ""lines"": 13}, ""src/vim9type.c"": {""insertions"": 5, ""deletions"": 1, ""lines"": 6}}"
2020-09-09 11:01:27,f842cd9e285afb9d86c6f9bff400e5e576f873c0,Bram Moolenaar,3,0,3,2,"{""src/os_amiga.h"": {""insertions"": 1, ""deletions"": 0, ""lines"": 1}, ""src/version.c"": {""insertions"": 2, ""deletions"": 0, ""lines"": 2}}"
2020-09-09 10:56:30,64075b0ab18449132ed01a07874fe1d1f3f356d4,Bram Moolenaar,110,105,215,2,"{""runtime/optwin.vim"": {""insertions"": 108, ""deletions"": 105, ""lines"": 213}, ""src/version.c"": {""insertions"": 2, ""deletions"": 0, ""lines"": 2}}"
2020-09-08 20:55:26,8e9be208ea58149c4e522166a6194da18a2eced7,Bram Moolenaar,25,21,46,2,"{""src/popupwin.c"": {""insertions"": 23, ""deletions"": 21, ""lines"": 44}, ""src/version.c"": {""insertions"": 2, ""deletions"": 0, ""lines"": 2}}"
2020-09-08 20:45:35,c3516f7e4507c77424b94cb89071f6d0841f4e6a,Bram Moolenaar,158,13,171,12,"{""src/edit.c"": {""insertions"": 2, ""deletions"": 2, ""lines"": 4}, ""src/ex_docmd.c"": {""insertions"": 1, ""deletions"": 1, ""lines"": 2}, ""src/mouse.c"": {""insertions"": 3, ""deletions"": 2, ""lines"": 5}, ""src/normal.c"": {""insertions"": 2, ""deletions"": 2, ""lines"": 4}, ""src/proto/register.pro"": {""insertions"": 1, ""deletions"": 1, ""lines"": 2}, ""src/register.c"": {""insertions"": 7, ""deletions"": 5, ""lines"": 12}, ""src/testdir/test_vim9_cmd.vim"": {""insertions"": 16, ""deletions"": 0, ""lines"": 16}, ""src/testdir/test_vim9_disassemble.vim"": {""insertions"": 15, ""deletions"": 0, ""lines"": 15}, ""src/version.c"": {""insertions"": 2, ""deletions"": 0, ""lines"": 2}, ""src/vim9.h"": {""insertions"": 9, ""deletions"": 0, ""lines"": 9}, ""src/vim9compile.c"": {""insertions"": 66, ""deletions"": 0, ""lines"": 66}, ""src/vim9execute.c"": {""insertions"": 34, ""deletions"": 0, ""lines"": 34}}"
2020-09-08 20:06:44,6defa7bf0a8935cc44f3dc12e9c87bbb40f190b7,Bram Moolenaar,99,3,102,7,"{""src/popupwin.c"": {""insertions"": 28, ""deletions"": 2, ""lines"": 30}, ""src/structs.h"": {""insertions"": 1, ""deletions"": 0, ""lines"": 1}, ""src/testdir/dumps/Test_popupwin_three_errors_1.dump"": {""insertions"": 10, ""deletions"": 0, ""lines"": 10}, ""src/testdir/dumps/Test_popupwin_three_errors_2.dump"": {""insertions"": 10, ""deletions"": 0, ""lines"": 10}, ""src/testdir/dumps/Test_popupwin_wrong_name.dump"": {""insertions"": 10, ""deletions"": 0, ""lines"": 10}, ""src/testdir/test_popupwin.vim"": {""insertions"": 38, ""deletions"": 1, ""lines"": 39}, ""src/version.c"": {""insertions"": 2, ""deletions"": 0, ""lines"": 2}}"
2020-09-08 17:06:30,57ad94c5a9ee6f3626e1ec728519a8558a4346c8,Bram Moolenaar,4,0,4,3,"{""runtime/doc/digraph.txt"": {""insertions"": 1, ""deletions"": 0, ""lines"": 1}, ""src/digraph.c"": {""insertions"": 1, ""deletions"": 0, ""lines"": 1}, ""src/version.c"": {""insertions"": 2, ""deletions"": 0, ""lines"": 2}}"
2020-09-07 20:18:52,1c6737b20a5cf71751b180461cea22fc76d8870c,Bram Moolenaar,1272,307,1579,35,"{"".github/CODEOWNERS"": {""insertions"": 49, ""deletions"": 7, ""lines"": 56}, ""runtime/compiler/dart.vim"": {""insertions"": 26, ""deletions"": 0, ""lines"": 26}, ""runtime/compiler/dart2js.vim"": {""insertions"": 28, ""deletions"": 0, ""lines"": 28}, ""runtime/compiler/dart2native.vim"": {""insertions"": 28, ""deletions"": 0, ""lines"": 28}, ""runtime/compiler/dartanalyser.vim"": {""insertions"": 23, ""deletions"": 0, ""lines"": 23}, ""runtime/compiler/dartdevc.vim"": {""insertions"": 28, ""deletions"": 0, ""lines"": 28}, ""runtime/compiler/dartdoc.vim"": {""insertions"": 26, ""deletions"": 0, ""lines"": 26}, ""runtime/compiler/dartfmt.vim"": {""insertions"": 25, ""deletions"": 0, ""lines"": 25}, ""runtime/compiler/javac.vim"": {""insertions"": 12, ""deletions"": 3, ""lines"": 15}, ""runtime/compiler/rhino.vim"": {""insertions"": 30, ""deletions"": 0, ""lines"": 30}, ""runtime/compiler/xmllint.vim"": {""insertions"": 10, ""deletions"": 8, ""lines"": 18}, ""runtime/doc/eval.txt"": {""insertions"": 10, ""deletions"": 8, ""lines"": 18}, ""runtime/doc/map.txt"": {""insertions"": 37, ""deletions"": 32, ""lines"": 69}, ""runtime/doc/message.txt"": {""insertions"": 2, ""deletions"": 2, ""lines"": 4}, ""runtime/doc/options.txt"": {""insertions"": 7, ""deletions"": 4, ""lines"": 11}, ""runtime/doc/pattern.txt"": {""insertions"": 14, ""deletions"": 10, ""lines"": 24}, ""runtime/doc/tags"": {""insertions"": 3, ""deletions"": 1, ""lines"": 4}, ""runtime/doc/terminal.txt"": {""insertions"": 5, ""deletions"": 3, ""lines"": 8}, ""runtime/doc/testing.txt"": {""insertions"": 1, ""deletions"": 1, ""lines"": 2}, ""runtime/doc/todo.txt"": {""insertions"": 39, ""deletions"": 17, ""lines"": 56}, ""runtime/doc/usr_03.txt"": {""insertions"": 10, ""deletions"": 9, ""lines"": 19}, ""runtime/doc/usr_40.txt"": {""insertions"": 5, ""deletions"": 5, ""lines"": 10}, ""runtime/doc/usr_41.txt"": {""insertions"": 24, ""deletions"": 24, ""lines"": 48}, ""runtime/doc/version5.txt"": {""insertions"": 2, ""deletions"": 2, ""lines"": 4}, ""runtime/doc/vim9.txt"": {""insertions"": 67, ""deletions"": 55, ""lines"": 122}, ""runtime/doc/windows.txt"": {""insertions"": 4, ""deletions"": 4, ""lines"": 8}, ""runtime/ftplugin/spec.vim"": {""insertions"": 3, ""deletions"": 5, ""lines"": 8}, ""runtime/indent/json.vim"": {""insertions"": 12, ""deletions"": 10, ""lines"": 22}, ""runtime/keymap/french-azerty.vim"": {""insertions"": 81, ""deletions"": 0, ""lines"": 81}, ""runtime/keymap/german-qwertz.vim"": {""insertions"": 76, ""deletions"": 0, ""lines"": 76}, ""runtime/keymap/turkish-f.vim"": {""insertions"": 1, ""deletions"": 0, ""lines"": 1}, ""runtime/syntax/php.vim"": {""insertions"": 88, ""deletions"": 40, ""lines"": 128}, ""runtime/tutor/tutor"": {""insertions"": 4, ""deletions"": 2, ""lines"": 6}, ""runtime/tutor/tutor.utf-8"": {""insertions"": 4, ""deletions"": 2, ""lines"": 6}, ""src/po/tr.po"": {""insertions"": 488, ""deletions"": 53, ""lines"": 541}}"
2020-09-07 20:05:28,9c929713b7588f2e44a1533809d2ba0bbd2631be,Bram Moolenaar,277,215,492,3,"{""src/ex_getln.c"": {""insertions"": 266, ""deletions"": 215, ""lines"": 481}, ""src/testdir/test_cmdline.vim"": {""insertions"": 9, ""deletions"": 0, ""lines"": 9}, ""src/version.c"": {""insertions"": 2, ""deletions"": 0, ""lines"": 2}}"
2020-09-07 16:53:21,e83cca291112ea66f49079975e102ee36a47a24e,Bram Moolenaar,9,7,16,4,"{""src/regexp.c"": {""insertions"": 1, ""deletions"": 1, ""lines"": 2}, ""src/regexp_bt.c"": {""insertions"": 5, ""deletions"": 5, ""lines"": 10}, ""src/regexp_nfa.c"": {""insertions"": 1, ""deletions"": 1, ""lines"": 2}, ""src/version.c"": {""insertions"": 2, ""deletions"": 0, ""lines"": 2}}"
2020-09-06 20:26:57,44d6652d561d628d12e3ff7f6636ea7d1f805ced,Bram Moolenaar,63,29,92,6,"{""src/errors.h"": {""insertions"": 6, ""deletions"": 0, ""lines"": 6}, ""src/testdir/test_assert.vim"": {""insertions"": 14, ""deletions"": 0, ""lines"": 14}, ""src/testdir/test_vim9_func.vim"": {""insertions"": 1, ""deletions"": 1, ""lines"": 2}, ""src/testdir/test_vim9_script.vim"": {""insertions"": 15, ""deletions"": 15, ""lines"": 30}, ""src/testing.c"": {""insertions"": 25, ""deletions"": 13, ""lines"": 38}, ""src/version.c"": {""insertions"": 2, ""deletions"": 0, ""lines"": 2}}"
2020-09-06 19:47:48,9bd5d879c2ecfbdbb168b090e12f4b89724a302e,Bram Moolenaar,50,26,76,7,"{""runtime/doc/testing.txt"": {""insertions"": 5, ""deletions"": 1, ""lines"": 6}, ""src/evalfunc.c"": {""insertions"": 1, ""deletions"": 1, ""lines"": 2}, ""src/globals.h"": {""insertions"": 1, ""deletions"": 0, ""lines"": 1}, ""src/message.c"": {""insertions"": 3, ""deletions"": 0, ""lines"": 3}, ""src/testdir/test_vim9_func.vim"": {""insertions"": 15, ""deletions"": 15, ""lines"": 30}, ""src/testing.c"": {""insertions"": 23, ""deletions"": 9, ""lines"": 32}, ""src/version.c"": {""insertions"": 2, ""deletions"": 0, ""lines"": 2}}"
2020-09-06 19:13:00,c98cdb3bc970f04f93b4c394b4ec94c2eb5546c3,Bram Moolenaar,5,3,8,3,"{""src/testdir/test_terminal.vim"": {""insertions"": 1, ""deletions"": 1, ""lines"": 2}, ""src/testdir/test_terminal2.vim"": {""insertions"": 2, ""deletions"": 2, ""lines"": 4}, ""src/version.c"": {""insertions"": 2, ""deletions"": 0, ""lines"": 2}}"
2020-09-06 18:06:59,63969ef07e99502744114717cb7d63bd4c6e7eae,Bram Moolenaar,18,8,26,2,"{""src/testdir/test_vim9_func.vim"": {""insertions"": 16, ""deletions"": 8, ""lines"": 24}, ""src/version.c"": {""insertions"": 2, ""deletions"": 0, ""lines"": 2}}"
2020-09-06 16:39:38,418155def2aa45afd7fc034db341dc874b00af3a,Bram Moolenaar,11,1,12,3,"{""src/testdir/test_vim9_func.vim"": {""insertions"": 8, ""deletions"": 0, ""lines"": 8}, ""src/time.c"": {""insertions"": 1, ""deletions"": 1, ""lines"": 2}, ""src/version.c"": {""insertions"": 2, ""deletions"": 0, ""lines"": 2}}"
2020-09-06 16:22:53,ad30470610e228e66afb837fdbab6bea36c43de4,Bram Moolenaar,28,3,31,5,"{""src/evalfunc.c"": {""insertions"": 1, ""deletions"": 1, ""lines"": 2}, ""src/job.c"": {""insertions"": 1, ""deletions"": 1, ""lines"": 2}, ""src/terminal.c"": {""insertions"": 1, ""deletions"": 1, ""lines"": 2}, ""src/testdir/test_vim9_func.vim"": {""insertions"": 23, ""deletions"": 0, ""lines"": 23}, ""src/version.c"": {""insertions"": 2, ""deletions"": 0, ""lines"": 2}}"
2020-09-06 15:13:44,707be5f3524accb8b36e80bd2532e00b8246df55,Bram Moolenaar,3,1,4,2,"{""src/testdir/test_utf8.vim"": {""insertions"": 1, ""deletions"": 1, ""lines"": 2}, ""src/version.c"": {""insertions"": 2, ""deletions"": 0, ""lines"": 2}}"
2020-09-06 15:09:12,30d6413782c8206899cee109f521895a03c76441,Bram Moolenaar,4,2,6,2,"{""src/regexp.c"": {""insertions"": 2, ""deletions"": 2, ""lines"": 4}, ""src/version.c"": {""insertions"": 2, ""deletions"": 0, ""lines"": 2}}"
2020-09-06 14:09:04,3986b94b090ea258109630008611230a599999ab,Bram Moolenaar,18,4,22,3,"{""src/evalfunc.c"": {""insertions"": 4, ""deletions"": 4, ""lines"": 8}, ""src/testdir/test_vim9_func.vim"": {""insertions"": 12, ""deletions"": 0, ""lines"": 12}, ""src/version.c"": {""insertions"": 2, ""deletions"": 0, ""lines"": 2}}"
2020-09-06 13:58:36,d2c617055ac8ff6ff244f69e23dce1f73741c5ad,Bram Moolenaar,263,261,524,7,"{""src/testdir/test_maparg.vim"": {""insertions"": 1, ""deletions"": 1, ""lines"": 2}, ""src/testdir/test_textprop.vim"": {""insertions"": 4, ""deletions"": 4, ""lines"": 8}, ""src/testdir/test_vim9_disassemble.vim"": {""insertions"": 6, ""deletions"": 6, ""lines"": 12}, ""src/testdir/test_vim9_expr.vim"": {""insertions"": 61, ""deletions"": 61, ""lines"": 122}, ""src/testdir/test_vim9_func.vim"": {""insertions"": 34, ""deletions"": 34, ""lines"": 68}, ""src/testdir/test_vim9_script.vim"": {""insertions"": 155, ""deletions"": 155, ""lines"": 310}, ""src/version.c"": {""insertions"": 2, ""deletions"": 0, ""lines"": 2}}"
2020-09-06 13:54:00,2f3cd2e4ec5617e3697ec4f4c6e1c9449061ad30,Bram Moolenaar,504,383,887,2,"{""src/ex_getln.c"": {""insertions"": 502, ""deletions"": 383, ""lines"": 885}, ""src/version.c"": {""insertions"": 2, ""deletions"": 0, ""lines"": 2}}"
2020-09-06 13:14:45,8a0dcf43305586853f452a77fa295b0c8d54b463,Bram Moolenaar,9,0,9,3,"{""src/regexp.c"": {""insertions"": 1, ""deletions"": 0, ""lines"": 1}, ""src/testdir/test_substitute.vim"": {""insertions"": 6, ""deletions"": 0, ""lines"": 6}, ""src/version.c"": {""insertions"": 2, ""deletions"": 0, ""lines"": 2}}"
2020-09-05 21:16:00,4140c4f3fff1a441f2837f2f911ab0f0368e412a,Bram Moolenaar,3,1,4,2,"{""src/search.c"": {""insertions"": 1, ""deletions"": 1, ""lines"": 2}, ""src/version.c"": {""insertions"": 2, ""deletions"": 0, ""lines"": 2}}"
2020-09-05 20:45:55,7c27f337bf278babc1ccdcb66ac975f115d660b7,Bram Moolenaar,11,1,12,3,"{""src/evalfunc.c"": {""insertions"": 1, ""deletions"": 1, ""lines"": 2}, ""src/testdir/test_vim9_func.vim"": {""insertions"": 8, ""deletions"": 0, ""lines"": 8}, ""src/version.c"": {""insertions"": 2, ""deletions"": 0, ""lines"": 2}}"
2020-09-05 20:37:39,401f0c07982247cc6d1cd22be08b05c44f7fd040,Bram Moolenaar,10,1,11,3,"{""src/quickfix.c"": {""insertions"": 1, ""deletions"": 1, ""lines"": 2}, ""src/testdir/test_vim9_func.vim"": {""insertions"": 7, ""deletions"": 0, ""lines"": 7}, ""src/version.c"": {""insertions"": 2, ""deletions"": 0, ""lines"": 2}}"
2020-09-05 19:57:53,4b9bd692bdffba03fda04f9979e25431b53e416b,Bram Moolenaar,138,126,264,3,"{""src/evalwindow.c"": {""insertions"": 2, ""deletions"": 2, ""lines"": 4}, ""src/testdir/test_vim9_func.vim"": {""insertions"": 134, ""deletions"": 124, ""lines"": 258}, ""src/version.c"": {""insertions"": 2, ""deletions"": 0, ""lines"": 2}}"
2020-09-05 19:41:56,fcb6d7082d563acc33866b3d3a659c32ad19a9e1,Bram Moolenaar,10,1,11,3,"{""src/evalfunc.c"": {""insertions"": 1, ""deletions"": 1, ""lines"": 2}, ""src/testdir/test_vim9_func.vim"": {""insertions"": 7, ""deletions"": 0, ""lines"": 7}, ""src/version.c"": {""insertions"": 2, ""deletions"": 0, ""lines"": 2}}"
2020-09-05 19:35:16,30788d3d37a90b0702d94b7272ed26672534ba6f,Bram Moolenaar,10,4,14,3,"{""src/evalfunc.c"": {""insertions"": 4, ""deletions"": 4, ""lines"": 8}, ""src/testdir/test_vim9_func.vim"": {""insertions"": 4, ""deletions"": 0, ""lines"": 4}, ""src/version.c"": {""insertions"": 2, ""deletions"": 0, ""lines"": 2}}"
2020-09-05 19:21:16,597aaac9d2b090e0eb738ab4e2afd454b7b92393,Bram Moolenaar,18,8,26,3,"{""src/search.c"": {""insertions"": 2, ""deletions"": 8, ""lines"": 10}, ""src/testdir/test_vim9_func.vim"": {""insertions"": 14, ""deletions"": 0, ""lines"": 14}, ""src/version.c"": {""insertions"": 2, ""deletions"": 0, ""lines"": 2}}"
2020-09-05 19:00:00,fa2e38df76b3e0919dc01dd1836257dce0ba62b1,Bram Moolenaar,16,3,19,3,"{""src/testdir/test_textprop.vim"": {""insertions"": 11, ""deletions"": 0, ""lines"": 11}, ""src/textprop.c"": {""insertions"": 3, ""deletions"": 3, ""lines"": 6}, ""src/version.c"": {""insertions"": 2, ""deletions"": 0, ""lines"": 2}}"
2020-09-05 18:50:49,a5a40c569695a750cace7d29824101ec8ef2b48f,Bram Moolenaar,16,8,24,3,"{""src/testdir/test_textprop.vim"": {""insertions"": 9, ""deletions"": 0, ""lines"": 9}, ""src/textprop.c"": {""insertions"": 5, ""deletions"": 8, ""lines"": 13}, ""src/version.c"": {""insertions"": 2, ""deletions"": 0, ""lines"": 2}}"
2020-09-05 18:29:41,ed6a430fae72c077ec106c9620379b69cfec3035,Bram Moolenaar,7,1,8,3,"{""src/evalfunc.c"": {""insertions"": 1, ""deletions"": 1, ""lines"": 2}, ""src/testdir/test_vim9_func.vim"": {""insertions"": 4, ""deletions"": 0, ""lines"": 4}, ""src/version.c"": {""insertions"": 2, ""deletions"": 0, ""lines"": 2}}"
2020-09-05 18:16:57,a48f786787e8e070c1a611146fd1f0f7e141e60a,Bram Moolenaar,11,2,13,4,"{""src/evalfunc.c"": {""insertions"": 1, ""deletions"": 1, ""lines"": 2}, ""src/list.c"": {""insertions"": 1, ""deletions"": 1, ""lines"": 2}, ""src/testdir/test_vim9_func.vim"": {""insertions"": 7, ""deletions"": 0, ""lines"": 7}, ""src/version.c"": {""insertions"": 2, ""deletions"": 0, ""lines"": 2}}"
2020-09-05 18:06:33,7918238528090cd019dc19613dbe76923ac9a1d7,Bram Moolenaar,23,10,33,2,"{""src/testdir/test_vim9_expr.vim"": {""insertions"": 21, ""deletions"": 10, ""lines"": 31}, ""src/version.c"": {""insertions"": 2, ""deletions"": 0, ""lines"": 2}}"
2020-09-05 17:59:39,15183b41c4416b7638cce26de0a9a83e55948bdc,Bram Moolenaar,7,3,10,2,"{""src/getchar.c"": {""insertions"": 5, ""deletions"": 3, ""lines"": 8}, ""src/version.c"": {""insertions"": 2, ""deletions"": 0, ""lines"": 2}}"
2020-09-05 16:48:57,636c5d5399e1a42e8eb5bcb5fede318438d2347a,Bram Moolenaar,4,0,4,2,"{""src/testdir/test_vim9_func.vim"": {""insertions"": 2, ""deletions"": 0, ""lines"": 2}, ""src/version.c"": {""insertions"": 2, ""deletions"": 0, ""lines"": 2}}"
2020-09-05 16:45:29,04637e243d39f791cfc97c3ce96d99ef1bf047e1,Bram Moolenaar,7,1,8,3,"{""src/evalfunc.c"": {""insertions"": 1, ""deletions"": 1, ""lines"": 2}, ""src/testdir/test_vim9_func.vim"": {""insertions"": 4, ""deletions"": 0, ""lines"": 4}, ""src/version.c"": {""insertions"": 2, ""deletions"": 0, ""lines"": 2}}"
2020-09-05 16:40:44,b02628b8a20ad0c42a097207b3b49ae5169d04d7,Bram Moolenaar,3,1,4,2,"{"".github/CODEOWNERS"": {""insertions"": 1, ""deletions"": 1, ""lines"": 2}, ""src/version.c"": {""insertions"": 2, ""deletions"": 0, ""lines"": 2}}"
2020-09-05 16:31:33,d217a87755ba01fc626b1c178c682fcd05ab3a28,Bram Moolenaar,10,1,11,3,"{""src/cmdexpand.c"": {""insertions"": 1, ""deletions"": 1, ""lines"": 2}, ""src/testdir/test_vim9_func.vim"": {""insertions"": 7, ""deletions"": 0, ""lines"": 7}, ""src/version.c"": {""insertions"": 2, ""deletions"": 0, ""lines"": 2}}"
2020-09-05 15:51:23,c08cc72947fdfab484f53c5d9bbea662bc5a9c8f,Bram Moolenaar,7,1,8,3,"{""src/getchar.c"": {""insertions"": 1, ""deletions"": 1, ""lines"": 2}, ""src/testdir/test_vim9_func.vim"": {""insertions"": 4, ""deletions"": 0, ""lines"": 4}, ""src/version.c"": {""insertions"": 2, ""deletions"": 0, ""lines"": 2}}"
2020-09-05 15:37:07,036c2cf719e3de445779a275514030be66e26883,Bram Moolenaar,14,15,29,3,"{""src/evalbuffer.c"": {""insertions"": 4, ""deletions"": 14, ""lines"": 18}, ""src/testdir/test_vim9_func.vim"": {""insertions"": 8, ""deletions"": 1, ""lines"": 9}, ""src/version.c"": {""insertions"": 2, ""deletions"": 0, ""lines"": 2}}"
2020-09-05 15:30:44,2df47310422f4a77e85de7901a5299923a1addd3,Bram Moolenaar,7,1,8,3,"{""src/evalfunc.c"": {""insertions"": 1, ""deletions"": 1, ""lines"": 2}, ""src/testdir/test_vim9_func.vim"": {""insertions"": 4, ""deletions"": 0, ""lines"": 4}, ""src/version.c"": {""insertions"": 2, ""deletions"": 0, ""lines"": 2}}"
2020-09-05 15:18:28,44b4a246b62e0622550b963bcf3034dce3bcfc0c,Bram Moolenaar,6,2,8,4,"{""src/evalfunc.c"": {""insertions"": 1, ""deletions"": 1, ""lines"": 2}, ""src/testdir/test_listdict.vim"": {""insertions"": 1, ""deletions"": 1, ""lines"": 2}, ""src/testdir/test_vim9_func.vim"": {""insertions"": 2, ""deletions"": 0, ""lines"": 2}, ""src/version.c"": {""insertions"": 2, ""deletions"": 0, ""lines"": 2}}"
2020-09-05 15:03:40,59941cbd8035415d68683edc4e571306b10669ad,Bram Moolenaar,21,1,22,3,"{""src/quickfix.c"": {""insertions"": 1, ""deletions"": 1, ""lines"": 2}, ""src/testdir/test_quickfix.vim"": {""insertions"": 18, ""deletions"": 0, ""lines"": 18}, ""src/version.c"": {""insertions"": 2, ""deletions"": 0, ""lines"": 2}}"
2020-09-05 14:08:49,2ce14589f210dcb3d17d1d80285256f8ac10abab,Bram Moolenaar,26,10,36,3,"{""src/terminal.c"": {""insertions"": 14, ""deletions"": 10, ""lines"": 24}, ""src/testdir/test_terminal2.vim"": {""insertions"": 10, ""deletions"": 0, ""lines"": 10}, ""src/version.c"": {""insertions"": 2, ""deletions"": 0, ""lines"": 2}}"
2020-09-05 13:48:51,8b5866ded6036f7adece26b6d16962bbd2d47842,Bram Moolenaar,2131,2089,4220,15,"{""Filelist"": {""insertions"": 2, ""deletions"": 0, ""lines"": 2}, ""src/Make_cyg_ming.mak"": {""insertions"": 1, ""deletions"": 1, ""lines"": 2}, ""src/Make_mvc.mak"": {""insertions"": 7, ""deletions"": 5, ""lines"": 12}, ""src/Makefile"": {""insertions"": 9, ""deletions"": 1, ""lines"": 10}, ""src/auto/configure"": {""insertions"": 2, ""deletions"": 2, ""lines"": 4}, ""src/channel.c"": {""insertions"": 133, ""deletions"": 1970, ""lines"": 2103}, ""src/configure.ac"": {""insertions"": 2, ""deletions"": 2, ""lines"": 4}, ""src/edit.c"": {""insertions"": 9, ""deletions"": 75, ""lines"": 84}, ""src/globals.h"": {""insertions"": 3, ""deletions"": 0, ""lines"": 3}, ""src/job.c"": {""insertions"": 1918, ""deletions"": 0, ""lines"": 1918}, ""src/proto.h"": {""insertions"": 1, ""deletions"": 0, ""lines"": 1}, ""src/proto/channel.pro"": {""insertions"": 4, ""deletions"": 30, ""lines"": 34}, ""src/proto/edit.pro"": {""insertions"": 1, ""deletions"": 3, ""lines"": 4}, ""src/proto/job.pro"": {""insertions"": 37, ""deletions"": 0, ""lines"": 37}, ""src/version.c"": {""insertions"": 2, ""deletions"": 0, ""lines"": 2}}"
2020-09-05 13:05:30,7dfc5ce7cf4a7f63370d7dce2e13f7410ca0230a,Bram Moolenaar,3,1,4,2,"{""src/testdir/test_terminal3.vim"": {""insertions"": 1, ""deletions"": 1, ""lines"": 2}, ""src/version.c"": {""insertions"": 2, ""deletions"": 0, ""lines"": 2}}"
2020-09-05 12:27:24,86394aa9720c5e087d85831e42d44e042987fbc0,Bram Moolenaar,73,4,77,6,"{""src/edit.c"": {""insertions"": 6, ""deletions"": 0, ""lines"": 6}, ""src/globals.h"": {""insertions"": 4, ""deletions"": 0, ""lines"": 4}, ""src/normal.c"": {""insertions"": 6, ""deletions"": 0, ""lines"": 6}, ""src/optionstr.c"": {""insertions"": 3, ""deletions"": 0, ""lines"": 3}, ""src/term.c"": {""insertions"": 52, ""deletions"": 4, ""lines"": 56}, ""src/version.c"": {""insertions"": 2, ""deletions"": 0, ""lines"": 2}}"
2020-09-05 11:48:58,cf8aa6448b3520905bea528ea8ad6533cbef288d,Bram Moolenaar,53,0,53,3,"{"".github/CODEOWNERS"": {""insertions"": 50, ""deletions"": 0, ""lines"": 50}, ""Filelist"": {""insertions"": 1, ""deletions"": 0, ""lines"": 1}, ""src/version.c"": {""insertions"": 2, ""deletions"": 0, ""lines"": 2}}"
2020-09-04 19:18:46,e2e4075fad1326181edc5a131e48c644ef613693,Bram Moolenaar,172,170,342,43,"{""src/testdir/test_assert.vim"": {""insertions"": 2, ""deletions"": 2, ""lines"": 4}, ""src/testdir/test_autocmd.vim"": {""insertions"": 11, ""deletions"": 11, ""lines"": 22}, ""src/testdir/test_backspace_opt.vim"": {""insertions"": 5, ""deletions"": 5, ""lines"": 10}, ""src/testdir/test_channel.vim"": {""insertions"": 2, ""deletions"": 2, ""lines"": 4}, ""src/testdir/test_clientserver.vim"": {""insertions"": 1, ""deletions"": 1, ""lines"": 2}, ""src/testdir/test_cmdline.vim"": {""insertions"": 1, ""deletions"": 1, ""lines"": 2}, ""src/testdir/test_const.vim"": {""insertions"": 2, ""deletions"": 2, ""lines"": 4}, ""src/testdir/test_cscope.vim"": {""insertions"": 3, ""deletions"": 3, ""lines"": 6}, ""src/testdir/test_eval_stuff.vim"": {""insertions"": 3, ""deletions"": 3, ""lines"": 6}, ""src/testdir/test_functions.vim"": {""insertions"": 1, ""deletions"": 1, ""lines"": 2}, ""src/testdir/test_global.vim"": {""insertions"": 1, ""deletions"": 1, ""lines"": 2}, ""src/testdir/test_gui.vim"": {""insertions"": 1, ""deletions"": 1, ""lines"": 2}, ""src/testdir/test_hlsearch.vim"": {""insertions"": 1, ""deletions"": 1, ""lines"": 2}, ""src/testdir/test_lambda.vim"": {""insertions"": 1, ""deletions"": 1, ""lines"": 2}, ""src/testdir/test_let.vim"": {""insertions"": 4, ""deletions"": 4, ""lines"": 8}, ""src/testdir/test_listdict.vim"": {""insertions"": 18, ""deletions"": 18, ""lines"": 36}, ""src/testdir/test_move.vim"": {""insertions"": 2, ""deletions"": 2, ""lines"": 4}, ""src/testdir/test_normal.vim"": {""insertions"": 10, ""deletions"": 10, ""lines"": 20}, ""src/testdir/test_popupwin.vim"": {""insertions"": 2, ""deletions"": 2, ""lines"": 4}, ""src/testdir/test_put.vim"": {""insertions"": 7, ""deletions"": 7, ""lines"": 14}, ""src/testdir/test_quickfix.vim"": {""insertions"": 12, ""deletions"": 12, ""lines"": 24}, ""src/testdir/test_rename.vim"": {""insertions"": 2, ""deletions"": 2, ""lines"": 4}, ""src/testdir/test_search.vim"": {""insertions"": 4, ""deletions"": 4, ""lines"": 8}, ""src/testdir/test_signs.vim"": {""insertions"": 1, ""deletions"": 1, ""lines"": 2}, ""src/testdir/test_substitute.vim"": {""insertions"": 2, ""deletions"": 2, ""lines"": 4}, ""src/testdir/test_syntax.vim"": {""insertions"": 3, ""deletions"": 3, ""lines"": 6}, ""src/testdir/test_tagfunc.vim"": {""insertions"": 1, ""deletions"": 1, ""lines"": 2}, ""src/testdir/test_tagjump.vim"": {""insertions"": 7, ""deletions"": 7, ""lines"": 14}, ""src/testdir/test_taglist.vim"": {""insertions"": 1, ""deletions"": 1, ""lines"": 2}, ""src/testdir/test_terminal.vim"": {""insertions"": 10, ""deletions"": 10, ""lines"": 20}, ""src/testdir/test_terminal2.vim"": {""insertions"": 3, ""deletions"": 3, ""lines"": 6}, ""src/testdir/test_textprop.vim"": {""insertions"": 2, ""deletions"": 2, ""lines"": 4}, ""src/testdir/test_timers.vim"": {""insertions"": 2, ""deletions"": 2, ""lines"": 4}, ""src/testdir/test_true_false.vim"": {""insertions"": 4, ""deletions"": 4, ""lines"": 8}, ""src/testdir/test_user_func.vim"": {""insertions"": 4, ""deletions"": 4, ""lines"": 8}, ""src/testdir/test_vim9_func.vim"": {""insertions"": 3, ""deletions"": 3, ""lines"": 6}, ""src/testdir/test_vim9_script.vim"": {""insertions"": 2, ""deletions"": 2, ""lines"": 4}, ""src/testdir/test_vimscript.vim"": {""insertions"": 19, ""deletions"": 19, ""lines"": 38}, ""src/testdir/test_winbar.vim"": {""insertions"": 1, ""deletions"": 1, ""lines"": 2}, ""src/testdir/test_winbuf_close.vim"": {""insertions"": 4, ""deletions"": 4, ""lines"": 8}, ""src/testdir/test_window_cmd.vim"": {""insertions"": 4, ""deletions"": 4, ""lines"": 8}, ""src/testdir/test_writefile.vim"": {""insertions"": 1, ""deletions"": 1, ""lines"": 2}, ""src/version.c"": {""insertions"": 2, ""deletions"": 0, ""lines"": 2}}"
2020-09-04 17:50:57,24f7750ffa9730579736d779b7cc94faff325fc1,Bram Moolenaar,7,1,8,3,"{""src/evalfunc.c"": {""insertions"": 1, ""deletions"": 1, ""lines"": 2}, ""src/testdir/test_vim9_func.vim"": {""insertions"": 4, ""deletions"": 0, ""lines"": 4}, ""src/version.c"": {""insertions"": 2, ""deletions"": 0, ""lines"": 2}}"
2020-09-04 16:38:06,c05d1c043a25c7a52dbf0a740d3f715a9d2691f7,Bram Moolenaar,8,6,14,3,"{""src/testdir/test_functions.vim"": {""insertions"": 4, ""deletions"": 4, ""lines"": 8}, ""src/testdir/test_quickfix.vim"": {""insertions"": 2, ""deletions"": 2, ""lines"": 4}, ""src/version.c"": {""insertions"": 2, ""deletions"": 0, ""lines"": 2}}"
2020-09-04 16:35:26,fe136c9a85412f4bdb5de70ef8416af5fa382b28,Bram Moolenaar,7,1,8,3,"{""src/evalbuffer.c"": {""insertions"": 1, ""deletions"": 1, ""lines"": 2}, ""src/testdir/test_vim9_func.vim"": {""insertions"": 4, ""deletions"": 0, ""lines"": 4}, ""src/version.c"": {""insertions"": 2, ""deletions"": 0, ""lines"": 2}}"
2020-09-04 16:34:09,b936b79424d435b83cdebed5507a9d3800e66e6c,Bram Moolenaar,74,24,98,4,"{""src/terminal.c"": {""insertions"": 36, ""deletions"": 15, ""lines"": 51}, ""src/testdir/term_util.vim"": {""insertions"": 8, ""deletions"": 6, ""lines"": 14}, ""src/testdir/test_terminal2.vim"": {""insertions"": 28, ""deletions"": 3, ""lines"": 31}, ""src/version.c"": {""insertions"": 2, ""deletions"": 0, ""lines"": 2}}"
2020-09-04 14:35:35,077cc7aa0e0c431e97795612374fe17fe7c88803,Bram Moolenaar,97,6,103,10,"{""runtime/doc/channel.txt"": {""insertions"": 8, ""deletions"": 2, ""lines"": 10}, ""runtime/doc/eval.txt"": {""insertions"": 13, ""deletions"": 1, ""lines"": 14}, ""runtime/doc/usr_41.txt"": {""insertions"": 1, ""deletions"": 0, ""lines"": 1}, ""src/channel.c"": {""insertions"": 23, ""deletions"": 0, ""lines"": 23}, ""src/edit.c"": {""insertions"": 13, ""deletions"": 3, ""lines"": 16}, ""src/evalfunc.c"": {""insertions"": 1, ""deletions"": 0, ""lines"": 1}, ""src/proto/channel.pro"": {""insertions"": 1, ""deletions"": 0, ""lines"": 1}, ""src/proto/edit.pro"": {""insertions"": 1, ""deletions"": 0, ""lines"": 1}, ""src/testdir/test_prompt_buffer.vim"": {""insertions"": 34, ""deletions"": 0, ""lines"": 34}, ""src/version.c"": {""insertions"": 2, ""deletions"": 0, ""lines"": 2}}"
2020-09-04 13:37:31,eadee486c70946ad0e1746d77898d6f4f4acc817,Bram Moolenaar,258,213,471,4,"{""src/cmdexpand.c"": {""insertions"": 249, ""deletions"": 0, ""lines"": 249}, ""src/ex_getln.c"": {""insertions"": 4, ""deletions"": 213, ""lines"": 217}, ""src/proto/cmdexpand.pro"": {""insertions"": 3, ""deletions"": 0, ""lines"": 3}, ""src/version.c"": {""insertions"": 2, ""deletions"": 0, ""lines"": 2}}"
2020-09-04 12:41:21,fe6dce873954a216eedb686bd5006710ffff4b89,Bram Moolenaar,44,0,44,2,"{""src/testdir/test_window_cmd.vim"": {""insertions"": 42, ""deletions"": 0, ""lines"": 42}, ""src/version.c"": {""insertions"": 2, ""deletions"": 0, ""lines"": 2}}"
2020-09-04 11:53:00,fa57335e532e505ce9229ddb2354a593fb057561,Bram Moolenaar,110,21,131,7,"{""src/po/Make_cyg.mak"": {""insertions"": 33, ""deletions"": 7, ""lines"": 40}, ""src/po/Make_ming.mak"": {""insertions"": 37, ""deletions"": 7, ""lines"": 44}, ""src/po/Make_mvc.mak"": {""insertions"": 33, ""deletions"": 3, ""lines"": 36}, ""src/po/Makefile"": {""insertions"": 2, ""deletions"": 1, ""lines"": 3}, ""src/po/README.txt"": {""insertions"": 2, ""deletions"": 2, ""lines"": 4}, ""src/po/fixfilenames.vim"": {""insertions"": 1, ""deletions"": 1, ""lines"": 2}, ""src/version.c"": {""insertions"": 2, ""deletions"": 0, ""lines"": 2}}"
2020-09-03 20:33:44,eb24556df3b16a19009ee3ddee8ae94dc058a3b2,Bram Moolenaar,18,13,31,3,"{""src/testdir/test_textprop.vim"": {""insertions"": 15, ""deletions"": 10, ""lines"": 25}, ""src/textprop.c"": {""insertions"": 1, ""deletions"": 3, ""lines"": 4}, ""src/version.c"": {""insertions"": 2, ""deletions"": 0, ""lines"": 2}}"
2020-09-03 17:50:05,18eedfa40b45b1de955d61417e9918ef7d6e83f9,Bram Moolenaar,13,0,13,2,"{""src/Make_cyg_ming.mak"": {""insertions"": 11, ""deletions"": 0, ""lines"": 11}, ""src/version.c"": {""insertions"": 2, ""deletions"": 0, ""lines"": 2}}"
2020-09-03 17:25:11,7ca86fe8dc584141d6a73408acf3e90d8c88c7b9,Bram Moolenaar,16,0,16,3,"{""src/os_win32.c"": {""insertions"": 7, ""deletions"": 0, ""lines"": 7}, ""src/ui.c"": {""insertions"": 7, ""deletions"": 0, ""lines"": 7}, ""src/version.c"": {""insertions"": 2, ""deletions"": 0, ""lines"": 2}}"
2020-09-03 16:52:24,1f42f5a675fdab9ce5cdafbecea59c45e81f7ff8,Bram Moolenaar,15,1,16,3,"{""src/evalwindow.c"": {""insertions"": 1, ""deletions"": 1, ""lines"": 2}, ""src/testdir/test_popupwin.vim"": {""insertions"": 12, ""deletions"": 0, ""lines"": 12}, ""src/version.c"": {""insertions"": 2, ""deletions"": 0, ""lines"": 2}}"
2020-09-03 14:50:13,a60053b8f4cc7e135ba9496a8f4855d26aee09e7,Bram Moolenaar,74,12,86,7,"{""src/ex_getln.c"": {""insertions"": 12, ""deletions"": 12, ""lines"": 24}, ""src/testdir/dumps/Test_wildmenu_1.dump"": {""insertions"": 8, ""deletions"": 0, ""lines"": 8}, ""src/testdir/dumps/Test_wildmenu_2.dump"": {""insertions"": 8, ""deletions"": 0, ""lines"": 8}, ""src/testdir/dumps/Test_wildmenu_3.dump"": {""insertions"": 8, ""deletions"": 0, ""lines"": 8}, ""src/testdir/dumps/Test_wildmenu_4.dump"": {""insertions"": 8, ""deletions"": 0, ""lines"": 8}, ""src/testdir/test_cmdline.vim"": {""insertions"": 28, ""deletions"": 0, ""lines"": 28}, ""src/version.c"": {""insertions"": 2, ""deletions"": 0, ""lines"": 2}}"
2020-09-03 14:05:04,5b5aa11801c75fac18a587bea02dc7a8b5b90c4b,Bram Moolenaar,28,8,36,2,"{"".travis.yml"": {""insertions"": 26, ""deletions"": 8, ""lines"": 34}, ""src/version.c"": {""insertions"": 2, ""deletions"": 0, ""lines"": 2}}"
2020-09-02 20:33:24,62f93f4ec9db1deca088bab7783a35306e2ed4cb,Bram Moolenaar,13,8,21,3,"{""src/popupwin.c"": {""insertions"": 1, ""deletions"": 1, ""lines"": 2}, ""src/testdir/test_popupwin.vim"": {""insertions"": 10, ""deletions"": 7, ""lines"": 17}, ""src/version.c"": {""insertions"": 2, ""deletions"": 0, ""lines"": 2}}"
2020-09-02 20:25:35,04d594b9c14299ed50da0774fb8d3a10fbc4076f,Bram Moolenaar,44,3,47,4,"{""src/evalfunc.c"": {""insertions"": 1, ""deletions"": 1, ""lines"": 2}, ""src/map.c"": {""insertions"": 2, ""deletions"": 2, ""lines"": 4}, ""src/testdir/test_vim9_func.vim"": {""insertions"": 39, ""deletions"": 0, ""lines"": 39}, ""src/version.c"": {""insertions"": 2, ""deletions"": 0, ""lines"": 2}}"
2020-09-02 20:10:34,6c553f9c04a698ac2e19584f8ea8e2cb7cd98c80,Bram Moolenaar,7,1,8,3,"{""src/evalfunc.c"": {""insertions"": 1, ""deletions"": 1, ""lines"": 2}, ""src/testdir/test_vim9_func.vim"": {""insertions"": 4, ""deletions"": 0, ""lines"": 4}, ""src/version.c"": {""insertions"": 2, ""deletions"": 0, ""lines"": 2}}"
2020-09-02 19:57:07,f966ce5ea24748eed10f708d4f828be44887a559,Bram Moolenaar,9,3,12,3,"{""src/filepath.c"": {""insertions"": 3, ""deletions"": 3, ""lines"": 6}, ""src/testdir/test_vim9_func.vim"": {""insertions"": 4, ""deletions"": 0, ""lines"": 4}, ""src/version.c"": {""insertions"": 2, ""deletions"": 0, ""lines"": 2}}"
2020-09-02 19:53:11,5892ea151197c8a6363c7ce2322d84277b97353e,Bram Moolenaar,9,3,12,3,"{""src/filepath.c"": {""insertions"": 3, ""deletions"": 3, ""lines"": 6}, ""src/testdir/test_vim9_func.vim"": {""insertions"": 4, ""deletions"": 0, ""lines"": 4}, ""src/version.c"": {""insertions"": 2, ""deletions"": 0, ""lines"": 2}}"
2020-09-02 19:45:54,67ff97ded70a87bc77f58d0bf9a261710ae88112,Bram Moolenaar,10,2,12,3,"{""src/evalfunc.c"": {""insertions"": 2, ""deletions"": 2, ""lines"": 4}, ""src/testdir/test_vim9_func.vim"": {""insertions"": 6, ""deletions"": 0, ""lines"": 6}, ""src/version.c"": {""insertions"": 2, ""deletions"": 0, ""lines"": 2}}"
2020-09-02 19:37:56,551d25e76545df785a9f62df52f34bc1dd368bfb,Bram Moolenaar,10,2,12,3,"{""src/evalfunc.c"": {""insertions"": 2, ""deletions"": 2, ""lines"": 4}, ""src/testdir/test_vim9_func.vim"": {""insertions"": 6, ""deletions"": 0, ""lines"": 6}, ""src/version.c"": {""insertions"": 2, ""deletions"": 0, ""lines"": 2}}"
2020-09-02 19:31:22,119f5572306c4abba91eaf446c0c52637db223e8,Bram Moolenaar,8,2,10,4,"{""src/list.c"": {""insertions"": 1, ""deletions"": 1, ""lines"": 2}, ""src/testdir/test_vim9_func.vim"": {""insertions"": 5, ""deletions"": 0, ""lines"": 5}, ""src/typval.c"": {""insertions"": 0, ""deletions"": 1, ""lines"": 1}, ""src/version.c"": {""insertions"": 2, ""deletions"": 0, ""lines"": 2}}"
2020-09-02 19:21:35,9d8bfae50fdaf5f5ec6307c60ebd1fad0927c6be,Bram Moolenaar,17,7,24,5,"{""src/auto/configure"": {""insertions"": 6, ""deletions"": 4, ""lines"": 10}, ""src/configure.ac"": {""insertions"": 2, ""deletions"": 2, ""lines"": 4}, ""src/fileio.c"": {""insertions"": 5, ""deletions"": 0, ""lines"": 5}, ""src/globals.h"": {""insertions"": 2, ""deletions"": 1, ""lines"": 3}, ""src/version.c"": {""insertions"": 2, ""deletions"": 0, ""lines"": 2}}"
2020-09-02 19:02:35,a5d3841177e0b3545381c875d0b4b442f38784bd,Bram Moolenaar,36,6,42,3,"{""src/evalfunc.c"": {""insertions"": 1, ""deletions"": 6, ""lines"": 7}, ""src/testdir/test_vim9_func.vim"": {""insertions"": 33, ""deletions"": 0, ""lines"": 33}, ""src/version.c"": {""insertions"": 2, ""deletions"": 0, ""lines"": 2}}"
2020-09-02 17:59:00,4da7a259f6b28a4f855a6fa7d0ede5e038600154,Bram Moolenaar,20,2,22,3,"{""src/testdir/test_textprop.vim"": {""insertions"": 16, ""deletions"": 0, ""lines"": 16}, ""src/textprop.c"": {""insertions"": 2, ""deletions"": 2, ""lines"": 4}, ""src/version.c"": {""insertions"": 2, ""deletions"": 0, ""lines"": 2}}"
2020-09-02 17:23:06,6efa46f4efd226f65634ba8eb6ddee54de1de563,Bram Moolenaar,13,3,16,2,"{""src/Makefile"": {""insertions"": 11, ""deletions"": 3, ""lines"": 14}, ""src/version.c"": {""insertions"": 2, ""deletions"": 0, ""lines"": 2}}"
2020-09-02 15:08:59,4488f5a545691ca4c8802bad0d70a5e750fc8844,Bram Moolenaar,7,3,10,3,"{""runtime/filetype.vim"": {""insertions"": 3, ""deletions"": 3, ""lines"": 6}, ""src/testdir/test_filetype.vim"": {""insertions"": 2, ""deletions"": 0, ""lines"": 2}, ""src/version.c"": {""insertions"": 2, ""deletions"": 0, ""lines"": 2}}"
2020-09-02 10:58:48,e90d63ea904187ecbb09d0f7f21b71b302b30644,Bram Moolenaar,3,2,5,2,"{""src/spellfile.c"": {""insertions"": 1, ""deletions"": 2, ""lines"": 3}, ""src/version.c"": {""insertions"": 2, ""deletions"": 0, ""lines"": 2}}"
2020-09-02 08:25:45,4ad739fc053c1666d07ba1cf59be26cb1c3e52d7,Bram Moolenaar,15,8,23,4,"{""src/spellfile.c"": {""insertions"": 8, ""deletions"": 4, ""lines"": 12}, ""src/spellsuggest.c"": {""insertions"": 3, ""deletions"": 3, ""lines"": 6}, ""src/version.c"": {""insertions"": 2, ""deletions"": 0, ""lines"": 2}, ""src/viminfo.c"": {""insertions"": 2, ""deletions"": 1, ""lines"": 3}}"
2020-09-01 21:16:32,6f84b6db10ab86bca85e33f3fc6ee735eec8bbe5,Bram Moolenaar,7,7,14,3,"{""src/evalvars.c"": {""insertions"": 2, ""deletions"": 7, ""lines"": 9}, ""src/testdir/test_vim9_func.vim"": {""insertions"": 3, ""deletions"": 0, ""lines"": 3}, ""src/version.c"": {""insertions"": 2, ""deletions"": 0, ""lines"": 2}}"
2020-09-01 21:06:01,3767e3a3302d745349eff8cfe45411f03e13de43,Bram Moolenaar,32,29,61,5,"{""src/evalbuffer.c"": {""insertions"": 5, ""deletions"": 29, ""lines"": 34}, ""src/proto/typval.pro"": {""insertions"": 1, ""deletions"": 0, ""lines"": 1}, ""src/testdir/test_vim9_func.vim"": {""insertions"": 5, ""deletions"": 0, ""lines"": 5}, ""src/typval.c"": {""insertions"": 19, ""deletions"": 0, ""lines"": 19}, ""src/version.c"": {""insertions"": 2, ""deletions"": 0, ""lines"": 2}}"
2020-09-01 19:21:24,81fcb67fb32a12414512b72e691a1bbbff9f8511,Bram Moolenaar,3,1,4,2,"{""src/fold.c"": {""insertions"": 1, ""deletions"": 1, ""lines"": 2}, ""src/version.c"": {""insertions"": 2, ""deletions"": 0, ""lines"": 2}}"
2020-09-01 17:56:15,9c2b06637b32742cac11bfd66b1a4e84583c6c2e,Bram Moolenaar,26,14,40,6,"{""src/eval.c"": {""insertions"": 1, ""deletions"": 1, ""lines"": 2}, ""src/fold.c"": {""insertions"": 12, ""deletions"": 10, ""lines"": 22}, ""src/spellfile.c"": {""insertions"": 1, ""deletions"": 1, ""lines"": 2}, ""src/spellsuggest.c"": {""insertions"": 2, ""deletions"": 0, ""lines"": 2}, ""src/version.c"": {""insertions"": 2, ""deletions"": 0, ""lines"": 2}, ""src/vim9compile.c"": {""insertions"": 8, ""deletions"": 2, ""lines"": 10}}"
2020-09-01 15:50:51,ca563b9b948aec18463c26e9f87ae7933571b40e,Bram Moolenaar,8,7,15,2,"{"".travis.yml"": {""insertions"": 6, ""deletions"": 7, ""lines"": 13}, ""src/version.c"": {""insertions"": 2, ""deletions"": 0, ""lines"": 2}}"
2020-08-31 21:18:00,2f1228463aa9ff62814f9732561b1849e5f01f75,Bram Moolenaar,3,0,3,2,"{""src/sign.c"": {""insertions"": 1, ""deletions"": 0, ""lines"": 1}, ""src/version.c"": {""insertions"": 2, ""deletions"": 0, ""lines"": 2}}"
2020-08-31 20:16:08,997cd1a17f030d004b334d17cf1c1c57050c9906,Bram Moolenaar,18,1,19,3,"{""src/quickfix.c"": {""insertions"": 1, ""deletions"": 1, ""lines"": 2}, ""src/testdir/test_quickfix.vim"": {""insertions"": 15, ""deletions"": 0, ""lines"": 15}, ""src/version.c"": {""insertions"": 2, ""deletions"": 0, ""lines"": 2}}"
2020-08-31 20:00:05,39f7aa3c3124065b50f182b1d2f7ac92a0918656,Bram Moolenaar,49,4,53,8,"{""runtime/doc/sign.txt"": {""insertions"": 5, ""deletions"": 1, ""lines"": 6}, ""runtime/pack/dist/opt/termdebug/plugin/termdebug.vim"": {""insertions"": 2, ""deletions"": 2, ""lines"": 4}, ""src/drawline.c"": {""insertions"": 13, ""deletions"": 1, ""lines"": 14}, ""src/structs.h"": {""insertions"": 1, ""deletions"": 0, ""lines"": 1}, ""src/testdir/dumps/Test_sign_cursor_5.dump"": {""insertions"": 6, ""deletions"": 0, ""lines"": 6}, ""src/testdir/dumps/Test_sign_cursor_6.dump"": {""insertions"": 6, ""deletions"": 0, ""lines"": 6}, ""src/testdir/test_signs.vim"": {""insertions"": 14, ""deletions"": 0, ""lines"": 14}, ""src/version.c"": {""insertions"": 2, ""deletions"": 0, ""lines"": 2}}"
2020-08-31 19:30:32,7d6979608ee83b06ccfab2589da3047b143defae,Bram Moolenaar,15,8,23,5,"{"".github/workflows/ci-windows.yaml"": {""insertions"": 5, ""deletions"": 4, ""lines"": 9}, ""src/testdir/runtest.vim"": {""insertions"": 2, ""deletions"": 0, ""lines"": 2}, ""src/testdir/test_python2.vim"": {""insertions"": 3, ""deletions"": 2, ""lines"": 5}, ""src/testdir/test_python3.vim"": {""insertions"": 3, ""deletions"": 2, ""lines"": 5}, ""src/version.c"": {""insertions"": 2, ""deletions"": 0, ""lines"": 2}}"
2020-08-31 19:22:40,07e87e9eb5e7195d47d47c0ca752b6c8372a99ea,Bram Moolenaar,5,0,5,2,"{""src/fold.c"": {""insertions"": 3, ""deletions"": 0, ""lines"": 3}, ""src/version.c"": {""insertions"": 2, ""deletions"": 0, ""lines"": 2}}"
2020-08-31 19:15:02,2c93c685e3334c50d9a748ad699df727a4501b08,Bram Moolenaar,29,21,50,2,"{""src/fold.c"": {""insertions"": 27, ""deletions"": 21, ""lines"": 48}, ""src/version.c"": {""insertions"": 2, ""deletions"": 0, ""lines"": 2}}"
2020-08-31 17:58:13,64f37d309025a65210dbc33823ec9ec5d547775f,Bram Moolenaar,25,11,36,2,"{""src/fold.c"": {""insertions"": 23, ""deletions"": 11, ""lines"": 34}, ""src/version.c"": {""insertions"": 2, ""deletions"": 0, ""lines"": 2}}"
2020-08-30 21:24:20,8b565c2c1522e0c41e3d18e1bb6e1bc4b3686842,Bram Moolenaar,40,38,78,8,"{""src/eval.c"": {""insertions"": 1, ""deletions"": 1, ""lines"": 2}, ""src/proto/vim9type.pro"": {""insertions"": 2, ""deletions"": 2, ""lines"": 4}, ""src/testdir/test_vim9_func.vim"": {""insertions"": 5, ""deletions"": 5, ""lines"": 10}, ""src/version.c"": {""insertions"": 2, ""deletions"": 0, ""lines"": 2}, ""src/vim9compile.c"": {""insertions"": 4, ""deletions"": 8, ""lines"": 12}, ""src/vim9execute.c"": {""insertions"": 4, ""deletions"": 3, ""lines"": 7}, ""src/vim9script.c"": {""insertions"": 1, ""deletions"": 1, ""lines"": 2}, ""src/vim9type.c"": {""insertions"": 21, ""deletions"": 18, ""lines"": 39}}"
2020-08-30 19:26:57,02aaad91094939758e053588dd23ebda467eea29,Bram Moolenaar,18,3,21,3,"{""src/evalbuffer.c"": {""insertions"": 8, ""deletions"": 3, ""lines"": 11}, ""src/testdir/test_vim9_func.vim"": {""insertions"": 8, ""deletions"": 0, ""lines"": 8}, ""src/version.c"": {""insertions"": 2, ""deletions"": 0, ""lines"": 2}}"
2020-08-30 18:46:38,ca774f67534e6d1843fda9d1dc9a899972d27577,Bram Moolenaar,16,0,16,2,"{""src/normal.c"": {""insertions"": 14, ""deletions"": 0, ""lines"": 14}, ""src/version.c"": {""insertions"": 2, ""deletions"": 0, ""lines"": 2}}"
2020-08-30 17:42:06,0b8cf278eca45241033033f9bf389e54669a8654,Bram Moolenaar,3,0,3,2,"{""src/po/check.vim"": {""insertions"": 1, ""deletions"": 0, ""lines"": 1}, ""src/version.c"": {""insertions"": 2, ""deletions"": 0, ""lines"": 2}}"
2020-08-30 17:26:45,02c037a4be6aeb7f6376e7dcc3ab41cfc6db3ede,Bram Moolenaar,26,13,39,9,"{""src/arglist.c"": {""insertions"": 1, ""deletions"": 1, ""lines"": 2}, ""src/libvterm/README"": {""insertions"": 5, ""deletions"": 2, ""lines"": 7}, ""src/map.c"": {""insertions"": 1, ""deletions"": 1, ""lines"": 2}, ""src/mbyte.c"": {""insertions"": 2, ""deletions"": 2, ""lines"": 4}, ""src/tag.c"": {""insertions"": 1, ""deletions"": 1, ""lines"": 2}, ""src/testdir/README.txt"": {""insertions"": 9, ""deletions"": 0, ""lines"": 9}, ""src/testdir/test_put.vim"": {""insertions"": 3, ""deletions"": 5, ""lines"": 8}, ""src/undo.c"": {""insertions"": 2, ""deletions"": 1, ""lines"": 3}, ""src/version.c"": {""insertions"": 2, ""deletions"": 0, ""lines"": 2}}"
2020-08-30 16:11:54,cd80006ecbde03f668a478a272d8009970b8cefa,Bram Moolenaar,7,78,85,2,"{""src/Makefile"": {""insertions"": 5, ""deletions"": 78, ""lines"": 83}, ""src/version.c"": {""insertions"": 2, ""deletions"": 0, ""lines"": 2}}"
2020-08-30 15:24:37,76603baac5a14445d0c41d7eb14144a07288d357,Bram Moolenaar,9,2,11,3,"{""src/channel.c"": {""insertions"": 4, ""deletions"": 1, ""lines"": 5}, ""src/os_unix.c"": {""insertions"": 3, ""deletions"": 1, ""lines"": 4}, ""src/version.c"": {""insertions"": 2, ""deletions"": 0, ""lines"": 2}}"
2020-08-30 15:20:20,207f009326c8f878defde0e594d7d9ed9860106e,Bram Moolenaar,1387,1118,2505,44,"{""runtime/autoload/dist/ft.vim"": {""insertions"": 1, ""deletions"": 1, ""lines"": 2}, ""runtime/compiler/eslint.vim"": {""insertions"": 2, ""deletions"": 2, ""lines"": 4}, ""runtime/compiler/standard.vim"": {""insertions"": 3, ""deletions"": 3, ""lines"": 6}, ""runtime/doc/change.txt"": {""insertions"": 5, ""deletions"": 5, ""lines"": 10}, ""runtime/doc/develop.txt"": {""insertions"": 2, ""deletions"": 2, ""lines"": 4}, ""runtime/doc/editing.txt"": {""insertions"": 3, ""deletions"": 3, ""lines"": 6}, ""runtime/doc/eval.txt"": {""insertions"": 14, ""deletions"": 10, ""lines"": 24}, ""runtime/doc/help.txt"": {""insertions"": 2, ""deletions"": 2, ""lines"": 4}, ""runtime/doc/intro.txt"": {""insertions"": 4, ""deletions"": 4, ""lines"": 8}, ""runtime/doc/map.txt"": {""insertions"": 8, ""deletions"": 2, ""lines"": 10}, ""runtime/doc/mbyte.txt"": {""insertions"": 12, ""deletions"": 12, ""lines"": 24}, ""runtime/doc/message.txt"": {""insertions"": 6, ""deletions"": 5, ""lines"": 11}, ""runtime/doc/mlang.txt"": {""insertions"": 2, ""deletions"": 2, ""lines"": 4}, ""runtime/doc/motion.txt"": {""insertions"": 7, ""deletions"": 6, ""lines"": 13}, ""runtime/doc/netbeans.txt"": {""insertions"": 3, ""deletions"": 3, ""lines"": 6}, ""runtime/doc/options.txt"": {""insertions"": 6, ""deletions"": 5, ""lines"": 11}, ""runtime/doc/pattern.txt"": {""insertions"": 7, ""deletions"": 7, ""lines"": 14}, ""runtime/doc/pi_netrw.txt"": {""insertions"": 2, ""deletions"": 2, ""lines"": 4}, ""runtime/doc/print.txt"": {""insertions"": 7, ""deletions"": 7, ""lines"": 14}, ""runtime/doc/quickref.txt"": {""insertions"": 3, ""deletions"": 3, ""lines"": 6}, ""runtime/doc/spell.txt"": {""insertions"": 1, ""deletions"": 1, ""lines"": 2}, ""runtime/doc/syntax.txt"": {""insertions"": 2, ""deletions"": 2, ""lines"": 4}, ""runtime/doc/tags"": {""insertions"": 15, ""deletions"": 1, ""lines"": 16}, ""runtime/doc/testing.txt"": {""insertions"": 1, ""deletions"": 1, ""lines"": 2}, ""runtime/doc/todo.txt"": {""insertions"": 32, ""deletions"": 30, ""lines"": 62}, ""runtime/doc/usr_41.txt"": {""insertions"": 2, ""deletions"": 2, ""lines"": 4}, ""runtime/doc/various.txt"": {""insertions"": 7, ""deletions"": 7, ""lines"": 14}, ""runtime/doc/version5.txt"": {""insertions"": 26, ""deletions"": 26, ""lines"": 52}, ""runtime/doc/version6.txt"": {""insertions"": 113, ""deletions"": 113, ""lines"": 226}, ""runtime/doc/version7.txt"": {""insertions"": 68, ""deletions"": 68, ""lines"": 136}, ""runtime/doc/version8.txt"": {""insertions"": 113, ""deletions"": 113, ""lines"": 226}, ""runtime/doc/vi_diff.txt"": {""insertions"": 2, ""deletions"": 2, ""lines"": 4}, ""runtime/doc/vim9.txt"": {""insertions"": 41, ""deletions"": 5, ""lines"": 46}, ""runtime/ftplugin/javascript.vim"": {""insertions"": 49, ""deletions"": 12, ""lines"": 61}, ""runtime/ftplugin/javascriptreact.vim"": {""insertions"": 5, ""deletions"": 0, ""lines"": 5}, ""runtime/keymap/russian-typograph.vim"": {""insertions"": 190, ""deletions"": 0, ""lines"": 190}, ""runtime/keymap/turkish-f.vim"": {""insertions"": 1, ""deletions"": 3, ""lines"": 4}, ""runtime/keymap/turkish-q.vim"": {""insertions"": 1, ""deletions"": 1, ""lines"": 2}, ""runtime/syntax/awk.vim"": {""insertions"": 3, ""deletions"": 1, ""lines"": 4}, ""runtime/syntax/c.vim"": {""insertions"": 3, ""deletions"": 1, ""lines"": 4}, ""runtime/syntax/help_ru.vim"": {""insertions"": 65, ""deletions"": 0, ""lines"": 65}, ""runtime/tools/unicode.vim"": {""insertions"": 122, ""deletions"": 60, ""lines"": 182}, ""src/po/nl.po"": {""insertions"": 24, ""deletions"": 0, ""lines"": 24}, ""src/po/tr.po"": {""insertions"": 402, ""deletions"": 583, ""lines"": 985}}"
2020-08-30 13:52:10,0b39c3fd4c5d1c8ebd2efa85fced7df5e17efd3b,Bram Moolenaar,136,15,151,10,"{""Filelist"": {""insertions"": 2, ""deletions"": 0, ""lines"": 2}, ""runtime/doc/eval.txt"": {""insertions"": 14, ""deletions"": 0, ""lines"": 14}, ""runtime/doc/usr_41.txt"": {""insertions"": 1, ""deletions"": 0, ""lines"": 1}, ""runtime/optwin.vim"": {""insertions"": 8, ""deletions"": 8, ""lines"": 16}, ""src/evalfunc.c"": {""insertions"": 22, ""deletions"": 0, ""lines"": 22}, ""src/po/Makefile"": {""insertions"": 47, ""deletions"": 6, ""lines"": 53}, ""src/po/README.txt"": {""insertions"": 9, ""deletions"": 1, ""lines"": 10}, ""src/po/fixfilenames.vim"": {""insertions"": 13, ""deletions"": 0, ""lines"": 13}, ""src/po/tojavascript.vim"": {""insertions"": 18, ""deletions"": 0, ""lines"": 18}, ""src/version.c"": {""insertions"": 2, ""deletions"": 0, ""lines"": 2}}"
2020-08-30 10:54:53,25859dd74cd5befe964627dc03b8369dfaebe837,Bram Moolenaar,6,4,10,2,"{""src/testdir/test_vim9_script.vim"": {""insertions"": 4, ""deletions"": 4, ""lines"": 8}, ""src/version.c"": {""insertions"": 2, ""deletions"": 0, ""lines"": 2}}"
2020-08-29 20:59:17,a5639848cc85f1226abad0f3ecf46b7847ce3fef,Bram Moolenaar,5,0,5,2,"{""src/testdir/test_vim9_script.vim"": {""insertions"": 3, ""deletions"": 0, ""lines"": 3}, ""src/version.c"": {""insertions"": 2, ""deletions"": 0, ""lines"": 2}}"
2020-08-29 15:47:08,95006e3dca099d3dc73d70d9872660308106e86c,Bram Moolenaar,31,4,35,4,"{""src/testdir/test_vim9_script.vim"": {""insertions"": 7, ""deletions"": 0, ""lines"": 7}, ""src/userfunc.c"": {""insertions"": 4, ""deletions"": 3, ""lines"": 7}, ""src/version.c"": {""insertions"": 2, ""deletions"": 0, ""lines"": 2}, ""src/vim9execute.c"": {""insertions"": 18, ""deletions"": 1, ""lines"": 19}}"
2020-08-29 14:41:27,98945560c1ae6e2ddee820a7de718a36e3f4b6e5,Bram Moolenaar,3,1,4,3,"{""Filelist"": {""insertions"": 0, ""deletions"": 1, ""lines"": 1}, ""{src/testdir => runtime/tools}/emoji_list.vim"": {""insertions"": 1, ""deletions"": 0, ""lines"": 1}, ""src/version.c"": {""insertions"": 2, ""deletions"": 0, ""lines"": 2}}"
2020-08-29 11:39:17,e3d4685f1f716e0c516332101d85e0930f20fc59,Bram Moolenaar,43,21,64,7,"{""src/evalvars.c"": {""insertions"": 2, ""deletions"": 2, ""lines"": 4}, ""src/globals.h"": {""insertions"": 3, ""deletions"": 2, ""lines"": 5}, ""src/profiler.c"": {""insertions"": 5, ""deletions"": 5, ""lines"": 10}, ""src/scriptfile.c"": {""insertions"": 1, ""deletions"": 1, ""lines"": 2}, ""src/testdir/test_vim9_script.vim"": {""insertions"": 9, ""deletions"": 0, ""lines"": 9}, ""src/version.c"": {""insertions"": 2, ""deletions"": 0, ""lines"": 2}, ""src/vim9compile.c"": {""insertions"": 21, ""deletions"": 11, ""lines"": 32}}"
2020-08-29 10:57:16,423a85a11a9d3d658906aea715fed7fe6aa83cd8,Bram Moolenaar,68,6,74,3,"{""src/if_py_both.h"": {""insertions"": 14, ""deletions"": 6, ""lines"": 20}, ""src/testdir/test_python3.vim"": {""insertions"": 52, ""deletions"": 0, ""lines"": 52}, ""src/version.c"": {""insertions"": 2, ""deletions"": 0, ""lines"": 2}}"
2020-08-28 21:27:20,b06a6d59d12dbd67d55b3c46f6e5547e9103c931,Bram Moolenaar,13,10,23,4,"{""src/errors.h"": {""insertions"": 1, ""deletions"": 1, ""lines"": 2}, ""src/mbyte.c"": {""insertions"": 9, ""deletions"": 8, ""lines"": 17}, ""src/testdir/test_utf8.vim"": {""insertions"": 1, ""deletions"": 1, ""lines"": 2}, ""src/version.c"": {""insertions"": 2, ""deletions"": 0, ""lines"": 2}}"
2020-08-28 20:24:57,4e4473c927167fd24e5c8df90e0e8035080cf2da,Bram Moolenaar,91,8,99,9,"{""Filelist"": {""insertions"": 1, ""deletions"": 0, ""lines"": 1}, ""runtime/doc/eval.txt"": {""insertions"": 13, ""deletions"": 0, ""lines"": 13}, ""runtime/doc/usr_41.txt"": {""insertions"": 1, ""deletions"": 0, ""lines"": 1}, ""src/evalfunc.c"": {""insertions"": 1, ""deletions"": 0, ""lines"": 1}, ""src/mbyte.c"": {""insertions"": 43, ""deletions"": 8, ""lines"": 51}, ""src/proto/mbyte.pro"": {""insertions"": 1, ""deletions"": 0, ""lines"": 1}, ""src/testdir/emoji_list.vim"": {""insertions"": 22, ""deletions"": 0, ""lines"": 22}, ""src/testdir/test_functions.vim"": {""insertions"": 7, ""deletions"": 0, ""lines"": 7}, ""src/version.c"": {""insertions"": 2, ""deletions"": 0, ""lines"": 2}}"
2020-08-28 19:04:24,08aac3c6192f0103cb87e280270a32b50e653be1,Bram Moolenaar,265,4,269,9,"{""runtime/doc/eval.txt"": {""insertions"": 24, ""deletions"": 0, ""lines"": 24}, ""runtime/doc/options.txt"": {""insertions"": 3, ""deletions"": 1, ""lines"": 4}, ""runtime/doc/usr_41.txt"": {""insertions"": 1, ""deletions"": 0, ""lines"": 1}, ""src/errors.h"": {""insertions"": 12, ""deletions"": 0, ""lines"": 12}, ""src/evalfunc.c"": {""insertions"": 1, ""deletions"": 0, ""lines"": 1}, ""src/mbyte.c"": {""insertions"": 186, ""deletions"": 3, ""lines"": 189}, ""src/proto/mbyte.pro"": {""insertions"": 1, ""deletions"": 0, ""lines"": 1}, ""src/testdir/test_utf8.vim"": {""insertions"": 35, ""deletions"": 0, ""lines"": 35}, ""src/version.c"": {""insertions"": 2, ""deletions"": 0, ""lines"": 2}}"
2020-08-28 15:19:07,ee8580e52e767916e2a95e8ac0732fd8a5ae0651,Bram Moolenaar,19,10,29,4,"{""src/testdir/test_vim9_func.vim"": {""insertions"": 9, ""deletions"": 0, ""lines"": 9}, ""src/userfunc.c"": {""insertions"": 0, ""deletions"": 7, ""lines"": 7}, ""src/version.c"": {""insertions"": 2, ""deletions"": 0, ""lines"": 2}, ""src/vim9execute.c"": {""insertions"": 8, ""deletions"": 3, ""lines"": 11}}"
2020-08-28 14:39:33,6a950581da52b410a74531044aae8f1f8f38a7df,Bram Moolenaar,10,1,11,3,"{""src/evalfunc.c"": {""insertions"": 1, ""deletions"": 1, ""lines"": 2}, ""src/testdir/test_vim9_func.vim"": {""insertions"": 7, ""deletions"": 0, ""lines"": 7}, ""src/version.c"": {""insertions"": 2, ""deletions"": 0, ""lines"": 2}}"
2020-08-28 14:38:11,2566054a7f406a6c9a082e7fd5f1597164668ca9,Bram Moolenaar,3,1,4,2,"{""src/eval.c"": {""insertions"": 1, ""deletions"": 1, ""lines"": 2}, ""src/version.c"": {""insertions"": 2, ""deletions"": 0, ""lines"": 2}}"
2020-08-27 21:57:57,7a3330fc578033f06a94c23de61a23edcc59f95e,Bram Moolenaar,3,1,4,2,"{""src/version.c"": {""insertions"": 2, ""deletions"": 0, ""lines"": 2}, ""src/vim9compile.c"": {""insertions"": 1, ""deletions"": 1, ""lines"": 2}}"
2020-08-27 21:37:09,5163fcce792c9d730bf864f4d9bb07f30625cff9,Bram Moolenaar,13,3,16,2,"{""src/version.c"": {""insertions"": 2, ""deletions"": 0, ""lines"": 2}, ""src/vim9compile.c"": {""insertions"": 11, ""deletions"": 3, ""lines"": 14}}"
2020-08-27 21:08:47,749639ec7248740cd271f34ec5f7bb70891b459c,Bram Moolenaar,9,1,10,3,"{""src/testdir/test_vim9_expr.vim"": {""insertions"": 3, ""deletions"": 1, ""lines"": 4}, ""src/version.c"": {""insertions"": 2, ""deletions"": 0, ""lines"": 2}, ""src/vim9compile.c"": {""insertions"": 4, ""deletions"": 0, ""lines"": 4}}"
2020-08-27 20:43:03,3988f64f9d512fd809d4a600b020638bf2c7d7ec,Bram Moolenaar,30,19,49,3,"{""src/testdir/test_vim9_script.vim"": {""insertions"": 8, ""deletions"": 0, ""lines"": 8}, ""src/version.c"": {""insertions"": 2, ""deletions"": 0, ""lines"": 2}, ""src/vim9compile.c"": {""insertions"": 20, ""deletions"": 19, ""lines"": 39}}"
2020-08-27 19:33:10,601e76ac3c8fa5d65ac04647a762792ea343ebd5,Bram Moolenaar,39,7,46,4,"{""src/evalvars.c"": {""insertions"": 14, ""deletions"": 0, ""lines"": 14}, ""src/testdir/test_vim9_expr.vim"": {""insertions"": 11, ""deletions"": 0, ""lines"": 11}, ""src/testdir/test_vim9_script.vim"": {""insertions"": 12, ""deletions"": 7, ""lines"": 19}, ""src/version.c"": {""insertions"": 2, ""deletions"": 0, ""lines"": 2}}"
2020-08-27 14:06:46,228e62975e7aef9d6224a5a7c43625c1c1494fc2,Bram Moolenaar,3,1,4,2,"{""src/testdir/Makefile"": {""insertions"": 1, ""deletions"": 1, ""lines"": 2}, ""src/version.c"": {""insertions"": 2, ""deletions"": 0, ""lines"": 2}}"
2020-08-26 20:29:57,6e3aeec8461cf27396b6574b5438019a00684e00,Bram Moolenaar,6,4,10,4,"{""src/testdir/Make_dos.mak"": {""insertions"": 1, ""deletions"": 1, ""lines"": 2}, ""src/testdir/Make_ming.mak"": {""insertions"": 1, ""deletions"": 1, ""lines"": 2}, ""src/testdir/Makefile"": {""insertions"": 2, ""deletions"": 2, ""lines"": 4}, ""src/version.c"": {""insertions"": 2, ""deletions"": 0, ""lines"": 2}}"
2020-08-25 20:37:48,2e0866128b6266829a7f38733d5188bc4ec68745,Bram Moolenaar,14,5,19,3,"{""src/eval.c"": {""insertions"": 6, ""deletions"": 5, ""lines"": 11}, ""src/testdir/test_eval_stuff.vim"": {""insertions"": 6, ""deletions"": 0, ""lines"": 6}, ""src/version.c"": {""insertions"": 2, ""deletions"": 0, ""lines"": 2}}"
2020-08-25 19:19:36,b9fc192f928b484c8809fb985ef334d7a2bb5a09,Bram Moolenaar,52,32,84,2,"{""src/testdir/test_spellfile.vim"": {""insertions"": 50, ""deletions"": 32, ""lines"": 82}, ""src/version.c"": {""insertions"": 2, ""deletions"": 0, ""lines"": 2}}"
2020-08-24 18:28:56,c8ec5fe56fc30201c889ca577bf1e69823fadb2a,Bram Moolenaar,225,0,225,2,"{""src/testdir/test_spellfile.vim"": {""insertions"": 223, ""deletions"": 0, ""lines"": 223}, ""src/version.c"": {""insertions"": 2, ""deletions"": 0, ""lines"": 2}}"
2020-08-24 18:05:50,07399e7f078729b03451ba2b342d0cb434ab75cf,Bram Moolenaar,14,7,21,3,"{""src/spell.h"": {""insertions"": 1, ""deletions"": 0, ""lines"": 1}, ""src/spellfile.c"": {""insertions"": 11, ""deletions"": 7, ""lines"": 18}, ""src/version.c"": {""insertions"": 2, ""deletions"": 0, ""lines"": 2}}"
2020-08-23 19:46:32,b3ea36c5bcb88b6a05a66347eedd461e9385103f,Bram Moolenaar,25,1,26,3,"{""src/normal.c"": {""insertions"": 3, ""deletions"": 1, ""lines"": 4}, ""src/testdir/test_vim9_cmd.vim"": {""insertions"": 20, ""deletions"": 0, ""lines"": 20}, ""src/version.c"": {""insertions"": 2, ""deletions"": 0, ""lines"": 2}}"
2020-08-23 19:06:02,c2af0afff5c44969ad7611ec2d47d0f52087fa7f,Bram Moolenaar,138,98,236,3,"{""src/ex_docmd.c"": {""insertions"": 124, ""deletions"": 98, ""lines"": 222}, ""src/testdir/test_vim9_script.vim"": {""insertions"": 12, ""deletions"": 0, ""lines"": 12}, ""src/version.c"": {""insertions"": 2, ""deletions"": 0, ""lines"": 2}}"
2020-08-23 17:34:48,2e80095501238e0c6b702ac7cdfa2e2b763dba28,Bram Moolenaar,51,18,69,6,"{""src/ex_docmd.c"": {""insertions"": 22, ""deletions"": 3, ""lines"": 25}, ""src/proto/ex_docmd.pro"": {""insertions"": 1, ""deletions"": 0, ""lines"": 1}, ""src/testdir/test_vim9_script.vim"": {""insertions"": 15, ""deletions"": 10, ""lines"": 25}, ""src/testdir/vim9.vim"": {""insertions"": 5, ""deletions"": 0, ""lines"": 5}, ""src/version.c"": {""insertions"": 2, ""deletions"": 0, ""lines"": 2}, ""src/vim9compile.c"": {""insertions"": 6, ""deletions"": 5, ""lines"": 11}}"
2020-08-23 15:34:46,6c53fca02301ff871cddc1c74c388e23e53a424a,Bram Moolenaar,36,14,50,4,"{""runtime/doc/eval.txt"": {""insertions"": 17, ""deletions"": 9, ""lines"": 26}, ""src/evalfunc.c"": {""insertions"": 13, ""deletions"": 5, ""lines"": 18}, ""src/testdir/test_functions.vim"": {""insertions"": 4, ""deletions"": 0, ""lines"": 4}, ""src/version.c"": {""insertions"": 2, ""deletions"": 0, ""lines"": 2}}"
2020-08-23 14:29:11,430deb1945cbc7a17ed42c5c737fc08d2eef327a,Bram Moolenaar,8,2,10,3,"{""src/testdir/test_vim9_script.vim"": {""insertions"": 3, ""deletions"": 2, ""lines"": 5}, ""src/version.c"": {""insertions"": 2, ""deletions"": 0, ""lines"": 2}, ""src/vim9execute.c"": {""insertions"": 3, ""deletions"": 0, ""lines"": 3}}"
2020-08-23 13:21:55,8436773fad285215481c4ce2b32692e66fca599f,Bram Moolenaar,22,2,24,3,"{""src/testdir/test_vim9_script.vim"": {""insertions"": 7, ""deletions"": 0, ""lines"": 7}, ""src/version.c"": {""insertions"": 2, ""deletions"": 0, ""lines"": 2}, ""src/vim9compile.c"": {""insertions"": 13, ""deletions"": 2, ""lines"": 15}}"
2020-08-23 13:09:36,dc0cf1db3e8e0de349e4cc5b0a7ab6c8b7dc2ebb,Bram Moolenaar,4,1,5,2,"{""src/screen.c"": {""insertions"": 2, ""deletions"": 1, ""lines"": 3}, ""src/version.c"": {""insertions"": 2, ""deletions"": 0, ""lines"": 2}}"
2020-08-23 12:28:37,0981c8729e09551f2e8e6c159bc29f2c1d04019c,Bram Moolenaar,41,26,67,12,"{""src/channel.c"": {""insertions"": 1, ""deletions"": 1, ""lines"": 2}, ""src/if_cscope.c"": {""insertions"": 2, ""deletions"": 2, ""lines"": 4}, ""src/os_amiga.c"": {""insertions"": 3, ""deletions"": 3, ""lines"": 6}, ""src/os_unix.c"": {""insertions"": 22, ""deletions"": 13, ""lines"": 35}, ""src/os_win32.c"": {""insertions"": 2, ""deletions"": 2, ""lines"": 4}, ""src/proto/os_amiga.pro"": {""insertions"": 1, ""deletions"": 1, ""lines"": 2}, ""src/proto/os_unix.pro"": {""insertions"": 1, ""deletions"": 1, ""lines"": 2}, ""src/proto/os_win32.pro"": {""insertions"": 1, ""deletions"": 1, ""lines"": 2}, ""src/term.c"": {""insertions"": 1, ""deletions"": 1, ""lines"": 2}, ""src/ui.c"": {""insertions"": 1, ""deletions"": 1, ""lines"": 2}, ""src/version.c"": {""insertions"": 2, ""deletions"": 0, ""lines"": 2}, ""src/vim.h"": {""insertions"": 4, ""deletions"": 0, ""lines"": 4}}"
2020-08-22 20:37:20,69e44552c567ff25b363ba0790ad3d43fa0397a7,Bram Moolenaar,54,0,54,4,"{""src/eval.c"": {""insertions"": 7, ""deletions"": 0, ""lines"": 7}, ""src/testdir/test_vim9_expr.vim"": {""insertions"": 21, ""deletions"": 0, ""lines"": 21}, ""src/testdir/test_vimscript.vim"": {""insertions"": 24, ""deletions"": 0, ""lines"": 24}, ""src/version.c"": {""insertions"": 2, ""deletions"": 0, ""lines"": 2}}"
2020-08-22 19:08:44,cd94277f72e29b740635da84bcd872c96e11bf67,Bram Moolenaar,36,2,38,3,"{""src/register.c"": {""insertions"": 25, ""deletions"": 2, ""lines"": 27}, ""src/testdir/test_visual.vim"": {""insertions"": 9, ""deletions"": 0, ""lines"": 9}, ""src/version.c"": {""insertions"": 2, ""deletions"": 0, ""lines"": 2}}"
2020-08-22 17:02:02,5390099a9733f7952a612670693dd4ebf9e0e178,Bram Moolenaar,33,27,60,3,"{""src/testdir/test_vim9_func.vim"": {""insertions"": 16, ""deletions"": 16, ""lines"": 32}, ""src/version.c"": {""insertions"": 2, ""deletions"": 0, ""lines"": 2}, ""src/vim9compile.c"": {""insertions"": 15, ""deletions"": 11, ""lines"": 26}}"
2020-08-22 15:21:14,9943b3d97955ece99c747c959e0a7d493bb762bb,Bram Moolenaar,4,1,5,2,"{""src/screen.c"": {""insertions"": 2, ""deletions"": 1, ""lines"": 3}, ""src/version.c"": {""insertions"": 2, ""deletions"": 0, ""lines"": 2}}"
2020-08-22 14:04:52,c63b72b6dc1347530ce906b462bb568994552c8b,Bram Moolenaar,95,0,95,2,"{""src/testdir/test_debugger.vim"": {""insertions"": 93, ""deletions"": 0, ""lines"": 93}, ""src/version.c"": {""insertions"": 2, ""deletions"": 0, ""lines"": 2}}"
2020-08-22 13:19:18,51b6eb47b3c41b01a5559b099e65354c8897093e,Bram Moolenaar,8,6,14,4,"{""src/eval.c"": {""insertions"": 4, ""deletions"": 3, ""lines"": 7}, ""src/memline.c"": {""insertions"": 1, ""deletions"": 2, ""lines"": 3}, ""src/version.c"": {""insertions"": 2, ""deletions"": 0, ""lines"": 2}, ""src/vimrun.c"": {""insertions"": 1, ""deletions"": 1, ""lines"": 2}}"
2020-08-22 13:06:35,d70840ed68296c1144d743e6335003c81c558c24,Bram Moolenaar,23,5,28,4,"{""src/errors.h"": {""insertions"": 2, ""deletions"": 1, ""lines"": 3}, ""src/testdir/test_vim9_func.vim"": {""insertions"": 12, ""deletions"": 2, ""lines"": 14}, ""src/typval.c"": {""insertions"": 7, ""deletions"": 2, ""lines"": 9}, ""src/version.c"": {""insertions"": 2, ""deletions"": 0, ""lines"": 2}}"
2020-08-21 20:46:11,1b04ce2d400fda97410a961288c496bd8f445a9c,Bram Moolenaar,40,6,46,4,"{""src/testdir/test_eval_stuff.vim"": {""insertions"": 19, ""deletions"": 6, ""lines"": 25}, ""src/testdir/test_fnamemodify.vim"": {""insertions"": 6, ""deletions"": 0, ""lines"": 6}, ""src/testdir/test_functions.vim"": {""insertions"": 13, ""deletions"": 0, ""lines"": 13}, ""src/version.c"": {""insertions"": 2, ""deletions"": 0, ""lines"": 2}}"
2020-08-21 20:36:47,7cb6fc29d067ed97c0b0c1d2d5767125ef9ae1ab,Bram Moolenaar,65,39,104,11,"{""src/dict.c"": {""insertions"": 4, ""deletions"": 4, ""lines"": 8}, ""src/errors.h"": {""insertions"": 6, ""deletions"": 6, ""lines"": 12}, ""src/evalvars.c"": {""insertions"": 1, ""deletions"": 1, ""lines"": 2}, ""src/list.c"": {""insertions"": 2, ""deletions"": 2, ""lines"": 4}, ""src/testdir/test_vim9_expr.vim"": {""insertions"": 2, ""deletions"": 1, ""lines"": 3}, ""src/testdir/vim9.vim"": {""insertions"": 7, ""deletions"": 0, ""lines"": 7}, ""src/userfunc.c"": {""insertions"": 20, ""deletions"": 4, ""lines"": 24}, ""src/version.c"": {""insertions"": 2, ""deletions"": 0, ""lines"": 2}, ""src/vim9compile.c"": {""insertions"": 16, ""deletions"": 16, ""lines"": 32}, ""src/vim9script.c"": {""insertions"": 1, ""deletions"": 1, ""lines"": 2}, ""src/vim9type.c"": {""insertions"": 4, ""deletions"": 4, ""lines"": 8}}"
2020-08-21 19:55:43,81e17fbe00fd2ed93b262adc3ba41c86b02e7f46,Bram Moolenaar,23,0,23,3,"{""src/testdir/test_vim9_script.vim"": {""insertions"": 17, ""deletions"": 0, ""lines"": 17}, ""src/version.c"": {""insertions"": 2, ""deletions"": 0, ""lines"": 2}, ""src/vim9script.c"": {""insertions"": 4, ""deletions"": 0, ""lines"": 4}}"
2020-08-21 19:32:50,122616d9c1b57f1e1f29f1151f8e26d24df9092a,Bram Moolenaar,13,4,17,4,"{""src/evalvars.c"": {""insertions"": 7, ""deletions"": 1, ""lines"": 8}, ""src/testdir/test_vim9_expr.vim"": {""insertions"": 0, ""deletions"": 2, ""lines"": 2}, ""src/testdir/test_vim9_script.vim"": {""insertions"": 4, ""deletions"": 1, ""lines"": 5}, ""src/version.c"": {""insertions"": 2, ""deletions"": 0, ""lines"": 2}}"
2020-08-21 18:43:17,3fc71285d5ae7c16cf7be5d997fd1fe140f196da,Bram Moolenaar,23,3,26,3,"{""src/testdir/test_vim9_expr.vim"": {""insertions"": 12, ""deletions"": 0, ""lines"": 12}, ""src/version.c"": {""insertions"": 2, ""deletions"": 0, ""lines"": 2}, ""src/vim9compile.c"": {""insertions"": 9, ""deletions"": 3, ""lines"": 12}}"
2020-08-20 21:04:06,5d72ce69c8783fd8f1a0355c00806c5084010eec,Bram Moolenaar,25,3,28,3,"{""src/testdir/test_vim9_script.vim"": {""insertions"": 7, ""deletions"": 0, ""lines"": 7}, ""src/version.c"": {""insertions"": 2, ""deletions"": 0, ""lines"": 2}, ""src/vim9compile.c"": {""insertions"": 16, ""deletions"": 3, ""lines"": 19}}"
2020-08-20 20:29:12,ec65d77fa26cc87f7ce54a5a941a799e3a667c50,Bram Moolenaar,17,5,22,3,"{""src/eval.c"": {""insertions"": 9, ""deletions"": 5, ""lines"": 14}, ""src/testdir/test_vim9_func.vim"": {""insertions"": 6, ""deletions"": 0, ""lines"": 6}, ""src/version.c"": {""insertions"": 2, ""deletions"": 0, ""lines"": 2}}"
2020-08-20 16:59:06,733d259a83bfdd3e1670cc1665e1bd56501799df,Bram Moolenaar,39,37,76,8,"{""src/testdir/test_digraph.vim"": {""insertions"": 3, ""deletions"": 3, ""lines"": 6}, ""src/testdir/test_display.vim"": {""insertions"": 1, ""deletions"": 1, ""lines"": 2}, ""src/testdir/test_popupwin.vim"": {""insertions"": 1, ""deletions"": 1, ""lines"": 2}, ""src/testdir/test_termcodes.vim"": {""insertions"": 2, ""deletions"": 2, ""lines"": 4}, ""src/testdir/test_terminal.vim"": {""insertions"": 4, ""deletions"": 4, ""lines"": 8}, ""src/testdir/test_terminal3.vim"": {""insertions"": 19, ""deletions"": 19, ""lines"": 38}, ""src/testdir/test_writefile.vim"": {""insertions"": 7, ""deletions"": 7, ""lines"": 14}, ""src/version.c"": {""insertions"": 2, ""deletions"": 0, ""lines"": 2}}"
2020-08-20 16:29:13,17f67547f36a06220ea4667aaee7bb130108f568,Bram Moolenaar,7,6,13,2,"{""src/testdir/test_autocmd.vim"": {""insertions"": 5, ""deletions"": 6, ""lines"": 11}, ""src/version.c"": {""insertions"": 2, ""deletions"": 0, ""lines"": 2}}"
2020-08-20 16:02:47,b8a9296cedb9fae35572041ef5cfa894f3ad9fbb,Bram Moolenaar,13,0,13,4,"{""src/ex_docmd.c"": {""insertions"": 1, ""deletions"": 0, ""lines"": 1}, ""src/testdir/test_vim9_cmd.vim"": {""insertions"": 9, ""deletions"": 0, ""lines"": 9}, ""src/version.c"": {""insertions"": 2, ""deletions"": 0, ""lines"": 2}, ""src/vim9compile.c"": {""insertions"": 1, ""deletions"": 0, ""lines"": 1}}"
2020-08-20 14:16:27,df2524bbb495c880d094d9542abf7c23d739cc53,Bram Moolenaar,3,2,5,2,"{""src/Makefile"": {""insertions"": 1, ""deletions"": 2, ""lines"": 3}, ""src/version.c"": {""insertions"": 2, ""deletions"": 0, ""lines"": 2}}"
2020-08-20 13:52:21,825b54415f71beadd125b5703bed08332c053168,Bram Moolenaar,4,1,5,2,"{""src/eval.c"": {""insertions"": 2, ""deletions"": 1, ""lines"": 3}, ""src/version.c"": {""insertions"": 2, ""deletions"": 0, ""lines"": 2}}"
2020-08-20 13:41:55,fc2a47ffc425777704b329c9edbe21163bedf63c,Bram Moolenaar,278,88,366,3,"{""src/spellfile.c"": {""insertions"": 1, ""deletions"": 1, ""lines"": 2}, ""src/testdir/test_spellfile.vim"": {""insertions"": 275, ""deletions"": 87, ""lines"": 362}, ""src/version.c"": {""insertions"": 2, ""deletions"": 0, ""lines"": 2}}"
2020-08-20 13:25:00,20b23c6358131baefb57b9083387fb4524d3ff24,Bram Moolenaar,20,18,38,3,"{""src/ex_docmd.c"": {""insertions"": 11, ""deletions"": 11, ""lines"": 22}, ""src/structs.h"": {""insertions"": 7, ""deletions"": 7, ""lines"": 14}, ""src/version.c"": {""insertions"": 2, ""deletions"": 0, ""lines"": 2}}"
2020-08-20 13:02:42,66250c932e8a0e3c43e7c7c7b1dbede040b9c508,Bram Moolenaar,81,45,126,16,"{""src/autocmd.c"": {""insertions"": 5, ""deletions"": 1, ""lines"": 6}, ""src/evalfunc.c"": {""insertions"": 1, ""deletions"": 2, ""lines"": 3}, ""src/ex_cmds.h"": {""insertions"": 1, ""deletions"": 1, ""lines"": 2}, ""src/ex_docmd.c"": {""insertions"": 6, ""deletions"": 6, ""lines"": 12}, ""src/ex_getln.c"": {""insertions"": 3, ""deletions"": 3, ""lines"": 6}, ""src/proto/autocmd.pro"": {""insertions"": 1, ""deletions"": 1, ""lines"": 2}, ""src/proto/ex_docmd.pro"": {""insertions"": 4, ""deletions"": 4, ""lines"": 8}, ""src/proto/ex_getln.pro"": {""insertions"": 2, ""deletions"": 2, ""lines"": 4}, ""src/proto/scriptfile.pro"": {""insertions"": 3, ""deletions"": 3, ""lines"": 6}, ""src/proto/userfunc.pro"": {""insertions"": 1, ""deletions"": 1, ""lines"": 2}, ""src/scriptfile.c"": {""insertions"": 15, ""deletions"": 6, ""lines"": 21}, ""src/structs.h"": {""insertions"": 8, ""deletions"": 1, ""lines"": 9}, ""src/testdir/test_vim9_script.vim"": {""insertions"": 11, ""deletions"": 0, ""lines"": 11}, ""src/userfunc.c"": {""insertions"": 8, ""deletions"": 7, ""lines"": 15}, ""src/version.c"": {""insertions"": 2, ""deletions"": 0, ""lines"": 2}, ""src/vim9compile.c"": {""insertions"": 10, ""deletions"": 7, ""lines"": 17}}"
2020-08-19 20:02:41,93ad14710bdf77591f927a2b244bba6a8cbc7706,Bram Moolenaar,27,22,49,3,"{""src/testdir/test_vim9_script.vim"": {""insertions"": 12, ""deletions"": 0, ""lines"": 12}, ""src/version.c"": {""insertions"": 2, ""deletions"": 0, ""lines"": 2}, ""src/vim9compile.c"": {""insertions"": 13, ""deletions"": 22, ""lines"": 35}}"
2020-08-19 19:20:49,191929b182ba38abe6bc431fb9d8d9507f408903,Bram Moolenaar,34,21,55,3,"{""src/evalvars.c"": {""insertions"": 20, ""deletions"": 21, ""lines"": 41}, ""src/testdir/test_vim9_func.vim"": {""insertions"": 12, ""deletions"": 0, ""lines"": 12}, ""src/version.c"": {""insertions"": 2, ""deletions"": 0, ""lines"": 2}}"
2020-08-19 18:19:48,9dc1917f42b23277e143fc58bbe27482b0b76bad,Bram Moolenaar,19,1,20,4,"{""src/drawscreen.c"": {""insertions"": 1, ""deletions"": 1, ""lines"": 2}, ""src/testdir/dumps/Test_display_scroll_at_topline.dump"": {""insertions"": 4, ""deletions"": 0, ""lines"": 4}, ""src/testdir/test_display.vim"": {""insertions"": 12, ""deletions"": 0, ""lines"": 12}, ""src/version.c"": {""insertions"": 2, ""deletions"": 0, ""lines"": 2}}"
2020-08-19 17:46:12,a7c4e747639ad7642cd50ed577ff4c93db200df4,Bram Moolenaar,15,9,24,3,"{"".travis.yml"": {""insertions"": 12, ""deletions"": 8, ""lines"": 20}, ""ci/load-snd-dummy.sh"": {""insertions"": 1, ""deletions"": 1, ""lines"": 2}, ""src/version.c"": {""insertions"": 2, ""deletions"": 0, ""lines"": 2}}"
2020-08-19 14:00:06,f8abbf37d66c41d980284e28e0e38a399890e918,Bram Moolenaar,41,37,78,3,"{""src/filepath.c"": {""insertions"": 37, ""deletions"": 36, ""lines"": 73}, ""src/testdir/test_vim9_func.vim"": {""insertions"": 2, ""deletions"": 1, ""lines"": 3}, ""src/version.c"": {""insertions"": 2, ""deletions"": 0, ""lines"": 2}}"
2020-08-19 11:55:01,af8822ce085e3bd8edeb52cbb7306ddd42427d39,Bram Moolenaar,12,0,12,3,"{""src/filepath.c"": {""insertions"": 6, ""deletions"": 0, ""lines"": 6}, ""src/testdir/test_vim9_func.vim"": {""insertions"": 4, ""deletions"": 0, ""lines"": 4}, ""src/version.c"": {""insertions"": 2, ""deletions"": 0, ""lines"": 2}}"
2020-08-18 21:24:13,9b02d64cff7664b9643205d6e23b08da688fe87a,Bram Moolenaar,4,1,5,2,"{""src/testing.c"": {""insertions"": 2, ""deletions"": 1, ""lines"": 3}, ""src/version.c"": {""insertions"": 2, ""deletions"": 0, ""lines"": 2}}"
2020-08-18 20:50:38,165036ddba1318576a29f75d82fae8c326a48f18,Bram Moolenaar,3,1,4,2,"{""src/popupwin.c"": {""insertions"": 1, ""deletions"": 1, ""lines"": 2}, ""src/version.c"": {""insertions"": 2, ""deletions"": 0, ""lines"": 2}}"
2020-08-18 20:32:03,aeb2bdd0de5ce5b566509dda5ba9ad6f976063b3,Bram Moolenaar,18,3,21,4,"{""src/eval.c"": {""insertions"": 5, ""deletions"": 2, ""lines"": 7}, ""src/scriptfile.c"": {""insertions"": 2, ""deletions"": 1, ""lines"": 3}, ""src/testdir/test_vim9_expr.vim"": {""insertions"": 9, ""deletions"": 0, ""lines"": 9}, ""src/version.c"": {""insertions"": 2, ""deletions"": 0, ""lines"": 2}}"
2020-08-18 18:34:13,3affe7a6c6fc813f5d29857933ee6aca0b9c7bd6,Bram Moolenaar,306,297,603,4,"{""src/testdir/test_vim9_expr.vim"": {""insertions"": 290, ""deletions"": 289, ""lines"": 579}, ""src/testdir/vim9.vim"": {""insertions"": 12, ""deletions"": 8, ""lines"": 20}, ""src/version.c"": {""insertions"": 2, ""deletions"": 0, ""lines"": 2}, ""src/vim9execute.c"": {""insertions"": 2, ""deletions"": 0, ""lines"": 2}}"
2020-08-18 17:11:38,e15eebd202e739ec7821a0e9c2aa72a445668bb8,Bram Moolenaar,22,1,23,5,"{""src/eval.c"": {""insertions"": 1, ""deletions"": 1, ""lines"": 2}, ""src/proto/typval.pro"": {""insertions"": 1, ""deletions"": 0, ""lines"": 1}, ""src/testdir/test_vim9_func.vim"": {""insertions"": 7, ""deletions"": 0, ""lines"": 7}, ""src/typval.c"": {""insertions"": 11, ""deletions"": 0, ""lines"": 11}, ""src/version.c"": {""insertions"": 2, ""deletions"": 0, ""lines"": 2}}"
2020-08-18 11:41:50,1d634542cf5ebcd1d5d83bd124b3e1d5e7c96c58,Bram Moolenaar,56,15,71,9,"{""runtime/doc/testing.txt"": {""insertions"": 12, ""deletions"": 3, ""lines"": 15}, ""src/evalfunc.c"": {""insertions"": 1, ""deletions"": 1, ""lines"": 2}, ""src/globals.h"": {""insertions"": 1, ""deletions"": 0, ""lines"": 1}, ""src/message.c"": {""insertions"": 3, ""deletions"": 0, ""lines"": 3}, ""src/testdir/test_vim9_expr.vim"": {""insertions"": 5, ""deletions"": 3, ""lines"": 8}, ""src/testdir/vim9.vim"": {""insertions"": 6, ""deletions"": 4, ""lines"": 10}, ""src/testing.c"": {""insertions"": 25, ""deletions"": 4, ""lines"": 29}, ""src/version.c"": {""insertions"": 2, ""deletions"": 0, ""lines"": 2}, ""src/vim9execute.c"": {""insertions"": 1, ""deletions"": 0, ""lines"": 1}}"
2020-08-18 11:04:15,558813314d63dd0263a7a86c0496c1e89b5c8cba,Bram Moolenaar,33,21,54,4,"{""src/dict.c"": {""insertions"": 15, ""deletions"": 0, ""lines"": 15}, ""src/popupwin.c"": {""insertions"": 15, ""deletions"": 21, ""lines"": 36}, ""src/proto/dict.pro"": {""insertions"": 1, ""deletions"": 0, ""lines"": 1}, ""src/version.c"": {""insertions"": 2, ""deletions"": 0, ""lines"": 2}}"
2020-08-17 20:21:36,f39397e515067d5a314be99778e63fe0acf93c51,Bram Moolenaar,9,1,10,3,"{""src/evalbuffer.c"": {""insertions"": 2, ""deletions"": 1, ""lines"": 3}, ""src/testdir/test_vim9_func.vim"": {""insertions"": 5, ""deletions"": 0, ""lines"": 5}, ""src/version.c"": {""insertions"": 2, ""deletions"": 0, ""lines"": 2}}"
2020-08-17 19:57:09,aa9675a61d510c4a56c3845d05b32b1ef780d119,Bram Moolenaar,3,1,4,2,"{""runtime/autoload/dist/ft.vim"": {""insertions"": 1, ""deletions"": 1, ""lines"": 2}, ""src/version.c"": {""insertions"": 2, ""deletions"": 0, ""lines"": 2}}"
2020-08-17 19:41:02,36967b32fd02eaab4273c1a1e7a1210a5fe45d09,Bram Moolenaar,46,26,72,4,"{""src/channel.c"": {""insertions"": 7, ""deletions"": 7, ""lines"": 14}, ""src/proto/typval.pro"": {""insertions"": 1, ""deletions"": 0, ""lines"": 1}, ""src/typval.c"": {""insertions"": 36, ""deletions"": 19, ""lines"": 55}, ""src/version.c"": {""insertions"": 2, ""deletions"": 0, ""lines"": 2}}"
2020-08-17 19:17:25,624b6eaf20f3e8c669425b6a32f17fb9ec2ebbd2,Bram Moolenaar,4,1,5,3,"{""runtime/autoload/dist/ft.vim"": {""insertions"": 1, ""deletions"": 1, ""lines"": 2}, ""src/testdir/test_filetype.vim"": {""insertions"": 1, ""deletions"": 0, ""lines"": 1}, ""src/version.c"": {""insertions"": 2, ""deletions"": 0, ""lines"": 2}}"
2020-08-17 19:07:22,021bda56710d98c09a6b35610a476ab2dd8c58ad,Bram Moolenaar,60,24,84,5,"{""runtime/doc/eval.txt"": {""insertions"": 11, ""deletions"": 3, ""lines"": 14}, ""src/eval.c"": {""insertions"": 2, ""deletions"": 0, ""lines"": 2}, ""src/evalvars.c"": {""insertions"": 21, ""deletions"": 12, ""lines"": 33}, ""src/testdir/test_const.vim"": {""insertions"": 24, ""deletions"": 9, ""lines"": 33}, ""src/version.c"": {""insertions"": 2, ""deletions"": 0, ""lines"": 2}}"
2020-08-17 17:34:10,7b22117c4ecf383b6f35acef041773a83ec28220,Bram Moolenaar,24,8,32,4,"{""src/arglist.c"": {""insertions"": 13, ""deletions"": 5, ""lines"": 18}, ""src/ex_docmd.c"": {""insertions"": 1, ""deletions"": 1, ""lines"": 2}, ""src/testdir/test_arglist.vim"": {""insertions"": 8, ""deletions"": 2, ""lines"": 10}, ""src/version.c"": {""insertions"": 2, ""deletions"": 0, ""lines"": 2}}"
2020-08-16 20:50:01,241572794f7e93d2f8b762de2300e5f7e4f07628,Bram Moolenaar,11,5,16,3,"{""src/evalvars.c"": {""insertions"": 1, ""deletions"": 1, ""lines"": 2}, ""src/testdir/test_const.vim"": {""insertions"": 8, ""deletions"": 4, ""lines"": 12}, ""src/version.c"": {""insertions"": 2, ""deletions"": 0, ""lines"": 2}}"
2020-08-16 19:51:49,c0f8823ee4ca629db5446ba0a935f68d4a4fb193,Bram Moolenaar,168,1,169,2,"{""src/testdir/test_spellfile.vim"": {""insertions"": 166, ""deletions"": 1, ""lines"": 167}, ""src/version.c"": {""insertions"": 2, ""deletions"": 0, ""lines"": 2}}"
2020-08-16 19:29:05,0aae4809fd52b445531766411a9c963dc6274a04,Bram Moolenaar,56,26,82,3,"{""src/evalvars.c"": {""insertions"": 28, ""deletions"": 14, ""lines"": 42}, ""src/testdir/test_vim9_script.vim"": {""insertions"": 26, ""deletions"": 12, ""lines"": 38}, ""src/version.c"": {""insertions"": 2, ""deletions"": 0, ""lines"": 2}}"
2020-08-16 16:42:53,f923571ec17b6caeeb7f4abfd7eec3f707ab9c45,Bram Moolenaar,10,1,11,3,"{""src/eval.c"": {""insertions"": 1, ""deletions"": 1, ""lines"": 2}, ""src/testdir/test_vim9_expr.vim"": {""insertions"": 7, ""deletions"": 0, ""lines"": 7}, ""src/version.c"": {""insertions"": 2, ""deletions"": 0, ""lines"": 2}}"
2020-08-16 16:29:35,e5abf7af08ff69e7e038c067497f080d4e44332c,Bram Moolenaar,22,10,32,4,"{""src/testdir/test_vim9_script.vim"": {""insertions"": 3, ""deletions"": 0, ""lines"": 3}, ""src/version.c"": {""insertions"": 2, ""deletions"": 0, ""lines"": 2}, ""src/vim9compile.c"": {""insertions"": 3, ""deletions"": 4, ""lines"": 7}, ""src/vim9execute.c"": {""insertions"": 14, ""deletions"": 6, ""lines"": 20}}"
2020-08-16 15:33:35,cc673e746ab98566556ff964d7a76f2fb46d7f84,Bram Moolenaar,410,205,615,11,"{""src/errors.h"": {""insertions"": 9, ""deletions"": 4, ""lines"": 13}, ""src/eval.c"": {""insertions"": 212, ""deletions"": 174, ""lines"": 386}, ""src/list.c"": {""insertions"": 1, ""deletions"": 1, ""lines"": 2}, ""src/proto/eval.pro"": {""insertions"": 2, ""deletions"": 0, ""lines"": 2}, ""src/testdir/test_vim9_disassemble.vim"": {""insertions"": 44, ""deletions"": 0, ""lines"": 44}, ""src/testdir/test_vim9_expr.vim"": {""insertions"": 86, ""deletions"": 4, ""lines"": 90}, ""src/testdir/test_vim9_script.vim"": {""insertions"": 1, ""deletions"": 1, ""lines"": 2}, ""src/version.c"": {""insertions"": 2, ""deletions"": 0, ""lines"": 2}, ""src/vim9.h"": {""insertions"": 2, ""deletions"": 0, ""lines"": 2}, ""src/vim9compile.c"": {""insertions"": 23, ""deletions"": 21, ""lines"": 44}, ""src/vim9execute.c"": {""insertions"": 28, ""deletions"": 0, ""lines"": 28}}"
2020-08-16 12:48:19,56acb0943ede35cd9d2f6667cde2442819ccbf59,Bram Moolenaar,71,67,138,9,"{""src/errors.h"": {""insertions"": 2, ""deletions"": 2, ""lines"": 4}, ""src/eval.c"": {""insertions"": 3, ""deletions"": 1, ""lines"": 4}, ""src/list.c"": {""insertions"": 4, ""deletions"": 1, ""lines"": 5}, ""src/testdir/test_vim9_expr.vim"": {""insertions"": 22, ""deletions"": 13, ""lines"": 35}, ""src/testdir/test_vim9_script.vim"": {""insertions"": 5, ""deletions"": 4, ""lines"": 9}, ""src/typval.c"": {""insertions"": 13, ""deletions"": 2, ""lines"": 15}, ""src/version.c"": {""insertions"": 2, ""deletions"": 0, ""lines"": 2}, ""src/vim9compile.c"": {""insertions"": 20, ""deletions"": 6, ""lines"": 26}, ""src/vim9execute.c"": {""insertions"": 0, ""deletions"": 38, ""lines"": 38}}"
2020-08-15 20:48:48,829ac868b7615d73dbfb536f7fcd44fc7c5b7c1d,Bram Moolenaar,2,1,3,2,"{""src/version.c"": {""insertions"": 2, ""deletions"": 0, ""lines"": 2}, ""src/vim9execute.c"": {""insertions"": 0, ""deletions"": 1, ""lines"": 1}}"
2020-08-15 20:14:53,ed5918771fcf9877d8445e74c62ab1ce6b8e28c1,Bram Moolenaar,175,57,232,9,"{""src/eval.c"": {""insertions"": 7, ""deletions"": 37, ""lines"": 44}, ""src/list.c"": {""insertions"": 55, ""deletions"": 0, ""lines"": 55}, ""src/proto/list.pro"": {""insertions"": 1, ""deletions"": 0, ""lines"": 1}, ""src/testdir/test_vim9_disassemble.vim"": {""insertions"": 47, ""deletions"": 0, ""lines"": 47}, ""src/testdir/test_vim9_expr.vim"": {""insertions"": 28, ""deletions"": 0, ""lines"": 28}, ""src/version.c"": {""insertions"": 2, ""deletions"": 0, ""lines"": 2}, ""src/vim9.h"": {""insertions"": 1, ""deletions"": 0, ""lines"": 1}, ""src/vim9compile.c"": {""insertions"": 10, ""deletions"": 6, ""lines"": 16}, ""src/vim9execute.c"": {""insertions"": 24, ""deletions"": 14, ""lines"": 38}}"
2020-08-15 19:10:16,11107bab7ead9124f46a7ddf6aa3bb66b43a8246,Bram Moolenaar,183,24,207,9,"{""src/errors.h"": {""insertions"": 2, ""deletions"": 1, ""lines"": 3}, ""src/eval.c"": {""insertions"": 71, ""deletions"": 5, ""lines"": 76}, ""src/proto/eval.pro"": {""insertions"": 1, ""deletions"": 0, ""lines"": 1}, ""src/testdir/test_vim9_disassemble.vim"": {""insertions"": 1, ""deletions"": 1, ""lines"": 2}, ""src/testdir/test_vim9_expr.vim"": {""insertions"": 23, ""deletions"": 1, ""lines"": 24}, ""src/version.c"": {""insertions"": 2, ""deletions"": 0, ""lines"": 2}, ""src/vim9.h"": {""insertions"": 1, ""deletions"": 0, ""lines"": 1}, ""src/vim9compile.c"": {""insertions"": 52, ""deletions"": 7, ""lines"": 59}, ""src/vim9execute.c"": {""insertions"": 30, ""deletions"": 9, ""lines"": 39}}"
2020-08-15 16:55:18,3d1cde8a2f28dce2c82d2b2b4c5e35e6662030e0,Bram Moolenaar,9035,137,9172,39,"{""README_VIM9.md"": {""insertions"": 1, ""deletions"": 1, ""lines"": 2}, ""runtime/colors/tools/check_colors.vim"": {""insertions"": 1, ""deletions"": 1, ""lines"": 2}, ""runtime/compiler/checkstyle.vim"": {""insertions"": 15, ""deletions"": 5, ""lines"": 20}, ""runtime/compiler/gawk.vim"": {""insertions"": 34, ""deletions"": 0, ""lines"": 34}, ""runtime/compiler/gjs.vim"": {""insertions"": 25, ""deletions"": 0, ""lines"": 25}, ""runtime/compiler/jest.vim"": {""insertions"": 30, ""deletions"": 0, ""lines"": 30}, ""runtime/compiler/jjs.vim"": {""insertions"": 24, ""deletions"": 0, ""lines"": 24}, ""runtime/compiler/jshint.vim"": {""insertions"": 25, ""deletions"": 0, ""lines"": 25}, ""runtime/compiler/jsonlint.vim"": {""insertions"": 25, ""deletions"": 0, ""lines"": 25}, ""runtime/compiler/rubocop.vim"": {""insertions"": 23, ""deletions"": 0, ""lines"": 23}, ""runtime/compiler/stylelint.vim"": {""insertions"": 26, ""deletions"": 0, ""lines"": 26}, ""runtime/compiler/ts-node.vim"": {""insertions"": 29, ""deletions"": 0, ""lines"": 29}, ""runtime/compiler/tsc.vim"": {""insertions"": 26, ""deletions"": 0, ""lines"": 26}, ""runtime/compiler/typedoc.vim"": {""insertions"": 28, ""deletions"": 0, ""lines"": 28}, ""runtime/doc/cmdline.txt"": {""insertions"": 3, ""deletions"": 2, ""lines"": 5}, ""runtime/doc/eval.txt"": {""insertions"": 1, ""deletions"": 1, ""lines"": 2}, ""runtime/doc/filetype.txt"": {""insertions"": 2, ""deletions"": 2, ""lines"": 4}, ""runtime/doc/gui.txt"": {""insertions"": 3, ""deletions"": 2, ""lines"": 5}, ""runtime/doc/options.txt"": {""insertions"": 10, ""deletions"": 22, ""lines"": 32}, ""runtime/doc/quickfix.txt"": {""insertions"": 2, ""deletions"": 2, ""lines"": 4}, ""runtime/doc/recover.txt"": {""insertions"": 3, ""deletions"": 3, ""lines"": 6}, ""runtime/doc/repeat.txt"": {""insertions"": 3, ""deletions"": 3, ""lines"": 6}, ""runtime/doc/spell.txt"": {""insertions"": 2, ""deletions"": 2, ""lines"": 4}, ""runtime/doc/tabpage.txt"": {""insertions"": 1, ""deletions"": 1, ""lines"": 2}, ""runtime/doc/tags"": {""insertions"": 6, ""deletions"": 0, ""lines"": 6}, ""runtime/doc/todo.txt"": {""insertions"": 23, ""deletions"": 15, ""lines"": 38}, ""runtime/doc/usr_41.txt"": {""insertions"": 26, ""deletions"": 26, ""lines"": 52}, ""runtime/doc/version6.txt"": {""insertions"": 9, ""deletions"": 9, ""lines"": 18}, ""runtime/doc/version7.txt"": {""insertions"": 4, ""deletions"": 4, ""lines"": 8}, ""runtime/doc/version8.txt"": {""insertions"": 8506, ""deletions"": 1, ""lines"": 8507}, ""runtime/doc/vim9.txt"": {""insertions"": 26, ""deletions"": 20, ""lines"": 46}, ""runtime/doc/windows.txt"": {""insertions"": 4, ""deletions"": 2, ""lines"": 6}, ""runtime/ftplugin/cobol.vim"": {""insertions"": 3, ""deletions"": 2, ""lines"": 5}, ""runtime/ftplugin/css.vim"": {""insertions"": 4, ""deletions"": 3, ""lines"": 7}, ""runtime/ftplugin/typescript.vim"": {""insertions"": 39, ""deletions"": 0, ""lines"": 39}, ""runtime/ftplugin/typescriptreact.vim"": {""insertions"": 33, ""deletions"": 0, ""lines"": 33}, ""runtime/ftplugin/vim.vim"": {""insertions"": 3, ""deletions"": 2, ""lines"": 5}, ""runtime/scripts.vim"": {""insertions"": 2, ""deletions"": 2, ""lines"": 4}, ""runtime/syntax/c.vim"": {""insertions"": 5, ""deletions"": 4, ""lines"": 9}}"
2020-08-15 16:39:05,e3c37d8ebf9dbbf210fde4a5fb28eb1f2a492a34,Bram Moolenaar,78,24,102,6,"{""runtime/doc/eval.txt"": {""insertions"": 24, ""deletions"": 12, ""lines"": 36}, ""src/eval.c"": {""insertions"": 28, ""deletions"": 0, ""lines"": 28}, ""src/proto/eval.pro"": {""insertions"": 1, ""deletions"": 0, ""lines"": 1}, ""src/testdir/test_vim9_expr.vim"": {""insertions"": 22, ""deletions"": 6, ""lines"": 28}, ""src/version.c"": {""insertions"": 2, ""deletions"": 0, ""lines"": 2}, ""src/vim9execute.c"": {""insertions"": 1, ""deletions"": 6, ""lines"": 7}}"
2020-08-15 14:33:28,451c2e3536a3cb77d07faf3cb2b834512e174351,Bram Moolenaar,369,182,551,18,"{""src/errors.h"": {""insertions"": 200, ""deletions"": 2, ""lines"": 202}, ""src/eval.c"": {""insertions"": 1, ""deletions"": 1, ""lines"": 2}, ""src/evalvars.c"": {""insertions"": 3, ""deletions"": 3, ""lines"": 6}, ""src/ex_cmds.c"": {""insertions"": 2, ""deletions"": 2, ""lines"": 4}, ""src/ex_docmd.c"": {""insertions"": 1, ""deletions"": 1, ""lines"": 2}, ""src/globals.h"": {""insertions"": 0, ""deletions"": 2, ""lines"": 2}, ""src/match.c"": {""insertions"": 1, ""deletions"": 1, ""lines"": 2}, ""src/scriptfile.c"": {""insertions"": 1, ""deletions"": 1, ""lines"": 2}, ""src/testdir/test_vim9_disassemble.vim"": {""insertions"": 1, ""deletions"": 1, ""lines"": 2}, ""src/testdir/test_vim9_expr.vim"": {""insertions"": 21, ""deletions"": 21, ""lines"": 42}, ""src/testdir/test_vim9_func.vim"": {""insertions"": 21, ""deletions"": 21, ""lines"": 42}, ""src/testdir/test_vim9_script.vim"": {""insertions"": 12, ""deletions"": 12, ""lines"": 24}, ""src/userfunc.c"": {""insertions"": 8, ""deletions"": 8, ""lines"": 16}, ""src/version.c"": {""insertions"": 2, ""deletions"": 0, ""lines"": 2}, ""src/vim9compile.c"": {""insertions"": 59, ""deletions"": 67, ""lines"": 126}, ""src/vim9execute.c"": {""insertions"": 12, ""deletions"": 12, ""lines"": 24}, ""src/vim9script.c"": {""insertions"": 16, ""deletions"": 19, ""lines"": 35}, ""src/vim9type.c"": {""insertions"": 8, ""deletions"": 8, ""lines"": 16}}"
2020-08-15 12:31:20,53b29e4845857d76ca7df1ff2fd0e03c3eeb82e1,Bram Moolenaar,14,1,15,3,"{""src/evalvars.c"": {""insertions"": 4, ""deletions"": 1, ""lines"": 5}, ""src/testdir/test_vim9_script.vim"": {""insertions"": 8, ""deletions"": 0, ""lines"": 8}, ""src/version.c"": {""insertions"": 2, ""deletions"": 0, ""lines"": 2}}"
2020-08-15 12:07:23,9a5c553f790f74e4c36295ce5d46c1aa7d13eae6,Bram Moolenaar,6,3,9,3,"{""runtime/filetype.vim"": {""insertions"": 1, ""deletions"": 1, ""lines"": 2}, ""src/testdir/test_filetype.vim"": {""insertions"": 3, ""deletions"": 2, ""lines"": 5}, ""src/version.c"": {""insertions"": 2, ""deletions"": 0, ""lines"": 2}}"
2020-08-15 11:49:17,793dcc540d96557919ae7dff9b2b3e21386a2e88,Bram Moolenaar,7,0,7,2,"{""src/version.c"": {""insertions"": 2, ""deletions"": 0, ""lines"": 2}, ""src/vim9execute.c"": {""insertions"": 5, ""deletions"": 0, ""lines"": 5}}"
2020-08-14 21:08:22,1623619119547142d94ddee4a75adc92304e55e9,Bram Moolenaar,6,4,10,2,"{""src/testdir/Make_dos.mak"": {""insertions"": 4, ""deletions"": 4, ""lines"": 8}, ""src/version.c"": {""insertions"": 2, ""deletions"": 0, ""lines"": 2}}"
2020-08-14 20:44:25,d1103587cf339feb8c77d282f7f7e92b7cff5add,Bram Moolenaar,12,2,14,3,"{""src/testdir/test_vim9_expr.vim"": {""insertions"": 6, ""deletions"": 0, ""lines"": 6}, ""src/version.c"": {""insertions"": 2, ""deletions"": 0, ""lines"": 2}, ""src/vim9compile.c"": {""insertions"": 4, ""deletions"": 2, ""lines"": 6}}"
2020-08-14 20:16:33,79e8db9a218ef111934594024a5cd8b1f93acada,Bram Moolenaar,17,1,18,4,"{""src/testdir/test_vim9_expr.vim"": {""insertions"": 8, ""deletions"": 0, ""lines"": 8}, ""src/version.c"": {""insertions"": 2, ""deletions"": 0, ""lines"": 2}, ""src/vim9compile.c"": {""insertions"": 3, ""deletions"": 0, ""lines"": 3}, ""src/vim9execute.c"": {""insertions"": 4, ""deletions"": 1, ""lines"": 5}}"
2020-08-14 19:49:08,8de2f44ac6af2276587a2e44a0d5fe1dc6789eb3,Bram Moolenaar,3,0,3,2,"{""src/testdir/test_vim9_expr.vim"": {""insertions"": 1, ""deletions"": 0, ""lines"": 1}, ""src/version.c"": {""insertions"": 2, ""deletions"": 0, ""lines"": 2}}"
2020-08-14 19:42:54,8d56622944d563a79676e99532bd372b2bc6fa1f,Bram Moolenaar,2,11,13,2,"{""src/version.c"": {""insertions"": 2, ""deletions"": 0, ""lines"": 2}, ""src/vim9compile.c"": {""insertions"": 0, ""deletions"": 11, ""lines"": 11}}"
2020-08-14 19:27:37,41fab3eac80893fd203663fc6a7ded09b04b633f,Bram Moolenaar,55,2,57,3,"{""src/testdir/test_vim9_expr.vim"": {""insertions"": 42, ""deletions"": 0, ""lines"": 42}, ""src/version.c"": {""insertions"": 2, ""deletions"": 0, ""lines"": 2}, ""src/vim9type.c"": {""insertions"": 11, ""deletions"": 2, ""lines"": 13}}"
2020-08-14 18:52:28,7d6997015d533604f18756e59b4a2a1266a66a97,Bram Moolenaar,38,0,38,2,"{""src/testdir/test_vim9_script.vim"": {""insertions"": 36, ""deletions"": 0, ""lines"": 36}, ""src/version.c"": {""insertions"": 2, ""deletions"": 0, ""lines"": 2}}"
2020-08-14 17:20:23,32a23ac61570365eff35097691d9b218b8539383,Bram Moolenaar,3,13,16,5,"{""src/testdir/Make_amiga.mak"": {""insertions"": 1, ""deletions"": 1, ""lines"": 2}, ""src/testdir/Make_dos.mak"": {""insertions"": 0, ""deletions"": 4, ""lines"": 4}, ""src/testdir/Make_ming.mak"": {""insertions"": 0, ""deletions"": 4, ""lines"": 4}, ""src/testdir/Make_vms.mms"": {""insertions"": 0, ""deletions"": 4, ""lines"": 4}, ""src/version.c"": {""insertions"": 2, ""deletions"": 0, ""lines"": 2}}"
2020-08-14 17:11:03,4ac97f476157ee0a3600e90f79f04813c418c172,Bram Moolenaar,7,1,8,2,"{""src/testdir/test77a.in"": {""insertions"": 5, ""deletions"": 1, ""lines"": 6}, ""src/version.c"": {""insertions"": 2, ""deletions"": 0, ""lines"": 2}}"
2020-08-14 16:56:45,32f335f75c5860baa452144f63ab7a4a3dd83134,Bram Moolenaar,8,1,9,3,"{""src/evalfunc.c"": {""insertions"": 1, ""deletions"": 1, ""lines"": 2}, ""src/testdir/test_vim9_func.vim"": {""insertions"": 5, ""deletions"": 0, ""lines"": 5}, ""src/version.c"": {""insertions"": 2, ""deletions"": 0, ""lines"": 2}}"
2020-08-14 16:35:07,7517ffdbb564250de72ee3ef64fecf4a486df519,Bram Moolenaar,44,1,45,3,"{""src/testdir/test_vim9_func.vim"": {""insertions"": 20, ""deletions"": 0, ""lines"": 20}, ""src/version.c"": {""insertions"": 2, ""deletions"": 0, ""lines"": 2}, ""src/vim9execute.c"": {""insertions"": 22, ""deletions"": 1, ""lines"": 23}}"
2020-08-14 15:08:15,c4ce36d48698669f81ec90f7c9dc9ab8c362e538,Bram Moolenaar,28,1,29,3,"{""src/testdir/test_vim9_script.vim"": {""insertions"": 23, ""deletions"": 0, ""lines"": 23}, ""src/userfunc.c"": {""insertions"": 3, ""deletions"": 1, ""lines"": 4}, ""src/version.c"": {""insertions"": 2, ""deletions"": 0, ""lines"": 2}}"
2020-08-13 20:47:35,bc4c505166dc82911553206bb0c2133c6ac94aa1,Bram Moolenaar,345,310,655,18,"{""Filelist"": {""insertions"": 1, ""deletions"": 0, ""lines"": 1}, ""src/Make_cyg_ming.mak"": {""insertions"": 1, ""deletions"": 1, ""lines"": 2}, ""src/Make_mvc.mak"": {""insertions"": 1, ""deletions"": 1, ""lines"": 2}, ""src/Make_vms.mms"": {""insertions"": 124, ""deletions"": 118, ""lines"": 242}, ""src/Makefile"": {""insertions"": 140, ""deletions"": 140, ""lines"": 280}, ""src/dict.c"": {""insertions"": 4, ""deletions"": 4, ""lines"": 8}, ""src/errors.h"": {""insertions"": 36, ""deletions"": 0, ""lines"": 36}, ""src/evalvars.c"": {""insertions"": 1, ""deletions"": 1, ""lines"": 2}, ""src/ex_docmd.c"": {""insertions"": 1, ""deletions"": 1, ""lines"": 2}, ""src/globals.h"": {""insertions"": 0, ""deletions"": 11, ""lines"": 11}, ""src/list.c"": {""insertions"": 2, ""deletions"": 2, ""lines"": 4}, ""src/userfunc.c"": {""insertions"": 3, ""deletions"": 3, ""lines"": 6}, ""src/version.c"": {""insertions"": 2, ""deletions"": 0, ""lines"": 2}, ""src/vim.h"": {""insertions"": 1, ""deletions"": 0, ""lines"": 1}, ""src/vim9compile.c"": {""insertions"": 20, ""deletions"": 20, ""lines"": 40}, ""src/vim9execute.c"": {""insertions"": 1, ""deletions"": 1, ""lines"": 2}, ""src/vim9script.c"": {""insertions"": 3, ""deletions"": 3, ""lines"": 6}, ""src/vim9type.c"": {""insertions"": 4, ""deletions"": 4, ""lines"": 8}}"
2020-08-13 19:40:18,cdd70f09a5340c3d7ae873f1aaaf9847f27410cc,Bram Moolenaar,11,8,19,2,"{""src/version.c"": {""insertions"": 2, ""deletions"": 0, ""lines"": 2}, ""src/vim9execute.c"": {""insertions"": 9, ""deletions"": 8, ""lines"": 17}}"
2020-08-13 19:05:39,be7529e8890f6e8a656efee8bc60c125dc8c2002,Bram Moolenaar,8,27,35,9,"{""READMEdir/README_extra.txt"": {""insertions"": 0, ""deletions"": 1, ""lines"": 1}, ""src/Makefile"": {""insertions"": 0, ""deletions"": 13, ""lines"": 13}, ""src/auto/configure"": {""insertions"": 1, ""deletions"": 2, ""lines"": 3}, ""src/configure.ac"": {""insertions"": 1, ""deletions"": 2, ""lines"": 3}, ""src/gui_haiku.cc"": {""insertions"": 1, ""deletions"": 1, ""lines"": 2}, ""src/os_macosx.m"": {""insertions"": 1, ""deletions"": 4, ""lines"": 5}, ""src/testdir/test_iminsert.vim"": {""insertions"": 2, ""deletions"": 2, ""lines"": 4}, ""src/version.c"": {""insertions"": 2, ""deletions"": 0, ""lines"": 2}, ""src/vim.h"": {""insertions"": 0, ""deletions"": 2, ""lines"": 2}}"
2020-08-13 17:42:39,c771908681bc9ee7689d83e09104cf4c6f984326,Bram Moolenaar,4,1,5,3,"{""src/testdir/Makefile"": {""insertions"": 1, ""deletions"": 1, ""lines"": 2}, ""src/testdir/summarize.vim"": {""insertions"": 1, ""deletions"": 0, ""lines"": 1}, ""src/version.c"": {""insertions"": 2, ""deletions"": 0, ""lines"": 2}}"
2020-08-13 17:20:04,16c6232cad40af37f37dc9c561392b7761b9e229,Bram Moolenaar,110,80,190,3,"{""src/testdir/test_debugger.vim"": {""insertions"": 15, ""deletions"": 30, ""lines"": 45}, ""src/testdir/test_vimscript.vim"": {""insertions"": 93, ""deletions"": 50, ""lines"": 143}, ""src/version.c"": {""insertions"": 2, ""deletions"": 0, ""lines"": 2}}"
2020-08-13 16:59:55,b96a32ef1a95dd4ebf9413d686bccb1b4645f74b,Bram Moolenaar,606,213,819,33,"{"".travis.yml"": {""insertions"": 3, ""deletions"": 3, ""lines"": 6}, ""Filelist"": {""insertions"": 2, ""deletions"": 4, ""lines"": 6}, ""Makefile"": {""insertions"": 1, ""deletions"": 1, ""lines"": 2}, ""runtime/doc/testing.txt"": {""insertions"": 6, ""deletions"": 0, ""lines"": 6}, ""src/Make_mvc.mak"": {""insertions"": 14, ""deletions"": 4, ""lines"": 18}, ""src/Makefile"": {""insertions"": 6, ""deletions"": 3, ""lines"": 9}, ""src/testdir/Make_all.mak"": {""insertions"": 23, ""deletions"": 2, ""lines"": 25}, ""src/testdir/Make_amiga.mak"": {""insertions"": 3, ""deletions"": 1, ""lines"": 4}, ""src/testdir/Make_dos.mak"": {""insertions"": 68, ""deletions"": 55, ""lines"": 123}, ""src/testdir/Make_ming.mak"": {""insertions"": 93, ""deletions"": 54, ""lines"": 147}, ""src/testdir/Make_vms.mms"": {""insertions"": 4, ""deletions"": 2, ""lines"": 6}, ""src/testdir/Makefile"": {""insertions"": 37, ""deletions"": 28, ""lines"": 65}, ""src/testdir/runtest.vim"": {""insertions"": 3, ""deletions"": 1, ""lines"": 4}, ""src/testdir/test1.in"": {""insertions"": 0, ""deletions"": 52, ""lines"": 52}, ""src/testdir/test1.ok"": {""insertions"": 0, ""deletions"": 1, ""lines"": 1}, ""src/testdir/test20.in"": {""insertions"": 27, ""deletions"": 0, ""lines"": 27}, ""src/testdir/test20.ok"": {""insertions"": 10, ""deletions"": 0, ""lines"": 10}, ""src/testdir/test21.in"": {""insertions"": 13, ""deletions"": 0, ""lines"": 13}, ""src/testdir/test21.ok"": {""insertions"": 4, ""deletions"": 0, ""lines"": 4}, ""src/testdir/test22.in"": {""insertions"": 15, ""deletions"": 0, ""lines"": 15}, ""src/testdir/test22.ok"": {""insertions"": 2, ""deletions"": 0, ""lines"": 2}, ""src/testdir/test23.in"": {""insertions"": 0, ""deletions"": 0, ""lines"": 0}, ""src/testdir/test23.ok"": {""insertions"": 32, ""deletions"": 0, ""lines"": 32}, ""src/testdir/test24.in"": {""insertions"": 0, ""deletions"": 0, ""lines"": 0}, ""src/testdir/test24.ok"": {""insertions"": 2, ""deletions"": 0, ""lines"": 2}, ""src/testdir/test25.in"": {""insertions"": 108, ""deletions"": 0, ""lines"": 108}, ""src/testdir/test25.ok"": {""insertions"": 99, ""deletions"": 0, ""lines"": 99}, ""src/testdir/test26.in"": {""insertions"": 24, ""deletions"": 0, ""lines"": 24}, ""src/testdir/test26.ok"": {""insertions"": 3, ""deletions"": 0, ""lines"": 3}, ""src/testdir/test27.in"": {""insertions"": 0, ""deletions"": 0, ""lines"": 0}, ""src/testdir/test27.ok"": {""insertions"": 0, ""deletions"": 0, ""lines"": 0}, ""src/testdir/test_options.vim"": {""insertions"": 2, ""deletions"": 2, ""lines"": 4}, ""src/version.c"": {""insertions"": 2, ""deletions"": 0, ""lines"": 2}}"
2020-08-12 20:22:09,7ac616cb0a52bc72b449e19cf9db93bee116c15a,Bram Moolenaar,125,0,125,2,"{""src/testdir/test_debugger.vim"": {""insertions"": 123, ""deletions"": 0, ""lines"": 123}, ""src/version.c"": {""insertions"": 2, ""deletions"": 0, ""lines"": 2}}"
2020-08-12 20:18:23,c9edd6b58218d25bfc5389af901021dc0eb82578,Bram Moolenaar,20,0,20,3,"{""src/eval.c"": {""insertions"": 4, ""deletions"": 0, ""lines"": 4}, ""src/testdir/test_vim9_script.vim"": {""insertions"": 14, ""deletions"": 0, ""lines"": 14}, ""src/version.c"": {""insertions"": 2, ""deletions"": 0, ""lines"": 2}}"
2020-08-12 19:58:12,66e0014ba651208ab7579797866ab0e4bd9e2b49,Bram Moolenaar,8,6,14,5,"{""src/ex_cmds.c"": {""insertions"": 1, ""deletions"": 1, ""lines"": 2}, ""src/ex_cmds.h"": {""insertions"": 3, ""deletions"": 3, ""lines"": 6}, ""src/ex_docmd.c"": {""insertions"": 1, ""deletions"": 1, ""lines"": 2}, ""src/proto/ex_cmds.pro"": {""insertions"": 1, ""deletions"": 1, ""lines"": 2}, ""src/version.c"": {""insertions"": 2, ""deletions"": 0, ""lines"": 2}}"
2020-08-12 19:34:49,418f1df54763b79600db1c91c880fbc1007b2e1f,Bram Moolenaar,157,12,169,10,"{""runtime/doc/vim9.txt"": {""insertions"": 8, ""deletions"": 2, ""lines"": 10}, ""src/eval.c"": {""insertions"": 16, ""deletions"": 2, ""lines"": 18}, ""src/evalfunc.c"": {""insertions"": 1, ""deletions"": 1, ""lines"": 2}, ""src/proto/vim9execute.pro"": {""insertions"": 1, ""deletions"": 0, ""lines"": 1}, ""src/testdir/test_vim9_disassemble.vim"": {""insertions"": 2, ""deletions"": 2, ""lines"": 4}, ""src/testdir/test_vim9_expr.vim"": {""insertions"": 67, ""deletions"": 0, ""lines"": 67}, ""src/version.c"": {""insertions"": 2, ""deletions"": 0, ""lines"": 2}, ""src/vim9.h"": {""insertions"": 2, ""deletions"": 1, ""lines"": 3}, ""src/vim9compile.c"": {""insertions"": 35, ""deletions"": 4, ""lines"": 39}, ""src/vim9execute.c"": {""insertions"": 23, ""deletions"": 0, ""lines"": 23}}"
2020-08-12 17:42:01,fd77748df2ba7d5f38aab649cb630374620462d7,Bram Moolenaar,18,0,18,3,"{""src/testdir/test_vim9_expr.vim"": {""insertions"": 13, ""deletions"": 0, ""lines"": 13}, ""src/version.c"": {""insertions"": 2, ""deletions"": 0, ""lines"": 2}, ""src/vim9compile.c"": {""insertions"": 3, ""deletions"": 0, ""lines"": 3}}"
2020-08-12 17:15:33,ba60cc45e786166767ca80f3dea6236d993c7971,Bram Moolenaar,24,5,29,3,"{""src/testdir/test_vim9_expr.vim"": {""insertions"": 15, ""deletions"": 0, ""lines"": 15}, ""src/version.c"": {""insertions"": 2, ""deletions"": 0, ""lines"": 2}, ""src/vim9compile.c"": {""insertions"": 7, ""deletions"": 5, ""lines"": 12}}"
2020-08-12 16:50:36,6d91bcb4d23b5c6a0be72c384beaf385e2d9d606,Bram Moolenaar,942,873,1815,159,"{""src/testdir/test_arglist.vim"": {""insertions"": 5, ""deletions"": 5, ""lines"": 10}, ""src/testdir/test_assert.vim"": {""insertions"": 2, ""deletions"": 0, ""lines"": 2}, ""src/testdir/test_autochdir.vim"": {""insertions"": 2, ""deletions"": 0, ""lines"": 2}, ""src/testdir/test_autocmd.vim"": {""insertions"": 10, ""deletions"": 18, ""lines"": 28}, ""src/testdir/test_autoload.vim"": {""insertions"": 2, ""deletions"": 0, ""lines"": 2}, ""src/testdir/test_balloon.vim"": {""insertions"": 2, ""deletions"": 0, ""lines"": 2}, ""src/testdir/test_balloon_gui.vim"": {""insertions"": 2, ""deletions"": 0, ""lines"": 2}, ""src/testdir/test_behave.vim"": {""insertions"": 2, ""deletions"": 0, ""lines"": 2}, ""src/testdir/test_blockedit.vim"": {""insertions"": 0, ""deletions"": 1, ""lines"": 1}, ""src/testdir/test_breakindent.vim"": {""insertions"": 20, ""deletions"": 60, ""lines"": 80}, ""src/testdir/test_bufline.vim"": {""insertions"": 2, ""deletions"": 0, ""lines"": 2}, ""src/testdir/test_bufwintabinfo.vim"": {""insertions"": 3, ""deletions"": 0, ""lines"": 3}, ""src/testdir/test_cd.vim"": {""insertions"": 2, ""deletions"": 0, ""lines"": 2}, ""src/testdir/test_changedtick.vim"": {""insertions"": 2, ""deletions"": 0, ""lines"": 2}, ""src/testdir/test_changelist.vim"": {""insertions"": 3, ""deletions"": 3, ""lines"": 6}, ""src/testdir/test_channel.vim"": {""insertions"": 1, ""deletions"": 3, ""lines"": 4}, ""src/testdir/test_checkpath.vim"": {""insertions"": 2, ""deletions"": 0, ""lines"": 2}, ""src/testdir/test_cindent.vim"": {""insertions"": 0, ""deletions"": 1, ""lines"": 1}, ""src/testdir/test_cjk_linebreak.vim"": {""insertions"": 4, ""deletions"": 0, ""lines"": 4}, ""src/testdir/test_clientserver.vim"": {""insertions"": 1, ""deletions"": 1, ""lines"": 2}, ""src/testdir/test_close_count.vim"": {""insertions"": 3, ""deletions"": 1, ""lines"": 4}, ""src/testdir/test_cmdline.vim"": {""insertions"": 12, ""deletions"": 24, ""lines"": 36}, ""src/testdir/test_command_count.vim"": {""insertions"": 2, ""deletions"": 0, ""lines"": 2}, ""src/testdir/test_comparators.vim"": {""insertions"": 4, ""deletions"": 0, ""lines"": 4}, ""src/testdir/test_compiler.vim"": {""insertions"": 2, ""deletions"": 0, ""lines"": 2}, ""src/testdir/test_crypt.vim"": {""insertions"": 2, ""deletions"": 0, ""lines"": 2}, ""src/testdir/test_cursorline.vim"": {""insertions"": 2, ""deletions"": 0, ""lines"": 2}, ""src/testdir/test_curswant.vim"": {""insertions"": 2, ""deletions"": 0, ""lines"": 2}, ""src/testdir/test_debugger.vim"": {""insertions"": 2, ""deletions"": 0, ""lines"": 2}, ""src/testdir/test_delete.vim"": {""insertions"": 2, ""deletions"": 0, ""lines"": 2}, ""src/testdir/test_diffmode.vim"": {""insertions"": 3, ""deletions"": 3, ""lines"": 6}, ""src/testdir/test_digraph.vim"": {""insertions"": 2, ""deletions"": 6, ""lines"": 8}, ""src/testdir/test_display.vim"": {""insertions"": 3, ""deletions"": 0, ""lines"": 3}, ""src/testdir/test_edit.vim"": {""insertions"": 16, ""deletions"": 30, ""lines"": 46}, ""src/testdir/test_environ.vim"": {""insertions"": 4, ""deletions"": 0, ""lines"": 4}, ""src/testdir/test_erasebackword.vim"": {""insertions"": 3, ""deletions"": 0, ""lines"": 3}, ""src/testdir/test_escaped_glob.vim"": {""insertions"": 7, ""deletions"": 5, ""lines"": 12}, ""src/testdir/test_ex_equal.vim"": {""insertions"": 2, ""deletions"": 0, ""lines"": 2}, ""src/testdir/test_ex_undo.vim"": {""insertions"": 2, ""deletions"": 0, ""lines"": 2}, ""src/testdir/test_ex_z.vim"": {""insertions"": 2, ""deletions"": 0, ""lines"": 2}, ""src/testdir/test_exec_while_if.vim"": {""insertions"": 2, ""deletions"": 0, ""lines"": 2}, ""src/testdir/test_exists.vim"": {""insertions"": 1, ""deletions"": 0, ""lines"": 1}, ""src/testdir/test_exists_autocmd.vim"": {""insertions"": 2, ""deletions"": 0, ""lines"": 2}, ""src/testdir/test_exit.vim"": {""insertions"": 2, ""deletions"": 0, ""lines"": 2}, ""src/testdir/test_expand_dllpath.vim"": {""insertions"": 4, ""deletions"": 0, ""lines"": 4}, ""src/testdir/test_expr_utf8.vim"": {""insertions"": 2, ""deletions"": 0, ""lines"": 2}, ""src/testdir/test_feedkeys.vim"": {""insertions"": 2, ""deletions"": 0, ""lines"": 2}, ""src/testdir/test_file_size.vim"": {""insertions"": 7, ""deletions"": 4, ""lines"": 11}, ""src/testdir/test_fileformat.vim"": {""insertions"": 1, ""deletions"": 0, ""lines"": 1}, ""src/testdir/test_filter_cmd.vim"": {""insertions"": 2, ""deletions"": 0, ""lines"": 2}, ""src/testdir/test_find_complete.vim"": {""insertions"": 2, ""deletions"": 0, ""lines"": 2}, ""src/testdir/test_findfile.vim"": {""insertions"": 2, ""deletions"": 0, ""lines"": 2}, ""src/testdir/test_fixeol.vim"": {""insertions"": 3, ""deletions"": 0, ""lines"": 3}, ""src/testdir/test_flatten.vim"": {""insertions"": 3, ""deletions"": 0, ""lines"": 3}, ""src/testdir/test_fnameescape.vim"": {""insertions"": 1, ""deletions"": 1, ""lines"": 2}, ""src/testdir/test_fold.vim"": {""insertions"": 1, ""deletions"": 3, ""lines"": 4}, ""src/testdir/test_functions.vim"": {""insertions"": 13, ""deletions"": 19, ""lines"": 32}, ""src/testdir/test_ga.vim"": {""insertions"": 1, ""deletions"": 0, ""lines"": 1}, ""src/testdir/test_getcwd.vim"": {""insertions"": 4, ""deletions"": 0, ""lines"": 4}, ""src/testdir/test_getvar.vim"": {""insertions"": 2, ""deletions"": 0, ""lines"": 2}, ""src/testdir/test_glob2regpat.vim"": {""insertions"": 2, ""deletions"": 0, ""lines"": 2}, ""src/testdir/test_global.vim"": {""insertions"": 2, ""deletions"": 0, ""lines"": 2}, ""src/testdir/test_gui.vim"": {""insertions"": 14, ""deletions"": 22, ""lines"": 36}, ""src/testdir/test_gui_init.vim"": {""insertions"": 2, ""deletions"": 0, ""lines"": 2}, ""src/testdir/test_highlight.vim"": {""insertions"": 4, ""deletions"": 12, ""lines"": 16}, ""src/testdir/test_hlsearch.vim"": {""insertions"": 5, ""deletions"": 3, ""lines"": 8}, ""src/testdir/test_iminsert.vim"": {""insertions"": 3, ""deletions"": 2, ""lines"": 5}, ""src/testdir/test_increment_dbcs.vim"": {""insertions"": 1, ""deletions"": 0, ""lines"": 1}, ""src/testdir/test_ins_complete.vim"": {""insertions"": 2, ""deletions"": 0, ""lines"": 2}, ""src/testdir/test_interrupt.vim"": {""insertions"": 2, ""deletions"": 0, ""lines"": 2}, ""src/testdir/test_job_fails.vim"": {""insertions"": 7, ""deletions"": 8, ""lines"": 15}, ""src/testdir/test_join.vim"": {""insertions"": 2, ""deletions"": 0, ""lines"": 2}, ""src/testdir/test_json.vim"": {""insertions"": 2, ""deletions"": 0, ""lines"": 2}, ""src/testdir/test_jumplist.vim"": {""insertions"": 5, ""deletions"": 3, ""lines"": 8}, ""src/testdir/test_jumps.vim"": {""insertions"": 4, ""deletions"": 0, ""lines"": 4}, ""src/testdir/test_lambda.vim"": {""insertions"": 3, ""deletions"": 3, ""lines"": 6}, ""src/testdir/test_langmap.vim"": {""insertions"": 2, ""deletions"": 0, ""lines"": 2}, ""src/testdir/test_largefile.vim"": {""insertions"": 2, ""deletions"": 0, ""lines"": 2}, ""src/testdir/test_lineending.vim"": {""insertions"": 3, ""deletions"": 0, ""lines"": 3}, ""src/testdir/test_listchars.vim"": {""insertions"": 2, ""deletions"": 0, ""lines"": 2}, ""src/testdir/test_listener.vim"": {""insertions"": 10, ""deletions"": 8, ""lines"": 18}, ""src/testdir/test_listlbr.vim"": {""insertions"": 3, ""deletions"": 1, ""lines"": 4}, ""src/testdir/test_listlbr_utf8.vim"": {""insertions"": 3, ""deletions"": 1, ""lines"": 4}, ""src/testdir/test_makeencoding.vim"": {""insertions"": 2, ""deletions"": 0, ""lines"": 2}, ""src/testdir/test_man.vim"": {""insertions"": 2, ""deletions"": 0, ""lines"": 2}, ""src/testdir/test_mapping.vim"": {""insertions"": 4, ""deletions"": 9, ""lines"": 13}, ""src/testdir/test_marks.vim"": {""insertions"": 1, ""deletions"": 0, ""lines"": 1}, ""src/testdir/test_matchadd_conceal.vim"": {""insertions"": 2, ""deletions"": 0, ""lines"": 2}, ""src/testdir/test_matchadd_conceal_utf8.vim"": {""insertions"": 2, ""deletions"": 0, ""lines"": 2}, ""src/testdir/test_memory_usage.vim"": {""insertions"": 2, ""deletions"": 0, ""lines"": 2}, ""src/testdir/test_menu.vim"": {""insertions"": 1, ""deletions"": 3, ""lines"": 4}, ""src/testdir/test_messages.vim"": {""insertions"": 4, ""deletions"": 6, ""lines"": 10}, ""src/testdir/test_mksession.vim"": {""insertions"": 9, ""deletions"": 12, ""lines"": 21}, ""src/testdir/test_modeline.vim"": {""insertions"": 6, ""deletions"": 6, ""lines"": 12}, ""src/testdir/test_nested_function.vim"": {""insertions"": 8, ""deletions"": 5, ""lines"": 13}, ""src/testdir/test_number.vim"": {""insertions"": 2, ""deletions"": 0, ""lines"": 2}, ""src/testdir/test_options.vim"": {""insertions"": 7, ""deletions"": 12, ""lines"": 19}, ""src/testdir/test_packadd.vim"": {""insertions"": 3, ""deletions"": 6, ""lines"": 9}, ""src/testdir/test_partial.vim"": {""insertions"": 21, ""deletions"": 22, ""lines"": 43}, ""src/testdir/test_paste.vim"": {""insertions"": 1, ""deletions"": 3, ""lines"": 4}, ""src/testdir/test_plus_arg_edit.vim"": {""insertions"": 1, ""deletions"": 0, ""lines"": 1}, ""src/testdir/test_preview.vim"": {""insertions"": 1, ""deletions"": 0, ""lines"": 1}, ""src/testdir/test_profile.vim"": {""insertions"": 2, ""deletions"": 0, ""lines"": 2}, ""src/testdir/test_prompt_buffer.vim"": {""insertions"": 6, ""deletions"": 14, ""lines"": 20}, ""src/testdir/test_quickfix.vim"": {""insertions"": 422, ""deletions"": 428, ""lines"": 850}, ""src/testdir/test_quotestar.vim"": {""insertions"": 3, ""deletions"": 1, ""lines"": 4}, ""src/testdir/test_random.vim"": {""insertions"": 2, ""deletions"": 0, ""lines"": 2}, ""src/testdir/test_recover.vim"": {""insertions"": 2, ""deletions"": 0, ""lines"": 2}, ""src/testdir/test_regex_char_classes.vim"": {""insertions"": 2, ""deletions"": 0, ""lines"": 2}, ""src/testdir/test_regexp_latin.vim"": {""insertions"": 1, ""deletions"": 0, ""lines"": 1}, ""src/testdir/test_registers.vim"": {""insertions"": 0, ""deletions"": 2, ""lines"": 2}, ""src/testdir/test_rename.vim"": {""insertions"": 2, ""deletions"": 0, ""lines"": 2}, ""src/testdir/test_retab.vim"": {""insertions"": 3, ""deletions"": 0, ""lines"": 3}, ""src/testdir/test_scriptnames.vim"": {""insertions"": 2, ""deletions"": 0, ""lines"": 2}, ""src/testdir/test_scroll_opt.vim"": {""insertions"": 2, ""deletions"": 1, ""lines"": 3}, ""src/testdir/test_scrollbind.vim"": {""insertions"": 3, ""deletions"": 0, ""lines"": 3}, ""src/testdir/test_search_stat.vim"": {""insertions"": 2, ""deletions"": 0, ""lines"": 2}, ""src/testdir/test_searchpos.vim"": {""insertions"": 2, ""deletions"": 0, ""lines"": 2}, ""src/testdir/test_set.vim"": {""insertions"": 2, ""deletions"": 0, ""lines"": 2}, ""src/testdir/test_sha256.vim"": {""insertions"": 2, ""deletions"": 0, ""lines"": 2}, ""src/testdir/test_shift.vim"": {""insertions"": 2, ""deletions"": 0, ""lines"": 2}, ""src/testdir/test_shortpathname.vim"": {""insertions"": 2, ""deletions"": 0, ""lines"": 2}, ""src/testdir/test_signs.vim"": {""insertions"": 2, ""deletions"": 0, ""lines"": 2}, ""src/testdir/test_sort.vim"": {""insertions"": 3, ""deletions"": 3, ""lines"": 6}, ""src/testdir/test_sound.vim"": {""insertions"": 2, ""deletions"": 0, ""lines"": 2}, ""src/testdir/test_source_utf8.vim"": {""insertions"": 3, ""deletions"": 0, ""lines"": 3}, ""src/testdir/test_spellfile.vim"": {""insertions"": 2, ""deletions"": 0, ""lines"": 2}, ""src/testdir/test_startup.vim"": {""insertions"": 5, ""deletions"": 12, ""lines"": 17}, ""src/testdir/test_startup_utf8.vim"": {""insertions"": 4, ""deletions"": 4, ""lines"": 8}, ""src/testdir/test_stat.vim"": {""insertions"": 12, ""deletions"": 7, ""lines"": 19}, ""src/testdir/test_suspend.vim"": {""insertions"": 5, ""deletions"": 4, ""lines"": 9}, ""src/testdir/test_swap.vim"": {""insertions"": 5, ""deletions"": 9, ""lines"": 14}, ""src/testdir/test_syntax.vim"": {""insertions"": 5, ""deletions"": 12, ""lines"": 17}, ""src/testdir/test_tab.vim"": {""insertions"": 2, ""deletions"": 0, ""lines"": 2}, ""src/testdir/test_tabline.vim"": {""insertions"": 1, ""deletions"": 0, ""lines"": 1}, ""src/testdir/test_tagcase.vim"": {""insertions"": 2, ""deletions"": 0, ""lines"": 2}, ""src/testdir/test_tagjump.vim"": {""insertions"": 6, ""deletions"": 8, ""lines"": 14}, ""src/testdir/test_taglist.vim"": {""insertions"": 5, ""deletions"": 6, ""lines"": 11}, ""src/testdir/test_termcodes.vim"": {""insertions"": 0, ""deletions"": 1, ""lines"": 1}, ""src/testdir/test_termencoding.vim"": {""insertions"": 2, ""deletions"": 0, ""lines"": 2}, ""src/testdir/test_terminal.vim"": {""insertions"": 1, ""deletions"": 3, ""lines"": 4}, ""src/testdir/test_terminal2.vim"": {""insertions"": 1, ""deletions"": 2, ""lines"": 3}, ""src/testdir/test_terminal3.vim"": {""insertions"": 2, ""deletions"": 0, ""lines"": 2}, ""src/testdir/test_terminal_fail.vim"": {""insertions"": 12, ""deletions"": 10, ""lines"": 22}, ""src/testdir/test_true_false.vim"": {""insertions"": 2, ""deletions"": 0, ""lines"": 2}, ""src/testdir/test_utf8_comparisons.vim"": {""insertions"": 2, ""deletions"": 0, ""lines"": 2}, ""src/testdir/test_vartabs.vim"": {""insertions"": 1, ""deletions"": 3, ""lines"": 4}, ""src/testdir/test_version.vim"": {""insertions"": 2, ""deletions"": 0, ""lines"": 2}, ""src/testdir/test_vim9_expr.vim"": {""insertions"": 2, ""deletions"": 0, ""lines"": 2}, ""src/testdir/test_winbar.vim"": {""insertions"": 1, ""deletions"": 0, ""lines"": 1}, ""src/testdir/test_winbuf_close.vim"": {""insertions"": 1, ""deletions"": 0, ""lines"": 1}, ""src/testdir/test_window_cmd.vim"": {""insertions"": 2, ""deletions"": 4, ""lines"": 6}, ""src/testdir/test_window_id.vim"": {""insertions"": 1, ""deletions"": 0, ""lines"": 1}, ""src/testdir/test_windows_home.vim"": {""insertions"": 2, ""deletions"": 0, ""lines"": 2}, ""src/testdir/test_wnext.vim"": {""insertions"": 2, ""deletions"": 0, ""lines"": 2}, ""src/testdir/test_wordcount.vim"": {""insertions"": 2, ""deletions"": 0, ""lines"": 2}, ""src/testdir/test_writefile.vim"": {""insertions"": 6, ""deletions"": 4, ""lines"": 10}, ""src/testdir/test_xxd.vim"": {""insertions"": 3, ""deletions"": 0, ""lines"": 3}, ""src/version.c"": {""insertions"": 2, ""deletions"": 0, ""lines"": 2}}"
2020-08-12 16:34:28,c3d6e8a46a8fc5de622e8df9dbd25edd03e00c5b,Bram Moolenaar,20,1,21,4,"{""src/dict.c"": {""insertions"": 6, ""deletions"": 1, ""lines"": 7}, ""src/testdir/test_vim9_expr.vim"": {""insertions"": 7, ""deletions"": 0, ""lines"": 7}, ""src/version.c"": {""insertions"": 2, ""deletions"": 0, ""lines"": 2}, ""src/vim9compile.c"": {""insertions"": 5, ""deletions"": 0, ""lines"": 5}}"
2020-08-12 16:01:53,db199216e81865350a8d56a603bb86cab672bfad,Bram Moolenaar,41,3,44,5,"{""src/dict.c"": {""insertions"": 7, ""deletions"": 2, ""lines"": 9}, ""src/list.c"": {""insertions"": 6, ""deletions"": 1, ""lines"": 7}, ""src/testdir/test_vim9_expr.vim"": {""insertions"": 21, ""deletions"": 0, ""lines"": 21}, ""src/version.c"": {""insertions"": 2, ""deletions"": 0, ""lines"": 2}, ""src/vim9compile.c"": {""insertions"": 5, ""deletions"": 0, ""lines"": 5}}"
2020-08-12 15:35:58,17a836cbee6b8d8ff555f8e307f48a779908db41,Bram Moolenaar,17,4,21,4,"{""src/testdir/test_vim9_expr.vim"": {""insertions"": 4, ""deletions"": 0, ""lines"": 4}, ""src/testdir/test_vim9_func.vim"": {""insertions"": 1, ""deletions"": 1, ""lines"": 2}, ""src/version.c"": {""insertions"": 2, ""deletions"": 0, ""lines"": 2}, ""src/vim9compile.c"": {""insertions"": 10, ""deletions"": 3, ""lines"": 13}}"
2020-08-12 14:38:10,ed677f5587af366f185f8922b7dde4a98c884328,Bram Moolenaar,29,4,33,3,"{""src/testdir/test_vim9_script.vim"": {""insertions"": 18, ""deletions"": 0, ""lines"": 18}, ""src/version.c"": {""insertions"": 2, ""deletions"": 0, ""lines"": 2}, ""src/vim9execute.c"": {""insertions"": 9, ""deletions"": 4, ""lines"": 13}}"
2020-08-12 13:48:55,7c5ad34878a338f1db57337b5ca9f68c0c39424e,Bram Moolenaar,34,15,49,3,"{""src/testdir/test_vim9_disassemble.vim"": {""insertions"": 31, ""deletions"": 14, ""lines"": 45}, ""src/version.c"": {""insertions"": 2, ""deletions"": 0, ""lines"": 2}, ""src/vim9compile.c"": {""insertions"": 1, ""deletions"": 1, ""lines"": 2}}"
2020-08-12 13:21:22,a177344dc0c337e5b272c1c59d13964a8318bcfa,Bram Moolenaar,45,4,49,5,"{""src/scriptfile.c"": {""insertions"": 1, ""deletions"": 1, ""lines"": 2}, ""src/testdir/test_vim9_expr.vim"": {""insertions"": 15, ""deletions"": 0, ""lines"": 15}, ""src/version.c"": {""insertions"": 2, ""deletions"": 0, ""lines"": 2}, ""src/vim9compile.c"": {""insertions"": 6, ""deletions"": 3, ""lines"": 9}, ""src/vim9execute.c"": {""insertions"": 21, ""deletions"": 0, ""lines"": 21}}"
2020-08-12 12:21:11,575f24b3f3d8cd8bfc2da402c2938c0c7ace7877,Bram Moolenaar,16,1,17,3,"{""src/testdir/test_vim9_func.vim"": {""insertions"": 6, ""deletions"": 0, ""lines"": 6}, ""src/version.c"": {""insertions"": 2, ""deletions"": 0, ""lines"": 2}, ""src/vim9compile.c"": {""insertions"": 8, ""deletions"": 1, ""lines"": 9}}"
2020-08-11 21:08:48,040f975fc1de14ada5e0a7324bb5e51e461be2dd,Bram Moolenaar,38,13,51,5,"{""src/auto/configure"": {""insertions"": 17, ""deletions"": 0, ""lines"": 17}, ""src/configure.ac"": {""insertions"": 15, ""deletions"": 0, ""lines"": 15}, ""src/libvterm/src/state.c"": {""insertions"": 2, ""deletions"": 2, ""lines"": 4}, ""src/os_macosx.m"": {""insertions"": 1, ""deletions"": 1, ""lines"": 2}, ""src/version.c"": {""insertions"": 3, ""deletions"": 10, ""lines"": 13}}"
2020-08-11 20:30:42,035d6e91bd83574cab5a913c5c3a924d9011696b,Bram Moolenaar,13,2,15,3,"{""src/testdir/test_vim9_func.vim"": {""insertions"": 9, ""deletions"": 0, ""lines"": 9}, ""src/userfunc.c"": {""insertions"": 2, ""deletions"": 2, ""lines"": 4}, ""src/version.c"": {""insertions"": 2, ""deletions"": 0, ""lines"": 2}}"
2020-08-11 19:58:20,097148e849136b49052b1b5123c714fb1d74db9b,Bram Moolenaar,48,7264,7312,26,"{""Filelist"": {""insertions"": 0, ""deletions"": 2, ""lines"": 2}, ""src/INSTALLmac.txt"": {""insertions"": 8, ""deletions"": 16, ""lines"": 24}, ""src/Makefile"": {""insertions"": 0, ""deletions"": 18, ""lines"": 18}, ""src/auto/configure"": {""insertions"": 13, ""deletions"": 105, ""lines"": 118}, ""src/configure.ac"": {""insertions"": 2, ""deletions"": 80, ""lines"": 82}, ""src/evalfunc.c"": {""insertions"": 1, ""deletions"": 7, ""lines"": 8}, ""src/feature.h"": {""insertions"": 5, ""deletions"": 15, ""lines"": 20}, ""src/fileio.c"": {""insertions"": 0, ""deletions"": 6, ""lines"": 6}, ""src/globals.h"": {""insertions"": 1, ""deletions"": 5, ""lines"": 6}, ""src/gui.c"": {""insertions"": 3, ""deletions"": 3, ""lines"": 6}, ""src/gui.h"": {""insertions"": 3, ""deletions"": 34, ""lines"": 37}, ""src/gui_mac.c"": {""insertions"": 0, ""deletions"": 6706, ""lines"": 6706}, ""src/if_mzsch.c"": {""insertions"": 0, ""deletions"": 14, ""lines"": 14}, ""src/main.c"": {""insertions"": 0, ""deletions"": 39, ""lines"": 39}, ""src/misc2.c"": {""insertions"": 1, ""deletions"": 1, ""lines"": 2}, ""src/mouse.c"": {""insertions"": 2, ""deletions"": 2, ""lines"": 4}, ""src/option.h"": {""insertions"": 0, ""deletions"": 3, ""lines"": 3}, ""src/optiondefs.h"": {""insertions"": 1, ""deletions"": 11, ""lines"": 12}, ""src/os_mac.h"": {""insertions"": 0, ""deletions"": 19, ""lines"": 19}, ""src/os_mac_conv.c"": {""insertions"": 1, ""deletions"": 1, ""lines"": 2}, ""src/os_unix.c"": {""insertions"": 2, ""deletions"": 2, ""lines"": 4}, ""src/proto.h"": {""insertions"": 0, ""deletions"": 3, ""lines"": 3}, ""src/proto/gui_mac.pro"": {""insertions"": 0, ""deletions"": 153, ""lines"": 153}, ""src/structs.h"": {""insertions"": 0, ""deletions"": 12, ""lines"": 12}, ""src/version.c"": {""insertions"": 2, ""deletions"": 0, ""lines"": 2}, ""src/vim.h"": {""insertions"": 3, ""deletions"": 7, ""lines"": 10}}"
2020-08-11 18:51:08,4301a729eabafee388aaf8465cf780d3f84cec95,Bram Moolenaar,11,7,18,2,"{""src/version.c"": {""insertions"": 2, ""deletions"": 0, ""lines"": 2}, ""src/vim9compile.c"": {""insertions"": 9, ""deletions"": 7, ""lines"": 16}}"
2020-08-11 18:42:19,f7c4d83609acdfe0e4d0fec9413697ac97c0c3f9,Bram Moolenaar,561,1682,2243,17,"{""Filelist"": {""insertions"": 5, ""deletions"": 4, ""lines"": 9}, ""runtime/doc/testing.txt"": {""insertions"": 4, ""deletions"": 11, ""lines"": 15}, ""src/Make_mvc.mak"": {""insertions"": 2, ""deletions"": 10, ""lines"": 12}, ""src/Makefile"": {""insertions"": 3, ""deletions"": 5, ""lines"": 8}, ""src/testdir/Make_all.mak"": {""insertions"": 0, ""deletions"": 18, ""lines"": 18}, ""src/testdir/Make_amiga.mak"": {""insertions"": 2, ""deletions"": 7, ""lines"": 9}, ""src/testdir/Make_dos.mak"": {""insertions"": 4, ""deletions"": 9, ""lines"": 13}, ""src/testdir/Make_ming.mak"": {""insertions"": 5, ""deletions"": 20, ""lines"": 25}, ""src/testdir/Make_vms.mms"": {""insertions"": 2, ""deletions"": 32, ""lines"": 34}, ""src/testdir/Makefile"": {""insertions"": 5, ""deletions"": 45, ""lines"": 50}, ""src/testdir/README.txt"": {""insertions"": 0, ""deletions"": 21, ""lines"": 21}, ""src/testdir/test49.in"": {""insertions"": 0, ""deletions"": 32, ""lines"": 32}, ""src/testdir/test49.ok"": {""insertions"": 0, ""deletions"": 12, ""lines"": 12}, ""src/testdir/test49.vim"": {""insertions"": 0, ""deletions"": 1454, ""lines"": 1454}, ""src/testdir/test_quickfix.vim"": {""insertions"": 23, ""deletions"": 0, ""lines"": 23}, ""src/testdir/test_vimscript.vim"": {""insertions"": 504, ""deletions"": 2, ""lines"": 506}, ""src/version.c"": {""insertions"": 2, ""deletions"": 0, ""lines"": 2}}"
2020-08-10 21:09:37,59eccb92e3c68f65525e08d2113213ff7d7ed00a,Bram Moolenaar,35,16,51,3,"{""src/testdir/test_vim9_expr.vim"": {""insertions"": 4, ""deletions"": 1, ""lines"": 5}, ""src/version.c"": {""insertions"": 2, ""deletions"": 0, ""lines"": 2}, ""src/vim9compile.c"": {""insertions"": 29, ""deletions"": 15, ""lines"": 44}}"
2020-08-10 20:40:56,8294d49937b99067522fda8a9399bb9533e3c44e,Bram Moolenaar,14,2,16,3,"{""src/testdir/test_vim9_expr.vim"": {""insertions"": 7, ""deletions"": 1, ""lines"": 8}, ""src/userfunc.c"": {""insertions"": 5, ""deletions"": 1, ""lines"": 6}, ""src/version.c"": {""insertions"": 2, ""deletions"": 0, ""lines"": 2}}"
2020-08-10 20:15:30,efb6482949580ab89e6d7c5e1cb8d744ddd6ef80,Bram Moolenaar,2025,2513,4538,4,"{""src/testdir/test49.ok"": {""insertions"": 0, ""deletions"": 14, ""lines"": 14}, ""src/testdir/test49.vim"": {""insertions"": 5, ""deletions"": 2462, ""lines"": 2467}, ""src/testdir/test_vimscript.vim"": {""insertions"": 2018, ""deletions"": 37, ""lines"": 2055}, ""src/version.c"": {""insertions"": 2, ""deletions"": 0, ""lines"": 2}}"
2020-08-10 19:57:54,3e06a1e2a8c0854c881574f33363e00264db1f1d,Bram Moolenaar,49,28,77,4,"{""src/eval.c"": {""insertions"": 10, ""deletions"": 3, ""lines"": 13}, ""src/testdir/test_vim9_expr.vim"": {""insertions"": 29, ""deletions"": 25, ""lines"": 54}, ""src/testdir/vim9.vim"": {""insertions"": 8, ""deletions"": 0, ""lines"": 8}, ""src/version.c"": {""insertions"": 2, ""deletions"": 0, ""lines"": 2}}"
2020-08-10 19:19:23,6f8f7337c1211692d508239eb4cbc8a6f67de497,Bram Moolenaar,44,0,44,4,"{""src/popupwin.c"": {""insertions"": 7, ""deletions"": 0, ""lines"": 7}, ""src/testdir/dumps/Test_popupwin_ctrl_c.dump"": {""insertions"": 10, ""deletions"": 0, ""lines"": 10}, ""src/testdir/test_popupwin.vim"": {""insertions"": 25, ""deletions"": 0, ""lines"": 25}, ""src/version.c"": {""insertions"": 2, ""deletions"": 0, ""lines"": 2}}"
2020-08-10 18:39:17,bf61fdd00808bfa7cc61a82c719fc220bba50ba3,Bram Moolenaar,45,18,63,5,"{""src/popupwin.c"": {""insertions"": 19, ""deletions"": 11, ""lines"": 30}, ""src/testdir/dumps/Test_popupwin_nospace.dump"": {""insertions"": 7, ""deletions"": 7, ""lines"": 14}, ""src/testdir/dumps/Test_popupwin_toohigh_3.dump"": {""insertions"": 10, ""deletions"": 0, ""lines"": 10}, ""src/testdir/test_popupwin.vim"": {""insertions"": 7, ""deletions"": 0, ""lines"": 7}, ""src/version.c"": {""insertions"": 2, ""deletions"": 0, ""lines"": 2}}"
2020-08-10 17:21:15,94f4ffa7704921a3634e56b878e6dc362bc3d508,Bram Moolenaar,49,6,55,5,"{""runtime/doc/tabpage.txt"": {""insertions"": 6, ""deletions"": 0, ""lines"": 6}, ""src/ex_docmd.c"": {""insertions"": 9, ""deletions"": 0, ""lines"": 9}, ""src/testdir/test_tabpage.vim"": {""insertions"": 30, ""deletions"": 5, ""lines"": 35}, ""src/version.c"": {""insertions"": 2, ""deletions"": 0, ""lines"": 2}, ""src/window.c"": {""insertions"": 2, ""deletions"": 1, ""lines"": 3}}"
2020-08-09 20:17:55,6e4cfffe809a894ea831fc8011527714481d2857,Bram Moolenaar,33,1,34,3,"{""src/eval.c"": {""insertions"": 13, ""deletions"": 1, ""lines"": 14}, ""src/testdir/test_vim9_expr.vim"": {""insertions"": 18, ""deletions"": 0, ""lines"": 18}, ""src/version.c"": {""insertions"": 2, ""deletions"": 0, ""lines"": 2}}"
2020-08-09 19:45:52,a9a47d157ab1946d1e286c9695bc68d71305af68,Bram Moolenaar,17,2,19,4,"{""src/clientserver.c"": {""insertions"": 4, ""deletions"": 2, ""lines"": 6}, ""src/testdir/test_cd.vim"": {""insertions"": 9, ""deletions"": 0, ""lines"": 9}, ""src/version.c"": {""insertions"": 2, ""deletions"": 0, ""lines"": 2}, ""src/window.c"": {""insertions"": 2, ""deletions"": 0, ""lines"": 2}}"
2020-08-09 18:05:41,7f7a8888699bca6df0a45a16db5f0e313383b5f1,Bram Moolenaar,30,2,32,3,"{""runtime/compiler/xo.vim"": {""insertions"": 26, ""deletions"": 0, ""lines"": 26}, ""src/testdir/test_compiler.vim"": {""insertions"": 2, ""deletions"": 2, ""lines"": 4}, ""src/version.c"": {""insertions"": 2, ""deletions"": 0, ""lines"": 2}}"
2020-08-09 17:32:39,1e91eafc2e19b84ea44347ea929d2791d2fdd5e3,Bram Moolenaar,9,1,10,3,"{""runtime/filetype.vim"": {""insertions"": 6, ""deletions"": 0, ""lines"": 6}, ""src/testdir/test_filetype.vim"": {""insertions"": 1, ""deletions"": 1, ""lines"": 2}, ""src/version.c"": {""insertions"": 2, ""deletions"": 0, ""lines"": 2}}"
2020-08-09 17:02:50,64d662d5fc2ff8af4dbf399ff02aa9d711cc9312,Bram Moolenaar,107,2,109,5,"{""runtime/doc/vim9.txt"": {""insertions"": 29, ""deletions"": 0, ""lines"": 29}, ""src/testdir/test_vim9_disassemble.vim"": {""insertions"": 18, ""deletions"": 0, ""lines"": 18}, ""src/testdir/test_vim9_expr.vim"": {""insertions"": 6, ""deletions"": 0, ""lines"": 6}, ""src/version.c"": {""insertions"": 2, ""deletions"": 0, ""lines"": 2}, ""src/vim9compile.c"": {""insertions"": 52, ""deletions"": 2, ""lines"": 54}}"
2020-08-09 15:22:04,127542bcebeb6480493b09d75a3be1d98a5f7797,Bram Moolenaar,91,17,108,6,"{""runtime/doc/vim9.txt"": {""insertions"": 8, ""deletions"": 0, ""lines"": 8}, ""src/proto/vim9type.pro"": {""insertions"": 1, ""deletions"": 0, ""lines"": 1}, ""src/testdir/test_vim9_expr.vim"": {""insertions"": 33, ""deletions"": 1, ""lines"": 34}, ""src/version.c"": {""insertions"": 2, ""deletions"": 0, ""lines"": 2}, ""src/vim9compile.c"": {""insertions"": 11, ""deletions"": 16, ""lines"": 27}, ""src/vim9type.c"": {""insertions"": 36, ""deletions"": 0, ""lines"": 36}}"
2020-08-09 14:37:48,a1b9b0cc011ef15869ac25cb93e1b4baa0cb7f38,Bram Moolenaar,76,6,82,5,"{""src/popupwin.c"": {""insertions"": 24, ""deletions"": 6, ""lines"": 30}, ""src/testdir/dumps/Test_popupwin_toohigh_1.dump"": {""insertions"": 10, ""deletions"": 0, ""lines"": 10}, ""src/testdir/dumps/Test_popupwin_toohigh_2.dump"": {""insertions"": 10, ""deletions"": 0, ""lines"": 10}, ""src/testdir/test_popupwin.vim"": {""insertions"": 30, ""deletions"": 0, ""lines"": 30}, ""src/version.c"": {""insertions"": 2, ""deletions"": 0, ""lines"": 2}}"
2020-08-09 13:25:14,a7cc9e697b9140da66a09f71cdf839d08e32f5fb,Bram Moolenaar,956,901,1857,10,"{""Filelist"": {""insertions"": 2, ""deletions"": 0, ""lines"": 2}, ""src/Make_cyg_ming.mak"": {""insertions"": 3, ""deletions"": 0, ""lines"": 3}, ""src/Make_mvc.mak"": {""insertions"": 4, ""deletions"": 0, ""lines"": 4}, ""src/Makefile"": {""insertions"": 10, ""deletions"": 0, ""lines"": 10}, ""src/proto.h"": {""insertions"": 1, ""deletions"": 0, ""lines"": 1}, ""src/proto/vim9compile.pro"": {""insertions"": 0, ""deletions"": 9, ""lines"": 9}, ""src/proto/vim9type.pro"": {""insertions"": 19, ""deletions"": 0, ""lines"": 19}, ""src/version.c"": {""insertions"": 2, ""deletions"": 0, ""lines"": 2}, ""src/vim9compile.c"": {""insertions"": 0, ""deletions"": 892, ""lines"": 892}, ""src/vim9type.c"": {""insertions"": 915, ""deletions"": 0, ""lines"": 915}}"
2020-08-09 12:43:58,b3ca98240761d8f320c5a49e077d1aac6496bb21,Bram Moolenaar,15,6,21,2,"{""src/testdir/test_vim9_script.vim"": {""insertions"": 13, ""deletions"": 6, ""lines"": 19}, ""src/version.c"": {""insertions"": 2, ""deletions"": 0, ""lines"": 2}}"
2020-08-09 12:33:55,3896a105eb3697b1a399255ac31c742c8840bd69,Bram Moolenaar,36,3,39,3,"{""src/ex_cmds.h"": {""insertions"": 3, ""deletions"": 3, ""lines"": 6}, ""src/testdir/test_vim9_script.vim"": {""insertions"": 31, ""deletions"": 0, ""lines"": 31}, ""src/version.c"": {""insertions"": 2, ""deletions"": 0, ""lines"": 2}}"
2020-08-09 12:07:52,94f6c06ac54401ea34a07f8c45242f11bd1e1e3a,Bram Moolenaar,9,6,15,2,"{"".travis.yml"": {""insertions"": 7, ""deletions"": 6, ""lines"": 13}, ""src/version.c"": {""insertions"": 2, ""deletions"": 0, ""lines"": 2}}"
2020-08-09 12:04:42,62a232506d06f6d1b3b7271801c907d6294dfe84,Bram Moolenaar,107,5,112,10,"{""runtime/doc/eval.txt"": {""insertions"": 7, ""deletions"": 2, ""lines"": 9}, ""runtime/doc/index.txt"": {""insertions"": 4, ""deletions"": 0, ""lines"": 4}, ""runtime/doc/tabpage.txt"": {""insertions"": 2, ""deletions"": 0, ""lines"": 2}, ""src/evalwindow.c"": {""insertions"": 3, ""deletions"": 0, ""lines"": 3}, ""src/globals.h"": {""insertions"": 3, ""deletions"": 1, ""lines"": 4}, ""src/normal.c"": {""insertions"": 12, ""deletions"": 1, ""lines"": 13}, ""src/proto/window.pro"": {""insertions"": 1, ""deletions"": 0, ""lines"": 1}, ""src/testdir/test_tabpage.vim"": {""insertions"": 45, ""deletions"": 1, ""lines"": 46}, ""src/version.c"": {""insertions"": 2, ""deletions"": 0, ""lines"": 2}, ""src/window.c"": {""insertions"": 28, ""deletions"": 0, ""lines"": 28}}"
2020-08-09 11:02:10,730b24833952f0f4a9a17b7815b0d9f87c609eb8,Bram Moolenaar,9,7,16,2,"{""src/testdir/test_vim9_script.vim"": {""insertions"": 7, ""deletions"": 7, ""lines"": 14}, ""src/version.c"": {""insertions"": 2, ""deletions"": 0, ""lines"": 2}}"
2020-08-08 20:16:00,efa94447e85eacce62c1fcf6b63e7f3431e2cb1b,Bram Moolenaar,45,9,54,5,"{""src/proto/vim9compile.pro"": {""insertions"": 1, ""deletions"": 0, ""lines"": 1}, ""src/testdir/test_vim9_script.vim"": {""insertions"": 25, ""deletions"": 0, ""lines"": 25}, ""src/userfunc.c"": {""insertions"": 8, ""deletions"": 7, ""lines"": 15}, ""src/version.c"": {""insertions"": 2, ""deletions"": 0, ""lines"": 2}, ""src/vim9compile.c"": {""insertions"": 9, ""deletions"": 2, ""lines"": 11}}"
2020-08-08 19:33:21,daa2f36573db3e1df7eb1fdbc3a09a2815644048,Bram Moolenaar,7,2,9,3,"{""src/scriptfile.c"": {""insertions"": 3, ""deletions"": 1, ""lines"": 4}, ""src/testdir/sautest/autoload/sourced.vim"": {""insertions"": 2, ""deletions"": 1, ""lines"": 3}, ""src/version.c"": {""insertions"": 2, ""deletions"": 0, ""lines"": 2}}"
2020-08-08 15:55:49,4a6d1b660fcea67931202527ad2852da55d26d49,Bram Moolenaar,25,1,26,3,"{""src/evalfunc.c"": {""insertions"": 10, ""deletions"": 1, ""lines"": 11}, ""src/testdir/test_maparg.vim"": {""insertions"": 13, ""deletions"": 0, ""lines"": 13}, ""src/version.c"": {""insertions"": 2, ""deletions"": 0, ""lines"": 2}}"
2020-08-08 14:47:30,5a849da57c5fb54ffcffd436a9e00ef40fdf094c,Bram Moolenaar,57,15,72,3,"{""src/testdir/test_vim9_func.vim"": {""insertions"": 38, ""deletions"": 6, ""lines"": 44}, ""src/version.c"": {""insertions"": 2, ""deletions"": 0, ""lines"": 2}, ""src/vim9compile.c"": {""insertions"": 17, ""deletions"": 9, ""lines"": 26}}"
2020-08-08 13:46:01,98b4f145eb89405021e23a4a37db51d60a75a1d0,Bram Moolenaar,20,10,30,8,"{""src/dict.c"": {""insertions"": 1, ""deletions"": 1, ""lines"": 2}, ""src/eval.c"": {""insertions"": 1, ""deletions"": 1, ""lines"": 2}, ""src/evalvars.c"": {""insertions"": 2, ""deletions"": 2, ""lines"": 4}, ""src/proto/evalvars.pro"": {""insertions"": 1, ""deletions"": 1, ""lines"": 2}, ""src/testdir/test_vim9_expr.vim"": {""insertions"": 4, ""deletions"": 4, ""lines"": 8}, ""src/testdir/test_vim9_script.vim"": {""insertions"": 1, ""deletions"": 0, ""lines"": 1}, ""src/version.c"": {""insertions"": 2, ""deletions"": 0, ""lines"": 2}, ""src/vim9compile.c"": {""insertions"": 8, ""deletions"": 1, ""lines"": 9}}"
2020-08-08 13:10:27,2dd0a2c39a3b3fbffc94d0676e472c78d02ebdbd,Bram Moolenaar,35,11,46,4,"{""src/testdir/test_vim9_func.vim"": {""insertions"": 25, ""deletions"": 0, ""lines"": 25}, ""src/testdir/test_vim9_script.vim"": {""insertions"": 0, ""deletions"": 5, ""lines"": 5}, ""src/version.c"": {""insertions"": 2, ""deletions"": 0, ""lines"": 2}, ""src/vim9compile.c"": {""insertions"": 8, ""deletions"": 6, ""lines"": 14}}"
2020-08-08 12:41:52,b7f4fa517793b0fe1a4895781b4cba451d60d7c2,Bram Moolenaar,276,10,286,2,"{""src/testdir/test_debugger.vim"": {""insertions"": 274, ""deletions"": 10, ""lines"": 284}, ""src/version.c"": {""insertions"": 2, ""deletions"": 0, ""lines"": 2}}"
2020-08-08 12:26:31,bf8feb5aeb71c8f56897845c4134793201aa459a,Bram Moolenaar,55,0,55,3,"{""src/testdir/test_vim9_func.vim"": {""insertions"": 41, ""deletions"": 0, ""lines"": 41}, ""src/userfunc.c"": {""insertions"": 12, ""deletions"": 0, ""lines"": 12}, ""src/version.c"": {""insertions"": 2, ""deletions"": 0, ""lines"": 2}}"
2020-08-07 20:00:26,fa211f3c6d27cf962b28f10e3c18b12dde4d20c3,Bram Moolenaar,16,0,16,3,"{""src/testdir/test_vim9_script.vim"": {""insertions"": 12, ""deletions"": 0, ""lines"": 12}, ""src/version.c"": {""insertions"": 2, ""deletions"": 0, ""lines"": 2}, ""src/vim9compile.c"": {""insertions"": 2, ""deletions"": 0, ""lines"": 2}}"
2020-08-07 19:28:34,1c199f9c70446933677d5210f34d2b86eefa2a43,Bram Moolenaar,8,1,9,3,"{""src/testdir/test_vim9_script.vim"": {""insertions"": 5, ""deletions"": 0, ""lines"": 5}, ""src/version.c"": {""insertions"": 2, ""deletions"": 0, ""lines"": 2}, ""src/vim9compile.c"": {""insertions"": 1, ""deletions"": 1, ""lines"": 2}}"
2020-08-07 18:47:39,74d95b5b58a36697975c48192e84be808b2512a8,Bram Moolenaar,3,0,3,2,"{""Filelist"": {""insertions"": 1, ""deletions"": 0, ""lines"": 1}, ""src/version.c"": {""insertions"": 2, ""deletions"": 0, ""lines"": 2}}"
2020-08-07 18:46:20,dd29f1b0569cca253c80856eda2e85e04c1e0627,Bram Moolenaar,77,32,109,3,"{""src/testdir/test_vim9_script.vim"": {""insertions"": 10, ""deletions"": 3, ""lines"": 13}, ""src/version.c"": {""insertions"": 2, ""deletions"": 0, ""lines"": 2}, ""src/vim9compile.c"": {""insertions"": 65, ""deletions"": 29, ""lines"": 94}}"
2020-08-07 17:54:59,e7b1ea0276cc83cd5c612f3189a174a60d57b5ed,Bram Moolenaar,400,162,562,38,"{""README_VIM9.md"": {""insertions"": 9, ""deletions"": 6, ""lines"": 15}, ""runtime/autoload/javascriptcomplete.vim"": {""insertions"": 33, ""deletions"": 11, ""lines"": 44}, ""runtime/doc/autocmd.txt"": {""insertions"": 3, ""deletions"": 3, ""lines"": 6}, ""runtime/doc/develop.txt"": {""insertions"": 3, ""deletions"": 3, ""lines"": 6}, ""runtime/doc/eval.txt"": {""insertions"": 18, ""deletions"": 16, ""lines"": 34}, ""runtime/doc/gui_w32.txt"": {""insertions"": 1, ""deletions"": 1, ""lines"": 2}, ""runtime/doc/helphelp.txt"": {""insertions"": 11, ""deletions"": 9, ""lines"": 20}, ""runtime/doc/if_lua.txt"": {""insertions"": 2, ""deletions"": 2, ""lines"": 4}, ""runtime/doc/if_tcl.txt"": {""insertions"": 2, ""deletions"": 2, ""lines"": 4}, ""runtime/doc/indent.txt"": {""insertions"": 14, ""deletions"": 14, ""lines"": 28}, ""runtime/doc/map.txt"": {""insertions"": 1, ""deletions"": 1, ""lines"": 2}, ""runtime/doc/options.txt"": {""insertions"": 12, ""deletions"": 6, ""lines"": 18}, ""runtime/doc/os_vms.txt"": {""insertions"": 1, ""deletions"": 1, ""lines"": 2}, ""runtime/doc/popup.txt"": {""insertions"": 4, ""deletions"": 4, ""lines"": 8}, ""runtime/doc/remote.txt"": {""insertions"": 1, ""deletions"": 1, ""lines"": 2}, ""runtime/doc/syntax.txt"": {""insertions"": 8, ""deletions"": 8, ""lines"": 16}, ""runtime/doc/tags"": {""insertions"": 1, ""deletions"": 0, ""lines"": 1}, ""runtime/doc/todo.txt"": {""insertions"": 17, ""deletions"": 10, ""lines"": 27}, ""runtime/doc/usr_04.txt"": {""insertions"": 1, ""deletions"": 1, ""lines"": 2}, ""runtime/doc/usr_05.txt"": {""insertions"": 2, ""deletions"": 2, ""lines"": 4}, ""runtime/doc/usr_20.txt"": {""insertions"": 4, ""deletions"": 4, ""lines"": 8}, ""runtime/doc/usr_30.txt"": {""insertions"": 1, ""deletions"": 1, ""lines"": 2}, ""runtime/doc/usr_31.txt"": {""insertions"": 3, ""deletions"": 3, ""lines"": 6}, ""runtime/doc/usr_40.txt"": {""insertions"": 4, ""deletions"": 4, ""lines"": 8}, ""runtime/doc/usr_41.txt"": {""insertions"": 2, ""deletions"": 2, ""lines"": 4}, ""runtime/doc/usr_42.txt"": {""insertions"": 2, ""deletions"": 2, ""lines"": 4}, ""runtime/doc/usr_46.txt"": {""insertions"": 1, ""deletions"": 1, ""lines"": 2}, ""runtime/doc/usr_toc.txt"": {""insertions"": 1, ""deletions"": 1, ""lines"": 2}, ""runtime/doc/vim9.txt"": {""insertions"": 22, ""deletions"": 17, ""lines"": 39}, ""runtime/doc/visual.txt"": {""insertions"": 4, ""deletions"": 4, ""lines"": 8}, ""runtime/filetype.vim"": {""insertions"": 1, ""deletions"": 1, ""lines"": 2}, ""runtime/ftplugin/vim.vim"": {""insertions"": 1, ""deletions"": 1, ""lines"": 2}, ""runtime/keymap/turkish-f.vim"": {""insertions"": 114, ""deletions"": 0, ""lines"": 114}, ""runtime/keymap/turkish-q.vim"": {""insertions"": 62, ""deletions"": 0, ""lines"": 62}, ""runtime/syntax/css.vim"": {""insertions"": 6, ""deletions"": 3, ""lines"": 9}, ""runtime/syntax/fstab.vim"": {""insertions"": 3, ""deletions"": 3, ""lines"": 6}, ""runtime/syntax/help.vim"": {""insertions"": 1, ""deletions"": 1, ""lines"": 2}, ""runtime/syntax/pamconf.vim"": {""insertions"": 24, ""deletions"": 13, ""lines"": 37}}"
2020-08-07 17:28:08,95dd9f2571f09a915674133c73b471b0ebbdcdbf,Bram Moolenaar,28,6,34,3,"{""src/eval.c"": {""insertions"": 15, ""deletions"": 6, ""lines"": 21}, ""src/testdir/test_vim9_script.vim"": {""insertions"": 11, ""deletions"": 0, ""lines"": 11}, ""src/version.c"": {""insertions"": 2, ""deletions"": 0, ""lines"": 2}}"
2020-08-07 17:12:41,994b89d28dc54c896e00eba66e247addb0540272,Bram Moolenaar,15,3,18,3,"{""src/option.c"": {""insertions"": 4, ""deletions"": 3, ""lines"": 7}, ""src/testdir/test_options.vim"": {""insertions"": 9, ""deletions"": 0, ""lines"": 9}, ""src/version.c"": {""insertions"": 2, ""deletions"": 0, ""lines"": 2}}"
2020-08-07 16:33:19,de6804d871def4d8973ef3ca3eece4155a5c3ab1,Bram Moolenaar,35,15,50,2,"{"".travis.yml"": {""insertions"": 33, ""deletions"": 15, ""lines"": 48}, ""src/version.c"": {""insertions"": 2, ""deletions"": 0, ""lines"": 2}}"
2020-08-07 16:12:18,8ce4b7ed85a7c6499bea5eb1312c85ee7a00e364,Bram Moolenaar,44,1,45,4,"{""src/quickfix.c"": {""insertions"": 19, ""deletions"": 1, ""lines"": 20}, ""src/testdir/runtest.vim"": {""insertions"": 3, ""deletions"": 0, ""lines"": 3}, ""src/testdir/test_quickfix.vim"": {""insertions"": 20, ""deletions"": 0, ""lines"": 20}, ""src/version.c"": {""insertions"": 2, ""deletions"": 0, ""lines"": 2}}"
2020-08-07 14:49:11,9470a4d88acf948af1596101527b3a505f8c14e9,Bram Moolenaar,1187,1219,2406,4,"{""src/testdir/test49.ok"": {""insertions"": 0, ""deletions"": 9, ""lines"": 9}, ""src/testdir/test49.vim"": {""insertions"": 38, ""deletions"": 1210, ""lines"": 1248}, ""src/testdir/test_vimscript.vim"": {""insertions"": 1147, ""deletions"": 0, ""lines"": 1147}, ""src/version.c"": {""insertions"": 2, ""deletions"": 0, ""lines"": 2}}"
2020-08-06 20:11:06,8e1986e3896cc8c2a05fc6291a39ebb275e1cebf,Bram Moolenaar,33,1,34,3,"{""src/ex_docmd.c"": {""insertions"": 1, ""deletions"": 1, ""lines"": 2}, ""src/testdir/test_vim9_script.vim"": {""insertions"": 30, ""deletions"": 0, ""lines"": 30}, ""src/version.c"": {""insertions"": 2, ""deletions"": 0, ""lines"": 2}}"
2020-08-06 19:47:11,56b8dc331dc7f499c8221ed7d1c7795ad5e3bdeb,Bram Moolenaar,51,1,52,4,"{""src/Make_cyg_ming.mak"": {""insertions"": 2, ""deletions"": 0, ""lines"": 2}, ""src/Make_mvc.mak"": {""insertions"": 5, ""deletions"": 1, ""lines"": 6}, ""src/if_python3.c"": {""insertions"": 42, ""deletions"": 0, ""lines"": 42}, ""src/version.c"": {""insertions"": 2, ""deletions"": 0, ""lines"": 2}}"
2020-08-06 19:26:59,3d945cc925dddb99a1ee86ec194b5b95221c72d7,Bram Moolenaar,18,1,19,3,"{""src/evalfunc.c"": {""insertions"": 10, ""deletions"": 1, ""lines"": 11}, ""src/testdir/test_vim9_func.vim"": {""insertions"": 6, ""deletions"": 0, ""lines"": 6}, ""src/version.c"": {""insertions"": 2, ""deletions"": 0, ""lines"": 2}}"
2020-08-06 14:38:12,ae95a3946b012d4e68bcb20b28f691f6d3b9caaf,Bram Moolenaar,25,1,26,3,"{""src/dict.c"": {""insertions"": 1, ""deletions"": 1, ""lines"": 2}, ""src/testdir/test_eval_stuff.vim"": {""insertions"": 22, ""deletions"": 0, ""lines"": 22}, ""src/version.c"": {""insertions"": 2, ""deletions"": 0, ""lines"": 2}}"
2020-08-06 09:23:36,bbd3e3c357487f7a5bdc704a819f63a7dd0dd66e,Bram Moolenaar,15,1,16,4,"{""src/eval.c"": {""insertions"": 4, ""deletions"": 1, ""lines"": 5}, ""src/testdir/test_expr.vim"": {""insertions"": 5, ""deletions"": 0, ""lines"": 5}, ""src/testdir/test_vim9_expr.vim"": {""insertions"": 4, ""deletions"": 0, ""lines"": 4}, ""src/version.c"": {""insertions"": 2, ""deletions"": 0, ""lines"": 2}}"
2020-08-05 20:07:26,b8d732e93e4b70ad992a12f761bc6a1279dd495b,Bram Moolenaar,4,0,4,2,"{""src/getchar.c"": {""insertions"": 2, ""deletions"": 0, ""lines"": 2}, ""src/version.c"": {""insertions"": 2, ""deletions"": 0, ""lines"": 2}}"
2020-08-05 14:20:03,803af686e23c7bb17273bb0c78ff0bf97e8d23f4,Bram Moolenaar,34,2,36,3,"{""src/ex_cmds.h"": {""insertions"": 2, ""deletions"": 2, ""lines"": 4}, ""src/testdir/test_vim9_script.vim"": {""insertions"": 30, ""deletions"": 0, ""lines"": 30}, ""src/version.c"": {""insertions"": 2, ""deletions"": 0, ""lines"": 2}}"
2020-08-05 13:43:44,c5da1fb7ea4126b6c70426cf0add51e720b7cd3f,Bram Moolenaar,5,3,8,3,"{""src/testdir/test_vim9_expr.vim"": {""insertions"": 2, ""deletions"": 2, ""lines"": 4}, ""src/version.c"": {""insertions"": 2, ""deletions"": 0, ""lines"": 2}, ""src/vim9compile.c"": {""insertions"": 1, ""deletions"": 1, ""lines"": 2}}"
2020-08-05 13:11:03,a71e2633207557c31432c954194078cb6062d04f,Bram Moolenaar,25,6,31,3,"{""src/testdir/test_vim9_script.vim"": {""insertions"": 14, ""deletions"": 0, ""lines"": 14}, ""src/version.c"": {""insertions"": 2, ""deletions"": 0, ""lines"": 2}, ""src/vim9compile.c"": {""insertions"": 9, ""deletions"": 6, ""lines"": 15}}"
2020-08-05 12:34:14,f9b2b49663226235f94f08230fe9023caf80a6e9,Bram Moolenaar,68,36,104,5,"{""src/structs.h"": {""insertions"": 3, ""deletions"": 1, ""lines"": 4}, ""src/testdir/test_vim9_script.vim"": {""insertions"": 9, ""deletions"": 0, ""lines"": 9}, ""src/userfunc.c"": {""insertions"": 1, ""deletions"": 0, ""lines"": 1}, ""src/version.c"": {""insertions"": 2, ""deletions"": 0, ""lines"": 2}, ""src/vim9compile.c"": {""insertions"": 53, ""deletions"": 35, ""lines"": 88}}"
2020-08-05 10:44:41,fdac71c5075062f97f77044e9619fa5c907e0327,Bram Moolenaar,61,4,65,3,"{""src/eval.c"": {""insertions"": 31, ""deletions"": 3, ""lines"": 34}, ""src/testdir/test_vim9_expr.vim"": {""insertions"": 28, ""deletions"": 1, ""lines"": 29}, ""src/version.c"": {""insertions"": 2, ""deletions"": 0, ""lines"": 2}}"
2020-08-05 10:32:38,3c1c9fd94bc80871119a8519f3b881595082a6c0,Bram Moolenaar,64,0,64,3,"{""src/eval.c"": {""insertions"": 28, ""deletions"": 0, ""lines"": 28}, ""src/testdir/test_vim9_expr.vim"": {""insertions"": 34, ""deletions"": 0, ""lines"": 34}, ""src/version.c"": {""insertions"": 2, ""deletions"": 0, ""lines"": 2}}"
2020-08-05 10:10:50,c753478b82613df37b145764e27f5514542edb97,Bram Moolenaar,11,1,12,2,"{""src/macros.h"": {""insertions"": 9, ""deletions"": 1, ""lines"": 10}, ""src/version.c"": {""insertions"": 2, ""deletions"": 0, ""lines"": 2}}"
2020-08-05 10:02:40,14ddd226daa324831e1872c352452f202fd6068c,Bram Moolenaar,3,1,4,2,"{""src/testdir/test_autocmd.vim"": {""insertions"": 1, ""deletions"": 1, ""lines"": 2}, ""src/version.c"": {""insertions"": 2, ""deletions"": 0, ""lines"": 2}}"
2020-08-05 09:51:30,ff1cd39cfe62d5089d5e703f4eb290694751ace3,Bram Moolenaar,53,5,58,3,"{""src/eval.c"": {""insertions"": 19, ""deletions"": 5, ""lines"": 24}, ""src/testdir/test_vim9_expr.vim"": {""insertions"": 32, ""deletions"": 0, ""lines"": 32}, ""src/version.c"": {""insertions"": 2, ""deletions"": 0, ""lines"": 2}}"
2020-08-05 09:36:52,b4caa163ff7bfacd4bec00e4baa55b5669ff1191,Bram Moolenaar,56,5,61,3,"{""src/eval.c"": {""insertions"": 18, ""deletions"": 4, ""lines"": 22}, ""src/testdir/test_vim9_expr.vim"": {""insertions"": 36, ""deletions"": 1, ""lines"": 37}, ""src/version.c"": {""insertions"": 2, ""deletions"": 0, ""lines"": 2}}"
2020-08-05 09:23:13,a6296200bd5191bab7efcdcc16c9e79eb498e8e0,Bram Moolenaar,1835,1752,3587,5,"{""src/testdir/script_util.vim"": {""insertions"": 69, ""deletions"": 0, ""lines"": 69}, ""src/testdir/test49.ok"": {""insertions"": 0, ""deletions"": 21, ""lines"": 21}, ""src/testdir/test49.vim"": {""insertions"": 3, ""deletions"": 1640, ""lines"": 1643}, ""src/testdir/test_vimscript.vim"": {""insertions"": 1761, ""deletions"": 91, ""lines"": 1852}, ""src/version.c"": {""insertions"": 2, ""deletions"": 0, ""lines"": 2}}"
2020-08-05 08:53:21,bb1b5e24ecc0abe1fee164e9de13796989eff784,Bram Moolenaar,80,26,106,7,"{""src/eval.c"": {""insertions"": 21, ""deletions"": 6, ""lines"": 27}, ""src/evalvars.c"": {""insertions"": 6, ""deletions"": 3, ""lines"": 9}, ""src/proto/vim9compile.pro"": {""insertions"": 1, ""deletions"": 0, ""lines"": 1}, ""src/testdir/test_vim9_expr.vim"": {""insertions"": 33, ""deletions"": 0, ""lines"": 33}, ""src/testdir/test_vim9_func.vim"": {""insertions"": 1, ""deletions"": 1, ""lines"": 2}, ""src/version.c"": {""insertions"": 2, ""deletions"": 0, ""lines"": 2}, ""src/vim9compile.c"": {""insertions"": 16, ""deletions"": 16, ""lines"": 32}}"
2020-08-04 19:46:18,282f9c64e570e832d3eba12950da15c9f1a40f06,Bram Moolenaar,4,2,6,2,"{""src/search.c"": {""insertions"": 2, ""deletions"": 2, ""lines"": 4}, ""src/version.c"": {""insertions"": 2, ""deletions"": 0, ""lines"": 2}}"
2020-08-04 19:04:57,e46a2ed0d8471b93a8b9edd98280d5de4a02c623,Bram Moolenaar,4,0,4,2,"{""src/testdir/test_termcodes.vim"": {""insertions"": 2, ""deletions"": 0, ""lines"": 2}, ""src/version.c"": {""insertions"": 2, ""deletions"": 0, ""lines"": 2}}"
2020-08-04 18:17:31,ecd34bf55d72f530859e290ac02ee41f9fb27cce,Bram Moolenaar,19,0,19,3,"{""src/term.c"": {""insertions"": 5, ""deletions"": 0, ""lines"": 5}, ""src/testdir/test_termcodes.vim"": {""insertions"": 12, ""deletions"": 0, ""lines"": 12}, ""src/version.c"": {""insertions"": 2, ""deletions"": 0, ""lines"": 2}}"
2020-08-04 13:53:01,6a25026262e2cdbbd8738361c5bd6ebef8862d87,Bram Moolenaar,6,0,6,3,"{""src/eval.c"": {""insertions"": 1, ""deletions"": 0, ""lines"": 1}, ""src/testdir/test_expr.vim"": {""insertions"": 3, ""deletions"": 0, ""lines"": 3}, ""src/version.c"": {""insertions"": 2, ""deletions"": 0, ""lines"": 2}}"
2020-08-03 20:39:28,f96e9dec636d7d105b015680d8c5d6b47d936e01,Bram Moolenaar,4,1,5,3,"{""src/eval.c"": {""insertions"": 1, ""deletions"": 1, ""lines"": 2}, ""src/testdir/test_filter_map.vim"": {""insertions"": 1, ""deletions"": 0, ""lines"": 1}, ""src/version.c"": {""insertions"": 2, ""deletions"": 0, ""lines"": 2}}"
2020-08-02 18:40:43,83144546488b544a1fe4e2a4f8be954b98c696fc,Bram Moolenaar,24,3,27,3,"{""src/ex_docmd.c"": {""insertions"": 5, ""deletions"": 3, ""lines"": 8}, ""src/testdir/test_vim9_script.vim"": {""insertions"": 17, ""deletions"": 0, ""lines"": 17}, ""src/version.c"": {""insertions"": 2, ""deletions"": 0, ""lines"": 2}}"
2020-08-02 18:03:25,434d72cbf2170d54cb4f8acbe995a9a55cceb92a,Bram Moolenaar,8,1,9,2,"{""src/testdir/test_vim9_script.vim"": {""insertions"": 6, ""deletions"": 1, ""lines"": 7}, ""src/version.c"": {""insertions"": 2, ""deletions"": 0, ""lines"": 2}}"
2020-08-02 16:58:54,658217276fccb5e53cdf4ba0f023bca80e0a8fed,Bram Moolenaar,24,6,30,4,"{""src/testdir/test_vim9_expr.vim"": {""insertions"": 7, ""deletions"": 0, ""lines"": 7}, ""src/testdir/test_vim9_script.vim"": {""insertions"": 2, ""deletions"": 1, ""lines"": 3}, ""src/version.c"": {""insertions"": 2, ""deletions"": 0, ""lines"": 2}, ""src/vim9compile.c"": {""insertions"": 13, ""deletions"": 5, ""lines"": 18}}"
2020-08-02 15:33:26,7226e5b19bd6e081043cbcc32541ef72bbdf667d,Bram Moolenaar,12,1,13,3,"{""src/testdir/test_vim9_expr.vim"": {""insertions"": 9, ""deletions"": 0, ""lines"": 9}, ""src/version.c"": {""insertions"": 2, ""deletions"": 0, ""lines"": 2}, ""src/vim9compile.c"": {""insertions"": 1, ""deletions"": 1, ""lines"": 2}}"
2020-08-02 14:59:00,c2ee44cc382d4b097f51ea3251f00fb35493ea4f,Bram Moolenaar,36,48,84,4,"{""src/evalvars.c"": {""insertions"": 8, ""deletions"": 6, ""lines"": 14}, ""src/testdir/test_vim9_script.vim"": {""insertions"": 4, ""deletions"": 1, ""lines"": 5}, ""src/version.c"": {""insertions"": 2, ""deletions"": 0, ""lines"": 2}, ""src/vim9compile.c"": {""insertions"": 22, ""deletions"": 41, ""lines"": 63}}"
2020-08-02 14:10:39,aa970abd0a987de96321d33db82f70bbceac931b,Bram Moolenaar,780,932,1712,8,"{""runtime/doc/eval.txt"": {""insertions"": 5, ""deletions"": 2, ""lines"": 7}, ""src/Makefile"": {""insertions"": 1, ""deletions"": 1, ""lines"": 2}, ""src/testdir/Make_all.mak"": {""insertions"": 3, ""deletions"": 1, ""lines"": 4}, ""src/testdir/Make_vms.mms"": {""insertions"": 1, ""deletions"": 32, ""lines"": 33}, ""src/testdir/test59.in"": {""insertions"": 0, ""deletions"": 626, ""lines"": 626}, ""src/testdir/test59.ok"": {""insertions"": 0, ""deletions"": 270, ""lines"": 270}, ""src/testdir/test_spell_utf8.vim"": {""insertions"": 768, ""deletions"": 0, ""lines"": 768}, ""src/version.c"": {""insertions"": 2, ""deletions"": 0, ""lines"": 2}}"
2020-08-02 13:05:05,8b89614e69b9b2330539d0482e44f4724053e780,Bram Moolenaar,23,1,24,3,"{""src/libvterm/src/screen.c"": {""insertions"": 6, ""deletions"": 1, ""lines"": 7}, ""src/testdir/test_terminal.vim"": {""insertions"": 15, ""deletions"": 0, ""lines"": 15}, ""src/version.c"": {""insertions"": 2, ""deletions"": 0, ""lines"": 2}}"
2020-08-01 21:22:18,ad486a0f0dd194826fdb733516bf0f35382c9dd7,Bram Moolenaar,23,1,24,3,"{""src/testdir/test_vim9_func.vim"": {""insertions"": 14, ""deletions"": 0, ""lines"": 14}, ""src/version.c"": {""insertions"": 2, ""deletions"": 0, ""lines"": 2}, ""src/vim9compile.c"": {""insertions"": 7, ""deletions"": 1, ""lines"": 8}}"
2020-08-01 20:35:13,bcbf41395f93aabd577a17dc4fbabe523d0a7ce8,Bram Moolenaar,11,1,12,3,"{""src/testdir/test_vim9_func.vim"": {""insertions"": 2, ""deletions"": 0, ""lines"": 2}, ""src/version.c"": {""insertions"": 2, ""deletions"": 0, ""lines"": 2}, ""src/vim9compile.c"": {""insertions"": 7, ""deletions"": 1, ""lines"": 8}}"
2020-08-01 20:23:20,b9a2cac3ef293bfdfe80dea6c6d16d02b7af5435,Bram Moolenaar,15,0,15,2,"{""src/testdir/test_vim9_script.vim"": {""insertions"": 13, ""deletions"": 0, ""lines"": 13}, ""src/version.c"": {""insertions"": 2, ""deletions"": 0, ""lines"": 2}}"
2020-08-01 20:16:43,eef2102e20d24f5fbd1c9f53c7a35df61585c5ab,Bram Moolenaar,66,10,76,5,"{""src/globals.h"": {""insertions"": 1, ""deletions"": 0, ""lines"": 1}, ""src/testdir/test_vim9_script.vim"": {""insertions"": 33, ""deletions"": 0, ""lines"": 33}, ""src/userfunc.c"": {""insertions"": 18, ""deletions"": 5, ""lines"": 23}, ""src/version.c"": {""insertions"": 2, ""deletions"": 0, ""lines"": 2}, ""src/vim9compile.c"": {""insertions"": 12, ""deletions"": 5, ""lines"": 17}}"
2020-08-01 19:11:38,e4218b9416bdcd78b9779a06258198573a0c369e,Bram Moolenaar,3,1,4,2,"{""src/ex_docmd.c"": {""insertions"": 1, ""deletions"": 1, ""lines"": 2}, ""src/version.c"": {""insertions"": 2, ""deletions"": 0, ""lines"": 2}}"
2020-08-01 18:45:11,909443028b57d7514ce3c71f00e9d808f2126b4f,Bram Moolenaar,38,7,45,4,"{""runtime/doc/map.txt"": {""insertions"": 4, ""deletions"": 0, ""lines"": 4}, ""src/ex_docmd.c"": {""insertions"": 13, ""deletions"": 1, ""lines"": 14}, ""src/testdir/test_expand_func.vim"": {""insertions"": 19, ""deletions"": 6, ""lines"": 25}, ""src/version.c"": {""insertions"": 2, ""deletions"": 0, ""lines"": 2}}"
2020-08-01 17:23:43,491799be5084dde7aa3367462f306e7b71dbc4a5,Bram Moolenaar,4,1,5,2,"{""src/ex_docmd.c"": {""insertions"": 2, ""deletions"": 1, ""lines"": 3}, ""src/version.c"": {""insertions"": 2, ""deletions"": 0, ""lines"": 2}}"
2020-08-01 17:14:13,f8992d47cd50494c64bb733329067c9de3c75200,Bram Moolenaar,38,3,41,4,"{""src/drawscreen.c"": {""insertions"": 6, ""deletions"": 3, ""lines"": 9}, ""src/testdir/dumps/Test_display_visual_block_scroll.dump"": {""insertions"": 7, ""deletions"": 0, ""lines"": 7}, ""src/testdir/test_display.vim"": {""insertions"": 23, ""deletions"": 0, ""lines"": 23}, ""src/version.c"": {""insertions"": 2, ""deletions"": 0, ""lines"": 2}}"
2020-08-01 16:57:52,2c79e9d14dc0e61d8c357946d01107ec23ec0fe2,Bram Moolenaar,15,0,15,2,"{""src/testdir/test_vim9_func.vim"": {""insertions"": 13, ""deletions"": 0, ""lines"": 13}, ""src/version.c"": {""insertions"": 2, ""deletions"": 0, ""lines"": 2}}"
2020-08-01 16:53:07,333894b195479c9304a19f4e6ec1a9c09ecf07e4,Bram Moolenaar,32,9,41,3,"{""src/testdir/test_vim9_func.vim"": {""insertions"": 15, ""deletions"": 0, ""lines"": 15}, ""src/userfunc.c"": {""insertions"": 15, ""deletions"": 9, ""lines"": 24}, ""src/version.c"": {""insertions"": 2, ""deletions"": 0, ""lines"": 2}}"
2020-08-01 15:00:03,f5a48010ef9e47319185f1aaac1bc6d45cd4d47a,Bram Moolenaar,22,11,33,6,"{""runtime/doc/vim9.txt"": {""insertions"": 6, ""deletions"": 5, ""lines"": 11}, ""src/ex_docmd.c"": {""insertions"": 3, ""deletions"": 0, ""lines"": 3}, ""src/testdir/test_vim9_script.vim"": {""insertions"": 8, ""deletions"": 5, ""lines"": 13}, ""src/version.c"": {""insertions"": 2, ""deletions"": 0, ""lines"": 2}, ""src/vim9compile.c"": {""insertions"": 1, ""deletions"": 0, ""lines"": 1}, ""src/vim9script.c"": {""insertions"": 2, ""deletions"": 1, ""lines"": 3}}"
2020-08-01 14:35:08,2ec208172c37b06a6177e32359214e5e02bfbed5,Bram Moolenaar,3,0,3,2,"{""src/globals.h"": {""insertions"": 1, ""deletions"": 0, ""lines"": 1}, ""src/version.c"": {""insertions"": 2, ""deletions"": 0, ""lines"": 2}}"
2020-08-01 14:08:19,b86abadf87bd0f85f800077171ec4b98aefff776,Bram Moolenaar,57,45,102,7,"{"".cirrus.yml"": {""insertions"": 5, ""deletions"": 2, ""lines"": 7}, ""src/testdir/test_backup.vim"": {""insertions"": 20, ""deletions"": 7, ""lines"": 27}, ""src/testdir/test_edit.vim"": {""insertions"": 0, ""deletions"": 1, ""lines"": 1}, ""src/testdir/test_viminfo.vim"": {""insertions"": 1, ""deletions"": 1, ""lines"": 2}, ""src/testdir/test_writefile.vim"": {""insertions"": 9, ""deletions"": 19, ""lines"": 28}, ""src/version.c"": {""insertions"": 2, ""deletions"": 0, ""lines"": 2}, ""src/viminfo.c"": {""insertions"": 20, ""deletions"": 15, ""lines"": 35}}"
2020-08-01 13:53:19,2caa1594e72be7a876c21ed5c2df252d3537cfa7,Bram Moolenaar,41,5,46,3,"{""src/testdir/test_vim9_script.vim"": {""insertions"": 24, ""deletions"": 0, ""lines"": 24}, ""src/version.c"": {""insertions"": 2, ""deletions"": 0, ""lines"": 2}, ""src/vim9compile.c"": {""insertions"": 15, ""deletions"": 5, ""lines"": 20}}"
2020-08-01 13:38:38,8e4c8c853e3ffbd9258f89180692879ec6bce72b,Bram Moolenaar,57,21,78,4,"{""src/testdir/test_vim9_script.vim"": {""insertions"": 23, ""deletions"": 0, ""lines"": 23}, ""src/version.c"": {""insertions"": 2, ""deletions"": 0, ""lines"": 2}, ""src/vim9compile.c"": {""insertions"": 27, ""deletions"": 21, ""lines"": 48}, ""src/vim9execute.c"": {""insertions"": 5, ""deletions"": 0, ""lines"": 5}}"
2020-08-01 12:06:38,586268721dd5d6e50903a8a457f02e0dda901856,Bram Moolenaar,8,13,21,3,"{""src/testdir/test_vim9_script.vim"": {""insertions"": 4, ""deletions"": 8, ""lines"": 12}, ""src/version.c"": {""insertions"": 2, ""deletions"": 0, ""lines"": 2}, ""src/vim9execute.c"": {""insertions"": 2, ""deletions"": 5, ""lines"": 7}}"
2020-08-01 11:22:10,af50e899e70ee34d5356846afbea7d75701cb22b,Bram Moolenaar,6,1,7,2,"{""src/gui.c"": {""insertions"": 4, ""deletions"": 1, ""lines"": 5}, ""src/version.c"": {""insertions"": 2, ""deletions"": 0, ""lines"": 2}}"
2020-08-01 11:10:14,4e1d8bd79b87b120bd40afe0eba54a419f8c3aee,Bram Moolenaar,52,15,67,6,"{""src/gui.c"": {""insertions"": 21, ""deletions"": 0, ""lines"": 21}, ""src/gui_gtk_x11.c"": {""insertions"": 9, ""deletions"": 4, ""lines"": 13}, ""src/gui_photon.c"": {""insertions"": 10, ""deletions"": 4, ""lines"": 14}, ""src/gui_x11.c"": {""insertions"": 9, ""deletions"": 7, ""lines"": 16}, ""src/proto/gui.pro"": {""insertions"": 1, ""deletions"": 0, ""lines"": 1}, ""src/version.c"": {""insertions"": 2, ""deletions"": 0, ""lines"": 2}}"
2020-08-01 10:26:04,b53da7918c643ef4de1256c37bc8b92413e6dcec,Bram Moolenaar,9,3,12,2,"{"".github/workflows/ci-windows.yaml"": {""insertions"": 7, ""deletions"": 3, ""lines"": 10}, ""src/version.c"": {""insertions"": 2, ""deletions"": 0, ""lines"": 2}}"
2020-07-31 22:03:09,af8edbb8dc551aaf2105a4d77b3d8495da239ef0,Bram Moolenaar,21,18,39,3,"{""src/testdir/test_vim9_func.vim"": {""insertions"": 16, ""deletions"": 15, ""lines"": 31}, ""src/userfunc.c"": {""insertions"": 3, ""deletions"": 3, ""lines"": 6}, ""src/version.c"": {""insertions"": 2, ""deletions"": 0, ""lines"": 2}}"
2020-07-31 21:47:12,ce6583568ff5b3e0e6438b37ede2c80bedffba10,Bram Moolenaar,49,25,74,5,"{""src/proto/userfunc.pro"": {""insertions"": 2, ""deletions"": 1, ""lines"": 3}, ""src/testdir/test_vim9_func.vim"": {""insertions"": 9, ""deletions"": 10, ""lines"": 19}, ""src/userfunc.c"": {""insertions"": 21, ""deletions"": 12, ""lines"": 33}, ""src/version.c"": {""insertions"": 2, ""deletions"": 0, ""lines"": 2}, ""src/vim9compile.c"": {""insertions"": 15, ""deletions"": 2, ""lines"": 17}}"
2020-07-31 20:38:17,badd8486f7442bfcf55e0234ece80488958e7114,Bram Moolenaar,11,1,12,3,"{""src/testdir/test_vim9_expr.vim"": {""insertions"": 8, ""deletions"": 0, ""lines"": 8}, ""src/version.c"": {""insertions"": 2, ""deletions"": 0, ""lines"": 2}, ""src/vim9compile.c"": {""insertions"": 1, ""deletions"": 1, ""lines"": 2}}"
2020-07-31 20:17:32,3a53ec8bdddccf06a0e9db263277c50a6015294d,Bram Moolenaar,25,10,35,2,"{"".github/workflows/ci-windows.yaml"": {""insertions"": 23, ""deletions"": 10, ""lines"": 33}, ""src/version.c"": {""insertions"": 2, ""deletions"": 0, ""lines"": 2}}"
2020-07-31 20:05:04,38ddf333f6b2806b0ea2dd052ee1cd50dd7f4525,Bram Moolenaar,237,12,249,11,"{""src/misc2.c"": {""insertions"": 35, ""deletions"": 0, ""lines"": 35}, ""src/proto/misc2.pro"": {""insertions"": 1, ""deletions"": 0, ""lines"": 1}, ""src/proto/userfunc.pro"": {""insertions"": 1, ""deletions"": 0, ""lines"": 1}, ""src/structs.h"": {""insertions"": 2, ""deletions"": 0, ""lines"": 2}, ""src/testdir/test_vim9_disassemble.vim"": {""insertions"": 18, ""deletions"": 0, ""lines"": 18}, ""src/testdir/test_vim9_func.vim"": {""insertions"": 22, ""deletions"": 0, ""lines"": 22}, ""src/userfunc.c"": {""insertions"": 79, ""deletions"": 4, ""lines"": 83}, ""src/version.c"": {""insertions"": 2, ""deletions"": 0, ""lines"": 2}, ""src/vim9.h"": {""insertions"": 8, ""deletions"": 0, ""lines"": 8}, ""src/vim9compile.c"": {""insertions"": 48, ""deletions"": 8, ""lines"": 56}, ""src/vim9execute.c"": {""insertions"": 21, ""deletions"": 0, ""lines"": 21}}"
2020-07-30 20:14:33,4d4d1cd5c8b61ef0296bd6190ca2a0b2d6d96ba7,Bram Moolenaar,17,2,19,4,"{""src/dict.c"": {""insertions"": 5, ""deletions"": 2, ""lines"": 7}, ""src/list.c"": {""insertions"": 3, ""deletions"": 0, ""lines"": 3}, ""src/testdir/test_listdict.vim"": {""insertions"": 7, ""deletions"": 0, ""lines"": 7}, ""src/version.c"": {""insertions"": 2, ""deletions"": 0, ""lines"": 2}}"
2020-07-30 18:18:08,f4ee528086dcff2b8744544c440853f177956261,Bram Moolenaar,12,4,16,3,"{""src/auto/configure"": {""insertions"": 3, ""deletions"": 2, ""lines"": 5}, ""src/configure.ac"": {""insertions"": 7, ""deletions"": 2, ""lines"": 9}, ""src/version.c"": {""insertions"": 2, ""deletions"": 0, ""lines"": 2}}"
2020-07-30 18:08:50,9d489566815d7913afc5dfc2a772bacede3970fb,Bram Moolenaar,62,37,99,11,"{""src/dict.c"": {""insertions"": 4, ""deletions"": 0, ""lines"": 4}, ""src/eval.c"": {""insertions"": 28, ""deletions"": 13, ""lines"": 41}, ""src/list.c"": {""insertions"": 2, ""deletions"": 2, ""lines"": 4}, ""src/testdir/test_functions.vim"": {""insertions"": 1, ""deletions"": 1, ""lines"": 2}, ""src/testdir/test_gn.vim"": {""insertions"": 1, ""deletions"": 1, ""lines"": 2}, ""src/testdir/test_popupwin.vim"": {""insertions"": 1, ""deletions"": 1, ""lines"": 2}, ""src/testdir/test_tabpage.vim"": {""insertions"": 1, ""deletions"": 1, ""lines"": 2}, ""src/testdir/test_textobjects.vim"": {""insertions"": 17, ""deletions"": 17, ""lines"": 34}, ""src/testdir/test_textprop.vim"": {""insertions"": 1, ""deletions"": 1, ""lines"": 2}, ""src/userfunc.c"": {""insertions"": 4, ""deletions"": 0, ""lines"": 4}, ""src/version.c"": {""insertions"": 2, ""deletions"": 0, ""lines"": 2}}"
2020-07-29 20:11:05,ea2d8d25718836bf627b67b7fcd28a1e528bb7b9,Bram Moolenaar,23,3,26,4,"{""runtime/doc/vim9.txt"": {""insertions"": 7, ""deletions"": 3, ""lines"": 10}, ""src/testdir/sautest/autoload/auto9.vim"": {""insertions"": 9, ""deletions"": 0, ""lines"": 9}, ""src/testdir/test_autoload.vim"": {""insertions"": 5, ""deletions"": 0, ""lines"": 5}, ""src/version.c"": {""insertions"": 2, ""deletions"": 0, ""lines"": 2}}"
2020-07-29 19:37:43,c7e44a7e4caedc1bc33f5c8e481109c0ae002823,Bram Moolenaar,24,2,26,3,"{""src/evalvars.c"": {""insertions"": 3, ""deletions"": 2, ""lines"": 5}, ""src/testdir/test_vim9_script.vim"": {""insertions"": 19, ""deletions"": 0, ""lines"": 19}, ""src/version.c"": {""insertions"": 2, ""deletions"": 0, ""lines"": 2}}"
2020-07-29 19:20:41,696ba23149eb5a7226e606e3fe6f15fdd064c5f7,Bram Moolenaar,38,41,79,5,"{""src/eval.c"": {""insertions"": 9, ""deletions"": 39, ""lines"": 48}, ""src/proto/vim9compile.pro"": {""insertions"": 1, ""deletions"": 0, ""lines"": 1}, ""src/testdir/test_vim9_expr.vim"": {""insertions"": 25, ""deletions"": 1, ""lines"": 26}, ""src/version.c"": {""insertions"": 2, ""deletions"": 0, ""lines"": 2}, ""src/vim9compile.c"": {""insertions"": 1, ""deletions"": 1, ""lines"": 2}}"
2020-07-29 18:00:38,1040956292a9f2c3d02fc08febd5acf349c85590,Bram Moolenaar,17,3,20,4,"{""src/ex_docmd.c"": {""insertions"": 3, ""deletions"": 1, ""lines"": 4}, ""src/testdir/test_vim9_expr.vim"": {""insertions"": 3, ""deletions"": 2, ""lines"": 5}, ""src/testdir/test_vim9_func.vim"": {""insertions"": 9, ""deletions"": 0, ""lines"": 9}, ""src/version.c"": {""insertions"": 2, ""deletions"": 0, ""lines"": 2}}"
2020-07-29 17:29:23,7b7f78f51dc5a2c307330af0d4e53faced34726f,Bram Moolenaar,4,0,4,2,"{"".github/workflows/ci-windows.yaml"": {""insertions"": 2, ""deletions"": 0, ""lines"": 2}, ""src/version.c"": {""insertions"": 2, ""deletions"": 0, ""lines"": 2}}"
2020-07-29 17:18:00,33afa2447bdb0bdd15253c69a2cf6f9903685815,Bram Moolenaar,38,7,45,3,"{""src/testdir/test_vim9_script.vim"": {""insertions"": 25, ""deletions"": 0, ""lines"": 25}, ""src/version.c"": {""insertions"": 2, ""deletions"": 0, ""lines"": 2}, ""src/vim9compile.c"": {""insertions"": 11, ""deletions"": 7, ""lines"": 18}}"
2020-07-29 15:43:55,ac7bf8c4bfcbb157a2db6b939927bf11edb6ba7b,Bram Moolenaar,4,2,6,3,"{"".github/workflows/ci-windows.yaml"": {""insertions"": 1, ""deletions"": 1, ""lines"": 2}, ""README.md"": {""insertions"": 1, ""deletions"": 1, ""lines"": 2}, ""src/version.c"": {""insertions"": 2, ""deletions"": 0, ""lines"": 2}}"
2020-07-29 15:34:33,ed3c7e633944cf70754bc05504a7cd724fdca178,Bram Moolenaar,3,0,3,2,"{""README.md"": {""insertions"": 1, ""deletions"": 0, ""lines"": 1}, ""src/version.c"": {""insertions"": 2, ""deletions"": 0, ""lines"": 2}}"
2020-07-29 14:32:21,f9a343f8bda8fbe17ff045bef7342ffd6179e2f5,Bram Moolenaar,230,34,264,5,"{"".github/workflows/ci-windows.yaml"": {""insertions"": 208, ""deletions"": 0, ""lines"": 208}, ""Filelist"": {""insertions"": 1, ""deletions"": 0, ""lines"": 1}, ""appveyor.yml"": {""insertions"": 5, ""deletions"": 4, ""lines"": 9}, ""ci/appveyor.bat"": {""insertions"": 14, ""deletions"": 30, ""lines"": 44}, ""src/version.c"": {""insertions"": 2, ""deletions"": 0, ""lines"": 2}}"
2020-07-29 14:08:21,b61ef01cce2afd70fbfa2805336a26643109dfb7,Bram Moolenaar,133,143,276,9,"{""src/Makefile"": {""insertions"": 1, ""deletions"": 1, ""lines"": 2}, ""src/testdir/Make_all.mak"": {""insertions"": 1, ""deletions"": 1, ""lines"": 2}, ""src/testdir/Make_dos.mak"": {""insertions"": 0, ""deletions"": 3, ""lines"": 3}, ""src/testdir/Make_ming.mak"": {""insertions"": 0, ""deletions"": 5, ""lines"": 5}, ""src/testdir/Make_vms.mms"": {""insertions"": 1, ""deletions"": 2, ""lines"": 3}, ""src/testdir/test42.in"": {""insertions"": 0, ""deletions"": 131, ""lines"": 131}, ""src/testdir/test42.ok"": {""insertions"": 0, ""deletions"": 0, ""lines"": 0}, ""src/testdir/test_writefile.vim"": {""insertions"": 128, ""deletions"": 0, ""lines"": 128}, ""src/version.c"": {""insertions"": 2, ""deletions"": 0, ""lines"": 2}}"
2020-07-29 13:03:01,45df2a01a79d562b59949383f79625bb8bd89a69,Bram Moolenaar,12,4,16,2,"{""src/testdir/runtest.vim"": {""insertions"": 10, ""deletions"": 4, ""lines"": 14}, ""src/version.c"": {""insertions"": 2, ""deletions"": 0, ""lines"": 2}}"
2020-07-29 12:40:25,9898107f54a330c6d9629976250a393169c698ca,Bram Moolenaar,10,3,13,3,"{""src/testdir/test_vim9_script.vim"": {""insertions"": 6, ""deletions"": 2, ""lines"": 8}, ""src/userfunc.c"": {""insertions"": 2, ""deletions"": 1, ""lines"": 3}, ""src/version.c"": {""insertions"": 2, ""deletions"": 0, ""lines"": 2}}"
2020-07-28 20:38:37,b5ed266037dea49024e00c4e1f9c89f3a9ebaa60,Bram Moolenaar,108,67,175,3,"{""src/ex_docmd.c"": {""insertions"": 81, ""deletions"": 67, ""lines"": 148}, ""src/testdir/test_vim9_script.vim"": {""insertions"": 25, ""deletions"": 0, ""lines"": 25}, ""src/version.c"": {""insertions"": 2, ""deletions"": 0, ""lines"": 2}}"
2020-07-28 19:40:27,066b12e36c32a87725303c0f71e968eb3f9a9f32,Bram Moolenaar,8,3,11,2,"{""src/testdir/test_terminal3.vim"": {""insertions"": 6, ""deletions"": 3, ""lines"": 9}, ""src/version.c"": {""insertions"": 2, ""deletions"": 0, ""lines"": 2}}"
2020-07-28 19:15:07,68e30449a2954557d6542fdc2ccea32d4f8ddf9d,Bram Moolenaar,13,10,23,2,"{""src/version.c"": {""insertions"": 2, ""deletions"": 0, ""lines"": 2}, ""src/vim9script.c"": {""insertions"": 11, ""deletions"": 10, ""lines"": 21}}"
2020-07-28 19:03:37,bd7f7c123db58dd7f50f4d1391577686d2f1bcc6,Bram Moolenaar,4,2,6,3,"{""src/auto/configure"": {""insertions"": 1, ""deletions"": 1, ""lines"": 2}, ""src/configure.ac"": {""insertions"": 1, ""deletions"": 1, ""lines"": 2}, ""src/version.c"": {""insertions"": 2, ""deletions"": 0, ""lines"": 2}}"
2020-07-28 18:25:47,461f21242a8fc7f2fe9d1c723741eeda45f0ac72,Bram Moolenaar,8,2,10,3,"{""src/ex_cmds.c"": {""insertions"": 4, ""deletions"": 2, ""lines"": 6}, ""src/ex_docmd.c"": {""insertions"": 2, ""deletions"": 0, ""lines"": 2}, ""src/version.c"": {""insertions"": 2, ""deletions"": 0, ""lines"": 2}}"
2020-07-28 18:07:27,ae616494d77e9930da703d65d12ac0abf6dc425f,Bram Moolenaar,79,27,106,8,"{""runtime/doc/vim9.txt"": {""insertions"": 27, ""deletions"": 25, ""lines"": 52}, ""src/ex_cmds.c"": {""insertions"": 6, ""deletions"": 0, ""lines"": 6}, ""src/ex_docmd.c"": {""insertions"": 2, ""deletions"": 0, ""lines"": 2}, ""src/proto/vim9script.pro"": {""insertions"": 1, ""deletions"": 0, ""lines"": 1}, ""src/testdir/test_vim9_script.vim"": {""insertions"": 15, ""deletions"": 0, ""lines"": 15}, ""src/version.c"": {""insertions"": 2, ""deletions"": 0, ""lines"": 2}, ""src/vim9compile.c"": {""insertions"": 7, ""deletions"": 0, ""lines"": 7}, ""src/vim9script.c"": {""insertions"": 19, ""deletions"": 2, ""lines"": 21}}"
2020-07-27 20:40:37,0aac67a4314d72a29d3fbee91b6f0ba89e950462,Bram Moolenaar,43,6,49,4,"{""src/popupwin.c"": {""insertions"": 21, ""deletions"": 6, ""lines"": 27}, ""src/testdir/dumps/Test_popupwin_sign_2.dump"": {""insertions"": 10, ""deletions"": 0, ""lines"": 10}, ""src/testdir/test_popupwin.vim"": {""insertions"": 10, ""deletions"": 0, ""lines"": 10}, ""src/version.c"": {""insertions"": 2, ""deletions"": 0, ""lines"": 2}}"
2020-07-27 19:43:28,b13ab99908097d54e21ab5adad22f4ad2a8ec688,Bram Moolenaar,40,10,50,7,"{""src/eval.c"": {""insertions"": 15, ""deletions"": 6, ""lines"": 21}, ""src/proto/eval.pro"": {""insertions"": 1, ""deletions"": 0, ""lines"": 1}, ""src/testdir/test_let.vim"": {""insertions"": 1, ""deletions"": 1, ""lines"": 2}, ""src/testdir/test_listdict.vim"": {""insertions"": 7, ""deletions"": 0, ""lines"": 7}, ""src/testdir/test_vim9_expr.vim"": {""insertions"": 12, ""deletions"": 1, ""lines"": 13}, ""src/version.c"": {""insertions"": 2, ""deletions"": 0, ""lines"": 2}, ""src/vim9compile.c"": {""insertions"": 2, ""deletions"": 2, ""lines"": 4}}"
2020-07-27 18:02:41,622b3568fa1baf07671d31390815fb0a55a99891,Bram Moolenaar,190,198,388,12,"{""src/Makefile"": {""insertions"": 1, ""deletions"": 4, ""lines"": 5}, ""src/testdir/Make_all.mak"": {""insertions"": 7, ""deletions"": 11, ""lines"": 18}, ""src/testdir/Make_amiga.mak"": {""insertions"": 0, ""deletions"": 6, ""lines"": 6}, ""src/testdir/Make_vms.mms"": {""insertions"": 3, ""deletions"": 24, ""lines"": 27}, ""src/testdir/runtest.vim"": {""insertions"": 1, ""deletions"": 1, ""lines"": 2}, ""src/testdir/test52.in"": {""insertions"": 0, ""deletions"": 65, ""lines"": 65}, ""src/testdir/test52.ok"": {""insertions"": 0, ""deletions"": 18, ""lines"": 18}, ""src/testdir/test70.in"": {""insertions"": 0, ""deletions"": 63, ""lines"": 63}, ""src/testdir/test70.ok"": {""insertions"": 0, ""deletions"": 6, ""lines"": 6}, ""src/testdir/test_mzscheme.vim"": {""insertions"": 62, ""deletions"": 0, ""lines"": 62}, ""src/testdir/test_writefile.vim"": {""insertions"": 114, ""deletions"": 0, ""lines"": 114}, ""src/version.c"": {""insertions"": 2, ""deletions"": 0, ""lines"": 2}}"
2020-07-27 17:47:07,6ca6ca48898750dd55cad13c88a9c1dfd7fdaad5,Bram Moolenaar,453,6,459,3,"{""src/testdir/runtest.vim"": {""insertions"": 5, ""deletions"": 0, ""lines"": 5}, ""src/testdir/test_debugger.vim"": {""insertions"": 446, ""deletions"": 6, ""lines"": 452}, ""src/version.c"": {""insertions"": 2, ""deletions"": 0, ""lines"": 2}}"
2020-07-26 20:20:54,6d585f4c5c8d120f768dd61bfd32f6e57ad562a7,Bram Moolenaar,16,2,18,3,"{""src/popupwin.c"": {""insertions"": 4, ""deletions"": 2, ""lines"": 6}, ""src/testdir/test_popupwin.vim"": {""insertions"": 10, ""deletions"": 0, ""lines"": 10}, ""src/version.c"": {""insertions"": 2, ""deletions"": 0, ""lines"": 2}}"
2020-07-26 16:33:09,01865ade85d2508639e24aaca5948b09fb284a82,Bram Moolenaar,29,5,34,3,"{""src/testdir/test_vim9_func.vim"": {""insertions"": 22, ""deletions"": 0, ""lines"": 22}, ""src/version.c"": {""insertions"": 2, ""deletions"": 0, ""lines"": 2}, ""src/vim9compile.c"": {""insertions"": 5, ""deletions"": 5, ""lines"": 10}}"
2020-07-26 16:16:58,ace6132aa8c5fce9d4965e1f2e3a42071815b9de,Bram Moolenaar,17,0,17,3,"{""src/testdir/test_vim9_func.vim"": {""insertions"": 13, ""deletions"": 0, ""lines"": 13}, ""src/version.c"": {""insertions"": 2, ""deletions"": 0, ""lines"": 2}, ""src/vim9compile.c"": {""insertions"": 2, ""deletions"": 0, ""lines"": 2}}"
2020-07-26 15:56:25,4fc224ca1cf2a8991c5ea17682a742c6ad5ad0f3,Bram Moolenaar,37,11,48,6,"{""src/evalvars.c"": {""insertions"": 1, ""deletions"": 1, ""lines"": 2}, ""src/proto/vim9compile.pro"": {""insertions"": 1, ""deletions"": 1, ""lines"": 2}, ""src/testdir/test_vim9_func.vim"": {""insertions"": 13, ""deletions"": 0, ""lines"": 13}, ""src/userfunc.c"": {""insertions"": 2, ""deletions"": 2, ""lines"": 4}, ""src/version.c"": {""insertions"": 2, ""deletions"": 0, ""lines"": 2}, ""src/vim9compile.c"": {""insertions"": 18, ""deletions"": 7, ""lines"": 25}}"
2020-07-26 15:00:44,2547aa930b59f5e2bcb70e81d5a57ed461e59b4f,Bram Moolenaar,768,474,1242,45,"{""runtime/autoload/decada.vim"": {""insertions"": 1, ""deletions"": 1, ""lines"": 2}, ""runtime/doc/arabic.txt"": {""insertions"": 2, ""deletions"": 2, ""lines"": 4}, ""runtime/doc/change.txt"": {""insertions"": 1, ""deletions"": 1, ""lines"": 2}, ""runtime/doc/cmdline.txt"": {""insertions"": 1, ""deletions"": 1, ""lines"": 2}, ""runtime/doc/digraph.txt"": {""insertions"": 3, ""deletions"": 1, ""lines"": 4}, ""runtime/doc/eval.txt"": {""insertions"": 4, ""deletions"": 2, ""lines"": 6}, ""runtime/doc/ft_sql.txt"": {""insertions"": 3, ""deletions"": 3, ""lines"": 6}, ""runtime/doc/map.txt"": {""insertions"": 4, ""deletions"": 5, ""lines"": 9}, ""runtime/doc/mbyte.txt"": {""insertions"": 5, ""deletions"": 5, ""lines"": 10}, ""runtime/doc/options.txt"": {""insertions"": 1, ""deletions"": 2, ""lines"": 3}, ""runtime/doc/os_unix.txt"": {""insertions"": 2, ""deletions"": 2, ""lines"": 4}, ""runtime/doc/repeat.txt"": {""insertions"": 1, ""deletions"": 1, ""lines"": 2}, ""runtime/doc/rileft.txt"": {""insertions"": 1, ""deletions"": 1, ""lines"": 2}, ""runtime/doc/sign.txt"": {""insertions"": 1, ""deletions"": 1, ""lines"": 2}, ""runtime/doc/syntax.txt"": {""insertions"": 1, ""deletions"": 1, ""lines"": 2}, ""runtime/doc/tags"": {""insertions"": 4, ""deletions"": 0, ""lines"": 4}, ""runtime/doc/testing.txt"": {""insertions"": 1, ""deletions"": 1, ""lines"": 2}, ""runtime/doc/todo.txt"": {""insertions"": 47, ""deletions"": 25, ""lines"": 72}, ""runtime/doc/usr_27.txt"": {""insertions"": 1, ""deletions"": 1, ""lines"": 2}, ""runtime/doc/usr_90.txt"": {""insertions"": 1, ""deletions"": 1, ""lines"": 2}, ""runtime/doc/version6.txt"": {""insertions"": 1, ""deletions"": 1, ""lines"": 2}, ""runtime/doc/vim-da.1"": {""insertions"": 1, ""deletions"": 1, ""lines"": 2}, ""runtime/doc/vim-da.UTF-8.1"": {""insertions"": 1, ""deletions"": 1, ""lines"": 2}, ""runtime/doc/vim-fr.1"": {""insertions"": 1, ""deletions"": 1, ""lines"": 2}, ""runtime/doc/vim-fr.UTF-8.1"": {""insertions"": 1, ""deletions"": 1, ""lines"": 2}, ""runtime/doc/vim-it.1"": {""insertions"": 1, ""deletions"": 1, ""lines"": 2}, ""runtime/doc/vim-it.UTF-8.1"": {""insertions"": 1, ""deletions"": 1, ""lines"": 2}, ""runtime/doc/vim-pl.1"": {""insertions"": 1, ""deletions"": 1, ""lines"": 2}, ""runtime/doc/vim-pl.UTF-8.1"": {""insertions"": 1, ""deletions"": 1, ""lines"": 2}, ""runtime/doc/vim-tr.1"": {""insertions"": 1, ""deletions"": 1, ""lines"": 2}, ""runtime/doc/vim-tr.UTF-8.1"": {""insertions"": 1, ""deletions"": 1, ""lines"": 2}, ""runtime/doc/vim.1"": {""insertions"": 1, ""deletions"": 1, ""lines"": 2}, ""runtime/doc/vim.man"": {""insertions"": 1, ""deletions"": 1, ""lines"": 2}, ""runtime/doc/vim9.txt"": {""insertions"": 35, ""deletions"": 26, ""lines"": 61}, ""runtime/ftplugin/cpp.vim"": {""insertions"": 7, ""deletions"": 2, ""lines"": 9}, ""runtime/ftplugin/diff.vim"": {""insertions"": 4, ""deletions"": 1, ""lines"": 5}, ""runtime/ftplugin/vim.vim"": {""insertions"": 2, ""deletions"": 2, ""lines"": 4}, ""runtime/indent/vim.vim"": {""insertions"": 2, ""deletions"": 1, ""lines"": 3}, ""runtime/pack/dist/opt/termdebug/plugin/termdebug.vim"": {""insertions"": 1, ""deletions"": 1, ""lines"": 2}, ""runtime/syntax/aidl.vim"": {""insertions"": 23, ""deletions"": 0, ""lines"": 23}, ""runtime/syntax/tex.vim"": {""insertions"": 36, ""deletions"": 17, ""lines"": 53}, ""runtime/syntax/vim.vim"": {""insertions"": 25, ""deletions"": 19, ""lines"": 44}, ""runtime/tutor/tutor.eo"": {""insertions"": 13, ""deletions"": 13, ""lines"": 26}, ""runtime/tutor/tutor.eo.utf-8"": {""insertions"": 13, ""deletions"": 13, ""lines"": 26}, ""src/po/eo.po"": {""insertions"": 509, ""deletions"": 309, ""lines"": 818}}"
2020-07-26 13:55:25,d3bb6a82a51d549bbd597bb4e94d8f074009be2a,Bram Moolenaar,6,4,10,2,"{""src/scriptfile.c"": {""insertions"": 4, ""deletions"": 4, ""lines"": 8}, ""src/version.c"": {""insertions"": 2, ""deletions"": 0, ""lines"": 2}}"
2020-07-26 13:51:06,cb4f69c2fd9ea81331c4aa54877fde612d182a51,Bram Moolenaar,3,1,4,2,"{""src/scriptfile.c"": {""insertions"": 1, ""deletions"": 1, ""lines"": 2}, ""src/version.c"": {""insertions"": 2, ""deletions"": 0, ""lines"": 2}}"
2020-07-26 13:37:02,a5d0423fa16f18b4576a2a07e50034e489587a7d,Bram Moolenaar,102,69,171,10,"{""runtime/doc/cmdline.txt"": {""insertions"": 10, ""deletions"": 6, ""lines"": 16}, ""src/debugger.c"": {""insertions"": 3, ""deletions"": 3, ""lines"": 6}, ""src/ex_docmd.c"": {""insertions"": 8, ""deletions"": 3, ""lines"": 11}, ""src/ex_eval.c"": {""insertions"": 2, ""deletions"": 2, ""lines"": 4}, ""src/message.c"": {""insertions"": 1, ""deletions"": 1, ""lines"": 2}, ""src/proto/scriptfile.pro"": {""insertions"": 1, ""deletions"": 1, ""lines"": 2}, ""src/scriptfile.c"": {""insertions"": 40, ""deletions"": 30, ""lines"": 70}, ""src/testdir/test_expand_func.vim"": {""insertions"": 34, ""deletions"": 22, ""lines"": 56}, ""src/testing.c"": {""insertions"": 1, ""deletions"": 1, ""lines"": 2}, ""src/version.c"": {""insertions"": 2, ""deletions"": 0, ""lines"": 2}}"
2020-07-26 11:27:16,d66cdcd43a598825add743bc95642cd8ed705252,Bram Moolenaar,22,1,23,2,"{""src/testdir/test_search.vim"": {""insertions"": 20, ""deletions"": 1, ""lines"": 21}, ""src/version.c"": {""insertions"": 2, ""deletions"": 0, ""lines"": 2}}"
2020-07-26 10:52:59,7d40b8a532fa2ce768f200ab118870d17875a7fe,Bram Moolenaar,130,205,335,9,"{""src/Makefile"": {""insertions"": 2, ""deletions"": 3, ""lines"": 5}, ""src/testdir/Make_all.mak"": {""insertions"": 1, ""deletions"": 3, ""lines"": 4}, ""src/testdir/Make_vms.mms"": {""insertions"": 1, ""deletions"": 1, ""lines"": 2}, ""src/testdir/test44.in"": {""insertions"": 0, ""deletions"": 81, ""lines"": 81}, ""src/testdir/test44.ok"": {""insertions"": 0, ""deletions"": 25, ""lines"": 25}, ""src/testdir/test99.in"": {""insertions"": 0, ""deletions"": 69, ""lines"": 69}, ""src/testdir/test99.ok"": {""insertions"": 0, ""deletions"": 23, ""lines"": 23}, ""src/testdir/test_regexp_utf8.vim"": {""insertions"": 124, ""deletions"": 0, ""lines"": 124}, ""src/version.c"": {""insertions"": 2, ""deletions"": 0, ""lines"": 2}}"
2020-07-25 17:38:18,37394ff75270877a032422abcd079a6732a29730,Bram Moolenaar,338,325,663,3,"{""src/ex_cmds.h"": {""insertions"": 321, ""deletions"": 320, ""lines"": 641}, ""src/ex_docmd.c"": {""insertions"": 15, ""deletions"": 5, ""lines"": 20}, ""src/version.c"": {""insertions"": 2, ""deletions"": 0, ""lines"": 2}}"
2020-07-25 17:30:59,2d6b20d6a9a034b39f79a7dbb889fb5d859583ae,Bram Moolenaar,35,1,36,3,"{""src/testdir/test_vim9_script.vim"": {""insertions"": 30, ""deletions"": 0, ""lines"": 30}, ""src/version.c"": {""insertions"": 2, ""deletions"": 0, ""lines"": 2}, ""src/vim9compile.c"": {""insertions"": 3, ""deletions"": 1, ""lines"": 4}}"
2020-07-25 14:53:12,2afc3b4f776a4fe2bb22d0a79e77012d79b4ec1e,Bram Moolenaar,6,0,6,3,"{""runtime/filetype.vim"": {""insertions"": 3, ""deletions"": 0, ""lines"": 3}, ""src/testdir/test_filetype.vim"": {""insertions"": 1, ""deletions"": 0, ""lines"": 1}, ""src/version.c"": {""insertions"": 2, ""deletions"": 0, ""lines"": 2}}"
2020-07-25 14:33:02,24aa48b7a265c24e18f0f978dfe0255e138e2b90,Bram Moolenaar,70,2,72,3,"{""src/testdir/test_vim9_func.vim"": {""insertions"": 49, ""deletions"": 1, ""lines"": 50}, ""src/version.c"": {""insertions"": 2, ""deletions"": 0, ""lines"": 2}, ""src/vim9execute.c"": {""insertions"": 19, ""deletions"": 1, ""lines"": 20}}"
2020-07-25 13:41:11,925e9fd6339981c1015410e1b6a6dd19e34f36cc,Bram Moolenaar,59,6,65,3,"{""src/testdir/test_vim9_script.vim"": {""insertions"": 48, ""deletions"": 0, ""lines"": 48}, ""src/userfunc.c"": {""insertions"": 9, ""deletions"": 6, ""lines"": 15}, ""src/version.c"": {""insertions"": 2, ""deletions"": 0, ""lines"": 2}}"
2020-07-25 12:11:55,c841afff6a89592f23710c6da5b0fea89b240937,Bram Moolenaar,4,11,15,2,"{""src/cmdexpand.c"": {""insertions"": 2, ""deletions"": 11, ""lines"": 13}, ""src/version.c"": {""insertions"": 2, ""deletions"": 0, ""lines"": 2}}"
2020-07-24 16:47:22,13e12b8a3c0fec29017f2dbdc6f57e372f8a7efd,Bram Moolenaar,12,1,13,3,"{""src/ex_docmd.c"": {""insertions"": 1, ""deletions"": 1, ""lines"": 2}, ""src/testdir/test_vim9_func.vim"": {""insertions"": 9, ""deletions"": 0, ""lines"": 9}, ""src/version.c"": {""insertions"": 2, ""deletions"": 0, ""lines"": 2}}"
2020-07-23 20:41:43,40f4f7a48cae491f83bd3cdbf7e9b5a23ed870ef,Bram Moolenaar,17,7,24,4,"{""src/testdir/test_vim9_script.vim"": {""insertions"": 7, ""deletions"": 0, ""lines"": 7}, ""src/version.c"": {""insertions"": 2, ""deletions"": 0, ""lines"": 2}, ""src/vim9compile.c"": {""insertions"": 5, ""deletions"": 7, ""lines"": 12}, ""src/vim9script.c"": {""insertions"": 3, ""deletions"": 0, ""lines"": 3}}"
2020-07-23 19:14:43,43e969d3f98766824c18d20b84f2fab00feef683,Bram Moolenaar,19,0,19,3,"{""src/ex_docmd.c"": {""insertions"": 8, ""deletions"": 0, ""lines"": 8}, ""src/testdir/test_vim9_script.vim"": {""insertions"": 9, ""deletions"": 0, ""lines"": 9}, ""src/version.c"": {""insertions"": 2, ""deletions"": 0, ""lines"": 2}}"
2020-07-23 18:56:04,b8070e31736decfcdf8dd47997882cb8f5a64c9d,Bram Moolenaar,34,0,34,3,"{""src/testdir/test_vim9_func.vim"": {""insertions"": 9, ""deletions"": 0, ""lines"": 9}, ""src/version.c"": {""insertions"": 2, ""deletions"": 0, ""lines"": 2}, ""src/vim9compile.c"": {""insertions"": 23, ""deletions"": 0, ""lines"": 23}}"
2020-07-23 18:09:10,bfba8651a51b66fdc52848f32c77aa925586e250,Bram Moolenaar,13,1,14,3,"{""src/testdir/test_vim9_func.vim"": {""insertions"": 10, ""deletions"": 0, ""lines"": 10}, ""src/version.c"": {""insertions"": 2, ""deletions"": 0, ""lines"": 2}, ""src/vim9compile.c"": {""insertions"": 1, ""deletions"": 1, ""lines"": 2}}"
2020-07-23 17:06:23,637cd7d1c9fa0ee47951ccdc310a388cb7ecfada,Bram Moolenaar,6,2,8,3,"{""src/testdir/test_vim9_expr.vim"": {""insertions"": 1, ""deletions"": 1, ""lines"": 2}, ""src/version.c"": {""insertions"": 2, ""deletions"": 0, ""lines"": 2}, ""src/vim9compile.c"": {""insertions"": 3, ""deletions"": 1, ""lines"": 4}}"
2020-07-23 16:26:30,6c4bfe4b31e8c5d3c4809536ab6e4835d50f0f67,Bram Moolenaar,17,8,25,3,"{""src/testdir/test_vim9_func.vim"": {""insertions"": 2, ""deletions"": 4, ""lines"": 6}, ""src/version.c"": {""insertions"": 2, ""deletions"": 0, ""lines"": 2}, ""src/vim9compile.c"": {""insertions"": 13, ""deletions"": 4, ""lines"": 17}}"
2020-07-23 15:16:18,2d06bfde29bd3a62fc85823d2aa719ef943bd319,Bram Moolenaar,24,22,46,13,"{""src/cmdhist.c"": {""insertions"": 2, ""deletions"": 2, ""lines"": 4}, ""src/eval.c"": {""insertions"": 1, ""deletions"": 1, ""lines"": 2}, ""src/evalfunc.c"": {""insertions"": 2, ""deletions"": 2, ""lines"": 4}, ""src/evalvars.c"": {""insertions"": 5, ""deletions"": 5, ""lines"": 10}, ""src/ex_cmds.c"": {""insertions"": 1, ""deletions"": 1, ""lines"": 2}, ""src/ex_docmd.c"": {""insertions"": 2, ""deletions"": 2, ""lines"": 4}, ""src/ex_eval.c"": {""insertions"": 1, ""deletions"": 1, ""lines"": 2}, ""src/json.c"": {""insertions"": 1, ""deletions"": 1, ""lines"": 2}, ""src/menu.c"": {""insertions"": 1, ""deletions"": 1, ""lines"": 2}, ""src/quickfix.c"": {""insertions"": 1, ""deletions"": 1, ""lines"": 2}, ""src/sign.c"": {""insertions"": 1, ""deletions"": 1, ""lines"": 2}, ""src/userfunc.c"": {""insertions"": 4, ""deletions"": 4, ""lines"": 8}, ""src/version.c"": {""insertions"": 2, ""deletions"": 0, ""lines"": 2}}"
2020-07-23 14:37:03,8930caaa1a283092aca81fdbc3fcf15c7eadb197,Bram Moolenaar,79,61,140,7,"{""src/buffer.c"": {""insertions"": 1, ""deletions"": 1, ""lines"": 2}, ""src/ex_docmd.c"": {""insertions"": 29, ""deletions"": 14, ""lines"": 43}, ""src/ex_eval.c"": {""insertions"": 22, ""deletions"": 22, ""lines"": 44}, ""src/match.c"": {""insertions"": 1, ""deletions"": 1, ""lines"": 2}, ""src/proto/ex_docmd.pro"": {""insertions"": 1, ""deletions"": 0, ""lines"": 1}, ""src/testdir/test_tabpage.vim"": {""insertions"": 23, ""deletions"": 23, ""lines"": 46}, ""src/version.c"": {""insertions"": 2, ""deletions"": 0, ""lines"": 2}}"
2020-07-23 13:50:40,8d5f6af5e5a5edfd3fa95f33540c204f4e74331e,Bram Moolenaar,5,3,8,2,"{"".travis.yml"": {""insertions"": 3, ""deletions"": 3, ""lines"": 6}, ""src/version.c"": {""insertions"": 2, ""deletions"": 0, ""lines"": 2}}"
2020-07-23 13:38:03,dd1a9af00f6954b176c5875af0a91acde72572c8,Bram Moolenaar,16,6,22,4,"{""src/globals.h"": {""insertions"": 1, ""deletions"": 0, ""lines"": 1}, ""src/testdir/test_vim9_expr.vim"": {""insertions"": 6, ""deletions"": 3, ""lines"": 9}, ""src/version.c"": {""insertions"": 2, ""deletions"": 0, ""lines"": 2}, ""src/vim9compile.c"": {""insertions"": 7, ""deletions"": 3, ""lines"": 10}}"
2020-07-23 12:59:07,7a87b4e3fe91c18a616536fe49154c4bb3da0a93,Bram Moolenaar,10,8,18,2,"{"".travis.yml"": {""insertions"": 8, ""deletions"": 8, ""lines"": 16}, ""src/version.c"": {""insertions"": 2, ""deletions"": 0, ""lines"": 2}}"
2020-07-23 12:51:02,4cc45a367363f7754dedd280cd7a065b7a220394,Bram Moolenaar,6,4,10,2,"{""src/testdir/test_system.vim"": {""insertions"": 4, ""deletions"": 4, ""lines"": 8}, ""src/version.c"": {""insertions"": 2, ""deletions"": 0, ""lines"": 2}}"
2020-07-23 12:39:47,5a67c37a554daa7627bdf0c8e7ddd5f1b597f978,Bram Moolenaar,4,2,6,2,"{""src/version.c"": {""insertions"": 2, ""deletions"": 0, ""lines"": 2}, ""src/vim9script.c"": {""insertions"": 2, ""deletions"": 2, ""lines"": 4}}"
2020-07-23 11:11:37,63be3d4ba01d565e645d8bf7f4dc900fc9011534,Bram Moolenaar,36,10,46,5,"{""src/eval.c"": {""insertions"": 2, ""deletions"": 1, ""lines"": 3}, ""src/evalvars.c"": {""insertions"": 21, ""deletions"": 7, ""lines"": 28}, ""src/testdir/test_let.vim"": {""insertions"": 2, ""deletions"": 2, ""lines"": 4}, ""src/testdir/test_vim9_script.vim"": {""insertions"": 9, ""deletions"": 0, ""lines"": 9}, ""src/version.c"": {""insertions"": 2, ""deletions"": 0, ""lines"": 2}}"
2020-07-22 20:23:40,c69950ac17225d07f973b39d5b0eb94291077808,Bram Moolenaar,9,0,9,2,"{""src/testdir/test_terminal.vim"": {""insertions"": 7, ""deletions"": 0, ""lines"": 7}, ""src/version.c"": {""insertions"": 2, ""deletions"": 0, ""lines"": 2}}"
2020-07-22 19:45:14,4cdb13ce81309b62b636f2c614241959174d3fef,Bram Moolenaar,105,74,179,7,"{""src/eval.c"": {""insertions"": 5, ""deletions"": 0, ""lines"": 5}, ""src/proto/vim9compile.pro"": {""insertions"": 3, ""deletions"": 2, ""lines"": 5}, ""src/testdir/test_vim9_script.vim"": {""insertions"": 3, ""deletions"": 0, ""lines"": 3}, ""src/version.c"": {""insertions"": 2, ""deletions"": 0, ""lines"": 2}, ""src/vim9compile.c"": {""insertions"": 89, ""deletions"": 70, ""lines"": 159}, ""src/vim9execute.c"": {""insertions"": 2, ""deletions"": 1, ""lines"": 3}, ""src/vim9script.c"": {""insertions"": 1, ""deletions"": 1, ""lines"": 2}}"
2020-07-22 18:16:11,0f60e80f9b6d778e460b4dc8333cd8e17c1b620b,Bram Moolenaar,37,0,37,3,"{""src/testdir/test_vim9_func.vim"": {""insertions"": 13, ""deletions"": 0, ""lines"": 13}, ""src/version.c"": {""insertions"": 2, ""deletions"": 0, ""lines"": 2}, ""src/vim9compile.c"": {""insertions"": 22, ""deletions"": 0, ""lines"": 22}}"
2020-07-22 17:30:06,2f1980f7b74a6a47d72f9c56417bc4ad47c6b66c,Bram Moolenaar,36,15,51,3,"{""src/testdir/test_vim9_func.vim"": {""insertions"": 10, ""deletions"": 0, ""lines"": 10}, ""src/version.c"": {""insertions"": 2, ""deletions"": 0, ""lines"": 2}, ""src/vim9compile.c"": {""insertions"": 24, ""deletions"": 15, ""lines"": 39}}"
2020-07-22 17:11:19,054f14bbe58fece17f1a74ca63f0b37518f0b4de,Bram Moolenaar,601,561,1162,14,"{""Filelist"": {""insertions"": 2, ""deletions"": 0, ""lines"": 2}, ""src/Make_cyg_ming.mak"": {""insertions"": 1, ""deletions"": 0, ""lines"": 1}, ""src/Make_morph.mak"": {""insertions"": 1, ""deletions"": 0, ""lines"": 1}, ""src/Make_mvc.mak"": {""insertions"": 4, ""deletions"": 0, ""lines"": 4}, ""src/Make_vms.mms"": {""insertions"": 6, ""deletions"": 0, ""lines"": 6}, ""src/Makefile"": {""insertions"": 10, ""deletions"": 0, ""lines"": 10}, ""src/README.md"": {""insertions"": 1, ""deletions"": 0, ""lines"": 1}, ""src/ex_cmds2.c"": {""insertions"": 0, ""deletions"": 502, ""lines"": 502}, ""src/locale.c"": {""insertions"": 564, ""deletions"": 0, ""lines"": 564}, ""src/main.c"": {""insertions"": 0, ""deletions"": 53, ""lines"": 53}, ""src/proto.h"": {""insertions"": 1, ""deletions"": 0, ""lines"": 1}, ""src/proto/ex_cmds2.pro"": {""insertions"": 0, ""deletions"": 6, ""lines"": 6}, ""src/proto/locale.pro"": {""insertions"": 9, ""deletions"": 0, ""lines"": 9}, ""src/version.c"": {""insertions"": 2, ""deletions"": 0, ""lines"": 2}}"
2020-07-22 16:17:08,e7e4838f25ac39177f3c3150ee53af8d6e8a0f28,Bram Moolenaar,40,4,44,3,"{""src/testdir/test_vim9_script.vim"": {""insertions"": 29, ""deletions"": 0, ""lines"": 29}, ""src/userfunc.c"": {""insertions"": 9, ""deletions"": 4, ""lines"": 13}, ""src/version.c"": {""insertions"": 2, ""deletions"": 0, ""lines"": 2}}"
2020-07-22 16:14:58,2690b5aed8b6b6070430b05dcae296cd9479c942,Bram Moolenaar,7,0,7,2,"{""src/testdir/runtest.vim"": {""insertions"": 5, ""deletions"": 0, ""lines"": 5}, ""src/version.c"": {""insertions"": 2, ""deletions"": 0, ""lines"": 2}}"
2020-07-21 20:34:41,bc6fcbe4ce52bc48c3d77b24086acc61ed3333bc,Bram Moolenaar,9,7,16,2,"{""src/Makefile"": {""insertions"": 7, ""deletions"": 7, ""lines"": 14}, ""src/version.c"": {""insertions"": 2, ""deletions"": 0, ""lines"": 2}}"
2020-07-21 20:25:51,7d5e744162c1e971e5a863e89787cadc8e56051c,Bram Moolenaar,5,2,7,2,"{""src/evalfunc.c"": {""insertions"": 3, ""deletions"": 2, ""lines"": 5}, ""src/version.c"": {""insertions"": 2, ""deletions"": 0, ""lines"": 2}}"
2020-07-21 19:48:58,420952175a652372affc78c0017d6049f20063c3,Bram Moolenaar,5,6,11,2,"{""src/testdir/test_terminal3.vim"": {""insertions"": 3, ""deletions"": 6, ""lines"": 9}, ""src/version.c"": {""insertions"": 2, ""deletions"": 0, ""lines"": 2}}"
2020-07-21 19:31:00,c71f36a889897aca4ac2ad3828926e3801728336,Bram Moolenaar,43,16,59,5,"{""src/eval.c"": {""insertions"": 7, ""deletions"": 6, ""lines"": 13}, ""src/testdir/test_vim9_expr.vim"": {""insertions"": 24, ""deletions"": 5, ""lines"": 29}, ""src/typval.c"": {""insertions"": 10, ""deletions"": 2, ""lines"": 12}, ""src/version.c"": {""insertions"": 2, ""deletions"": 0, ""lines"": 2}, ""src/vim9execute.c"": {""insertions"": 0, ""deletions"": 3, ""lines"": 3}}"
2020-07-21 19:07:20,f868ba89039045b25efe83d12ca501d657e170e8,Bram Moolenaar,1344,1346,2690,14,"{""Filelist"": {""insertions"": 2, ""deletions"": 0, ""lines"": 2}, ""src/Make_cyg_ming.mak"": {""insertions"": 1, ""deletions"": 0, ""lines"": 1}, ""src/Make_morph.mak"": {""insertions"": 1, ""deletions"": 0, ""lines"": 1}, ""src/Make_mvc.mak"": {""insertions"": 4, ""deletions"": 0, ""lines"": 4}, ""src/Make_vms.mms"": {""insertions"": 6, ""deletions"": 0, ""lines"": 6}, ""src/Makefile"": {""insertions"": 17, ""deletions"": 7, ""lines"": 24}, ""src/README.md"": {""insertions"": 1, ""deletions"": 0, ""lines"": 1}, ""src/cmdexpand.c"": {""insertions"": 0, ""deletions"": 56, ""lines"": 56}, ""src/ex_cmds.c"": {""insertions"": 0, ""deletions"": 1274, ""lines"": 1274}, ""src/help.c"": {""insertions"": 1295, ""deletions"": 0, ""lines"": 1295}, ""src/proto.h"": {""insertions"": 1, ""deletions"": 0, ""lines"": 1}, ""src/proto/ex_cmds.pro"": {""insertions"": 0, ""deletions"": 9, ""lines"": 9}, ""src/proto/help.pro"": {""insertions"": 14, ""deletions"": 0, ""lines"": 14}, ""src/version.c"": {""insertions"": 2, ""deletions"": 0, ""lines"": 2}}"
2020-07-21 18:55:50,c7db57788b661a5da0b375d4fffdf10721550141,Bram Moolenaar,29,3,32,4,"{""src/testdir/test_vim9_expr.vim"": {""insertions"": 21, ""deletions"": 0, ""lines"": 21}, ""src/version.c"": {""insertions"": 2, ""deletions"": 0, ""lines"": 2}, ""src/vim9compile.c"": {""insertions"": 5, ""deletions"": 3, ""lines"": 8}, ""src/vim9execute.c"": {""insertions"": 1, ""deletions"": 0, ""lines"": 1}}"
2020-07-21 17:44:47,7591116acffc45b5880c49244646651badac1629,Bram Moolenaar,31,27,58,4,"{""src/testdir/test_autocmd.vim"": {""insertions"": 29, ""deletions"": 0, ""lines"": 29}, ""src/testdir/test_buffer.vim"": {""insertions"": 0, ""deletions"": 9, ""lines"": 9}, ""src/testdir/test_normal.vim"": {""insertions"": 0, ""deletions"": 18, ""lines"": 18}, ""src/version.c"": {""insertions"": 2, ""deletions"": 0, ""lines"": 2}}"
2020-07-21 17:25:18,f56c95fdad5af521887f8cd7bc15729b5355231d,Bram Moolenaar,33,1,34,3,"{""src/buffer.c"": {""insertions"": 8, ""deletions"": 1, ""lines"": 9}, ""src/testdir/test_tabline.vim"": {""insertions"": 23, ""deletions"": 0, ""lines"": 23}, ""src/version.c"": {""insertions"": 2, ""deletions"": 0, ""lines"": 2}}"
2020-07-20 21:10:56,08815a1d0350fbcc007aea5dd1272454c03fab4f,Bram Moolenaar,8,1,9,2,"{""src/normal.c"": {""insertions"": 6, ""deletions"": 1, ""lines"": 7}, ""src/version.c"": {""insertions"": 2, ""deletions"": 0, ""lines"": 2}}"
2020-07-20 20:37:44,b31be3f909e074214b7f346888209c866faed56f,Bram Moolenaar,26,3,29,3,"{""src/ex_docmd.c"": {""insertions"": 12, ""deletions"": 3, ""lines"": 15}, ""src/testdir/test_vim9_script.vim"": {""insertions"": 12, ""deletions"": 0, ""lines"": 12}, ""src/version.c"": {""insertions"": 2, ""deletions"": 0, ""lines"": 2}}"
2020-07-20 20:09:34,7892b953e0e496408008434ae3505293c0c93af1,Bram Moolenaar,12,3,15,3,"{""src/testdir/test_vim9_expr.vim"": {""insertions"": 4, ""deletions"": 0, ""lines"": 4}, ""src/version.c"": {""insertions"": 2, ""deletions"": 0, ""lines"": 2}, ""src/vim9compile.c"": {""insertions"": 6, ""deletions"": 3, ""lines"": 9}}"
2020-07-20 19:31:32,d43906d2e5969288f239df851f5ad7b1dc2c7251,Bram Moolenaar,224,57,281,11,"{""runtime/doc/eval.txt"": {""insertions"": 7, ""deletions"": 5, ""lines"": 12}, ""runtime/doc/options.txt"": {""insertions"": 2, ""deletions"": 1, ""lines"": 3}, ""runtime/doc/quickfix.txt"": {""insertions"": 4, ""deletions"": 1, ""lines"": 5}, ""src/channel.c"": {""insertions"": 0, ""deletions"": 21, ""lines"": 21}, ""src/evalvars.c"": {""insertions"": 21, ""deletions"": 0, ""lines"": 21}, ""src/optionstr.c"": {""insertions"": 8, ""deletions"": 0, ""lines"": 8}, ""src/proto/evalvars.pro"": {""insertions"": 1, ""deletions"": 0, ""lines"": 1}, ""src/proto/quickfix.pro"": {""insertions"": 1, ""deletions"": 0, ""lines"": 1}, ""src/quickfix.c"": {""insertions"": 120, ""deletions"": 19, ""lines"": 139}, ""src/testdir/test_quickfix.vim"": {""insertions"": 58, ""deletions"": 10, ""lines"": 68}, ""src/version.c"": {""insertions"": 2, ""deletions"": 0, ""lines"": 2}}"
2020-07-20 19:21:30,470adb827f3d9e6cf62f685738d2db216daf3738,Bram Moolenaar,5,0,5,2,"{""src/testdir/test_regexp_utf8.vim"": {""insertions"": 3, ""deletions"": 0, ""lines"": 3}, ""src/version.c"": {""insertions"": 2, ""deletions"": 0, ""lines"": 2}}"
2020-07-19 21:06:05,b146e01a7e41bf5787a2b5ccc6c340ed6001f308,Bram Moolenaar,4,1,5,2,"{""src/normal.c"": {""insertions"": 2, ""deletions"": 1, ""lines"": 3}, ""src/version.c"": {""insertions"": 2, ""deletions"": 0, ""lines"": 2}}"
2020-07-19 20:09:06,54c3fcd852f9d986f81547429e850b3364f058d6,Bram Moolenaar,43,21,64,3,"{""src/mark.c"": {""insertions"": 12, ""deletions"": 2, ""lines"": 14}, ""src/testdir/test_marks.vim"": {""insertions"": 29, ""deletions"": 19, ""lines"": 48}, ""src/version.c"": {""insertions"": 2, ""deletions"": 0, ""lines"": 2}}"
2020-07-19 18:48:59,682d0a15462f3d4f9404e98a56b340ae131cbb09,Bram Moolenaar,13,7,20,4,"{""src/proto/userfunc.pro"": {""insertions"": 1, ""deletions"": 0, ""lines"": 1}, ""src/userfunc.c"": {""insertions"": 1, ""deletions"": 1, ""lines"": 2}, ""src/version.c"": {""insertions"": 2, ""deletions"": 0, ""lines"": 2}, ""src/vim9execute.c"": {""insertions"": 9, ""deletions"": 6, ""lines"": 15}}"
2020-07-19 17:47:35,2f8ce0ae8a8247563be0a77a308130e767e0566e,Bram Moolenaar,147,40,187,6,"{""src/testdir/test_vim9_disassemble.vim"": {""insertions"": 20, ""deletions"": 0, ""lines"": 20}, ""src/testdir/test_vim9_expr.vim"": {""insertions"": 26, ""deletions"": 0, ""lines"": 26}, ""src/version.c"": {""insertions"": 2, ""deletions"": 0, ""lines"": 2}, ""src/vim9.h"": {""insertions"": 4, ""deletions"": 0, ""lines"": 4}, ""src/vim9compile.c"": {""insertions"": 49, ""deletions"": 40, ""lines"": 89}, ""src/vim9execute.c"": {""insertions"": 46, ""deletions"": 0, ""lines"": 46}}"
2020-07-19 16:38:37,747f11ad6ecad4dd85ce386a0a539cb853fec41a,Bram Moolenaar,24,1,25,2,"{""src/testdir/test_vim9_disassemble.vim"": {""insertions"": 22, ""deletions"": 1, ""lines"": 23}, ""src/version.c"": {""insertions"": 2, ""deletions"": 0, ""lines"": 2}}"
2020-07-19 16:24:32,956501594e6c64f28a01fa649ad9016f3b25f05b,Bram Moolenaar,159,143,302,2,"{""src/testdir/test_netbeans.vim"": {""insertions"": 157, ""deletions"": 143, ""lines"": 300}, ""src/version.c"": {""insertions"": 2, ""deletions"": 0, ""lines"": 2}}"
2020-07-19 15:55:44,bf9d8c3765a5255c0a0b577ca2e25d70a8bcb688,Bram Moolenaar,63,5,68,5,"{""src/testdir/test_vim9_expr.vim"": {""insertions"": 9, ""deletions"": 0, ""lines"": 9}, ""src/version.c"": {""insertions"": 2, ""deletions"": 0, ""lines"": 2}, ""src/vim9.h"": {""insertions"": 2, ""deletions"": 1, ""lines"": 3}, ""src/vim9compile.c"": {""insertions"": 10, ""deletions"": 2, ""lines"": 12}, ""src/vim9execute.c"": {""insertions"": 40, ""deletions"": 2, ""lines"": 42}}"
2020-07-19 15:17:02,b209750b5e907003568c20856215122670ee22d2,Bram Moolenaar,21,3,24,3,"{""src/testdir/test_vim9_script.vim"": {""insertions"": 18, ""deletions"": 2, ""lines"": 20}, ""src/version.c"": {""insertions"": 2, ""deletions"": 0, ""lines"": 2}, ""src/vim9compile.c"": {""insertions"": 1, ""deletions"": 1, ""lines"": 2}}"
2020-07-19 14:32:09,f398238a37522fed9a2e7915741d1ab14ccc81a0,Bram Moolenaar,10,2,12,2,"{""src/scriptfile.c"": {""insertions"": 8, ""deletions"": 2, ""lines"": 10}, ""src/version.c"": {""insertions"": 2, ""deletions"": 0, ""lines"": 2}}"
2020-07-19 13:49:49,6802cce407b8b181bcf3eafe701fa9f8a91f7a73,Bram Moolenaar,31,9,40,3,"{""src/testdir/test_vim9_expr.vim"": {""insertions"": 4, ""deletions"": 1, ""lines"": 5}, ""src/version.c"": {""insertions"": 2, ""deletions"": 0, ""lines"": 2}, ""src/vim9compile.c"": {""insertions"": 25, ""deletions"": 8, ""lines"": 33}}"
2020-07-19 12:41:58,75783bd84e42e8431e4a62dfbabc9be1a1e56901,Bram Moolenaar,13,4,17,5,"{""src/eval.c"": {""insertions"": 1, ""deletions"": 1, ""lines"": 2}, ""src/proto/vim9compile.pro"": {""insertions"": 1, ""deletions"": 0, ""lines"": 1}, ""src/scriptfile.c"": {""insertions"": 8, ""deletions"": 2, ""lines"": 10}, ""src/version.c"": {""insertions"": 2, ""deletions"": 0, ""lines"": 2}, ""src/vim9compile.c"": {""insertions"": 1, ""deletions"": 1, ""lines"": 2}}"
2020-07-19 12:03:09,65b9545f4494abcb455400c08e51de27bc305866,Bram Moolenaar,61,0,61,5,"{""src/proto/vim9compile.pro"": {""insertions"": 1, ""deletions"": 0, ""lines"": 1}, ""src/testdir/test_vim9_func.vim"": {""insertions"": 11, ""deletions"": 0, ""lines"": 11}, ""src/version.c"": {""insertions"": 2, ""deletions"": 0, ""lines"": 2}, ""src/vim9compile.c"": {""insertions"": 44, ""deletions"": 0, ""lines"": 44}, ""src/vim9execute.c"": {""insertions"": 3, ""deletions"": 0, ""lines"": 3}}"
2020-07-18 20:24:22,6434fc574dfbde11461e70e5a62712370edf38e6,Bram Moolenaar,10,2,12,4,"{""runtime/doc/eval.txt"": {""insertions"": 4, ""deletions"": 1, ""lines"": 5}, ""src/evalfunc.c"": {""insertions"": 1, ""deletions"": 1, ""lines"": 2}, ""src/testdir/test_bufwintabinfo.vim"": {""insertions"": 3, ""deletions"": 0, ""lines"": 3}, ""src/version.c"": {""insertions"": 2, ""deletions"": 0, ""lines"": 2}}"
2020-07-18 20:03:11,10e1d01aaf5504675fd9197c75d1da0de0e5b429,Bram Moolenaar,9,0,9,2,"{""src/testdir/runtest.vim"": {""insertions"": 7, ""deletions"": 0, ""lines"": 7}, ""src/version.c"": {""insertions"": 2, ""deletions"": 0, ""lines"": 2}}"
2020-07-18 19:40:41,de2396fc875837c47b1c13f5e80e0a1200c5eb61,Bram Moolenaar,26,1,27,5,"{""src/popupmenu.c"": {""insertions"": 8, ""deletions"": 1, ""lines"": 9}, ""src/popupwin.c"": {""insertions"": 1, ""deletions"": 0, ""lines"": 1}, ""src/structs.h"": {""insertions"": 1, ""deletions"": 0, ""lines"": 1}, ""src/testdir/dumps/Test_popupwin_infopopup_9.dump"": {""insertions"": 14, ""deletions"": 0, ""lines"": 14}, ""src/version.c"": {""insertions"": 2, ""deletions"": 0, ""lines"": 2}}"
2020-07-18 16:13:02,d032f34a51c6722101626c4167dffecc427ac343,Bram Moolenaar,82,36,118,3,"{""src/testdir/test_vim9_script.vim"": {""insertions"": 56, ""deletions"": 1, ""lines"": 57}, ""src/version.c"": {""insertions"": 2, ""deletions"": 0, ""lines"": 2}, ""src/vim9execute.c"": {""insertions"": 24, ""deletions"": 35, ""lines"": 59}}"
2020-07-18 14:07:16,447bfba24b231777a79bf53cdb33f44d9691e47e,Bram Moolenaar,42,3,45,7,"{""runtime/doc/options.txt"": {""insertions"": 5, ""deletions"": 3, ""lines"": 8}, ""src/optionstr.c"": {""insertions"": 2, ""deletions"": 0, ""lines"": 2}, ""src/popupwin.c"": {""insertions"": 12, ""deletions"": 0, ""lines"": 12}, ""src/proto/popupwin.pro"": {""insertions"": 1, ""deletions"": 0, ""lines"": 1}, ""src/testdir/dumps/Test_popupwin_infopopup_8.dump"": {""insertions"": 14, ""deletions"": 0, ""lines"": 14}, ""src/testdir/test_popupwin.vim"": {""insertions"": 6, ""deletions"": 0, ""lines"": 6}, ""src/version.c"": {""insertions"": 2, ""deletions"": 0, ""lines"": 2}}"
2020-07-18 13:17:02,e859312e748297bde67a053fd3c486fc2c14b532,Bram Moolenaar,113,19,132,4,"{""src/testdir/test_vim9_script.vim"": {""insertions"": 71, ""deletions"": 7, ""lines"": 78}, ""src/version.c"": {""insertions"": 2, ""deletions"": 0, ""lines"": 2}, ""src/vim9compile.c"": {""insertions"": 12, ""deletions"": 0, ""lines"": 12}, ""src/vim9execute.c"": {""insertions"": 28, ""deletions"": 12, ""lines"": 40}}"
2020-07-18 10:59:19,2764d06ab7140c95b6317e344d853e4a32c76e9a,Bram Moolenaar,271,26,297,3,"{""src/testdir/mouse.vim"": {""insertions"": 18, ""deletions"": 0, ""lines"": 18}, ""src/testdir/test_termcodes.vim"": {""insertions"": 251, ""deletions"": 26, ""lines"": 277}, ""src/version.c"": {""insertions"": 2, ""deletions"": 0, ""lines"": 2}}"
2020-07-18 10:50:35,066e7da3cd0e3af438ff878a90ff1678363ce2a2,Bram Moolenaar,10,2,12,2,"{""src/if_lua.c"": {""insertions"": 8, ""deletions"": 2, ""lines"": 10}, ""src/version.c"": {""insertions"": 2, ""deletions"": 0, ""lines"": 2}}"
2020-07-17 21:03:17,f0b9f43c3169037b7f2cd70e4939ba1ef26ada1c,Bram Moolenaar,71,24,95,3,"{""src/testdir/test_vim9_script.vim"": {""insertions"": 52, ""deletions"": 0, ""lines"": 52}, ""src/version.c"": {""insertions"": 2, ""deletions"": 0, ""lines"": 2}, ""src/vim9execute.c"": {""insertions"": 17, ""deletions"": 24, ""lines"": 41}}"
2020-07-17 20:26:53,b68ced5f07a3cd6c01cf8fa2156f2e2949d2d4f1,Bram Moolenaar,20,4,24,2,"{""src/gui_w32.c"": {""insertions"": 18, ""deletions"": 4, ""lines"": 22}, ""src/version.c"": {""insertions"": 2, ""deletions"": 0, ""lines"": 2}}"
2020-07-17 20:17:03,945c857844b74866f90be20714aefc3149d2a991,Bram Moolenaar,6,15,21,3,"{""src/gui_w32.c"": {""insertions"": 4, ""deletions"": 14, ""lines"": 18}, ""src/proto/gui_w32.pro"": {""insertions"": 0, ""deletions"": 1, ""lines"": 1}, ""src/version.c"": {""insertions"": 2, ""deletions"": 0, ""lines"": 2}}"
2020-07-17 20:06:44,68d130c618f363821761f231c4122a0b9b764b71,Bram Moolenaar,55,2,57,3,"{""src/testdir/test_vim9_script.vim"": {""insertions"": 37, ""deletions"": 0, ""lines"": 37}, ""src/version.c"": {""insertions"": 2, ""deletions"": 0, ""lines"": 2}, ""src/vim9execute.c"": {""insertions"": 16, ""deletions"": 2, ""lines"": 18}}"
2020-07-17 18:47:51,6e36b1c18e636549f3424546f2c20101604a2d33,Bram Moolenaar,4,3,7,3,"{""src/ex_docmd.c"": {""insertions"": 2, ""deletions"": 2, ""lines"": 4}, ""src/proto/ex_docmd.pro"": {""insertions"": 0, ""deletions"": 1, ""lines"": 1}, ""src/version.c"": {""insertions"": 2, ""deletions"": 0, ""lines"": 2}}"
2020-07-17 18:43:43,203ec7760d255d9f92950c8779ddfc587d7896e0,Bram Moolenaar,144,2,146,16,"{""src/gui.c"": {""insertions"": 4, ""deletions"": 2, ""lines"": 6}, ""src/gui_athena.c"": {""insertions"": 16, ""deletions"": 0, ""lines"": 16}, ""src/gui_gtk.c"": {""insertions"": 16, ""deletions"": 0, ""lines"": 16}, ""src/gui_haiku.cc"": {""insertions"": 16, ""deletions"": 0, ""lines"": 16}, ""src/gui_mac.c"": {""insertions"": 16, ""deletions"": 0, ""lines"": 16}, ""src/gui_motif.c"": {""insertions"": 16, ""deletions"": 0, ""lines"": 16}, ""src/gui_photon.c"": {""insertions"": 16, ""deletions"": 0, ""lines"": 16}, ""src/gui_w32.c"": {""insertions"": 28, ""deletions"": 0, ""lines"": 28}, ""src/proto/gui_athena.pro"": {""insertions"": 2, ""deletions"": 0, ""lines"": 2}, ""src/proto/gui_gtk.pro"": {""insertions"": 2, ""deletions"": 0, ""lines"": 2}, ""src/proto/gui_haiku.pro"": {""insertions"": 2, ""deletions"": 0, ""lines"": 2}, ""src/proto/gui_mac.pro"": {""insertions"": 2, ""deletions"": 0, ""lines"": 2}, ""src/proto/gui_motif.pro"": {""insertions"": 2, ""deletions"": 0, ""lines"": 2}, ""src/proto/gui_photon.pro"": {""insertions"": 2, ""deletions"": 0, ""lines"": 2}, ""src/proto/gui_w32.pro"": {""insertions"": 2, ""deletions"": 0, ""lines"": 2}, ""src/version.c"": {""insertions"": 2, ""deletions"": 0, ""lines"": 2}}"
2020-07-17 18:36:00,f5be8cdb77786f93c23237d7d8162feca92067e2,Bram Moolenaar,167,126,293,9,"{""runtime/doc/vim9.txt"": {""insertions"": 18, ""deletions"": 11, ""lines"": 29}, ""src/ex_docmd.c"": {""insertions"": 48, ""deletions"": 21, ""lines"": 69}, ""src/proto/ex_docmd.pro"": {""insertions"": 1, ""deletions"": 0, ""lines"": 1}, ""src/testdir/test_vim9_disassemble.vim"": {""insertions"": 5, ""deletions"": 5, ""lines"": 10}, ""src/testdir/test_vim9_expr.vim"": {""insertions"": 26, ""deletions"": 26, ""lines"": 52}, ""src/testdir/test_vim9_func.vim"": {""insertions"": 6, ""deletions"": 6, ""lines"": 12}, ""src/testdir/test_vim9_script.vim"": {""insertions"": 49, ""deletions"": 49, ""lines"": 98}, ""src/version.c"": {""insertions"": 2, ""deletions"": 0, ""lines"": 2}, ""src/vim9compile.c"": {""insertions"": 12, ""deletions"": 8, ""lines"": 20}}"
2020-07-16 20:30:31,98af99f2d79b310e81003f5e27862a7b522d8372,Bram Moolenaar,23,38,61,2,"{""src/gui_w32.c"": {""insertions"": 21, ""deletions"": 38, ""lines"": 59}, ""src/version.c"": {""insertions"": 2, ""deletions"": 0, ""lines"": 2}}"
2020-07-16 20:15:53,ee1b93169d21896e5401a54a5189c9465abb7bc9,Bram Moolenaar,39,3,42,2,"{""src/if_python3.c"": {""insertions"": 37, ""deletions"": 3, ""lines"": 40}, ""src/version.c"": {""insertions"": 2, ""deletions"": 0, ""lines"": 2}}"
2020-07-15 20:38:56,a90afb9a590c92d537faeb16f9ccd282fc78aeff,Bram Moolenaar,40,2,42,3,"{""src/testdir/test_vim9_func.vim"": {""insertions"": 18, ""deletions"": 0, ""lines"": 18}, ""src/version.c"": {""insertions"": 2, ""deletions"": 0, ""lines"": 2}, ""src/vim9execute.c"": {""insertions"": 20, ""deletions"": 2, ""lines"": 22}}"
2020-07-15 17:48:20,e30f64b4b551bb00318dc09c2f13ecd3d711119a,Bram Moolenaar,11,1,12,3,"{""src/testdir/test_vim9_func.vim"": {""insertions"": 8, ""deletions"": 0, ""lines"": 8}, ""src/version.c"": {""insertions"": 2, ""deletions"": 0, ""lines"": 2}, ""src/vim9compile.c"": {""insertions"": 1, ""deletions"": 1, ""lines"": 2}}"
2020-07-15 16:29:18,657a826c07b4ea3f8846b6acb2c50b82c2d81e50,Bram Moolenaar,3,1,4,2,"{""src/testdir/shared.vim"": {""insertions"": 1, ""deletions"": 1, ""lines"": 2}, ""src/version.c"": {""insertions"": 2, ""deletions"": 0, ""lines"": 2}}"
2020-07-15 16:27:08,02f9e6a60f9851046154ccf2ac170f25a0b3cc7d,Bram Moolenaar,7,0,7,2,"{""src/popupwin.c"": {""insertions"": 5, ""deletions"": 0, ""lines"": 5}, ""src/version.c"": {""insertions"": 2, ""deletions"": 0, ""lines"": 2}}"
2020-07-15 15:38:21,452143c6bf0dcf76ef415281b0e4fbc3edff4b6b,Bram Moolenaar,89,19,108,7,"{""src/mouse.c"": {""insertions"": 9, ""deletions"": 6, ""lines"": 15}, ""src/testdir/dumps/Test_popupwin_term_01.dump"": {""insertions"": 10, ""deletions"": 4, ""lines"": 14}, ""src/testdir/dumps/Test_popupwin_term_02.dump"": {""insertions"": 11, ""deletions"": 5, ""lines"": 16}, ""src/testdir/dumps/Test_popupwin_term_03.dump"": {""insertions"": 16, ""deletions"": 0, ""lines"": 16}, ""src/testdir/dumps/Test_popupwin_term_04.dump"": {""insertions"": 16, ""deletions"": 0, ""lines"": 16}, ""src/testdir/test_popupwin.vim"": {""insertions"": 25, ""deletions"": 4, ""lines"": 29}, ""src/version.c"": {""insertions"": 2, ""deletions"": 0, ""lines"": 2}}"
2020-07-15 13:30:05,5966ea105ea86e52a734e04267956e11efffc92d,Bram Moolenaar,41,9,50,3,"{""src/memline.c"": {""insertions"": 9, ""deletions"": 9, ""lines"": 18}, ""src/testdir/test_swap.vim"": {""insertions"": 30, ""deletions"": 0, ""lines"": 30}, ""src/version.c"": {""insertions"": 2, ""deletions"": 0, ""lines"": 2}}"
2020-07-15 12:15:52,3d48e25dcb661eb09ccdaa73d4e2559201ff2eb1,Bram Moolenaar,57,25,82,4,"{""src/ex_docmd.c"": {""insertions"": 38, ""deletions"": 21, ""lines"": 59}, ""src/testdir/test_vim9_func.vim"": {""insertions"": 9, ""deletions"": 0, ""lines"": 9}, ""src/version.c"": {""insertions"": 2, ""deletions"": 0, ""lines"": 2}, ""src/vim9compile.c"": {""insertions"": 8, ""deletions"": 4, ""lines"": 12}}"
2020-07-15 09:19:11,1e1f612bd42085becb2208b9a95ed3ed0d272ee8,Bram Moolenaar,20,9,29,2,"{""src/testdir/test_startup.vim"": {""insertions"": 18, ""deletions"": 9, ""lines"": 27}, ""src/version.c"": {""insertions"": 2, ""deletions"": 0, ""lines"": 2}}"
2020-07-14 23:37:36,b6e4e4c6f7b4f7eadcc4c2397bfa57e0734e005f,Bram Moolenaar,5,3,8,2,"{""src/testdir/test_startup.vim"": {""insertions"": 3, ""deletions"": 3, ""lines"": 6}, ""src/version.c"": {""insertions"": 2, ""deletions"": 0, ""lines"": 2}}"
2020-07-14 21:02:44,e3f915d12c8fe0466918a29ab4eaef153f71a2cd,Bram Moolenaar,47,453,500,13,"{""Filelist"": {""insertions"": 0, ""deletions"": 2, ""lines"": 2}, ""READMEdir/README_extra.txt"": {""insertions"": 0, ""deletions"": 2, ""lines"": 2}, ""runtime/doc/os_mint.txt"": {""insertions"": 4, ""deletions"": 28, ""lines"": 32}, ""src/INSTALL"": {""insertions"": 1, ""deletions"": 200, ""lines"": 201}, ""src/Make_mint.mak"": {""insertions"": 0, ""deletions"": 56, ""lines"": 56}, ""src/digraph.c"": {""insertions"": 36, ""deletions"": 103, ""lines"": 139}, ""src/fileio.c"": {""insertions"": 1, ""deletions"": 1, ""lines"": 2}, ""src/memfile.c"": {""insertions"": 0, ""deletions"": 3, ""lines"": 3}, ""src/os_mint.h"": {""insertions"": 0, ""deletions"": 13, ""lines"": 13}, ""src/os_unix.c"": {""insertions"": 1, ""deletions"": 2, ""lines"": 3}, ""src/term.c"": {""insertions"": 2, ""deletions"": 39, ""lines"": 41}, ""src/version.c"": {""insertions"": 2, ""deletions"": 0, ""lines"": 2}, ""src/vim.h"": {""insertions"": 0, ""deletions"": 4, ""lines"": 4}}"
2020-07-14 20:24:40,ceb56ddbafbca01e52ff4291d9480bf83d739793,Bram Moolenaar,22,25,47,2,"{""nsis/gvim.nsi"": {""insertions"": 20, ""deletions"": 25, ""lines"": 45}, ""src/version.c"": {""insertions"": 2, ""deletions"": 0, ""lines"": 2}}"
2020-07-14 20:11:04,297bec07311e512ef625a48b0af8bdca8118f131,Bram Moolenaar,439,4,443,2,"{""src/testdir/test_termcodes.vim"": {""insertions"": 437, ""deletions"": 4, ""lines"": 441}, ""src/version.c"": {""insertions"": 2, ""deletions"": 0, ""lines"": 2}}"
2020-07-14 19:54:28,5551b131daef3a621a28dcbbe118920f5b9fabe6,Bram Moolenaar,12,1,13,2,"{""src/if_lua.c"": {""insertions"": 10, ""deletions"": 1, ""lines"": 11}, ""src/version.c"": {""insertions"": 2, ""deletions"": 0, ""lines"": 2}}"
2020-07-14 19:22:30,8455c5ed31c9cb2919f5e62693bab6b09bf60df2,Bram Moolenaar,23,0,23,3,"{""src/move.c"": {""insertions"": 1, ""deletions"": 0, ""lines"": 1}, ""src/testdir/test_diffmode.vim"": {""insertions"": 20, ""deletions"": 0, ""lines"": 20}, ""src/version.c"": {""insertions"": 2, ""deletions"": 0, ""lines"": 2}}"
2020-07-14 19:08:49,1f22cc5cdb2da867d6bbf54dd371f279c38a2f56,Bram Moolenaar,26,27,53,3,"{""src/if_py_both.h"": {""insertions"": 14, ""deletions"": 17, ""lines"": 31}, ""src/userfunc.c"": {""insertions"": 10, ""deletions"": 10, ""lines"": 20}, ""src/version.c"": {""insertions"": 2, ""deletions"": 0, ""lines"": 2}}"
2020-07-14 14:15:34,21c16f868d725fffc8fa36620cba33dd5f2ed576,Bram Moolenaar,5,0,5,2,"{""src/hashtab.c"": {""insertions"": 3, ""deletions"": 0, ""lines"": 3}, ""src/version.c"": {""insertions"": 2, ""deletions"": 0, ""lines"": 2}}"
2020-07-14 13:47:23,49fe0d6b289ee640cf5c49b1704bbbd641a0237d,Bram Moolenaar,3,0,3,2,"{""src/structs.h"": {""insertions"": 1, ""deletions"": 0, ""lines"": 1}, ""src/version.c"": {""insertions"": 2, ""deletions"": 0, ""lines"": 2}}"
2020-07-14 13:01:05,7ce85be63b37ab4ec791dde93a380e8a4d8a04dd,Bram Moolenaar,10,10,20,3,"{""src/testdir/test_vim9_expr.vim"": {""insertions"": 2, ""deletions"": 4, ""lines"": 6}, ""src/userfunc.c"": {""insertions"": 6, ""deletions"": 6, ""lines"": 12}, ""src/version.c"": {""insertions"": 2, ""deletions"": 0, ""lines"": 2}}"
2020-07-13 21:22:54,1bce831e13c42daa3563c7f90432d9bd9b959b81,Bram Moolenaar,6,2,8,2,"{""src/testdir/test_vim9_expr.vim"": {""insertions"": 4, ""deletions"": 2, ""lines"": 6}, ""src/version.c"": {""insertions"": 2, ""deletions"": 0, ""lines"": 2}}"
2020-07-13 20:29:02,8c34ea54ad1ba3ea9a604ba0495669bdd1393d9a,Bram Moolenaar,134,30,164,3,"{""src/eval.c"": {""insertions"": 58, ""deletions"": 24, ""lines"": 82}, ""src/testdir/test_vim9_expr.vim"": {""insertions"": 74, ""deletions"": 6, ""lines"": 80}, ""src/version.c"": {""insertions"": 2, ""deletions"": 0, ""lines"": 2}}"
2020-07-13 19:59:33,5d2eb0fff0fbe905da2c57fd73f7f127a73d1c99,Bram Moolenaar,31,2,33,3,"{""src/eval.c"": {""insertions"": 16, ""deletions"": 2, ""lines"": 18}, ""src/testdir/test_vim9_expr.vim"": {""insertions"": 13, ""deletions"": 0, ""lines"": 13}, ""src/version.c"": {""insertions"": 2, ""deletions"": 0, ""lines"": 2}}"
2020-07-13 19:28:03,3ac9c4701a5f1e39303ca2885956db92215966db,Bram Moolenaar,24,13,37,2,"{""src/eval.c"": {""insertions"": 22, ""deletions"": 13, ""lines"": 35}, ""src/version.c"": {""insertions"": 2, ""deletions"": 0, ""lines"": 2}}"
2020-07-13 18:41:08,08f7a41b0a280e5901eb4ee4bbfe682113863492,Bram Moolenaar,41,3,44,3,"{""src/testdir/test_vim9_func.vim"": {""insertions"": 19, ""deletions"": 0, ""lines"": 19}, ""src/version.c"": {""insertions"": 2, ""deletions"": 0, ""lines"": 2}, ""src/vim9execute.c"": {""insertions"": 20, ""deletions"": 3, ""lines"": 23}}"
2020-07-13 16:55:48,f1a2368d81fc3f70dfcf7d577957185da6ccf0b6,Bram Moolenaar,18,1,19,3,"{""src/testdir/test_vim9_func.vim"": {""insertions"": 8, ""deletions"": 0, ""lines"": 8}, ""src/version.c"": {""insertions"": 2, ""deletions"": 0, ""lines"": 2}, ""src/vim9compile.c"": {""insertions"": 8, ""deletions"": 1, ""lines"": 9}}"
2020-07-13 16:18:00,bfd65589d9b6bd5fd2c8ee768d1427469bd61ead,Bram Moolenaar,23,1,24,3,"{""src/testdir/test_vim9_disassemble.vim"": {""insertions"": 13, ""deletions"": 0, ""lines"": 13}, ""src/version.c"": {""insertions"": 2, ""deletions"": 0, ""lines"": 2}, ""src/vim9execute.c"": {""insertions"": 8, ""deletions"": 1, ""lines"": 9}}"
2020-07-12 21:09:20,7177da9dd4d9a521c6141c6fbf7e9a4d6296ab05,Bram Moolenaar,54,5,59,3,"{""src/testdir/test_assert.vim"": {""insertions"": 46, ""deletions"": 0, ""lines"": 46}, ""src/testing.c"": {""insertions"": 6, ""deletions"": 5, ""lines"": 11}, ""src/version.c"": {""insertions"": 2, ""deletions"": 0, ""lines"": 2}}"
2020-07-12 19:38:29,a4b442614c5ca4ebf32acf5cf0b7b718496f1c94,Bram Moolenaar,46,44,90,3,"{""src/testdir/test_terminal2.vim"": {""insertions"": 0, ""deletions"": 44, ""lines"": 44}, ""src/testdir/test_terminal3.vim"": {""insertions"": 44, ""deletions"": 0, ""lines"": 44}, ""src/version.c"": {""insertions"": 2, ""deletions"": 0, ""lines"": 2}}"
2020-07-12 18:49:29,c212dd0a346d57f62013094ea6861eb28e33023c,Bram Moolenaar,4,2,6,2,"{""src/testdir/test_clientserver.vim"": {""insertions"": 2, ""deletions"": 2, ""lines"": 4}, ""src/version.c"": {""insertions"": 2, ""deletions"": 0, ""lines"": 2}}"
2020-07-12 18:44:37,83e7450053399942e1c9efa802c568b51d948541,Bram Moolenaar,4,0,4,2,"{""src/popupwin.c"": {""insertions"": 2, ""deletions"": 0, ""lines"": 2}, ""src/version.c"": {""insertions"": 2, ""deletions"": 0, ""lines"": 2}}"
2020-07-12 18:00:24,4d57ba02029071e5947a54766e9f5d42e3bb3008,Bram Moolenaar,6,2,8,2,"{""src/testdir/test_clientserver.vim"": {""insertions"": 4, ""deletions"": 2, ""lines"": 6}, ""src/version.c"": {""insertions"": 2, ""deletions"": 0, ""lines"": 2}}"
2020-07-12 17:52:36,a4dc6f92bb29b00783f8945bbe1101e837b6ad3c,Bram Moolenaar,5,2,7,4,"{""src/testdir/dumps/Test_popupwin_term_01.dump"": {""insertions"": 1, ""deletions"": 1, ""lines"": 2}, ""src/testdir/dumps/Test_popupwin_term_02.dump"": {""insertions"": 1, ""deletions"": 1, ""lines"": 2}, ""src/testdir/test_popupwin.vim"": {""insertions"": 1, ""deletions"": 0, ""lines"": 1}, ""src/version.c"": {""insertions"": 2, ""deletions"": 0, ""lines"": 2}}"
2020-07-12 17:24:10,35910f2d54bd670a0d83b3474b4c23faa94252d3,Bram Moolenaar,76,13,89,5,"{""src/popupwin.c"": {""insertions"": 20, ""deletions"": 13, ""lines"": 33}, ""src/testdir/dumps/Test_popupwin_term_01.dump"": {""insertions"": 10, ""deletions"": 0, ""lines"": 10}, ""src/testdir/dumps/Test_popupwin_term_02.dump"": {""insertions"": 10, ""deletions"": 0, ""lines"": 10}, ""src/testdir/test_popupwin.vim"": {""insertions"": 34, ""deletions"": 0, ""lines"": 34}, ""src/version.c"": {""insertions"": 2, ""deletions"": 0, ""lines"": 2}}"
2020-07-12 16:33:53,b898a029b01866b1dbe07521e153d54917b9527d,Bram Moolenaar,14,4,18,2,"{""src/testdir/test_lua.vim"": {""insertions"": 12, ""deletions"": 4, ""lines"": 16}, ""src/version.c"": {""insertions"": 2, ""deletions"": 0, ""lines"": 2}}"
2020-07-12 15:31:09,985116ae0b7b3ef17e0c0ea2669068dd6b3b39c7,Bram Moolenaar,17,0,17,4,"{""src/structs.h"": {""insertions"": 1, ""deletions"": 0, ""lines"": 1}, ""src/testdir/test_vim9_func.vim"": {""insertions"": 12, ""deletions"": 0, ""lines"": 12}, ""src/version.c"": {""insertions"": 2, ""deletions"": 0, ""lines"": 2}, ""src/vim9compile.c"": {""insertions"": 2, ""deletions"": 0, ""lines"": 2}}"
2020-07-12 15:07:05,eb6880b6eb7c4631f6103575c0d1336b149348c1,Bram Moolenaar,26,28,54,9,"{""src/dict.c"": {""insertions"": 1, ""deletions"": 1, ""lines"": 2}, ""src/eval.c"": {""insertions"": 5, ""deletions"": 6, ""lines"": 11}, ""src/evalvars.c"": {""insertions"": 9, ""deletions"": 13, ""lines"": 22}, ""src/ex_docmd.c"": {""insertions"": 1, ""deletions"": 1, ""lines"": 2}, ""src/list.c"": {""insertions"": 1, ""deletions"": 1, ""lines"": 2}, ""src/scriptfile.c"": {""insertions"": 1, ""deletions"": 1, ""lines"": 2}, ""src/userfunc.c"": {""insertions"": 2, ""deletions"": 3, ""lines"": 5}, ""src/version.c"": {""insertions"": 2, ""deletions"": 0, ""lines"": 2}, ""src/vim9script.c"": {""insertions"": 4, ""deletions"": 2, ""lines"": 6}}"
2020-07-12 14:32:19,8af81d656a4c501611f6211b6379ea9dd650c545,Bram Moolenaar,141,109,250,3,"{""src/eval.c"": {""insertions"": 118, ""deletions"": 109, ""lines"": 227}, ""src/testdir/test_vim9_expr.vim"": {""insertions"": 21, ""deletions"": 0, ""lines"": 21}, ""src/version.c"": {""insertions"": 2, ""deletions"": 0, ""lines"": 2}}"
2020-07-12 12:34:00,6d3a7213f58da834b0fc869d05f87e86010c66cf,Bram Moolenaar,8,5,13,3,"{""src/json.c"": {""insertions"": 4, ""deletions"": 5, ""lines"": 9}, ""src/testdir/test_json.vim"": {""insertions"": 2, ""deletions"": 0, ""lines"": 2}, ""src/version.c"": {""insertions"": 2, ""deletions"": 0, ""lines"": 2}}"
2020-07-12 12:09:23,c85156bb897085d7f5a8e4e180287f87bf19b948,Bram Moolenaar,37,29,66,2,"{""src/testdir/test_terminal2.vim"": {""insertions"": 35, ""deletions"": 29, ""lines"": 64}, ""src/version.c"": {""insertions"": 2, ""deletions"": 0, ""lines"": 2}}"
2020-07-12 11:47:42,13c046316b2e651871701ed81e2ba4763b19b67d,Bram Moolenaar,51,51,102,2,"{""src/mouse.c"": {""insertions"": 49, ""deletions"": 51, ""lines"": 100}, ""src/version.c"": {""insertions"": 2, ""deletions"": 0, ""lines"": 2}}"
2020-07-11 20:49:59,ecdd14a427108aa6f133c00655788f6ae80ad463,Bram Moolenaar,11,8,19,3,"{""src/testdir/test_lua.vim"": {""insertions"": 2, ""deletions"": 2, ""lines"": 4}, ""src/testdir/test_tcl.vim"": {""insertions"": 7, ""deletions"": 6, ""lines"": 13}, ""src/version.c"": {""insertions"": 2, ""deletions"": 0, ""lines"": 2}}"
2020-07-11 20:25:57,2b6ef856fb89f703714f3f1f567d9bd7c81079f3,Bram Moolenaar,10,12,22,4,"{""src/evalvars.c"": {""insertions"": 0, ""deletions"": 1, ""lines"": 1}, ""src/testdir/test_assert.vim"": {""insertions"": 4, ""deletions"": 4, ""lines"": 8}, ""src/testdir/test_eval_stuff.vim"": {""insertions"": 4, ""deletions"": 7, ""lines"": 11}, ""src/version.c"": {""insertions"": 2, ""deletions"": 0, ""lines"": 2}}"
2020-07-11 20:14:59,9b7bf9e98f06ece595fed7a3ff53ecce89797a53,Bram Moolenaar,227,154,381,53,"{""runtime/doc/testing.txt"": {""insertions"": 17, ""deletions"": 2, ""lines"": 19}, ""src/evalvars.c"": {""insertions"": 3, ""deletions"": 6, ""lines"": 9}, ""src/globals.h"": {""insertions"": 4, ""deletions"": 0, ""lines"": 4}, ""src/if_cscope.c"": {""insertions"": 0, ""deletions"": 1, ""lines"": 1}, ""src/message.c"": {""insertions"": 3, ""deletions"": 0, ""lines"": 3}, ""src/testdir/test_autocmd.vim"": {""insertions"": 4, ""deletions"": 8, ""lines"": 12}, ""src/testdir/test_buffer.vim"": {""insertions"": 2, ""deletions"": 2, ""lines"": 4}, ""src/testdir/test_cd.vim"": {""insertions"": 2, ""deletions"": 2, ""lines"": 4}, ""src/testdir/test_channel.vim"": {""insertions"": 7, ""deletions"": 7, ""lines"": 14}, ""src/testdir/test_clientserver.vim"": {""insertions"": 3, ""deletions"": 3, ""lines"": 6}, ""src/testdir/test_cmdline.vim"": {""insertions"": 3, ""deletions"": 3, ""lines"": 6}, ""src/testdir/test_cpoptions.vim"": {""insertions"": 1, ""deletions"": 1, ""lines"": 2}, ""src/testdir/test_cscope.vim"": {""insertions"": 1, ""deletions"": 1, ""lines"": 2}, ""src/testdir/test_excmd.vim"": {""insertions"": 2, ""deletions"": 2, ""lines"": 4}, ""src/testdir/test_expr.vim"": {""insertions"": 1, ""deletions"": 1, ""lines"": 2}, ""src/testdir/test_functions.vim"": {""insertions"": 5, ""deletions"": 5, ""lines"": 10}, ""src/testdir/test_global.vim"": {""insertions"": 1, ""deletions"": 1, ""lines"": 2}, ""src/testdir/test_json.vim"": {""insertions"": 20, ""deletions"": 20, ""lines"": 40}, ""src/testdir/test_let.vim"": {""insertions"": 1, ""deletions"": 1, ""lines"": 2}, ""src/testdir/test_listdict.vim"": {""insertions"": 3, ""deletions"": 3, ""lines"": 6}, ""src/testdir/test_listener.vim"": {""insertions"": 2, ""deletions"": 2, ""lines"": 4}, ""src/testdir/test_match.vim"": {""insertions"": 1, ""deletions"": 1, ""lines"": 2}, ""src/testdir/test_menu.vim"": {""insertions"": 1, ""deletions"": 1, ""lines"": 2}, ""src/testdir/test_method.vim"": {""insertions"": 2, ""deletions"": 2, ""lines"": 4}, ""src/testdir/test_normal.vim"": {""insertions"": 1, ""deletions"": 1, ""lines"": 2}, ""src/testdir/test_popup.vim"": {""insertions"": 1, ""deletions"": 1, ""lines"": 2}, ""src/testdir/test_python2.vim"": {""insertions"": 1, ""deletions"": 1, ""lines"": 2}, ""src/testdir/test_python3.vim"": {""insertions"": 6, ""deletions"": 6, ""lines"": 12}, ""src/testdir/test_quickfix.vim"": {""insertions"": 3, ""deletions"": 3, ""lines"": 6}, ""src/testdir/test_random.vim"": {""insertions"": 5, ""deletions"": 5, ""lines"": 10}, ""src/testdir/test_regexp_latin.vim"": {""insertions"": 1, ""deletions"": 1, ""lines"": 2}, ""src/testdir/test_search.vim"": {""insertions"": 4, ""deletions"": 4, ""lines"": 8}, ""src/testdir/test_signs.vim"": {""insertions"": 3, ""deletions"": 3, ""lines"": 6}, ""src/testdir/test_spell.vim"": {""insertions"": 1, ""deletions"": 1, ""lines"": 2}, ""src/testdir/test_substitute.vim"": {""insertions"": 4, ""deletions"": 4, ""lines"": 8}, ""src/testdir/test_syntax.vim"": {""insertions"": 1, ""deletions"": 1, ""lines"": 2}, ""src/testdir/test_tagfunc.vim"": {""insertions"": 1, ""deletions"": 1, ""lines"": 2}, ""src/testdir/test_tagjump.vim"": {""insertions"": 2, ""deletions"": 2, ""lines"": 4}, ""src/testdir/test_taglist.vim"": {""insertions"": 1, ""deletions"": 1, ""lines"": 2}, ""src/testdir/test_terminal.vim"": {""insertions"": 12, ""deletions"": 12, ""lines"": 24}, ""src/testdir/test_textprop.vim"": {""insertions"": 4, ""deletions"": 4, ""lines"": 8}, ""src/testdir/test_trycatch.vim"": {""insertions"": 1, ""deletions"": 1, ""lines"": 2}, ""src/testdir/test_utf8.vim"": {""insertions"": 1, ""deletions"": 1, ""lines"": 2}, ""src/testdir/test_vim9_disassemble.vim"": {""insertions"": 2, ""deletions"": 2, ""lines"": 4}, ""src/testdir/test_vim9_func.vim"": {""insertions"": 1, ""deletions"": 1, ""lines"": 2}, ""src/testdir/test_vim9_script.vim"": {""insertions"": 3, ""deletions"": 3, ""lines"": 6}, ""src/testdir/test_viminfo.vim"": {""insertions"": 3, ""deletions"": 3, ""lines"": 6}, ""src/testdir/test_winbuf_close.vim"": {""insertions"": 1, ""deletions"": 1, ""lines"": 2}, ""src/testdir/test_window_cmd.vim"": {""insertions"": 1, ""deletions"": 1, ""lines"": 2}, ""src/testdir/test_writefile.vim"": {""insertions"": 1, ""deletions"": 1, ""lines"": 2}, ""src/testing.c"": {""insertions"": 55, ""deletions"": 4, ""lines"": 59}, ""src/version.c"": {""insertions"": 2, ""deletions"": 0, ""lines"": 2}, ""src/vim9compile.c"": {""insertions"": 16, ""deletions"": 10, ""lines"": 26}}"
2020-07-11 13:20:48,914e7eaa67f8d816e15fb4a1180e6bece88d9742,Bram Moolenaar,16,3,19,4,"{""src/testdir/test_vim9_expr.vim"": {""insertions"": 2, ""deletions"": 1, ""lines"": 3}, ""src/testdir/test_vim9_func.vim"": {""insertions"": 1, ""deletions"": 1, ""lines"": 2}, ""src/userfunc.c"": {""insertions"": 11, ""deletions"": 1, ""lines"": 12}, ""src/version.c"": {""insertions"": 2, ""deletions"": 0, ""lines"": 2}}"
2020-07-11 12:26:08,21e5bdd271fa4d0ff4511cf74b160315e1d17cff,Bram Moolenaar,23,0,23,2,"{""src/testdir/test_json.vim"": {""insertions"": 21, ""deletions"": 0, ""lines"": 21}, ""src/version.c"": {""insertions"": 2, ""deletions"": 0, ""lines"": 2}}"
2020-07-11 12:08:04,1e624c912dff19e889c9398b56fe537952c02fef,Bram Moolenaar,4,1,5,2,"{""src/ex_docmd.c"": {""insertions"": 2, ""deletions"": 1, ""lines"": 3}, ""src/version.c"": {""insertions"": 2, ""deletions"": 0, ""lines"": 2}}"
2020-07-11 12:04:28,f65927fc8d0102ef2d0fea776381caedf4c51e32,Bram Moolenaar,4,0,4,2,"{""src/testdir/test_terminal2.vim"": {""insertions"": 2, ""deletions"": 0, ""lines"": 2}, ""src/version.c"": {""insertions"": 2, ""deletions"": 0, ""lines"": 2}}"
2020-07-11 11:40:45,b074e8b8d4d3cefefc675dfaf3982d388ee07772,Bram Moolenaar,14,1,15,4,"{""src/ex_docmd.c"": {""insertions"": 5, ""deletions"": 1, ""lines"": 6}, ""src/testdir/test_vim9_cmd.vim"": {""insertions"": 6, ""deletions"": 0, ""lines"": 6}, ""src/version.c"": {""insertions"": 2, ""deletions"": 0, ""lines"": 2}, ""src/vim9compile.c"": {""insertions"": 1, ""deletions"": 0, ""lines"": 1}}"
2020-07-11 11:09:36,18aa13d13b69c090dbe186cd4939896488c433e3,Bram Moolenaar,1000,976,1976,6,"{""src/testdir/Make_all.mak"": {""insertions"": 2, ""deletions"": 0, ""lines"": 2}, ""src/testdir/runtest.vim"": {""insertions"": 5, ""deletions"": 0, ""lines"": 5}, ""src/testdir/test_terminal.vim"": {""insertions"": 467, ""deletions"": 1, ""lines"": 468}, ""src/testdir/test_terminal2.vim"": {""insertions"": 1, ""deletions"": 975, ""lines"": 976}, ""src/testdir/test_terminal3.vim"": {""insertions"": 523, ""deletions"": 0, ""lines"": 523}, ""src/version.c"": {""insertions"": 2, ""deletions"": 0, ""lines"": 2}}"
2020-07-10 20:45:38,543e6f3467f208930a5d7fadb82133334bf31356,Bram Moolenaar,41,3,44,5,"{""src/eval.c"": {""insertions"": 9, ""deletions"": 1, ""lines"": 10}, ""src/proto/vim9compile.pro"": {""insertions"": 1, ""deletions"": 0, ""lines"": 1}, ""src/testdir/test_vim9_expr.vim"": {""insertions"": 20, ""deletions"": 1, ""lines"": 21}, ""src/version.c"": {""insertions"": 2, ""deletions"": 0, ""lines"": 2}, ""src/vim9compile.c"": {""insertions"": 9, ""deletions"": 1, ""lines"": 10}}"
2020-07-10 20:00:53,7ff78465f7057a672a6de0d75d56286da253501b,Bram Moolenaar,690,420,1110,21,"{""runtime/autoload/spellfile.vim"": {""insertions"": 4, ""deletions"": 8, ""lines"": 12}, ""runtime/doc/channel.txt"": {""insertions"": 2, ""deletions"": 2, ""lines"": 4}, ""runtime/doc/editing.txt"": {""insertions"": 3, ""deletions"": 3, ""lines"": 6}, ""runtime/doc/eval.txt"": {""insertions"": 18, ""deletions"": 7, ""lines"": 25}, ""runtime/doc/options.txt"": {""insertions"": 1, ""deletions"": 1, ""lines"": 2}, ""runtime/doc/pattern.txt"": {""insertions"": 2, ""deletions"": 2, ""lines"": 4}, ""runtime/doc/spell.txt"": {""insertions"": 7, ""deletions"": 6, ""lines"": 13}, ""runtime/doc/syntax.txt"": {""insertions"": 2, ""deletions"": 2, ""lines"": 4}, ""runtime/doc/tags"": {""insertions"": 3, ""deletions"": 0, ""lines"": 3}, ""runtime/doc/testing.txt"": {""insertions"": 3, ""deletions"": 2, ""lines"": 5}, ""runtime/doc/textprop.txt"": {""insertions"": 1, ""deletions"": 1, ""lines"": 2}, ""runtime/doc/todo.txt"": {""insertions"": 20, ""deletions"": 32, ""lines"": 52}, ""runtime/doc/usr_11.txt"": {""insertions"": 2, ""deletions"": 2, ""lines"": 4}, ""runtime/doc/various.txt"": {""insertions"": 2, ""deletions"": 2, ""lines"": 4}, ""runtime/doc/vim9.txt"": {""insertions"": 57, ""deletions"": 9, ""lines"": 66}, ""runtime/ftplugin/vim.vim"": {""insertions"": 3, ""deletions"": 3, ""lines"": 6}, ""runtime/indent/Makefile"": {""insertions"": 1, ""deletions"": 1, ""lines"": 2}, ""runtime/indent/html.vim"": {""insertions"": 3, ""deletions"": 4, ""lines"": 7}, ""runtime/indent/testdir/html.in"": {""insertions"": 30, ""deletions"": 0, ""lines"": 30}, ""runtime/indent/testdir/html.ok"": {""insertions"": 59, ""deletions"": 29, ""lines"": 88}, ""src/po/de.po"": {""insertions"": 467, ""deletions"": 304, ""lines"": 771}}"
2020-07-10 19:50:41,a7eedf317a806fceec1ddd8f9bebed6e00be0ed2,Bram Moolenaar,32,4,36,3,"{""src/testdir/test_vim9_expr.vim"": {""insertions"": 7, ""deletions"": 1, ""lines"": 8}, ""src/version.c"": {""insertions"": 2, ""deletions"": 0, ""lines"": 2}, ""src/vim9compile.c"": {""insertions"": 23, ""deletions"": 3, ""lines"": 26}}"
2020-07-10 19:17:51,11a5b19a8ce543c258832ac53d771047f4e1061d,Bram Moolenaar,16,0,16,2,"{""src/testdir/test_registers.vim"": {""insertions"": 14, ""deletions"": 0, ""lines"": 14}, ""src/version.c"": {""insertions"": 2, ""deletions"": 0, ""lines"": 2}}"
2020-07-10 18:45:31,40043152924827fa8c4064951065ff507c610164,Bram Moolenaar,6,0,6,2,"{""src/tee/tee.c"": {""insertions"": 4, ""deletions"": 0, ""lines"": 4}, ""src/version.c"": {""insertions"": 2, ""deletions"": 0, ""lines"": 2}}"
2020-07-10 18:40:23,08fc48492acc07259d91293df12bf66447819443,Bram Moolenaar,4,2,6,3,"{""runtime/doc/Makefile"": {""insertions"": 1, ""deletions"": 1, ""lines"": 2}, ""src/tee/Makefile"": {""insertions"": 1, ""deletions"": 1, ""lines"": 2}, ""src/version.c"": {""insertions"": 2, ""deletions"": 0, ""lines"": 2}}"
2020-07-10 18:30:12,58bb61cf5ee008254eb331bc3574eac87d2dcc4a,Bram Moolenaar,4,0,4,2,"{""src/syntax.c"": {""insertions"": 2, ""deletions"": 0, ""lines"": 2}, ""src/version.c"": {""insertions"": 2, ""deletions"": 0, ""lines"": 2}}"
2020-07-10 18:24:07,ef85a9b2d9e992ab594e089af3883e381cfad426,Bram Moolenaar,21,1,22,3,"{""src/register.c"": {""insertions"": 1, ""deletions"": 1, ""lines"": 2}, ""src/testdir/test_registers.vim"": {""insertions"": 18, ""deletions"": 0, ""lines"": 18}, ""src/version.c"": {""insertions"": 2, ""deletions"": 0, ""lines"": 2}}"
2020-07-10 18:03:03,97d2f34c8763ab3a46c9f43284cc17bad3cf9568,Bram Moolenaar,4,1,5,2,"{""src/spellfile.c"": {""insertions"": 2, ""deletions"": 1, ""lines"": 3}, ""src/version.c"": {""insertions"": 2, ""deletions"": 0, ""lines"": 2}}"
2020-07-09 20:53:30,92053ce59ecf93838f4d6e3019eef1bc47be4184,Bram Moolenaar,3,1,4,2,"{""src/evalfunc.c"": {""insertions"": 1, ""deletions"": 1, ""lines"": 2}, ""src/version.c"": {""insertions"": 2, ""deletions"": 0, ""lines"": 2}}"
2020-07-09 19:20:47,389df259c49d1ca4f7aa129b702f6083985b1e73,Bram Moolenaar,94,10,104,7,"{""src/evalfunc.c"": {""insertions"": 7, ""deletions"": 5, ""lines"": 12}, ""src/testdir/test_vim9_disassemble.vim"": {""insertions"": 18, ""deletions"": 0, ""lines"": 18}, ""src/testdir/test_vim9_expr.vim"": {""insertions"": 22, ""deletions"": 0, ""lines"": 22}, ""src/version.c"": {""insertions"": 2, ""deletions"": 0, ""lines"": 2}, ""src/vim9.h"": {""insertions"": 8, ""deletions"": 0, ""lines"": 8}, ""src/vim9compile.c"": {""insertions"": 15, ""deletions"": 3, ""lines"": 18}, ""src/vim9execute.c"": {""insertions"": 22, ""deletions"": 2, ""lines"": 24}}"
2020-07-09 17:16:35,ae97b94176062d30ea8c68bb83cde034c5150c78,Bram Moolenaar,7,4,11,3,"{""runtime/doc/eval.txt"": {""insertions"": 3, ""deletions"": 2, ""lines"": 5}, ""src/getchar.c"": {""insertions"": 2, ""deletions"": 2, ""lines"": 4}, ""src/version.c"": {""insertions"": 2, ""deletions"": 0, ""lines"": 2}}"
2020-07-09 16:49:23,e4358906fdbd0b2df1889dad49c79a9c8cee5ac4,Bram Moolenaar,57,2,59,2,"{""src/testdir/test_tcl.vim"": {""insertions"": 55, ""deletions"": 2, ""lines"": 57}, ""src/version.c"": {""insertions"": 2, ""deletions"": 0, ""lines"": 2}}"
2020-07-08 21:09:28,96916ac67ad9ed5d79ce87b099f9d01aa4c13745,Bram Moolenaar,15,0,15,4,"{""src/proto/screen.pro"": {""insertions"": 1, ""deletions"": 0, ""lines"": 1}, ""src/screen.c"": {""insertions"": 10, ""deletions"": 0, ""lines"": 10}, ""src/term.c"": {""insertions"": 2, ""deletions"": 0, ""lines"": 2}, ""src/version.c"": {""insertions"": 2, ""deletions"": 0, ""lines"": 2}}"
2020-07-08 20:36:17,6e13530ca03dd9cad245221177dd65f712211448,Bram Moolenaar,3,1,4,2,"{""src/globals.h"": {""insertions"": 1, ""deletions"": 1, ""lines"": 2}, ""src/version.c"": {""insertions"": 2, ""deletions"": 0, ""lines"": 2}}"
2020-07-08 20:24:09,efaaaa683b7b0cebc128be5c0c257b9d6578ac96,Bram Moolenaar,4,2,6,2,"{""src/userfunc.c"": {""insertions"": 2, ""deletions"": 2, ""lines"": 4}, ""src/version.c"": {""insertions"": 2, ""deletions"": 0, ""lines"": 2}}"
2020-07-08 20:01:49,8e2730a315b8b06192f5fc822dc218dbb3cff7ae,Bram Moolenaar,67,33,100,6,"{""src/eval.c"": {""insertions"": 41, ""deletions"": 19, ""lines"": 60}, ""src/proto/eval.pro"": {""insertions"": 1, ""deletions"": 1, ""lines"": 2}, ""src/structs.h"": {""insertions"": 4, ""deletions"": 1, ""lines"": 5}, ""src/userfunc.c"": {""insertions"": 17, ""deletions"": 12, ""lines"": 29}, ""src/version.c"": {""insertions"": 2, ""deletions"": 0, ""lines"": 2}, ""src/vim9compile.c"": {""insertions"": 2, ""deletions"": 0, ""lines"": 2}}"
2020-07-08 17:35:21,6110e79a5872dd6c5529f909d1bd670e3325927b,Bram Moolenaar,13,5,18,5,"{""src/proto/vim9compile.pro"": {""insertions"": 1, ""deletions"": 0, ""lines"": 1}, ""src/userfunc.c"": {""insertions"": 1, ""deletions"": 4, ""lines"": 5}, ""src/version.c"": {""insertions"": 2, ""deletions"": 0, ""lines"": 2}, ""src/vim9compile.c"": {""insertions"": 8, ""deletions"": 0, ""lines"": 8}, ""src/vim9script.c"": {""insertions"": 1, ""deletions"": 1, ""lines"": 2}}"
2020-07-08 16:38:08,6b7a0a8c201bbace7e69fe0709f72b95092193df,Bram Moolenaar,11,1,12,4,"{""src/testdir/test_vim9_expr.vim"": {""insertions"": 1, ""deletions"": 0, ""lines"": 1}, ""src/testdir/test_vim9_script.vim"": {""insertions"": 1, ""deletions"": 1, ""lines"": 2}, ""src/version.c"": {""insertions"": 2, ""deletions"": 0, ""lines"": 2}, ""src/vim9compile.c"": {""insertions"": 7, ""deletions"": 0, ""lines"": 7}}"
2020-07-08 16:34:57,b335b29e1c3428fd475026412297d5aa63b623e6,Bram Moolenaar,3,1,4,2,"{""src/globals.h"": {""insertions"": 1, ""deletions"": 1, ""lines"": 2}, ""src/version.c"": {""insertions"": 2, ""deletions"": 0, ""lines"": 2}}"
2020-07-08 16:30:06,0a47e0970a0e5d99aa7089169e0bcca0401decce,Bram Moolenaar,22,1,23,3,"{""src/ex_docmd.c"": {""insertions"": 3, ""deletions"": 1, ""lines"": 4}, ""src/testdir/test_vim9_cmd.vim"": {""insertions"": 17, ""deletions"": 0, ""lines"": 17}, ""src/version.c"": {""insertions"": 2, ""deletions"": 0, ""lines"": 2}}"
2020-07-08 15:47:57,002262f4dee452964190b0d022aa7443f602b288,Bram Moolenaar,7,1,8,3,"{""src/testdir/test_vim9_expr.vim"": {""insertions"": 1, ""deletions"": 1, ""lines"": 2}, ""src/version.c"": {""insertions"": 2, ""deletions"": 0, ""lines"": 2}, ""src/vim9compile.c"": {""insertions"": 4, ""deletions"": 0, ""lines"": 4}}"
2020-07-08 15:36:21,7a4b8980ea5ecaea061caae7816ea62cc4940011,Bram Moolenaar,115,63,178,6,"{""src/eval.c"": {""insertions"": 74, ""deletions"": 48, ""lines"": 122}, ""src/proto/vim9compile.pro"": {""insertions"": 2, ""deletions"": 0, ""lines"": 2}, ""src/structs.h"": {""insertions"": 3, ""deletions"": 0, ""lines"": 3}, ""src/testdir/test_vim9_func.vim"": {""insertions"": 12, ""deletions"": 0, ""lines"": 12}, ""src/version.c"": {""insertions"": 2, ""deletions"": 0, ""lines"": 2}, ""src/vim9compile.c"": {""insertions"": 22, ""deletions"": 15, ""lines"": 37}}"
2020-07-08 13:16:19,c620c055ce8505596a7208ba696a32b8a3be4f4b,Bram Moolenaar,84,20,104,7,"{""src/evalvars.c"": {""insertions"": 25, ""deletions"": 9, ""lines"": 34}, ""src/proto/scriptfile.pro"": {""insertions"": 2, ""deletions"": 2, ""lines"": 4}, ""src/scriptfile.c"": {""insertions"": 8, ""deletions"": 5, ""lines"": 13}, ""src/structs.h"": {""insertions"": 3, ""deletions"": 0, ""lines"": 3}, ""src/testdir/test_vim9_script.vim"": {""insertions"": 31, ""deletions"": 2, ""lines"": 33}, ""src/version.c"": {""insertions"": 2, ""deletions"": 0, ""lines"": 2}, ""src/vim9execute.c"": {""insertions"": 13, ""deletions"": 2, ""lines"": 15}}"
2020-07-07 21:31:36,bed36b939a4c66f41d1f24e32cfa521b10f22b82,Bram Moolenaar,3,1,4,2,"{""src/testdir/test_vim9_script.vim"": {""insertions"": 1, ""deletions"": 1, ""lines"": 2}, ""src/version.c"": {""insertions"": 2, ""deletions"": 0, ""lines"": 2}}"
2020-07-07 20:50:12,fe465a01cfbbbae5d870d6108e0ad0947f03b0c4,Bram Moolenaar,37,1,38,3,"{""src/testdir/test_vim9_script.vim"": {""insertions"": 33, ""deletions"": 0, ""lines"": 33}, ""src/version.c"": {""insertions"": 2, ""deletions"": 0, ""lines"": 2}, ""src/vim9compile.c"": {""insertions"": 2, ""deletions"": 1, ""lines"": 3}}"
2020-07-07 18:50:39,0ab55d62012c1fb38c4b540a4233421820a59389,Bram Moolenaar,52,0,52,3,"{""src/testdir/test_python2.vim"": {""insertions"": 25, ""deletions"": 0, ""lines"": 25}, ""src/testdir/test_python3.vim"": {""insertions"": 25, ""deletions"": 0, ""lines"": 25}, ""src/version.c"": {""insertions"": 2, ""deletions"": 0, ""lines"": 2}}"
2020-07-07 18:12:54,bb790dcc46b74e6f9a1c4126be8a575f9fe73444,Bram Moolenaar,24,17,41,4,"{""src/if_py_both.h"": {""insertions"": 10, ""deletions"": 5, ""lines"": 15}, ""src/testdir/test_python2.vim"": {""insertions"": 6, ""deletions"": 6, ""lines"": 12}, ""src/testdir/test_python3.vim"": {""insertions"": 6, ""deletions"": 6, ""lines"": 12}, ""src/version.c"": {""insertions"": 2, ""deletions"": 0, ""lines"": 2}}"
2020-07-06 21:04:49,007f9d6ed597bd212acb95be9d0767c97d2a1438,Bram Moolenaar,31,14,45,3,"{""src/testdir/test_vim9_cmd.vim"": {""insertions"": 15, ""deletions"": 0, ""lines"": 15}, ""src/version.c"": {""insertions"": 2, ""deletions"": 0, ""lines"": 2}, ""src/vim9compile.c"": {""insertions"": 14, ""deletions"": 14, ""lines"": 28}}"
2020-07-06 19:53:17,cbb6bdcd8967edc8ad123746d27ec30ccc7c1718,Bram Moolenaar,5,3,8,4,"{""src/proto/vim9compile.pro"": {""insertions"": 1, ""deletions"": 1, ""lines"": 2}, ""src/version.c"": {""insertions"": 2, ""deletions"": 0, ""lines"": 2}, ""src/vim9compile.c"": {""insertions"": 1, ""deletions"": 1, ""lines"": 2}, ""src/vim9script.c"": {""insertions"": 1, ""deletions"": 1, ""lines"": 2}}"
2020-07-06 19:24:57,27321dbeedf8bb833c48b01bf18536125794f65e,Bram Moolenaar,93,35,128,3,"{""src/message.c"": {""insertions"": 6, ""deletions"": 0, ""lines"": 6}, ""src/testdir/test_excmd.vim"": {""insertions"": 85, ""deletions"": 35, ""lines"": 120}, ""src/version.c"": {""insertions"": 2, ""deletions"": 0, ""lines"": 2}}"
2020-07-06 19:03:06,ab5894638413748fcedfe28691e6c27893924520,Bram Moolenaar,634,134,768,6,"{""src/if_py_both.h"": {""insertions"": 16, ""deletions"": 1, ""lines"": 17}, ""src/if_python3.c"": {""insertions"": 4, ""deletions"": 0, ""lines"": 4}, ""src/testdir/shared.vim"": {""insertions"": 15, ""deletions"": 0, ""lines"": 15}, ""src/testdir/test_python2.vim"": {""insertions"": 288, ""deletions"": 83, ""lines"": 371}, ""src/testdir/test_python3.vim"": {""insertions"": 309, ""deletions"": 50, ""lines"": 359}, ""src/version.c"": {""insertions"": 2, ""deletions"": 0, ""lines"": 2}}"
2020-07-05 19:38:11,0ad3e894d75236915e67dfbbcc821b6bb3c05d91,Bram Moolenaar,50,5,55,4,"{""src/testdir/test_vim9_disassemble.vim"": {""insertions"": 37, ""deletions"": 0, ""lines"": 37}, ""src/testdir/test_vim9_script.vim"": {""insertions"": 7, ""deletions"": 1, ""lines"": 8}, ""src/version.c"": {""insertions"": 2, ""deletions"": 0, ""lines"": 2}, ""src/vim9compile.c"": {""insertions"": 4, ""deletions"": 4, ""lines"": 8}}"
2020-07-05 19:10:24,67627355accff4af4f2a7e727c77ea8df675636e,Bram Moolenaar,12,1,13,3,"{""src/evalfunc.c"": {""insertions"": 1, ""deletions"": 1, ""lines"": 2}, ""src/testdir/test_vim9_func.vim"": {""insertions"": 9, ""deletions"": 0, ""lines"": 9}, ""src/version.c"": {""insertions"": 2, ""deletions"": 0, ""lines"": 2}}"
2020-07-05 18:55:29,ad7c24932725b9ab37b65fe359a41f8ba3e3dfcf,Bram Moolenaar,23,1,24,3,"{""src/evalfunc.c"": {""insertions"": 12, ""deletions"": 1, ""lines"": 13}, ""src/testdir/test_vim9_func.vim"": {""insertions"": 9, ""deletions"": 0, ""lines"": 9}, ""src/version.c"": {""insertions"": 2, ""deletions"": 0, ""lines"": 2}}"
2020-07-05 18:47:18,252e88a78535d239ec4b764d8e3f04aad5a94a76,Bram Moolenaar,12,1,13,3,"{""src/evalfunc.c"": {""insertions"": 1, ""deletions"": 1, ""lines"": 2}, ""src/testdir/test_vim9_func.vim"": {""insertions"": 9, ""deletions"": 0, ""lines"": 9}, ""src/version.c"": {""insertions"": 2, ""deletions"": 0, ""lines"": 2}}"
2020-07-05 18:16:41,0d94ad69586972e7522ec6ca1441a517af2ade7a,Bram Moolenaar,12,1,13,3,"{""src/evalfunc.c"": {""insertions"": 1, ""deletions"": 1, ""lines"": 2}, ""src/testdir/test_vim9_func.vim"": {""insertions"": 9, ""deletions"": 0, ""lines"": 9}, ""src/version.c"": {""insertions"": 2, ""deletions"": 0, ""lines"": 2}}"
2020-07-05 18:08:39,b3c019cbc32e2e9250ac668bf77d61ebd89c13f2,Bram Moolenaar,12,1,13,3,"{""src/evalfunc.c"": {""insertions"": 1, ""deletions"": 1, ""lines"": 2}, ""src/testdir/test_vim9_func.vim"": {""insertions"": 9, ""deletions"": 0, ""lines"": 9}, ""src/version.c"": {""insertions"": 2, ""deletions"": 0, ""lines"": 2}}"
2020-07-05 16:48:23,8f510afcd616fc62291fb41f9dd03ce298f1c601,Bram Moolenaar,6,4,10,2,"{""src/testdir/test_vim9_func.vim"": {""insertions"": 4, ""deletions"": 4, ""lines"": 8}, ""src/version.c"": {""insertions"": 2, ""deletions"": 0, ""lines"": 2}}"
2020-07-05 16:41:08,a66ba01a5fbbd72375ef6982b901d6552da2414f,Bram Moolenaar,20,2,22,3,"{""src/evalfunc.c"": {""insertions"": 2, ""deletions"": 2, ""lines"": 4}, ""src/testdir/test_vim9_func.vim"": {""insertions"": 16, ""deletions"": 0, ""lines"": 16}, ""src/version.c"": {""insertions"": 2, ""deletions"": 0, ""lines"": 2}}"
2020-07-05 16:18:42,47e7d70b58e8bfc1daaf6d35569ef2dbd0339ddc,Bram Moolenaar,61,27,88,6,"{""src/ex_docmd.c"": {""insertions"": 26, ""deletions"": 27, ""lines"": 53}, ""src/proto/ex_docmd.pro"": {""insertions"": 1, ""deletions"": 0, ""lines"": 1}, ""src/testdir/dumps/Test_vim9_silent_echo.dump"": {""insertions"": 6, ""deletions"": 0, ""lines"": 6}, ""src/testdir/test_vim9_func.vim"": {""insertions"": 23, ""deletions"": 0, ""lines"": 23}, ""src/version.c"": {""insertions"": 2, ""deletions"": 0, ""lines"": 2}, ""src/vim9compile.c"": {""insertions"": 3, ""deletions"": 0, ""lines"": 3}}"
2020-07-05 15:04:13,846178a72ca0860073d47fc0dc95f98d15f1d921,Bram Moolenaar,23,1,24,3,"{""src/evalfunc.c"": {""insertions"": 12, ""deletions"": 1, ""lines"": 13}, ""src/testdir/test_vim9_func.vim"": {""insertions"": 9, ""deletions"": 0, ""lines"": 9}, ""src/version.c"": {""insertions"": 2, ""deletions"": 0, ""lines"": 2}}"
2020-07-05 14:51:26,50788ef34947aeb1729604cd3876845afbd15e3c,Bram Moolenaar,13,3,16,3,"{""src/testdir/test_vim9_expr.vim"": {""insertions"": 3, ""deletions"": 0, ""lines"": 3}, ""src/version.c"": {""insertions"": 2, ""deletions"": 0, ""lines"": 2}, ""src/vim9execute.c"": {""insertions"": 8, ""deletions"": 3, ""lines"": 11}}"
2020-07-05 14:42:13,435d89789ef4dd329938edbe17c646db9f0ea772,Bram Moolenaar,14,2,16,3,"{""src/testdir/test_vim9_expr.vim"": {""insertions"": 5, ""deletions"": 0, ""lines"": 5}, ""src/version.c"": {""insertions"": 2, ""deletions"": 0, ""lines"": 2}, ""src/vim9execute.c"": {""insertions"": 7, ""deletions"": 2, ""lines"": 9}}"
2020-07-05 14:07:21,fce82b3aa7dd87f9e15a4c12eda2c65de285d99a,Bram Moolenaar,9,1,10,3,"{""src/evalfunc.c"": {""insertions"": 1, ""deletions"": 1, ""lines"": 2}, ""src/testdir/test_vim9_func.vim"": {""insertions"": 6, ""deletions"": 0, ""lines"": 6}, ""src/version.c"": {""insertions"": 2, ""deletions"": 0, ""lines"": 2}}"
2020-07-05 14:01:56,9978d473e32cee928d6f901a5eb9a297a2970132,Bram Moolenaar,12,2,14,3,"{""src/evalfunc.c"": {""insertions"": 2, ""deletions"": 2, ""lines"": 4}, ""src/testdir/test_vim9_func.vim"": {""insertions"": 8, ""deletions"": 0, ""lines"": 8}, ""src/version.c"": {""insertions"": 2, ""deletions"": 0, ""lines"": 2}}"
2020-07-05 13:52:19,05a5551a86e013e35d1dfa10fd0d811c587f9c88,Bram Moolenaar,16,4,20,3,"{""src/testdir/test_vim9_func.vim"": {""insertions"": 3, ""deletions"": 3, ""lines"": 6}, ""src/version.c"": {""insertions"": 2, ""deletions"": 0, ""lines"": 2}, ""src/vim9compile.c"": {""insertions"": 11, ""deletions"": 1, ""lines"": 12}}"
2020-07-05 13:32:17,788123c00c4b7acc4e6ba3e9f1cc8b175ae9aae8,Bram Moolenaar,11,1,12,3,"{""src/testdir/test_vim9_cmd.vim"": {""insertions"": 7, ""deletions"": 0, ""lines"": 7}, ""src/version.c"": {""insertions"": 2, ""deletions"": 0, ""lines"": 2}, ""src/vim9compile.c"": {""insertions"": 2, ""deletions"": 1, ""lines"": 3}}"
2020-07-05 12:57:51,e9f262bdff2defa248e5d40b6520251799581ea4,Bram Moolenaar,66,2,68,3,"{""src/testdir/test_vim9_cmd.vim"": {""insertions"": 34, ""deletions"": 0, ""lines"": 34}, ""src/version.c"": {""insertions"": 2, ""deletions"": 0, ""lines"": 2}, ""src/vim9compile.c"": {""insertions"": 30, ""deletions"": 2, ""lines"": 32}}"
2020-07-05 12:10:13,3f40ce78f5c178d15871bd784ed878c78f0b8a44,Bram Moolenaar,13,11,24,9,"{""runtime/doc/options.txt"": {""insertions"": 1, ""deletions"": 1, ""lines"": 2}, ""src/fileio.c"": {""insertions"": 2, ""deletions"": 2, ""lines"": 4}, ""src/testdir/dumps/Test_diff_syntax_1.dump"": {""insertions"": 1, ""deletions"": 1, ""lines"": 2}, ""src/testdir/dumps/Test_display_unprintable_01.dump"": {""insertions"": 1, ""deletions"": 1, ""lines"": 2}, ""src/testdir/dumps/Test_long_file_name_1.dump"": {""insertions"": 1, ""deletions"": 1, ""lines"": 2}, ""src/testdir/dumps/Test_tselect_1.dump"": {""insertions"": 1, ""deletions"": 1, ""lines"": 2}, ""src/testdir/test_cscope.vim"": {""insertions"": 2, ""deletions"": 2, ""lines"": 4}, ""src/testdir/test_netbeans.vim"": {""insertions"": 2, ""deletions"": 2, ""lines"": 4}, ""src/version.c"": {""insertions"": 2, ""deletions"": 0, ""lines"": 2}}"
2020-07-04 17:19:43,fb9d5c51c8b5b44863f974e1adbee9ae330e75ff,Bram Moolenaar,10,1,11,3,"{""src/testdir/test_vim9_expr.vim"": {""insertions"": 3, ""deletions"": 0, ""lines"": 3}, ""src/version.c"": {""insertions"": 2, ""deletions"": 0, ""lines"": 2}, ""src/vim9execute.c"": {""insertions"": 5, ""deletions"": 1, ""lines"": 6}}"
2020-07-04 15:39:10,eeb27bfe28ad6f889c52628268acbe30a7584e30,Bram Moolenaar,9,1,10,3,"{""src/evalvars.c"": {""insertions"": 1, ""deletions"": 1, ""lines"": 2}, ""src/testdir/test_vim9_script.vim"": {""insertions"": 6, ""deletions"": 0, ""lines"": 6}, ""src/version.c"": {""insertions"": 2, ""deletions"": 0, ""lines"": 2}}"
2020-07-04 12:15:00,962d7213194647e90f9bdc608f693d39dd07cbd5,Bram Moolenaar,15,26,41,6,"{""src/dict.c"": {""insertions"": 4, ""deletions"": 4, ""lines"": 8}, ""src/eval.c"": {""insertions"": 6, ""deletions"": 18, ""lines"": 24}, ""src/list.c"": {""insertions"": 2, ""deletions"": 2, ""lines"": 4}, ""src/proto/eval.pro"": {""insertions"": 0, ""deletions"": 1, ""lines"": 1}, ""src/version.c"": {""insertions"": 2, ""deletions"": 0, ""lines"": 2}, ""src/vim9script.c"": {""insertions"": 1, ""deletions"": 1, ""lines"": 2}}"
2020-07-04 11:15:31,1c991144c502ade477e1a32fdfd0f78b6299fdc7,Bram Moolenaar,179,91,270,5,"{""src/proto/vim9script.pro"": {""insertions"": 2, ""deletions"": 2, ""lines"": 4}, ""src/testdir/test_vim9_script.vim"": {""insertions"": 44, ""deletions"": 0, ""lines"": 44}, ""src/version.c"": {""insertions"": 2, ""deletions"": 0, ""lines"": 2}, ""src/vim9compile.c"": {""insertions"": 15, ""deletions"": 3, ""lines"": 18}, ""src/vim9script.c"": {""insertions"": 116, ""deletions"": 86, ""lines"": 202}}"
2020-07-03 19:17:34,effb0cd75de647a2a0bf95cb26eaa2feee8068d9,Bram Moolenaar,3358,3231,6589,8,"{""src/Makefile"": {""insertions"": 0, ""deletions"": 1, ""lines"": 1}, ""src/testdir/Make_all.mak"": {""insertions"": 1, ""deletions"": 6, ""lines"": 7}, ""src/testdir/Make_vms.mms"": {""insertions"": 2, ""deletions"": 6, ""lines"": 8}, ""src/testdir/test87.in"": {""insertions"": 0, ""deletions"": 1725, ""lines"": 1725}, ""src/testdir/test87.ok"": {""insertions"": 0, ""deletions"": 1445, ""lines"": 1445}, ""src/testdir/test_python2.vim"": {""insertions"": 45, ""deletions"": 45, ""lines"": 90}, ""src/testdir/test_python3.vim"": {""insertions"": 3308, ""deletions"": 3, ""lines"": 3311}, ""src/version.c"": {""insertions"": 2, ""deletions"": 0, ""lines"": 2}}"
2020-07-03 19:09:52,442af2f89e29fb60790bffde2def9cd74a081780,Bram Moolenaar,59,3,62,3,"{""src/eval.c"": {""insertions"": 20, ""deletions"": 3, ""lines"": 23}, ""src/testdir/test_vim9_expr.vim"": {""insertions"": 37, ""deletions"": 0, ""lines"": 37}, ""src/version.c"": {""insertions"": 2, ""deletions"": 0, ""lines"": 2}}"
2020-07-03 16:15:06,743d0620203388bf87dc611cea544b485e4b9f85,Bram Moolenaar,15,9,24,3,"{""src/cmdexpand.c"": {""insertions"": 9, ""deletions"": 8, ""lines"": 17}, ""src/testdir/test_cmdline.vim"": {""insertions"": 4, ""deletions"": 1, ""lines"": 5}, ""src/version.c"": {""insertions"": 2, ""deletions"": 0, ""lines"": 2}}"
2020-07-03 16:00:05,92fdd1e75db3048516a93a18cc53ed984813c9e5,Bram Moolenaar,3368,3167,6535,7,"{""src/Makefile"": {""insertions"": 1, ""deletions"": 1, ""lines"": 2}, ""src/testdir/Make_all.mak"": {""insertions"": 0, ""deletions"": 1, ""lines"": 1}, ""src/testdir/Make_vms.mms"": {""insertions"": 1, ""deletions"": 1, ""lines"": 2}, ""src/testdir/test86.in"": {""insertions"": 0, ""deletions"": 1711, ""lines"": 1711}, ""src/testdir/test86.ok"": {""insertions"": 0, ""deletions"": 1445, ""lines"": 1445}, ""src/testdir/test_python2.vim"": {""insertions"": 3364, ""deletions"": 8, ""lines"": 3372}, ""src/version.c"": {""insertions"": 2, ""deletions"": 0, ""lines"": 2}}"
2020-07-02 20:50:37,5289783e0b07cfc3f92ee933261ca4c4acdca007,Bram Moolenaar,6,4,10,3,"{""src/auto/configure"": {""insertions"": 2, ""deletions"": 2, ""lines"": 4}, ""src/configure.ac"": {""insertions"": 2, ""deletions"": 2, ""lines"": 4}, ""src/version.c"": {""insertions"": 2, ""deletions"": 0, ""lines"": 2}}"
2020-07-02 19:23:42,810af5ea460eab820cc5899892067d8c242be688,Bram Moolenaar,2,2,4,2,"{""src/move.c"": {""insertions"": 0, ""deletions"": 2, ""lines"": 2}, ""src/version.c"": {""insertions"": 2, ""deletions"": 0, ""lines"": 2}}"
2020-07-02 19:17:57,a9a8e5f0dc22aaa9e53578b5b2d7569279e6cb94,Bram Moolenaar,4,0,4,2,"{""src/if_lua.c"": {""insertions"": 2, ""deletions"": 0, ""lines"": 2}, ""src/version.c"": {""insertions"": 2, ""deletions"": 0, ""lines"": 2}}"
2020-07-02 19:11:34,d2ef6b320bf2e2f3fcc0bb858b16898e6f74b4d9,Bram Moolenaar,19,12,31,3,"{""src/ex_docmd.c"": {""insertions"": 16, ""deletions"": 11, ""lines"": 27}, ""src/testdir/test_vim9_cmd.vim"": {""insertions"": 1, ""deletions"": 1, ""lines"": 2}, ""src/version.c"": {""insertions"": 2, ""deletions"": 0, ""lines"": 2}}"
2020-07-02 18:59:05,c19fd917be656b127c5619080f866a23ce1fe755,Bram Moolenaar,4,2,6,2,"{""src/testdir/test_iminsert.vim"": {""insertions"": 2, ""deletions"": 2, ""lines"": 4}, ""src/version.c"": {""insertions"": 2, ""deletions"": 0, ""lines"": 2}}"
2020-07-01 19:53:50,1112c0febb509d0cb219f3a2479fd36833507167,Bram Moolenaar,1581,1563,3144,6,"{""src/testdir/Make_all.mak"": {""insertions"": 2, ""deletions"": 0, ""lines"": 2}, ""src/testdir/Makefile"": {""insertions"": 0, ""deletions"": 8, ""lines"": 8}, ""src/testdir/term_util.vim"": {""insertions"": 24, ""deletions"": 0, ""lines"": 24}, ""src/testdir/test_terminal.vim"": {""insertions"": 3, ""deletions"": 1555, ""lines"": 1558}, ""src/testdir/test_terminal2.vim"": {""insertions"": 1550, ""deletions"": 0, ""lines"": 1550}, ""src/version.c"": {""insertions"": 2, ""deletions"": 0, ""lines"": 2}}"
2020-07-01 18:19:37,a0d072ef8203b225bd46bcd826cb3d2e3c3b941a,Bram Moolenaar,13,0,13,2,"{""src/testdir/test_user_func.vim"": {""insertions"": 11, ""deletions"": 0, ""lines"": 11}, ""src/version.c"": {""insertions"": 2, ""deletions"": 0, ""lines"": 2}}"
2020-07-01 18:07:14,5f195938d4d489aa288bdb54ee6112a34aed1df9,Bram Moolenaar,50,21,71,5,"{""src/ex_docmd.c"": {""insertions"": 15, ""deletions"": 5, ""lines"": 20}, ""src/testdir/test_vim9_cmd.vim"": {""insertions"": 17, ""deletions"": 0, ""lines"": 17}, ""src/testdir/test_vim9_expr.vim"": {""insertions"": 2, ""deletions"": 2, ""lines"": 4}, ""src/testdir/test_vim9_script.vim"": {""insertions"": 14, ""deletions"": 14, ""lines"": 28}, ""src/version.c"": {""insertions"": 2, ""deletions"": 0, ""lines"": 2}}"
2020-07-01 16:29:55,9a78e6df17033223ebdf499f2b02b2538601c52d,Bram Moolenaar,55,50,105,12,"{""src/eval.c"": {""insertions"": 12, ""deletions"": 9, ""lines"": 21}, ""src/evalfunc.c"": {""insertions"": 1, ""deletions"": 1, ""lines"": 2}, ""src/evalvars.c"": {""insertions"": 5, ""deletions"": 5, ""lines"": 10}, ""src/list.c"": {""insertions"": 1, ""deletions"": 1, ""lines"": 2}, ""src/proto/evalvars.pro"": {""insertions"": 1, ""deletions"": 1, ""lines"": 2}, ""src/proto/list.pro"": {""insertions"": 1, ""deletions"": 1, ""lines"": 2}, ""src/proto/typval.pro"": {""insertions"": 13, ""deletions"": 13, ""lines"": 26}, ""src/typval.c"": {""insertions"": 6, ""deletions"": 6, ""lines"": 12}, ""src/version.c"": {""insertions"": 2, ""deletions"": 0, ""lines"": 2}, ""src/vim9compile.c"": {""insertions"": 9, ""deletions"": 9, ""lines"": 18}, ""src/vim9execute.c"": {""insertions"": 2, ""deletions"": 2, ""lines"": 4}, ""src/vim9script.c"": {""insertions"": 2, ""deletions"": 2, ""lines"": 4}}"
2020-07-01 15:28:33,e6b5324e3a3d354363f3c48e784c42ce3e77453f,Bram Moolenaar,80,32,112,10,"{""src/dict.c"": {""insertions"": 3, ""deletions"": 3, ""lines"": 6}, ""src/eval.c"": {""insertions"": 31, ""deletions"": 9, ""lines"": 40}, ""src/ex_eval.c"": {""insertions"": 1, ""deletions"": 7, ""lines"": 8}, ""src/list.c"": {""insertions"": 5, ""deletions"": 4, ""lines"": 9}, ""src/proto/eval.pro"": {""insertions"": 2, ""deletions"": 0, ""lines"": 2}, ""src/proto/userfunc.pro"": {""insertions"": 1, ""deletions"": 1, ""lines"": 2}, ""src/testdir/test_vim9_expr.vim"": {""insertions"": 7, ""deletions"": 0, ""lines"": 7}, ""src/testdir/test_vim9_func.vim"": {""insertions"": 16, ""deletions"": 0, ""lines"": 16}, ""src/userfunc.c"": {""insertions"": 12, ""deletions"": 8, ""lines"": 20}, ""src/version.c"": {""insertions"": 2, ""deletions"": 0, ""lines"": 2}}"
2020-07-01 14:00:44,086eb18ba16164ca5258068cff9c4b2db742f2ef,Bram Moolenaar,3,1,4,2,"{""src/version.c"": {""insertions"": 2, ""deletions"": 0, ""lines"": 2}, ""src/vim9compile.c"": {""insertions"": 1, ""deletions"": 1, ""lines"": 2}}"
2020-07-01 13:49:29,d58d4f90aeb381045000ea46493b5bd9b9d1fa23,Bram Moolenaar,89,22,111,6,"{""src/libvterm/src/mouse.c"": {""insertions"": 2, ""deletions"": 2, ""lines"": 4}, ""src/mouse.c"": {""insertions"": 41, ""deletions"": 16, ""lines"": 57}, ""src/terminal.c"": {""insertions"": 4, ""deletions"": 2, ""lines"": 6}, ""src/testdir/mouse.vim"": {""insertions"": 16, ""deletions"": 0, ""lines"": 16}, ""src/testdir/test_termcodes.vim"": {""insertions"": 24, ""deletions"": 2, ""lines"": 26}, ""src/version.c"": {""insertions"": 2, ""deletions"": 0, ""lines"": 2}}"
2020-07-01 13:12:44,ef8c617b9c4dc262ed34598d7e382237696c3d61,Bram Moolenaar,7,8,15,4,"{""runtime/doc/options.txt"": {""insertions"": 2, ""deletions"": 2, ""lines"": 4}, ""src/gui_xim.c"": {""insertions"": 1, ""deletions"": 1, ""lines"": 2}, ""src/testdir/test_iminsert.vim"": {""insertions"": 2, ""deletions"": 5, ""lines"": 7}, ""src/version.c"": {""insertions"": 2, ""deletions"": 0, ""lines"": 2}}"
2020-07-01 12:38:12,8e6cbb72324b6fb25d1a9abd6cc4d102d0e5f14e,Bram Moolenaar,21,1,22,3,"{""src/testdir/test_vimscript.vim"": {""insertions"": 16, ""deletions"": 1, ""lines"": 17}, ""src/version.c"": {""insertions"": 2, ""deletions"": 0, ""lines"": 2}, ""src/vim9compile.c"": {""insertions"": 3, ""deletions"": 0, ""lines"": 3}}"
2020-07-01 11:52:55,e49b8e8d7589e85e75aedefab7ce97da47adbf74,Bram Moolenaar,171,18,189,3,"{""src/if_lua.c"": {""insertions"": 16, ""deletions"": 13, ""lines"": 29}, ""src/testdir/test_lua.vim"": {""insertions"": 153, ""deletions"": 5, ""lines"": 158}, ""src/version.c"": {""insertions"": 2, ""deletions"": 0, ""lines"": 2}}"
2020-07-01 11:15:24,11b6600c88165c70d9ccbbdd4d9c96e8266e365f,Bram Moolenaar,4,1,5,2,"{""src/spellsuggest.c"": {""insertions"": 2, ""deletions"": 1, ""lines"": 3}, ""src/version.c"": {""insertions"": 2, ""deletions"": 0, ""lines"": 2}}"
2020-07-01 11:07:37,e707c882b23a53d2c1f0d1f7fc3a7be247aca614,Bram Moolenaar,3,1,4,2,"{""src/eval.c"": {""insertions"": 1, ""deletions"": 1, ""lines"": 2}, ""src/version.c"": {""insertions"": 2, ""deletions"": 0, ""lines"": 2}}"
2020-07-01 11:04:05,90049492215aa458b90215b8e0fc50f04d5ad270,Bram Moolenaar,10,6,16,2,"{""src/quickfix.c"": {""insertions"": 8, ""deletions"": 6, ""lines"": 14}, ""src/version.c"": {""insertions"": 2, ""deletions"": 0, ""lines"": 2}}"
2020-06-30 20:11:44,be7a50c22f63478a6e64fe6b932a847830191b95,Bram Moolenaar,13,0,13,3,"{""src/quickfix.c"": {""insertions"": 8, ""deletions"": 0, ""lines"": 8}, ""src/testdir/test_quickfix.vim"": {""insertions"": 3, ""deletions"": 0, ""lines"": 3}, ""src/version.c"": {""insertions"": 2, ""deletions"": 0, ""lines"": 2}}"
2020-06-30 20:02:02,47e880d6c13c3ec2888398fd9ba1f5a7180d791a,Bram Moolenaar,50,4,54,3,"{""src/eval.c"": {""insertions"": 8, ""deletions"": 4, ""lines"": 12}, ""src/testdir/test_vim9_script.vim"": {""insertions"": 40, ""deletions"": 0, ""lines"": 40}, ""src/version.c"": {""insertions"": 2, ""deletions"": 0, ""lines"": 2}}"
2020-06-30 19:18:36,37c837119579ff70b005a4e54c2e26ca42b74022,Bram Moolenaar,36,23,59,3,"{""src/eval.c"": {""insertions"": 20, ""deletions"": 23, ""lines"": 43}, ""src/testdir/test_vim9_script.vim"": {""insertions"": 14, ""deletions"": 0, ""lines"": 14}, ""src/version.c"": {""insertions"": 2, ""deletions"": 0, ""lines"": 2}}"
2020-06-30 18:55:15,006ad48b8a15c3bace741d8caaf3195e592fbe78,Bram Moolenaar,26,2,28,3,"{""src/eval.c"": {""insertions"": 10, ""deletions"": 2, ""lines"": 12}, ""src/testdir/test_vim9_script.vim"": {""insertions"": 14, ""deletions"": 0, ""lines"": 14}, ""src/version.c"": {""insertions"": 2, ""deletions"": 0, ""lines"": 2}}"
2020-06-30 18:38:27,e46a4405056276b4cbdacee76b11f85c8ea1830b,Bram Moolenaar,650,839,1489,7,"{""runtime/doc/eval.txt"": {""insertions"": 57, ""deletions"": 41, ""lines"": 98}, ""runtime/doc/if_lua.txt"": {""insertions"": 1, ""deletions"": 1, ""lines"": 2}, ""runtime/doc/tags"": {""insertions"": 2, ""deletions"": 0, ""lines"": 2}, ""runtime/doc/todo.txt"": {""insertions"": 46, ""deletions"": 78, ""lines"": 124}, ""runtime/doc/vim9.txt"": {""insertions"": 44, ""deletions"": 1, ""lines"": 45}, ""runtime/filetype.vim"": {""insertions"": 1, ""deletions"": 1, ""lines"": 2}, ""runtime/syntax/neomuttrc.vim"": {""insertions"": 499, ""deletions"": 717, ""lines"": 1216}}"
2020-06-30 16:45:43,de8f0f47f653ff10bd8cc12b3e0817ed5bdf64ea,Bram Moolenaar,50,0,50,3,"{""src/testdir/test_filter_cmd.vim"": {""insertions"": 5, ""deletions"": 0, ""lines"": 5}, ""src/testdir/test_highlight.vim"": {""insertions"": 43, ""deletions"": 0, ""lines"": 43}, ""src/version.c"": {""insertions"": 2, ""deletions"": 0, ""lines"": 2}}"
2020-06-30 11:38:01,f151ad1c70825a91afb112e611db5c712e2656ef,Bram Moolenaar,44,2,46,3,"{""src/evalfunc.c"": {""insertions"": 26, ""deletions"": 2, ""lines"": 28}, ""src/testdir/test_vim9_func.vim"": {""insertions"": 16, ""deletions"": 0, ""lines"": 16}, ""src/version.c"": {""insertions"": 2, ""deletions"": 0, ""lines"": 2}}"
2020-06-29 21:18:42,6b949615edac2dd33d5e865be8328561f296b045,Bram Moolenaar,6,3,9,2,"{""src/spellsuggest.c"": {""insertions"": 4, ""deletions"": 3, ""lines"": 7}, ""src/version.c"": {""insertions"": 2, ""deletions"": 0, ""lines"": 2}}"
2020-06-29 21:14:02,a53618dd1dd91c7bb67b5dfc83dc29371b47f55b,Bram Moolenaar,3,2,5,2,"{""src/libvterm/src/pen.c"": {""insertions"": 1, ""deletions"": 2, ""lines"": 3}, ""src/version.c"": {""insertions"": 2, ""deletions"": 0, ""lines"": 2}}"
2020-06-29 21:07:44,de19b745eee06a8a204988ae9989d97143caece9,Bram Moolenaar,2,1,3,2,"{""src/if_py_both.h"": {""insertions"": 0, ""deletions"": 1, ""lines"": 1}, ""src/version.c"": {""insertions"": 2, ""deletions"": 0, ""lines"": 2}}"
2020-06-29 21:02:21,cf070112ca2a6ac9ec5466be1cdc667f6abe8fd0,Bram Moolenaar,5,2,7,2,"{""src/textprop.c"": {""insertions"": 3, ""deletions"": 2, ""lines"": 5}, ""src/version.c"": {""insertions"": 2, ""deletions"": 0, ""lines"": 2}}"
2020-06-29 20:40:42,d034220c54c63daaa2841e97b653842a47f5e90e,Bram Moolenaar,4,0,4,2,"{""src/os_unix.c"": {""insertions"": 2, ""deletions"": 0, ""lines"": 2}, ""src/version.c"": {""insertions"": 2, ""deletions"": 0, ""lines"": 2}}"
2020-06-29 20:31:36,9b5384b97e832958573ffdcd3c1e230635b434e4,Bram Moolenaar,5,1,6,2,"{""src/eval.c"": {""insertions"": 3, ""deletions"": 1, ""lines"": 4}, ""src/version.c"": {""insertions"": 2, ""deletions"": 0, ""lines"": 2}}"
2020-06-29 20:24:56,927b7dd0fe9a0a82b39d600779edb4390ecdeda6,Bram Moolenaar,4,3,7,2,"{""src/spellfile.c"": {""insertions"": 2, ""deletions"": 3, ""lines"": 5}, ""src/version.c"": {""insertions"": 2, ""deletions"": 0, ""lines"": 2}}"
2020-06-29 19:32:06,6378b21d6dd38cc0f80aa6d31d747db6c287483b,Bram Moolenaar,9,3,12,2,"{""src/fileio.c"": {""insertions"": 7, ""deletions"": 3, ""lines"": 10}, ""src/version.c"": {""insertions"": 2, ""deletions"": 0, ""lines"": 2}}"
2020-06-29 19:14:51,566cc8c72bb8036f015a435800f28ef9f6a9a3b6,Bram Moolenaar,8,1,9,2,"{""src/filepath.c"": {""insertions"": 6, ""deletions"": 1, ""lines"": 7}, ""src/version.c"": {""insertions"": 2, ""deletions"": 0, ""lines"": 2}}"
2020-06-29 18:40:37,cf30643ae607ae1a97b50e19c622dc8303723fa2,Bram Moolenaar,12,6,18,2,"{""src/indent.c"": {""insertions"": 10, ""deletions"": 6, ""lines"": 16}, ""src/version.c"": {""insertions"": 2, ""deletions"": 0, ""lines"": 2}}"
2020-06-29 18:23:32,6d90c61c5a6437ff5058b6c5874ba71bff574e60,Bram Moolenaar,7,5,12,2,"{""src/register.c"": {""insertions"": 5, ""deletions"": 5, ""lines"": 10}, ""src/version.c"": {""insertions"": 2, ""deletions"": 0, ""lines"": 2}}"
2020-06-29 18:20:33,7d2ac92ebc36049f9ce2f4ce08b8a80ca212ace2,Bram Moolenaar,4,15,19,2,"{""src/userfunc.c"": {""insertions"": 2, ""deletions"": 15, ""lines"": 17}, ""src/version.c"": {""insertions"": 2, ""deletions"": 0, ""lines"": 2}}"
2020-06-29 18:09:36,fda20c4cc59008264676a6deb6a3095ed0c248e0,Bram Moolenaar,23,13,36,3,"{""src/list.c"": {""insertions"": 18, ""deletions"": 13, ""lines"": 31}, ""src/testdir/test_listdict.vim"": {""insertions"": 3, ""deletions"": 0, ""lines"": 3}, ""src/version.c"": {""insertions"": 2, ""deletions"": 0, ""lines"": 2}}"
2020-06-29 17:55:58,91639195eff7b29213a0a3c279ac46e46ac76edd,Bram Moolenaar,6,4,10,2,"{""src/evalfunc.c"": {""insertions"": 4, ""deletions"": 4, ""lines"": 8}, ""src/version.c"": {""insertions"": 2, ""deletions"": 0, ""lines"": 2}}"
2020-06-28 20:41:26,a1f9f8666ed3a462eb8a518e78418c57dc41bbd4,Bram Moolenaar,64,11,75,4,"{""runtime/doc/if_lua.txt"": {""insertions"": 14, ""deletions"": 2, ""lines"": 16}, ""src/if_lua.c"": {""insertions"": 22, ""deletions"": 9, ""lines"": 31}, ""src/testdir/test_lua.vim"": {""insertions"": 26, ""deletions"": 0, ""lines"": 26}, ""src/version.c"": {""insertions"": 2, ""deletions"": 0, ""lines"": 2}}"
2020-06-28 16:43:40,b7a78f7a6713f07d2fcad0b27dea22925c7b1cdf,Bram Moolenaar,101,23,124,8,"{""src/eval.c"": {""insertions"": 39, ""deletions"": 16, ""lines"": 55}, ""src/ex_eval.c"": {""insertions"": 22, ""deletions"": 3, ""lines"": 25}, ""src/globals.h"": {""insertions"": 1, ""deletions"": 1, ""lines"": 2}, ""src/proto/eval.pro"": {""insertions"": 2, ""deletions"": 1, ""lines"": 3}, ""src/structs.h"": {""insertions"": 3, ""deletions"": 2, ""lines"": 5}, ""src/testdir/test_vim9_cmd.vim"": {""insertions"": 31, ""deletions"": 0, ""lines"": 31}, ""src/userfunc.c"": {""insertions"": 1, ""deletions"": 0, ""lines"": 1}, ""src/version.c"": {""insertions"": 2, ""deletions"": 0, ""lines"": 2}}"
2020-06-28 13:51:16,d5053d015a957b343ad9c9e45e0abd2978f10cf0,Bram Moolenaar,113,45,158,8,"{""src/eval.c"": {""insertions"": 13, ""deletions"": 7, ""lines"": 20}, ""src/evalvars.c"": {""insertions"": 5, ""deletions"": 2, ""lines"": 7}, ""src/ex_docmd.c"": {""insertions"": 68, ""deletions"": 30, ""lines"": 98}, ""src/globals.h"": {""insertions"": 1, ""deletions"": 1, ""lines"": 2}, ""src/proto/ex_docmd.pro"": {""insertions"": 2, ""deletions"": 1, ""lines"": 3}, ""src/structs.h"": {""insertions"": 2, ""deletions"": 1, ""lines"": 3}, ""src/testdir/test_vim9_cmd.vim"": {""insertions"": 20, ""deletions"": 3, ""lines"": 23}, ""src/version.c"": {""insertions"": 2, ""deletions"": 0, ""lines"": 2}}"
2020-06-28 11:17:26,06cf97e714fd8bf9b35ff5f8a6f2302c79acdd03,Bram Moolenaar,1396,1359,2755,13,"{""Filelist"": {""insertions"": 2, ""deletions"": 0, ""lines"": 2}, ""src/Make_cyg_ming.mak"": {""insertions"": 1, ""deletions"": 0, ""lines"": 1}, ""src/Make_morph.mak"": {""insertions"": 1, ""deletions"": 0, ""lines"": 1}, ""src/Make_mvc.mak"": {""insertions"": 4, ""deletions"": 0, ""lines"": 4}, ""src/Make_vms.mms"": {""insertions"": 5, ""deletions"": 0, ""lines"": 5}, ""src/Makefile"": {""insertions"": 10, ""deletions"": 0, ""lines"": 10}, ""src/README.md"": {""insertions"": 2, ""deletions"": 1, ""lines"": 3}, ""src/highlight.c"": {""insertions"": 0, ""deletions"": 1343, ""lines"": 1343}, ""src/match.c"": {""insertions"": 1351, ""deletions"": 0, ""lines"": 1351}, ""src/proto.h"": {""insertions"": 1, ""deletions"": 0, ""lines"": 1}, ""src/proto/highlight.pro"": {""insertions"": 0, ""deletions"": 15, ""lines"": 15}, ""src/proto/match.pro"": {""insertions"": 17, ""deletions"": 0, ""lines"": 17}, ""src/version.c"": {""insertions"": 2, ""deletions"": 0, ""lines"": 2}}"
2020-06-28 11:10:22,75e15670b8749845cde2962ddb738dd5c6e73191,Bram Moolenaar,100,2,102,5,"{""runtime/doc/syntax.txt"": {""insertions"": 1, ""deletions"": 1, ""lines"": 2}, ""src/testdir/test_cmdline.vim"": {""insertions"": 12, ""deletions"": 0, ""lines"": 12}, ""src/testdir/test_highlight.vim"": {""insertions"": 49, ""deletions"": 1, ""lines"": 50}, ""src/testdir/test_match.vim"": {""insertions"": 36, ""deletions"": 0, ""lines"": 36}, ""src/version.c"": {""insertions"": 2, ""deletions"": 0, ""lines"": 2}}"
2020-06-27 21:07:36,faf8626b79e380fe81e7ae2439a535ed7619d27b,Bram Moolenaar,73,12,85,5,"{""src/eval.c"": {""insertions"": 28, ""deletions"": 11, ""lines"": 39}, ""src/evalvars.c"": {""insertions"": 1, ""deletions"": 1, ""lines"": 2}, ""src/proto/eval.pro"": {""insertions"": 1, ""deletions"": 0, ""lines"": 1}, ""src/testdir/test_vim9_cmd.vim"": {""insertions"": 41, ""deletions"": 0, ""lines"": 41}, ""src/version.c"": {""insertions"": 2, ""deletions"": 0, ""lines"": 2}}"
2020-06-27 19:56:17,7e8967fdcdf45caf08753bb791dc3779e78b34c8,Bram Moolenaar,26,0,26,3,"{""src/eval.c"": {""insertions"": 1, ""deletions"": 0, ""lines"": 1}, ""src/testdir/test_vim9_cmd.vim"": {""insertions"": 23, ""deletions"": 0, ""lines"": 23}, ""src/version.c"": {""insertions"": 2, ""deletions"": 0, ""lines"": 2}}"
2020-06-27 19:18:00,9215f01218b2ed2cfe49c1f43fcf342bd9ffdded,Bram Moolenaar,67,49,116,7,"{""src/dict.c"": {""insertions"": 3, ""deletions"": 12, ""lines"": 15}, ""src/eval.c"": {""insertions"": 20, ""deletions"": 19, ""lines"": 39}, ""src/list.c"": {""insertions"": 2, ""deletions"": 8, ""lines"": 10}, ""src/proto/eval.pro"": {""insertions"": 1, ""deletions"": 0, ""lines"": 1}, ""src/testdir/test_vim9_expr.vim"": {""insertions"": 35, ""deletions"": 0, ""lines"": 35}, ""src/userfunc.c"": {""insertions"": 4, ""deletions"": 10, ""lines"": 14}, ""src/version.c"": {""insertions"": 2, ""deletions"": 0, ""lines"": 2}}"
2020-06-27 18:46:29,7a4981b93642b5b62018cd8150b3fb0dfa2417d4,Bram Moolenaar,28,0,28,3,"{""src/eval.c"": {""insertions"": 13, ""deletions"": 0, ""lines"": 13}, ""src/testdir/test_vim9_expr.vim"": {""insertions"": 13, ""deletions"": 0, ""lines"": 13}, ""src/version.c"": {""insertions"": 2, ""deletions"": 0, ""lines"": 2}}"
2020-06-27 16:13:10,a0a0c4147fd966e0cd923a2bbfb84b14b15a297e,Bram Moolenaar,22,4,26,3,"{""src/libvterm/src/state.c"": {""insertions"": 4, ""deletions"": 4, ""lines"": 8}, ""src/libvterm/t/63screen_resize.test"": {""insertions"": 16, ""deletions"": 0, ""lines"": 16}, ""src/version.c"": {""insertions"": 2, ""deletions"": 0, ""lines"": 2}}"
2020-06-27 16:06:45,e40fbc2ca9fda07332a4da5af1fcaba91bed865b,Bram Moolenaar,160,56,216,12,"{""src/eval.c"": {""insertions"": 97, ""deletions"": 40, ""lines"": 137}, ""src/evalvars.c"": {""insertions"": 4, ""deletions"": 2, ""lines"": 6}, ""src/ex_eval.c"": {""insertions"": 1, ""deletions"": 0, ""lines"": 1}, ""src/globals.h"": {""insertions"": 5, ""deletions"": 1, ""lines"": 6}, ""src/popupwin.c"": {""insertions"": 1, ""deletions"": 1, ""lines"": 2}, ""src/proto/eval.pro"": {""insertions"": 2, ""deletions"": 1, ""lines"": 3}, ""src/proto/userfunc.pro"": {""insertions"": 2, ""deletions"": 2, ""lines"": 4}, ""src/structs.h"": {""insertions"": 5, ""deletions"": 0, ""lines"": 5}, ""src/testdir/test_vim9_expr.vim"": {""insertions"": 12, ""deletions"": 0, ""lines"": 12}, ""src/userfunc.c"": {""insertions"": 26, ""deletions"": 6, ""lines"": 32}, ""src/version.c"": {""insertions"": 2, ""deletions"": 0, ""lines"": 2}, ""src/vim9compile.c"": {""insertions"": 3, ""deletions"": 3, ""lines"": 6}}"
2020-06-27 15:04:05,ab19d495fd880b25a38d58cbeb5b21e4d0ee5835,Bram Moolenaar,3,0,3,2,"{""src/dict.c"": {""insertions"": 1, ""deletions"": 0, ""lines"": 1}, ""src/version.c"": {""insertions"": 2, ""deletions"": 0, ""lines"": 2}}"
2020-06-27 14:36:05,e6e031739c9d0c4140e371031b58a249db0eb572,Bram Moolenaar,11,1,12,2,"{""src/list.c"": {""insertions"": 9, ""deletions"": 1, ""lines"": 10}, ""src/version.c"": {""insertions"": 2, ""deletions"": 0, ""lines"": 2}}"
2020-06-27 12:11:53,8ea9390b78da9e34a20e7418712921397c0c1989,Bram Moolenaar,82,15,97,6,"{""src/dict.c"": {""insertions"": 35, ""deletions"": 10, ""lines"": 45}, ""src/eval.c"": {""insertions"": 2, ""deletions"": 2, ""lines"": 4}, ""src/proto/dict.pro"": {""insertions"": 1, ""deletions"": 1, ""lines"": 2}, ""src/testdir/test_vim9_expr.vim"": {""insertions"": 40, ""deletions"": 0, ""lines"": 40}, ""src/version.c"": {""insertions"": 2, ""deletions"": 0, ""lines"": 2}, ""src/vim9compile.c"": {""insertions"": 2, ""deletions"": 2, ""lines"": 4}}"
2020-06-27 11:11:50,0b1cd52ff6bf690388f892be686a91721a082e55,Bram Moolenaar,38,18,56,7,"{""src/eval.c"": {""insertions"": 20, ""deletions"": 12, ""lines"": 32}, ""src/evalvars.c"": {""insertions"": 3, ""deletions"": 4, ""lines"": 7}, ""src/proto/eval.pro"": {""insertions"": 1, ""deletions"": 1, ""lines"": 2}, ""src/testdir/test_expr.vim"": {""insertions"": 7, ""deletions"": 0, ""lines"": 7}, ""src/testdir/test_vim9_expr.vim"": {""insertions"": 4, ""deletions"": 0, ""lines"": 4}, ""src/userfunc.c"": {""insertions"": 1, ""deletions"": 1, ""lines"": 2}, ""src/version.c"": {""insertions"": 2, ""deletions"": 0, ""lines"": 2}}"
2020-06-27 10:32:57,bd84617d1a6766efd59c94aabebb044bef805b99,Bram Moolenaar,32,16,48,4,"{""runtime/doc/if_lua.txt"": {""insertions"": 8, ""deletions"": 4, ""lines"": 12}, ""src/if_lua.c"": {""insertions"": 11, ""deletions"": 1, ""lines"": 12}, ""src/testdir/test_lua.vim"": {""insertions"": 11, ""deletions"": 11, ""lines"": 22}, ""src/version.c"": {""insertions"": 2, ""deletions"": 0, ""lines"": 2}}"
2020-06-26 20:46:27,7147820cb978f5b179cfec2f9d8b7774e28d43e0,Bram Moolenaar,70,31,101,8,"{""src/eval.c"": {""insertions"": 3, ""deletions"": 3, ""lines"": 6}, ""src/list.c"": {""insertions"": 21, ""deletions"": 9, ""lines"": 30}, ""src/proto/eval.pro"": {""insertions"": 2, ""deletions"": 0, ""lines"": 2}, ""src/proto/list.pro"": {""insertions"": 1, ""deletions"": 1, ""lines"": 2}, ""src/testdir/test_arglist.vim"": {""insertions"": 19, ""deletions"": 16, ""lines"": 35}, ""src/testdir/test_vim9_expr.vim"": {""insertions"": 21, ""deletions"": 1, ""lines"": 22}, ""src/version.c"": {""insertions"": 2, ""deletions"": 0, ""lines"": 2}, ""src/vim9compile.c"": {""insertions"": 1, ""deletions"": 1, ""lines"": 2}}"
2020-06-26 20:00:38,e6536aa766e95b6c64489678eb029e6909ee6a35,Bram Moolenaar,44,1,45,3,"{""src/eval.c"": {""insertions"": 5, ""deletions"": 1, ""lines"": 6}, ""src/testdir/test_vim9_expr.vim"": {""insertions"": 37, ""deletions"": 0, ""lines"": 37}, ""src/version.c"": {""insertions"": 2, ""deletions"": 0, ""lines"": 2}}"
2020-06-26 19:38:51,be7ee488761a5582a5605197c3951a17f20d072e,Bram Moolenaar,60,2,62,3,"{""src/eval.c"": {""insertions"": 18, ""deletions"": 2, ""lines"": 20}, ""src/testdir/test_vim9_expr.vim"": {""insertions"": 40, ""deletions"": 0, ""lines"": 40}, ""src/version.c"": {""insertions"": 2, ""deletions"": 0, ""lines"": 2}}"
2020-06-26 19:28:25,793648fb563359396a23740c72a6e04cb64df3a9,Bram Moolenaar,35,2,37,3,"{""src/eval.c"": {""insertions"": 12, ""deletions"": 2, ""lines"": 14}, ""src/testdir/test_vim9_expr.vim"": {""insertions"": 21, ""deletions"": 0, ""lines"": 21}, ""src/version.c"": {""insertions"": 2, ""deletions"": 0, ""lines"": 2}}"
2020-06-26 18:41:39,5d3c9f8c2a0fc29ba4ac8e0f052378b64d9e3dd3,Bram Moolenaar,352,5,357,10,"{""src/testdir/test_excmd.vim"": {""insertions"": 5, ""deletions"": 0, ""lines"": 5}, ""src/testdir/test_gf.vim"": {""insertions"": 9, ""deletions"": 2, ""lines"": 11}, ""src/testdir/test_options.vim"": {""insertions"": 20, ""deletions"": 0, ""lines"": 20}, ""src/testdir/test_popupwin.vim"": {""insertions"": 2, ""deletions"": 0, ""lines"": 2}, ""src/testdir/test_quickfix.vim"": {""insertions"": 17, ""deletions"": 0, ""lines"": 17}, ""src/testdir/test_tabpage.vim"": {""insertions"": 65, ""deletions"": 0, ""lines"": 65}, ""src/testdir/test_tagjump.vim"": {""insertions"": 45, ""deletions"": 0, ""lines"": 45}, ""src/testdir/test_window_cmd.vim"": {""insertions"": 185, ""deletions"": 1, ""lines"": 186}, ""src/version.c"": {""insertions"": 2, ""deletions"": 0, ""lines"": 2}, ""src/window.c"": {""insertions"": 2, ""deletions"": 2, ""lines"": 4}}"
2020-06-26 18:23:45,5f36d5fbb836e6fdeb9e3b2c26edb88e45150db4,Bram Moolenaar,4,2,6,3,"{""runtime/filetype.vim"": {""insertions"": 1, ""deletions"": 1, ""lines"": 2}, ""src/testdir/test_filetype.vim"": {""insertions"": 1, ""deletions"": 1, ""lines"": 2}, ""src/version.c"": {""insertions"": 2, ""deletions"": 0, ""lines"": 2}}"
2020-06-26 17:44:06,cf8441704d6e517bda1899f4afa82c6b4eecbaec,Bram Moolenaar,32,2,34,5,"{""src/ex_docmd.c"": {""insertions"": 7, ""deletions"": 0, ""lines"": 7}, ""src/globals.h"": {""insertions"": 1, ""deletions"": 0, ""lines"": 1}, ""src/testdir/test_autocmd.vim"": {""insertions"": 21, ""deletions"": 1, ""lines"": 22}, ""src/version.c"": {""insertions"": 2, ""deletions"": 0, ""lines"": 2}, ""src/window.c"": {""insertions"": 1, ""deletions"": 1, ""lines"": 2}}"
2020-06-25 20:23:48,fc838d6cb0f22c77a6ee2befd034b593e1c5ea06,Bram Moolenaar,41,0,41,4,"{""src/drawline.c"": {""insertions"": 5, ""deletions"": 0, ""lines"": 5}, ""src/testdir/test_conceal.vim"": {""insertions"": 22, ""deletions"": 0, ""lines"": 22}, ""src/testdir/test_diffmode.vim"": {""insertions"": 12, ""deletions"": 0, ""lines"": 12}, ""src/version.c"": {""insertions"": 2, ""deletions"": 0, ""lines"": 2}}"
2020-06-25 18:56:42,1e4c7d0ed272201fa3a7cf34a462abb139170759,Bram Moolenaar,12,0,12,2,"{""src/if_lua.c"": {""insertions"": 10, ""deletions"": 0, ""lines"": 10}, ""src/version.c"": {""insertions"": 2, ""deletions"": 0, ""lines"": 2}}"
2020-06-25 18:07:04,211dd3fd82216ca879fe7f917ea345b3ae366ce1,Bram Moolenaar,87,27,114,4,"{""src/drawline.c"": {""insertions"": 5, ""deletions"": 4, ""lines"": 9}, ""src/highlight.c"": {""insertions"": 5, ""deletions"": 7, ""lines"": 12}, ""src/testdir/test_matchadd_conceal.vim"": {""insertions"": 75, ""deletions"": 16, ""lines"": 91}, ""src/version.c"": {""insertions"": 2, ""deletions"": 0, ""lines"": 2}}"
2020-06-25 17:53:24,73b4465ba7f170c5a1701ad908144970e758b1f5,Bram Moolenaar,31,2,33,3,"{""runtime/filetype.vim"": {""insertions"": 10, ""deletions"": 1, ""lines"": 11}, ""src/testdir/test_filetype.vim"": {""insertions"": 19, ""deletions"": 1, ""lines"": 20}, ""src/version.c"": {""insertions"": 2, ""deletions"": 0, ""lines"": 2}}"
2020-06-25 17:27:56,801ab069341c8652680d63c174530fd4feb2911e,Bram Moolenaar,213,1,214,7,"{""runtime/doc/if_lua.txt"": {""insertions"": 8, ""deletions"": 0, ""lines"": 8}, ""src/if_lua.c"": {""insertions"": 100, ""deletions"": 1, ""lines"": 101}, ""src/proto/userfunc.pro"": {""insertions"": 1, ""deletions"": 0, ""lines"": 1}, ""src/structs.h"": {""insertions"": 9, ""deletions"": 0, ""lines"": 9}, ""src/testdir/test_lua.vim"": {""insertions"": 29, ""deletions"": 0, ""lines"": 29}, ""src/userfunc.c"": {""insertions"": 64, ""deletions"": 0, ""lines"": 64}, ""src/version.c"": {""insertions"": 2, ""deletions"": 0, ""lines"": 2}}"
2020-06-25 17:01:36,832adf9bb8cd39d8e982d8a35ed8a6d39b974494,Bram Moolenaar,81,6,87,4,"{""src/testdir/test_autocmd.vim"": {""insertions"": 22, ""deletions"": 3, ""lines"": 25}, ""src/testdir/test_statusline.vim"": {""insertions"": 14, ""deletions"": 3, ""lines"": 17}, ""src/testdir/test_tabline.vim"": {""insertions"": 43, ""deletions"": 0, ""lines"": 43}, ""src/version.c"": {""insertions"": 2, ""deletions"": 0, ""lines"": 2}}"
2020-06-24 21:02:40,7acde51832f383f9a6d2e740cd0420b433ea841a,Bram Moolenaar,4,2,6,2,"{""src/eval.c"": {""insertions"": 2, ""deletions"": 2, ""lines"": 4}, ""src/version.c"": {""insertions"": 2, ""deletions"": 0, ""lines"": 2}}"
2020-06-24 20:07:46,ca275a05d8b79f6a9101604fdede2373d0dea44e,Bram Moolenaar,17,2,19,3,"{""src/list.c"": {""insertions"": 6, ""deletions"": 2, ""lines"": 8}, ""src/testdir/test_listdict.vim"": {""insertions"": 9, ""deletions"": 0, ""lines"": 9}, ""src/version.c"": {""insertions"": 2, ""deletions"": 0, ""lines"": 2}}"
2020-06-24 19:00:25,65a8ed37f7bc61fbe5c612a7b0eb0dfc16ad3e11,Bram Moolenaar,5,0,5,2,"{""src/ex_cmds.h"": {""insertions"": 3, ""deletions"": 0, ""lines"": 3}, ""src/version.c"": {""insertions"": 2, ""deletions"": 0, ""lines"": 2}}"
2020-06-24 18:34:03,b171fb179053fa631fec74911b5fb9374cb6a8a1,Bram Moolenaar,90,55,145,23,"{""src/beval.c"": {""insertions"": 1, ""deletions"": 1, ""lines"": 2}, ""src/buffer.c"": {""insertions"": 2, ""deletions"": 2, ""lines"": 4}, ""src/clientserver.c"": {""insertions"": 1, ""deletions"": 1, ""lines"": 2}, ""src/eval.c"": {""insertions"": 50, ""deletions"": 20, ""lines"": 70}, ""src/evalvars.c"": {""insertions"": 1, ""deletions"": 1, ""lines"": 2}, ""src/ex_docmd.c"": {""insertions"": 2, ""deletions"": 1, ""lines"": 3}, ""src/ex_eval.c"": {""insertions"": 6, ""deletions"": 6, ""lines"": 12}, ""src/filepath.c"": {""insertions"": 1, ""deletions"": 1, ""lines"": 2}, ""src/findfile.c"": {""insertions"": 1, ""deletions"": 1, ""lines"": 2}, ""src/fold.c"": {""insertions"": 1, ""deletions"": 1, ""lines"": 2}, ""src/globals.h"": {""insertions"": 1, ""deletions"": 1, ""lines"": 2}, ""src/if_ole.cpp"": {""insertions"": 1, ""deletions"": 1, ""lines"": 2}, ""src/if_perl.xs"": {""insertions"": 1, ""deletions"": 2, ""lines"": 3}, ""src/if_tcl.c"": {""insertions"": 1, ""deletions"": 1, ""lines"": 2}, ""src/map.c"": {""insertions"": 1, ""deletions"": 1, ""lines"": 2}, ""src/proto/eval.pro"": {""insertions"": 8, ""deletions"": 8, ""lines"": 16}, ""src/quickfix.c"": {""insertions"": 1, ""deletions"": 1, ""lines"": 2}, ""src/regexp.c"": {""insertions"": 1, ""deletions"": 1, ""lines"": 2}, ""src/register.c"": {""insertions"": 1, ""deletions"": 1, ""lines"": 2}, ""src/screen.c"": {""insertions"": 1, ""deletions"": 1, ""lines"": 2}, ""src/structs.h"": {""insertions"": 3, ""deletions"": 0, ""lines"": 3}, ""src/userfunc.c"": {""insertions"": 2, ""deletions"": 2, ""lines"": 4}, ""src/version.c"": {""insertions"": 2, ""deletions"": 0, ""lines"": 2}}"
2020-06-24 17:05:29,9d40c63c7dc8c3eb3886c58dcd334bc7f37eceba,Bram Moolenaar,6,0,6,2,"{""src/structs.h"": {""insertions"": 4, ""deletions"": 0, ""lines"": 4}, ""src/version.c"": {""insertions"": 2, ""deletions"": 0, ""lines"": 2}}"
2020-06-24 16:37:35,5409f5d8c95007216ae1190565a7a8ee9ebd7100,Bram Moolenaar,300,111,411,15,"{""src/dict.c"": {""insertions"": 8, ""deletions"": 3, ""lines"": 11}, ""src/eval.c"": {""insertions"": 189, ""deletions"": 85, ""lines"": 274}, ""src/evalfunc.c"": {""insertions"": 1, ""deletions"": 1, ""lines"": 2}, ""src/evalvars.c"": {""insertions"": 8, ""deletions"": 5, ""lines"": 13}, ""src/ex_eval.c"": {""insertions"": 5, ""deletions"": 2, ""lines"": 7}, ""src/globals.h"": {""insertions"": 3, ""deletions"": 0, ""lines"": 3}, ""src/list.c"": {""insertions"": 5, ""deletions"": 1, ""lines"": 6}, ""src/proto/eval.pro"": {""insertions"": 2, ""deletions"": 2, ""lines"": 4}, ""src/proto/scriptfile.pro"": {""insertions"": 1, ""deletions"": 0, ""lines"": 1}, ""src/scriptfile.c"": {""insertions"": 9, ""deletions"": 0, ""lines"": 9}, ""src/structs.h"": {""insertions"": 13, ""deletions"": 0, ""lines"": 13}, ""src/testdir/test_vim9_expr.vim"": {""insertions"": 40, ""deletions"": 0, ""lines"": 40}, ""src/userfunc.c"": {""insertions"": 14, ""deletions"": 8, ""lines"": 22}, ""src/version.c"": {""insertions"": 2, ""deletions"": 0, ""lines"": 2}, ""src/vim.h"": {""insertions"": 0, ""deletions"": 4, ""lines"": 4}}"
2020-06-24 11:37:35,b7e2483655d9b68df0c7349918027d800051a28a,Bram Moolenaar,487,272,759,7,"{""src/testdir/Make_all.mak"": {""insertions"": 2, ""deletions"": 0, ""lines"": 2}, ""src/testdir/test_buffer.vim"": {""insertions"": 204, ""deletions"": 0, ""lines"": 204}, ""src/testdir/test_cmdline.vim"": {""insertions"": 1, ""deletions"": 0, ""lines"": 1}, ""src/testdir/test_comments.vim"": {""insertions"": 277, ""deletions"": 0, ""lines"": 277}, ""src/testdir/test_normal.vim"": {""insertions"": 1, ""deletions"": 0, ""lines"": 1}, ""src/testdir/test_textformat.vim"": {""insertions"": 0, ""deletions"": 272, ""lines"": 272}, ""src/version.c"": {""insertions"": 2, ""deletions"": 0, ""lines"": 2}}"
2020-06-23 20:26:05,67fbdfefd26a237831c3838f799d3e6198c8a34a,Bram Moolenaar,121,28,149,3,"{""src/testdir/test_vim9_expr.vim"": {""insertions"": 51, ""deletions"": 20, ""lines"": 71}, ""src/version.c"": {""insertions"": 2, ""deletions"": 0, ""lines"": 2}, ""src/vim9compile.c"": {""insertions"": 68, ""deletions"": 8, ""lines"": 76}}"
2020-06-23 19:01:38,ef6d86c173becdf82b7a9a1329342c9368340def,Bram Moolenaar,5,2,7,3,"{""runtime/filetype.vim"": {""insertions"": 2, ""deletions"": 1, ""lines"": 3}, ""src/testdir/test_filetype.vim"": {""insertions"": 1, ""deletions"": 1, ""lines"": 2}, ""src/version.c"": {""insertions"": 2, ""deletions"": 0, ""lines"": 2}}"
2020-06-23 18:00:50,4014e2ceb03b8aeb947a0c671a099b677c8f2d5d,Bram Moolenaar,13,1,14,2,"{""src/testdir/test_statusline.vim"": {""insertions"": 11, ""deletions"": 1, ""lines"": 12}, ""src/version.c"": {""insertions"": 2, ""deletions"": 0, ""lines"": 2}}"
2020-06-22 21:02:51,df069eec3b90401e880e9b0e258146d8f36c474d,Bram Moolenaar,59,25,84,7,"{""runtime/doc/vim9.txt"": {""insertions"": 21, ""deletions"": 13, ""lines"": 34}, ""src/ex_docmd.c"": {""insertions"": 8, ""deletions"": 1, ""lines"": 9}, ""src/globals.h"": {""insertions"": 1, ""deletions"": 0, ""lines"": 1}, ""src/testdir/test_vim9_expr.vim"": {""insertions"": 6, ""deletions"": 6, ""lines"": 12}, ""src/testdir/test_vim9_script.vim"": {""insertions"": 11, ""deletions"": 3, ""lines"": 14}, ""src/version.c"": {""insertions"": 2, ""deletions"": 0, ""lines"": 2}, ""src/vim9compile.c"": {""insertions"": 10, ""deletions"": 2, ""lines"": 12}}"
2020-06-22 20:10:06,7eaafe65eef88493c789b160914c8e2e8e42d4a7,Bram Moolenaar,3,1,4,2,"{""src/testdir/summarize.vim"": {""insertions"": 1, ""deletions"": 1, ""lines"": 2}, ""src/version.c"": {""insertions"": 2, ""deletions"": 0, ""lines"": 2}}"
2020-06-22 19:34:30,bdd2c290d3cda69e0046c42f0c651f60bc510a16,Bram Moolenaar,251,48,299,7,"{""src/testdir/test_cursor_func.vim"": {""insertions"": 1, ""deletions"": 0, ""lines"": 1}, ""src/testdir/test_functions.vim"": {""insertions"": 5, ""deletions"": 0, ""lines"": 5}, ""src/testdir/test_gf.vim"": {""insertions"": 30, ""deletions"": 0, ""lines"": 30}, ""src/testdir/test_normal.vim"": {""insertions"": 135, ""deletions"": 2, ""lines"": 137}, ""src/testdir/test_options.vim"": {""insertions"": 32, ""deletions"": 0, ""lines"": 32}, ""src/testdir/test_quickfix.vim"": {""insertions"": 46, ""deletions"": 46, ""lines"": 92}, ""src/version.c"": {""insertions"": 2, ""deletions"": 0, ""lines"": 2}}"
2020-06-22 18:30:27,25fd2672875351ff56a925284a03a900081f70c0,Bram Moolenaar,22,2,24,3,"{""src/testdir/test_registers.vim"": {""insertions"": 18, ""deletions"": 0, ""lines"": 18}, ""src/version.c"": {""insertions"": 2, ""deletions"": 0, ""lines"": 2}, ""src/winclip.c"": {""insertions"": 2, ""deletions"": 2, ""lines"": 4}}"
2020-06-22 18:22:19,b2b218d89b3a6f450e65afd5e59ac234a5fa1eb7,Bram Moolenaar,3,2,5,2,"{""src/testdir/test_popupwin.vim"": {""insertions"": 1, ""deletions"": 2, ""lines"": 3}, ""src/version.c"": {""insertions"": 2, ""deletions"": 0, ""lines"": 2}}"
2020-06-22 17:39:03,acd4c5e914f8a06745624ba585f3d06d5faf4ddd,Bram Moolenaar,17,1,18,3,"{""src/testdir/test_vim9_func.vim"": {""insertions"": 11, ""deletions"": 0, ""lines"": 11}, ""src/version.c"": {""insertions"": 2, ""deletions"": 0, ""lines"": 2}, ""src/vim9compile.c"": {""insertions"": 4, ""deletions"": 1, ""lines"": 5}}"
2020-06-22 17:24:23,373c65104e0991724cb57910dfb3e5c276e2d7e7,Bram Moolenaar,5,1,6,2,"{""src/testdir/test_popupwin.vim"": {""insertions"": 3, ""deletions"": 1, ""lines"": 4}, ""src/version.c"": {""insertions"": 2, ""deletions"": 0, ""lines"": 2}}"
2020-06-22 17:10:56,7633fe595e6a27d6bb376548ff89f0dcce481600,Bram Moolenaar,71,36,107,3,"{""src/evalfunc.c"": {""insertions"": 61, ""deletions"": 36, ""lines"": 97}, ""src/testdir/test_registers.vim"": {""insertions"": 8, ""deletions"": 0, ""lines"": 8}, ""src/version.c"": {""insertions"": 2, ""deletions"": 0, ""lines"": 2}}"
2020-06-21 20:17:18,38041da1c263f5840f21e15484d7ccb30999ed62,Bram Moolenaar,4,2,6,2,"{""src/version.c"": {""insertions"": 2, ""deletions"": 0, ""lines"": 2}, ""src/vim9compile.c"": {""insertions"": 2, ""deletions"": 2, ""lines"": 4}}"
2020-06-21 20:12:03,73fef33014dbf21fc59e7e47fb091117868d82fb,Bram Moolenaar,105,59,164,15,"{""runtime/doc/eval.txt"": {""insertions"": 17, ""deletions"": 15, ""lines"": 32}, ""runtime/doc/mlang.txt"": {""insertions"": 1, ""deletions"": 1, ""lines"": 2}, ""runtime/doc/tags"": {""insertions"": 3, ""deletions"": 0, ""lines"": 3}, ""runtime/doc/testing.txt"": {""insertions"": 1, ""deletions"": 1, ""lines"": 2}, ""runtime/doc/todo.txt"": {""insertions"": 13, ""deletions"": 10, ""lines"": 23}, ""runtime/doc/usr_11.txt"": {""insertions"": 1, ""deletions"": 1, ""lines"": 2}, ""runtime/doc/usr_46.txt"": {""insertions"": 2, ""deletions"": 2, ""lines"": 4}, ""runtime/doc/usr_toc.txt"": {""insertions"": 7, ""deletions"": 1, ""lines"": 8}, ""runtime/doc/vim9.txt"": {""insertions"": 12, ""deletions"": 5, ""lines"": 17}, ""runtime/filetype.vim"": {""insertions"": 13, ""deletions"": 13, ""lines"": 26}, ""runtime/ftplugin/vim.vim"": {""insertions"": 2, ""deletions"": 3, ""lines"": 5}, ""runtime/indent/html.vim"": {""insertions"": 2, ""deletions"": 2, ""lines"": 4}, ""runtime/indent/testdir/html.in"": {""insertions"": 10, ""deletions"": 0, ""lines"": 10}, ""runtime/indent/testdir/html.ok"": {""insertions"": 10, ""deletions"": 0, ""lines"": 10}, ""runtime/plugin/matchparen.vim"": {""insertions"": 11, ""deletions"": 5, ""lines"": 16}}"
2020-06-21 18:39:37,8d9437968b6693ecb14e7375bcb242e657e75266,Bram Moolenaar,13,1,14,2,"{""src/testdir/runtest.vim"": {""insertions"": 11, ""deletions"": 1, ""lines"": 12}, ""src/version.c"": {""insertions"": 2, ""deletions"": 0, ""lines"": 2}}"
2020-06-21 18:38:28,7fe875583bb474d03d281ca59af3320e7e176953,Bram Moolenaar,11,7,18,3,"{""src/globals.h"": {""insertions"": 2, ""deletions"": 1, ""lines"": 3}, ""src/version.c"": {""insertions"": 2, ""deletions"": 0, ""lines"": 2}, ""src/vim9compile.c"": {""insertions"": 7, ""deletions"": 6, ""lines"": 13}}"
2020-06-21 18:06:54,f5433fbfe4324fd443664fb924116b5ed675bef5,Bram Moolenaar,21,0,21,2,"{""src/if_perl.xs"": {""insertions"": 19, ""deletions"": 0, ""lines"": 19}, ""src/version.c"": {""insertions"": 2, ""deletions"": 0, ""lines"": 2}}"
2020-06-21 15:57:32,da58134eedf43ae4b9013c93ecbdf55e4da4b8a3,Bram Moolenaar,18,10,28,3,"{""src/libvterm/src/screen.c"": {""insertions"": 12, ""deletions"": 0, ""lines"": 12}, ""src/libvterm/src/state.c"": {""insertions"": 4, ""deletions"": 10, ""lines"": 14}, ""src/version.c"": {""insertions"": 2, ""deletions"": 0, ""lines"": 2}}"
2020-06-21 14:58:13,23c55273739b2fb09912140e2e03a4b8ff15dd04,Bram Moolenaar,89,56,145,3,"{""src/testdir/test_vim9_expr.vim"": {""insertions"": 18, ""deletions"": 0, ""lines"": 18}, ""src/version.c"": {""insertions"": 2, ""deletions"": 0, ""lines"": 2}, ""src/vim9compile.c"": {""insertions"": 69, ""deletions"": 56, ""lines"": 125}}"
2020-06-21 13:52:59,e55b1c098d9dc04c960e6575bb554b5130af8989,Bram Moolenaar,75,23,98,7,"{""src/evalvars.c"": {""insertions"": 13, ""deletions"": 5, ""lines"": 18}, ""src/globals.h"": {""insertions"": 1, ""deletions"": 1, ""lines"": 2}, ""src/proto/vim9compile.pro"": {""insertions"": 1, ""deletions"": 0, ""lines"": 1}, ""src/testdir/test_vim9_expr.vim"": {""insertions"": 1, ""deletions"": 1, ""lines"": 2}, ""src/testdir/test_vim9_script.vim"": {""insertions"": 34, ""deletions"": 7, ""lines"": 41}, ""src/version.c"": {""insertions"": 2, ""deletions"": 0, ""lines"": 2}, ""src/vim9compile.c"": {""insertions"": 23, ""deletions"": 9, ""lines"": 32}}"
2020-06-21 13:09:14,820ffa567c5a4bc0d3517c79c91d63d8062c358e,Bram Moolenaar,12,6,18,3,"{""src/gui_gtk_x11.c"": {""insertions"": 5, ""deletions"": 3, ""lines"": 8}, ""src/gui_x11.c"": {""insertions"": 5, ""deletions"": 3, ""lines"": 8}, ""src/version.c"": {""insertions"": 2, ""deletions"": 0, ""lines"": 2}}"
2020-06-21 12:12:17,a3b7fdc1bb227897f41b8f2958a48d0a26292ff7,Bram Moolenaar,30,4,34,3,"{""src/testdir/test_vim9_expr.vim"": {""insertions"": 15, ""deletions"": 0, ""lines"": 15}, ""src/version.c"": {""insertions"": 2, ""deletions"": 0, ""lines"": 2}, ""src/vim9compile.c"": {""insertions"": 13, ""deletions"": 4, ""lines"": 17}}"
2020-06-21 11:23:45,8c524f76ebd43f006e765534765b595de7095f12,Bram Moolenaar,81,1,82,3,"{""src/testdir/test_digraph.vim"": {""insertions"": 1, ""deletions"": 1, ""lines"": 2}, ""src/testdir/test_tabpage.vim"": {""insertions"": 78, ""deletions"": 0, ""lines"": 78}, ""src/version.c"": {""insertions"": 2, ""deletions"": 0, ""lines"": 2}}"
2020-06-20 20:50:47,6797966dfc0219313886be55767e53d5a388b5c5,Bram Moolenaar,33,13,46,10,"{""src/evalvars.c"": {""insertions"": 8, ""deletions"": 0, ""lines"": 8}, ""src/globals.h"": {""insertions"": 1, ""deletions"": 0, ""lines"": 1}, ""src/scriptfile.c"": {""insertions"": 1, ""deletions"": 1, ""lines"": 2}, ""src/structs.h"": {""insertions"": 2, ""deletions"": 0, ""lines"": 2}, ""src/testdir/test_vim9_disassemble.vim"": {""insertions"": 1, ""deletions"": 1, ""lines"": 2}, ""src/testdir/test_vim9_func.vim"": {""insertions"": 1, ""deletions"": 1, ""lines"": 2}, ""src/testdir/test_vim9_script.vim"": {""insertions"": 13, ""deletions"": 8, ""lines"": 21}, ""src/userfunc.c"": {""insertions"": 3, ""deletions"": 0, ""lines"": 3}, ""src/version.c"": {""insertions"": 2, ""deletions"": 0, ""lines"": 2}, ""src/vim9compile.c"": {""insertions"": 1, ""deletions"": 2, ""lines"": 3}}"
2020-06-20 16:19:09,0cb5bcf5836de83f7d64fb01d3ce708caacaf66c,Bram Moolenaar,57,37,94,8,"{""src/eval.c"": {""insertions"": 1, ""deletions"": 1, ""lines"": 2}, ""src/evalvars.c"": {""insertions"": 1, ""deletions"": 1, ""lines"": 2}, ""src/proto/vim9compile.pro"": {""insertions"": 1, ""deletions"": 1, ""lines"": 2}, ""src/structs.h"": {""insertions"": 7, ""deletions"": 3, ""lines"": 10}, ""src/userfunc.c"": {""insertions"": 15, ""deletions"": 13, ""lines"": 28}, ""src/version.c"": {""insertions"": 2, ""deletions"": 0, ""lines"": 2}, ""src/vim9compile.c"": {""insertions"": 24, ""deletions"": 12, ""lines"": 36}, ""src/vim9execute.c"": {""insertions"": 6, ""deletions"": 6, ""lines"": 12}}"
2020-06-20 14:05:32,845e0ee59430eac07e74b6cb92020e420d17953d,Bram Moolenaar,330,11,341,15,"{""src/testdir/test_blob.vim"": {""insertions"": 1, ""deletions"": 0, ""lines"": 1}, ""src/testdir/test_cpoptions.vim"": {""insertions"": 14, ""deletions"": 6, ""lines"": 20}, ""src/testdir/test_digraph.vim"": {""insertions"": 17, ""deletions"": 0, ""lines"": 17}, ""src/testdir/test_edit.vim"": {""insertions"": 115, ""deletions"": 3, ""lines"": 118}, ""src/testdir/test_iminsert.vim"": {""insertions"": 27, ""deletions"": 1, ""lines"": 28}, ""src/testdir/test_paste.vim"": {""insertions"": 18, ""deletions"": 0, ""lines"": 18}, ""src/testdir/test_prompt_buffer.vim"": {""insertions"": 5, ""deletions"": 0, ""lines"": 5}, ""src/testdir/test_selectmode.vim"": {""insertions"": 3, ""deletions"": 0, ""lines"": 3}, ""src/testdir/test_tabpage.vim"": {""insertions"": 11, ""deletions"": 0, ""lines"": 11}, ""src/testdir/test_tagjump.vim"": {""insertions"": 54, ""deletions"": 1, ""lines"": 55}, ""src/testdir/test_textformat.vim"": {""insertions"": 14, ""deletions"": 0, ""lines"": 14}, ""src/testdir/test_viminfo.vim"": {""insertions"": 22, ""deletions"": 0, ""lines"": 22}, ""src/testdir/test_virtualedit.vim"": {""insertions"": 18, ""deletions"": 0, ""lines"": 18}, ""src/testdir/test_visual.vim"": {""insertions"": 9, ""deletions"": 0, ""lines"": 9}, ""src/version.c"": {""insertions"": 2, ""deletions"": 0, ""lines"": 2}}"
2020-06-20 14:00:25,a190548e9165bbae75144a3e47f01d7708b29073,Bram Moolenaar,23,0,23,2,"{""src/testdir/test_ruby.vim"": {""insertions"": 21, ""deletions"": 0, ""lines"": 21}, ""src/version.c"": {""insertions"": 2, ""deletions"": 0, ""lines"": 2}}"
2020-06-20 13:03:38,b326edf5b30813b2ccdee3ac07ee6495ca5187ff,Bram Moolenaar,7,1,8,2,"{""src/testdir/test_popupwin.vim"": {""insertions"": 5, ""deletions"": 1, ""lines"": 6}, ""src/version.c"": {""insertions"": 2, ""deletions"": 0, ""lines"": 2}}"
2020-06-20 12:43:23,ef6746f637adbdb6860b4fa0266c43c49fa498bc,Bram Moolenaar,32,14,46,5,"{""src/gui_gtk_x11.c"": {""insertions"": 8, ""deletions"": 3, ""lines"": 11}, ""src/misc2.c"": {""insertions"": 19, ""deletions"": 0, ""lines"": 19}, ""src/proto/misc2.pro"": {""insertions"": 1, ""deletions"": 0, ""lines"": 1}, ""src/term.c"": {""insertions"": 2, ""deletions"": 11, ""lines"": 13}, ""src/version.c"": {""insertions"": 2, ""deletions"": 0, ""lines"": 2}}"
2020-06-20 11:29:03,280b0dc815a31b99dafc384baa415072e5f2bec1,Bram Moolenaar,10,8,18,2,"{""src/version.c"": {""insertions"": 2, ""deletions"": 0, ""lines"": 2}, ""src/vim9compile.c"": {""insertions"": 8, ""deletions"": 8, ""lines"": 16}}"
2020-06-19 20:37:47,1089374130862e5c19745d3ff4314f0c5690baf1,Bram Moolenaar,7,1,8,2,"{""ci/appveyor.bat"": {""insertions"": 5, ""deletions"": 1, ""lines"": 6}, ""src/version.c"": {""insertions"": 2, ""deletions"": 0, ""lines"": 2}}"
2020-06-19 20:35:44,7e380030c15d961421a3fcda6cc358e2d112f4f8,Bram Moolenaar,3,0,3,2,"{""src/version.c"": {""insertions"": 2, ""deletions"": 0, ""lines"": 2}, ""src/vim9compile.c"": {""insertions"": 1, ""deletions"": 0, ""lines"": 1}}"
2020-06-19 19:46:52,20298ce679dbf21c07c8fe2161724a12424f1e69,Bram Moolenaar,19,6,25,4,"{""src/misc2.c"": {""insertions"": 5, ""deletions"": 3, ""lines"": 8}, ""src/term.c"": {""insertions"": 5, ""deletions"": 2, ""lines"": 7}, ""src/testdir/test_popupwin.vim"": {""insertions"": 7, ""deletions"": 1, ""lines"": 8}, ""src/version.c"": {""insertions"": 2, ""deletions"": 0, ""lines"": 2}}"
2020-06-19 17:30:53,1e0b7b11db61bd906266d3174fee0bbaf20a101f,Bram Moolenaar,25,24,49,2,"{""src/typval.c"": {""insertions"": 23, ""deletions"": 24, ""lines"": 47}, ""src/version.c"": {""insertions"": 2, ""deletions"": 0, ""lines"": 2}}"
2020-06-19 17:10:59,ec9b017b879cb744393aadd3d105ee5da1332437,Bram Moolenaar,11,13,24,2,"{""src/testdir/test_channel.vim"": {""insertions"": 9, ""deletions"": 13, ""lines"": 22}, ""src/version.c"": {""insertions"": 2, ""deletions"": 0, ""lines"": 2}}"
2020-06-19 17:01:43,3b74b6b4bb9a022f8c6f6e544360d628e10df1ab,Bram Moolenaar,39,2,41,4,"{""src/scriptfile.c"": {""insertions"": 1, ""deletions"": 1, ""lines"": 2}, ""src/testdir/test_vim9_script.vim"": {""insertions"": 35, ""deletions"": 0, ""lines"": 35}, ""src/version.c"": {""insertions"": 2, ""deletions"": 0, ""lines"": 2}, ""src/vim9script.c"": {""insertions"": 1, ""deletions"": 1, ""lines"": 2}}"
2020-06-19 16:34:15,c785b9a7f471f12825a1d6d2041c144c74242b7c,Bram Moolenaar,32,21,53,7,"{""src/evalvars.c"": {""insertions"": 6, ""deletions"": 5, ""lines"": 11}, ""src/proto/vim9script.pro"": {""insertions"": 1, ""deletions"": 1, ""lines"": 2}, ""src/testdir/test_vim9_expr.vim"": {""insertions"": 1, ""deletions"": 0, ""lines"": 1}, ""src/testdir/test_vim9_script.vim"": {""insertions"": 13, ""deletions"": 0, ""lines"": 13}, ""src/version.c"": {""insertions"": 2, ""deletions"": 0, ""lines"": 2}, ""src/vim9execute.c"": {""insertions"": 3, ""deletions"": 11, ""lines"": 14}, ""src/vim9script.c"": {""insertions"": 6, ""deletions"": 4, ""lines"": 10}}"
2020-06-19 15:20:41,128d3079635ae62786a13adc435d0063a64a014a,Bram Moolenaar,3,1,4,2,"{""src/libvterm/src/state.c"": {""insertions"": 1, ""deletions"": 1, ""lines"": 2}, ""src/version.c"": {""insertions"": 2, ""deletions"": 0, ""lines"": 2}}"
2020-06-18 20:43:27,c5b1c20b6b1968873ea31edac1db659773b3b93d,Bram Moolenaar,24,5,29,3,"{""src/testdir/test_vim9_script.vim"": {""insertions"": 21, ""deletions"": 0, ""lines"": 21}, ""src/version.c"": {""insertions"": 2, ""deletions"": 0, ""lines"": 2}, ""src/vim9execute.c"": {""insertions"": 1, ""deletions"": 5, ""lines"": 6}}"
2020-06-18 20:18:18,0779fab2979d6d055ba3c464f1c2b9d90dc9e49f,Bram Moolenaar,38,0,38,2,"{""src/testdir/test_vim9_disassemble.vim"": {""insertions"": 36, ""deletions"": 0, ""lines"": 36}, ""src/version.c"": {""insertions"": 2, ""deletions"": 0, ""lines"": 2}}"
2020-06-18 19:14:30,c8cb883015619cfe6db931ac2d6e15b0be5c56ed,Bram Moolenaar,26,0,26,3,"{""src/cmdexpand.c"": {""insertions"": 9, ""deletions"": 0, ""lines"": 9}, ""src/testdir/test_cmdline.vim"": {""insertions"": 15, ""deletions"": 0, ""lines"": 15}, ""src/version.c"": {""insertions"": 2, ""deletions"": 0, ""lines"": 2}}"
2020-06-18 18:50:10,efd885559405e1561d577e1b0e6fa827705d285e,Bram Moolenaar,128,31,159,4,"{""src/testdir/test_vim9_disassemble.vim"": {""insertions"": 24, ""deletions"": 0, ""lines"": 24}, ""src/testdir/test_vim9_func.vim"": {""insertions"": 25, ""deletions"": 0, ""lines"": 25}, ""src/version.c"": {""insertions"": 2, ""deletions"": 0, ""lines"": 2}, ""src/vim9compile.c"": {""insertions"": 77, ""deletions"": 31, ""lines"": 108}}"
2020-06-18 17:31:08,9b68c82b7ca768100f3eb4223d100c62c5429e53,Bram Moolenaar,38,28,66,2,"{""src/version.c"": {""insertions"": 2, ""deletions"": 0, ""lines"": 2}, ""src/vim9compile.c"": {""insertions"": 36, ""deletions"": 28, ""lines"": 64}}"
2020-06-18 17:15:27,511feec6f0a9e954f1d7353425fa51232b1a8e88,Bram Moolenaar,90,3,93,6,"{""src/drawline.c"": {""insertions"": 3, ""deletions"": 3, ""lines"": 6}, ""src/testdir/dumps/Test_diff_rnu_01.dump"": {""insertions"": 20, ""deletions"": 0, ""lines"": 20}, ""src/testdir/dumps/Test_diff_rnu_02.dump"": {""insertions"": 20, ""deletions"": 0, ""lines"": 20}, ""src/testdir/dumps/Test_diff_rnu_03.dump"": {""insertions"": 20, ""deletions"": 0, ""lines"": 20}, ""src/testdir/test_diffmode.vim"": {""insertions"": 25, ""deletions"": 0, ""lines"": 25}, ""src/version.c"": {""insertions"": 2, ""deletions"": 0, ""lines"": 2}}"
2020-06-18 16:45:49,865af6b990f058fab10c9ff10c77eb0e3bd48ad5,Bram Moolenaar,16,1,17,3,"{""src/evalfunc.c"": {""insertions"": 9, ""deletions"": 1, ""lines"": 10}, ""src/testdir/test_vim9_func.vim"": {""insertions"": 5, ""deletions"": 0, ""lines"": 5}, ""src/version.c"": {""insertions"": 2, ""deletions"": 0, ""lines"": 2}}"
2020-06-18 16:33:59,ceb2e7751089bd417c6250d63e28616483b5796b,Bram Moolenaar,8,4,12,2,"{""src/testdir/term_util.vim"": {""insertions"": 6, ""deletions"": 4, ""lines"": 10}, ""src/version.c"": {""insertions"": 2, ""deletions"": 0, ""lines"": 2}}"
2020-06-18 16:26:24,72abcf42d4b28719863c3bdf72b4c05d147a7d83,Bram Moolenaar,71,38,109,3,"{""src/testdir/test_vim9_script.vim"": {""insertions"": 20, ""deletions"": 0, ""lines"": 20}, ""src/version.c"": {""insertions"": 2, ""deletions"": 0, ""lines"": 2}, ""src/vim9compile.c"": {""insertions"": 49, ""deletions"": 38, ""lines"": 87}}"
2020-06-18 15:28:39,158ea175a99fc23eae1b0a5ee9a81cdd973854a6,Bram Moolenaar,15,1,16,3,"{""src/ex_docmd.c"": {""insertions"": 2, ""deletions"": 1, ""lines"": 3}, ""src/testdir/test_ex_mode.vim"": {""insertions"": 11, ""deletions"": 0, ""lines"": 11}, ""src/version.c"": {""insertions"": 2, ""deletions"": 0, ""lines"": 2}}"
2020-06-18 13:33:25,2f03e5a0a9cfaabb01c57dd3348a05e86c26623c,Bram Moolenaar,28,0,28,3,"{""src/testdir/test_textobjects.vim"": {""insertions"": 11, ""deletions"": 0, ""lines"": 11}, ""src/textobject.c"": {""insertions"": 15, ""deletions"": 0, ""lines"": 15}, ""src/version.c"": {""insertions"": 2, ""deletions"": 0, ""lines"": 2}}"
2020-06-17 20:58:35,3d9207ad2fc98b4f92f77b5a3d52a3a4d25b9561,Bram Moolenaar,71,0,71,2,"{""src/testdir/test_tagjump.vim"": {""insertions"": 69, ""deletions"": 0, ""lines"": 69}, ""src/version.c"": {""insertions"": 2, ""deletions"": 0, ""lines"": 2}}"
2020-06-17 19:47:23,856c1110c1cf0d6e44e387b70732ca4b4c8ef0f2,Bram Moolenaar,169,1,170,4,"{""runtime/doc/repeat.txt"": {""insertions"": 5, ""deletions"": 0, ""lines"": 5}, ""src/register.c"": {""insertions"": 86, ""deletions"": 1, ""lines"": 87}, ""src/testdir/test_registers.vim"": {""insertions"": 76, ""deletions"": 0, ""lines"": 76}, ""src/version.c"": {""insertions"": 2, ""deletions"": 0, ""lines"": 2}}"
2020-06-17 19:41:35,40a019f157c549dcdc17c33f082975485567bb06,Bram Moolenaar,5,3,8,4,"{""runtime/doc/eval.txt"": {""insertions"": 1, ""deletions"": 1, ""lines"": 2}, ""src/evalwindow.c"": {""insertions"": 1, ""deletions"": 1, ""lines"": 2}, ""src/testdir/test_autocmd.vim"": {""insertions"": 1, ""deletions"": 1, ""lines"": 2}, ""src/version.c"": {""insertions"": 2, ""deletions"": 0, ""lines"": 2}}"
2020-06-17 18:30:44,e17f8817a1713a1ef20257c777a483b7ab57a841,Bram Moolenaar,21,0,21,2,"{""src/testdir/test_functions.vim"": {""insertions"": 19, ""deletions"": 0, ""lines"": 19}, ""src/version.c"": {""insertions"": 2, ""deletions"": 0, ""lines"": 2}}"
2020-06-17 18:03:36,9bb3eb3e02a942fb71a4c1ce913f938d0ddf82d5,Bram Moolenaar,14,6,20,2,"{""src/testdir/test_vim9_script.vim"": {""insertions"": 12, ""deletions"": 6, ""lines"": 18}, ""src/version.c"": {""insertions"": 2, ""deletions"": 0, ""lines"": 2}}"
2020-06-17 10:04:54,f7d267ef20a38eb316915b91cb5a89021555f9d8,Bram Moolenaar,9,8,17,2,"{""src/testdir/test_vim9_script.vim"": {""insertions"": 7, ""deletions"": 8, ""lines"": 15}, ""src/version.c"": {""insertions"": 2, ""deletions"": 0, ""lines"": 2}}"
2020-06-16 21:18:51,101f4810e27e432970bc8809e18f018e1795937f,Bram Moolenaar,44,12,56,4,"{""src/testdir/term_util.vim"": {""insertions"": 12, ""deletions"": 10, ""lines"": 22}, ""src/testdir/test_vim9_script.vim"": {""insertions"": 20, ""deletions"": 0, ""lines"": 20}, ""src/version.c"": {""insertions"": 2, ""deletions"": 0, ""lines"": 2}, ""src/vim9script.c"": {""insertions"": 10, ""deletions"": 2, ""lines"": 12}}"
2020-06-16 20:42:04,0fe937fd8616fcd24b1b1ef2ab9f1657615dd22c,Bram Moolenaar,36,3,39,5,"{""runtime/doc/eval.txt"": {""insertions"": 3, ""deletions"": 0, ""lines"": 3}, ""src/evalwindow.c"": {""insertions"": 8, ""deletions"": 3, ""lines"": 11}, ""src/testdir/test_autocmd.vim"": {""insertions"": 22, ""deletions"": 0, ""lines"": 22}, ""src/testdir/test_preview.vim"": {""insertions"": 1, ""deletions"": 0, ""lines"": 1}, ""src/version.c"": {""insertions"": 2, ""deletions"": 0, ""lines"": 2}}"
2020-06-16 20:27:39,a1bc6f12936a9f621238b940d5c6e97837809447,Bram Moolenaar,4,2,6,3,"{""src/globals.h"": {""insertions"": 1, ""deletions"": 2, ""lines"": 3}, ""src/testdir/test_functions.vim"": {""insertions"": 1, ""deletions"": 0, ""lines"": 1}, ""src/version.c"": {""insertions"": 2, ""deletions"": 0, ""lines"": 2}}"
2020-06-16 18:58:07,a6e8bf2d8929ef52eeda495e0e0c3d2bff8f5830,Bram Moolenaar,19,0,19,3,"{""src/libvterm/src/screen.c"": {""insertions"": 6, ""deletions"": 0, ""lines"": 6}, ""src/libvterm/src/state.c"": {""insertions"": 11, ""deletions"": 0, ""lines"": 11}, ""src/version.c"": {""insertions"": 2, ""deletions"": 0, ""lines"": 2}}"
2020-06-16 18:03:43,84cf6bd81bec93b49166cd48fccc7087fdbaa6fc,Bram Moolenaar,272,32,304,17,"{""runtime/doc/eval.txt"": {""insertions"": 49, ""deletions"": 11, ""lines"": 60}, ""runtime/doc/mlang.txt"": {""insertions"": 10, ""deletions"": 2, ""lines"": 12}, ""src/auto/configure"": {""insertions"": 1, ""deletions"": 1, ""lines"": 2}, ""src/cmdexpand.c"": {""insertions"": 2, ""deletions"": 1, ""lines"": 3}, ""src/config.h.in"": {""insertions"": 1, ""deletions"": 0, ""lines"": 1}, ""src/configure.ac"": {""insertions"": 1, ""deletions"": 1, ""lines"": 2}, ""src/evalfunc.c"": {""insertions"": 2, ""deletions"": 2, ""lines"": 4}, ""src/evalvars.c"": {""insertions"": 1, ""deletions"": 0, ""lines"": 1}, ""src/ex_cmds2.c"": {""insertions"": 19, ""deletions"": 3, ""lines"": 22}, ""src/fileio.c"": {""insertions"": 32, ""deletions"": 5, ""lines"": 37}, ""src/filepath.c"": {""insertions"": 42, ""deletions"": 2, ""lines"": 44}, ""src/globals.h"": {""insertions"": 2, ""deletions"": 0, ""lines"": 2}, ""src/proto/fileio.pro"": {""insertions"": 1, ""deletions"": 1, ""lines"": 2}, ""src/testdir/test_cmdline.vim"": {""insertions"": 14, ""deletions"": 1, ""lines"": 15}, ""src/testdir/test_functions.vim"": {""insertions"": 79, ""deletions"": 0, ""lines"": 79}, ""src/version.c"": {""insertions"": 2, ""deletions"": 0, ""lines"": 2}, ""src/vim.h"": {""insertions"": 14, ""deletions"": 2, ""lines"": 16}}"
2020-06-16 09:34:42,9af78769eeae0318e07aa8b6af4d6e2244481ca7,Bram Moolenaar,161,17,178,8,"{""src/eval.c"": {""insertions"": 1, ""deletions"": 12, ""lines"": 13}, ""src/list.c"": {""insertions"": 20, ""deletions"": 0, ""lines"": 20}, ""src/proto/list.pro"": {""insertions"": 1, ""deletions"": 0, ""lines"": 1}, ""src/testdir/test_vim9_script.vim"": {""insertions"": 26, ""deletions"": 1, ""lines"": 27}, ""src/version.c"": {""insertions"": 2, ""deletions"": 0, ""lines"": 2}, ""src/vim9.h"": {""insertions"": 9, ""deletions"": 0, ""lines"": 9}, ""src/vim9compile.c"": {""insertions"": 48, ""deletions"": 4, ""lines"": 52}, ""src/vim9execute.c"": {""insertions"": 54, ""deletions"": 0, ""lines"": 54}}"
2020-06-15 21:18:12,c70222d12a2f8552273c0de48a3bf7138d649175,Bram Moolenaar,6,2,8,2,"{""src/testdir/test_functions.vim"": {""insertions"": 4, ""deletions"": 2, ""lines"": 6}, ""src/version.c"": {""insertions"": 2, ""deletions"": 0, ""lines"": 2}}"
2020-06-15 19:41:56,fdcbe3c3fedf48a43b22938c9331addb2f1182f1,Bram Moolenaar,17,1,18,3,"{""src/findfile.c"": {""insertions"": 8, ""deletions"": 0, ""lines"": 8}, ""src/testdir/test_functions.vim"": {""insertions"": 7, ""deletions"": 1, ""lines"": 8}, ""src/version.c"": {""insertions"": 2, ""deletions"": 0, ""lines"": 2}}"
2020-06-15 19:19:08,ab176ce982ac67f7cfcfa1fa885f9117ef8bbafe,Bram Moolenaar,35,5,40,3,"{""src/popupwin.c"": {""insertions"": 16, ""deletions"": 5, ""lines"": 21}, ""src/testdir/test_popupwin.vim"": {""insertions"": 17, ""deletions"": 0, ""lines"": 17}, ""src/version.c"": {""insertions"": 2, ""deletions"": 0, ""lines"": 2}}"
2020-06-15 18:24:58,ad72350360d1a68d251da62a6e8610950926278c,Bram Moolenaar,5,2,7,3,"{""runtime/filetype.vim"": {""insertions"": 2, ""deletions"": 1, ""lines"": 3}, ""src/testdir/test_filetype.vim"": {""insertions"": 1, ""deletions"": 1, ""lines"": 2}, ""src/version.c"": {""insertions"": 2, ""deletions"": 0, ""lines"": 2}}"
2020-06-15 17:51:56,b340baed9f7fc1c19a0742e2214d54982190c15e,Bram Moolenaar,196,3,199,9,"{""runtime/doc/testing.txt"": {""insertions"": 2, ""deletions"": 0, ""lines"": 2}, ""src/globals.h"": {""insertions"": 1, ""deletions"": 0, ""lines"": 1}, ""src/testdir/test_autocmd.vim"": {""insertions"": 53, ""deletions"": 0, ""lines"": 53}, ""src/testdir/test_edit.vim"": {""insertions"": 111, ""deletions"": 2, ""lines"": 113}, ""src/testdir/test_filechanged.vim"": {""insertions"": 9, ""deletions"": 0, ""lines"": 9}, ""src/testdir/test_writefile.vim"": {""insertions"": 8, ""deletions"": 0, ""lines"": 8}, ""src/testing.c"": {""insertions"": 3, ""deletions"": 0, ""lines"": 3}, ""src/ui.c"": {""insertions"": 7, ""deletions"": 1, ""lines"": 8}, ""src/version.c"": {""insertions"": 2, ""deletions"": 0, ""lines"": 2}}"
2020-06-14 21:05:10,47a519a933e8bcaf703a5feaac5c01491a658ee3,Bram Moolenaar,741,558,1299,8,"{""src/eval.c"": {""insertions"": 1, ""deletions"": 1, ""lines"": 2}, ""src/evalvars.c"": {""insertions"": 17, ""deletions"": 11, ""lines"": 28}, ""src/proto/evalvars.pro"": {""insertions"": 2, ""deletions"": 1, ""lines"": 3}, ""src/testdir/test_vim9_script.vim"": {""insertions"": 8, ""deletions"": 0, ""lines"": 8}, ""src/version.c"": {""insertions"": 2, ""deletions"": 0, ""lines"": 2}, ""src/vim9.h"": {""insertions"": 1, ""deletions"": 0, ""lines"": 1}, ""src/vim9compile.c"": {""insertions"": 683, ""deletions"": 545, ""lines"": 1228}, ""src/vim9execute.c"": {""insertions"": 27, ""deletions"": 0, ""lines"": 27}}"
2020-06-14 18:04:32,a65d8b5bb9e9267c6e4500c67d26c839a64f30eb,Bram Moolenaar,4,1,5,3,"{""runtime/filetype.vim"": {""insertions"": 1, ""deletions"": 0, ""lines"": 1}, ""src/testdir/test_filetype.vim"": {""insertions"": 1, ""deletions"": 1, ""lines"": 2}, ""src/version.c"": {""insertions"": 2, ""deletions"": 0, ""lines"": 2}}"
2020-06-14 15:29:55,65e0d77a66b7e50beb562ad554ace46c32ef8f0f,Bram Moolenaar,626,229,855,25,"{""runtime/doc/Makefile"": {""insertions"": 2, ""deletions"": 0, ""lines"": 2}, ""runtime/doc/autocmd.txt"": {""insertions"": 1, ""deletions"": 1, ""lines"": 2}, ""runtime/doc/eval.txt"": {""insertions"": 24, ""deletions"": 8, ""lines"": 32}, ""runtime/doc/options.txt"": {""insertions"": 2, ""deletions"": 2, ""lines"": 4}, ""runtime/doc/os_vms.txt"": {""insertions"": 1, ""deletions"": 1, ""lines"": 2}, ""runtime/doc/quickref.txt"": {""insertions"": 2, ""deletions"": 1, ""lines"": 3}, ""runtime/doc/spell.txt"": {""insertions"": 1, ""deletions"": 1, ""lines"": 2}, ""runtime/doc/syntax.txt"": {""insertions"": 7, ""deletions"": 5, ""lines"": 12}, ""runtime/doc/tags"": {""insertions"": 20, ""deletions"": 14, ""lines"": 34}, ""runtime/doc/testing.txt"": {""insertions"": 1, ""deletions"": 1, ""lines"": 2}, ""runtime/doc/todo.txt"": {""insertions"": 39, ""deletions"": 82, ""lines"": 121}, ""runtime/doc/usr_41.txt"": {""insertions"": 8, ""deletions"": 5, ""lines"": 13}, ""runtime/doc/usr_45.txt"": {""insertions"": 4, ""deletions"": 4, ""lines"": 8}, ""runtime/doc/usr_46.txt"": {""insertions"": 192, ""deletions"": 0, ""lines"": 192}, ""runtime/doc/usr_90.txt"": {""insertions"": 2, ""deletions"": 2, ""lines"": 4}, ""runtime/doc/usr_toc.txt"": {""insertions"": 3, ""deletions"": 2, ""lines"": 5}, ""runtime/doc/version8.txt"": {""insertions"": 4, ""deletions"": 4, ""lines"": 8}, ""runtime/doc/vim9.txt"": {""insertions"": 55, ""deletions"": 12, ""lines"": 67}, ""runtime/doc/windows.txt"": {""insertions"": 6, ""deletions"": 0, ""lines"": 6}, ""runtime/menu.vim"": {""insertions"": 4, ""deletions"": 4, ""lines"": 8}, ""runtime/optwin.vim"": {""insertions"": 4, ""deletions"": 1, ""lines"": 5}, ""runtime/pack/dist/opt/termdebug/plugin/termdebug.vim"": {""insertions"": 2, ""deletions"": 2, ""lines"": 4}, ""runtime/syntax/desktop.vim"": {""insertions"": 233, ""deletions"": 73, ""lines"": 306}, ""runtime/syntax/objc.vim"": {""insertions"": 3, ""deletions"": 2, ""lines"": 5}, ""runtime/syntax/tex.vim"": {""insertions"": 6, ""deletions"": 2, ""lines"": 8}}"
2020-06-14 14:43:47,8e20f75e58f4879308b0011b468ef928a3f93085,Bram Moolenaar,4,1,5,2,"{""src/term.c"": {""insertions"": 2, ""deletions"": 1, ""lines"": 3}, ""src/version.c"": {""insertions"": 2, ""deletions"": 0, ""lines"": 2}}"
2020-06-14 13:35:58,0c8059e0b673a11f878acf4067a4b92679f1e0e5,Bram Moolenaar,3,1,4,2,"{""src/term.c"": {""insertions"": 1, ""deletions"": 1, ""lines"": 2}, ""src/version.c"": {""insertions"": 2, ""deletions"": 0, ""lines"": 2}}"
2020-06-14 12:34:16,8dff4cbf6d917e20322821e8e866ffc1c1175258,Bram Moolenaar,10,2,12,3,"{""src/term.c"": {""insertions"": 2, ""deletions"": 1, ""lines"": 3}, ""src/testdir/test_termcodes.vim"": {""insertions"": 6, ""deletions"": 1, ""lines"": 7}, ""src/version.c"": {""insertions"": 2, ""deletions"": 0, ""lines"": 2}}"
2020-06-14 11:50:55,df7df59d85e7e56a796912dc865488a75d3f0e53,Bram Moolenaar,301,81,382,5,"{""src/testdir/test_cd.vim"": {""insertions"": 0, ""deletions"": 24, ""lines"": 24}, ""src/testdir/test_charsearch.vim"": {""insertions"": 0, ""deletions"": 30, ""lines"": 30}, ""src/testdir/test_cpoptions.vim"": {""insertions"": 299, ""deletions"": 19, ""lines"": 318}, ""src/testdir/test_normal.vim"": {""insertions"": 0, ""deletions"": 8, ""lines"": 8}, ""src/version.c"": {""insertions"": 2, ""deletions"": 0, ""lines"": 2}}"
2020-06-14 10:50:24,984dddbef421eda6b8ad60936f380c5f00aebb96,Bram Moolenaar,27,3,30,3,"{""src/testdir/test_vim9_script.vim"": {""insertions"": 17, ""deletions"": 0, ""lines"": 17}, ""src/version.c"": {""insertions"": 2, ""deletions"": 0, ""lines"": 2}, ""src/vim9script.c"": {""insertions"": 8, ""deletions"": 3, ""lines"": 11}}"
2020-06-13 17:56:38,f3decc5830ef8d8d94902b76114935283dd4142e,Bram Moolenaar,5,0,5,2,"{""src/version.c"": {""insertions"": 2, ""deletions"": 0, ""lines"": 2}, ""src/vim9script.c"": {""insertions"": 3, ""deletions"": 0, ""lines"": 3}}"
2020-06-13 17:00:10,34db91f7a47b7bd4aabf1e1dfbaa8a08278bf78d,Bram Moolenaar,51,8,59,7,"{""src/evalvars.c"": {""insertions"": 10, ""deletions"": 5, ""lines"": 15}, ""src/proto/vim9compile.pro"": {""insertions"": 2, ""deletions"": 0, ""lines"": 2}, ""src/proto/vim9script.pro"": {""insertions"": 1, ""deletions"": 0, ""lines"": 1}, ""src/testdir/test_vim9_script.vim"": {""insertions"": 9, ""deletions"": 0, ""lines"": 9}, ""src/version.c"": {""insertions"": 2, ""deletions"": 0, ""lines"": 2}, ""src/vim9compile.c"": {""insertions"": 2, ""deletions"": 3, ""lines"": 5}, ""src/vim9script.c"": {""insertions"": 25, ""deletions"": 0, ""lines"": 25}}"
2020-06-13 16:09:19,c82a5b5da5eab15bc35115545b639fb590272ad7,Bram Moolenaar,92,5,97,7,"{""src/evalvars.c"": {""insertions"": 12, ""deletions"": 2, ""lines"": 14}, ""src/globals.h"": {""insertions"": 2, ""deletions"": 0, ""lines"": 2}, ""src/proto/vim9script.pro"": {""insertions"": 1, ""deletions"": 0, ""lines"": 1}, ""src/testdir/test_vim9_script.vim"": {""insertions"": 16, ""deletions"": 0, ""lines"": 16}, ""src/version.c"": {""insertions"": 2, ""deletions"": 0, ""lines"": 2}, ""src/vim9compile.c"": {""insertions"": 4, ""deletions"": 3, ""lines"": 7}, ""src/vim9script.c"": {""insertions"": 55, ""deletions"": 0, ""lines"": 55}}"
2020-06-13 14:39:31,142499de3352e1edb2ab6cc2bf3b82441c8e5f4f,Bram Moolenaar,9,1,10,2,"{""src/term.c"": {""insertions"": 7, ""deletions"": 1, ""lines"": 8}, ""src/version.c"": {""insertions"": 2, ""deletions"": 0, ""lines"": 2}}"
2020-06-13 13:47:25,0c0eddd3ddd266bcc2036362fae7b2b8b9d2c7bf,Bram Moolenaar,172,5,177,11,"{""runtime/doc/eval.txt"": {""insertions"": 38, ""deletions"": 1, ""lines"": 39}, ""runtime/doc/testing.txt"": {""insertions"": 2, ""deletions"": 0, ""lines"": 2}, ""runtime/doc/usr_41.txt"": {""insertions"": 1, ""deletions"": 0, ""lines"": 1}, ""src/evalfunc.c"": {""insertions"": 1, ""deletions"": 0, ""lines"": 1}, ""src/globals.h"": {""insertions"": 1, ""deletions"": 0, ""lines"": 1}, ""src/main.c"": {""insertions"": 4, ""deletions"": 0, ""lines"": 4}, ""src/proto/term.pro"": {""insertions"": 2, ""deletions"": 0, ""lines"": 2}, ""src/term.c"": {""insertions"": 26, ""deletions"": 4, ""lines"": 30}, ""src/testdir/test_termcodes.vim"": {""insertions"": 92, ""deletions"": 0, ""lines"": 92}, ""src/testing.c"": {""insertions"": 3, ""deletions"": 0, ""lines"": 3}, ""src/version.c"": {""insertions"": 2, ""deletions"": 0, ""lines"": 2}}"
2020-06-13 13:13:38,4a021dfbeee88ac09d07e257912485314ecdcabe,Bram Moolenaar,99,2,101,3,"{""src/testdir/test_assert.vim"": {""insertions"": 20, ""deletions"": 0, ""lines"": 20}, ""src/testing.c"": {""insertions"": 77, ""deletions"": 2, ""lines"": 79}, ""src/version.c"": {""insertions"": 2, ""deletions"": 0, ""lines"": 2}}"
2020-06-13 11:20:48,c9630d2658af9dcaa01913e899b201bfdef7b536,Bram Moolenaar,631,110,741,5,"{""src/testdir/Make_all.mak"": {""insertions"": 2, ""deletions"": 0, ""lines"": 2}, ""src/testdir/test_cpoptions.vim"": {""insertions"": 627, ""deletions"": 0, ""lines"": 627}, ""src/testdir/test_edit.vim"": {""insertions"": 0, ""deletions"": 33, ""lines"": 33}, ""src/testdir/test_normal.vim"": {""insertions"": 0, ""deletions"": 77, ""lines"": 77}, ""src/version.c"": {""insertions"": 2, ""deletions"": 0, ""lines"": 2}}"
2020-06-12 20:59:11,71ccd03ee8a43b20000214a9c99dcc90f039edca,Bram Moolenaar,66,64,130,31,"{""src/evalvars.c"": {""insertions"": 1, ""deletions"": 1, ""lines"": 2}, ""src/ex_cmds.c"": {""insertions"": 1, ""deletions"": 1, ""lines"": 2}, ""src/ex_eval.c"": {""insertions"": 3, ""deletions"": 3, ""lines"": 6}, ""src/fileio.c"": {""insertions"": 1, ""deletions"": 1, ""lines"": 2}, ""src/filepath.c"": {""insertions"": 6, ""deletions"": 6, ""lines"": 12}, ""src/findfile.c"": {""insertions"": 2, ""deletions"": 2, ""lines"": 4}, ""src/highlight.c"": {""insertions"": 2, ""deletions"": 2, ""lines"": 4}, ""src/if_perl.xs"": {""insertions"": 1, ""deletions"": 1, ""lines"": 2}, ""src/if_ruby.c"": {""insertions"": 1, ""deletions"": 1, ""lines"": 2}, ""src/insexpand.c"": {""insertions"": 2, ""deletions"": 2, ""lines"": 4}, ""src/json.c"": {""insertions"": 1, ""deletions"": 1, ""lines"": 2}, ""src/mark.c"": {""insertions"": 1, ""deletions"": 1, ""lines"": 2}, ""src/memline.c"": {""insertions"": 1, ""deletions"": 1, ""lines"": 2}, ""src/menu.c"": {""insertions"": 2, ""deletions"": 2, ""lines"": 4}, ""src/misc1.c"": {""insertions"": 3, ""deletions"": 3, ""lines"": 6}, ""src/ops.c"": {""insertions"": 1, ""deletions"": 1, ""lines"": 2}, ""src/os_win32.c"": {""insertions"": 1, ""deletions"": 2, ""lines"": 3}, ""src/regexp.c"": {""insertions"": 2, ""deletions"": 2, ""lines"": 4}, ""src/regexp_bt.c"": {""insertions"": 1, ""deletions"": 1, ""lines"": 2}, ""src/regexp_nfa.c"": {""insertions"": 1, ""deletions"": 2, ""lines"": 3}, ""src/register.c"": {""insertions"": 1, ""deletions"": 1, ""lines"": 2}, ""src/search.c"": {""insertions"": 1, ""deletions"": 1, ""lines"": 2}, ""src/sign.c"": {""insertions"": 4, ""deletions"": 4, ""lines"": 8}, ""src/syntax.c"": {""insertions"": 8, ""deletions"": 6, ""lines"": 14}, ""src/term.c"": {""insertions"": 2, ""deletions"": 2, ""lines"": 4}, ""src/terminal.c"": {""insertions"": 2, ""deletions"": 2, ""lines"": 4}, ""src/undo.c"": {""insertions"": 1, ""deletions"": 1, ""lines"": 2}, ""src/usercmd.c"": {""insertions"": 2, ""deletions"": 2, ""lines"": 4}, ""src/userfunc.c"": {""insertions"": 5, ""deletions"": 5, ""lines"": 10}, ""src/version.c"": {""insertions"": 2, ""deletions"": 0, ""lines"": 2}, ""src/vim9compile.c"": {""insertions"": 4, ""deletions"": 4, ""lines"": 8}}"
2020-06-12 20:31:00,722e505d1a55dfde5ab62241d10da91d2e10c3c1,Bram Moolenaar,15,5,20,7,"{""src/buffer.c"": {""insertions"": 1, ""deletions"": 1, ""lines"": 2}, ""src/bufwrite.c"": {""insertions"": 7, ""deletions"": 1, ""lines"": 8}, ""src/fileio.c"": {""insertions"": 2, ""deletions"": 1, ""lines"": 3}, ""src/proto/bufwrite.pro"": {""insertions"": 1, ""deletions"": 0, ""lines"": 1}, ""src/testdir/dumps/Test_popup_textprop_corn_5.dump"": {""insertions"": 1, ""deletions"": 1, ""lines"": 2}, ""src/testdir/dumps/Test_start_with_tabs.dump"": {""insertions"": 1, ""deletions"": 1, ""lines"": 2}, ""src/version.c"": {""insertions"": 2, ""deletions"": 0, ""lines"": 2}}"
2020-06-12 20:15:31,5055c56cfbedc6326c607d40c7a1241682f7675e,Bram Moolenaar,2,10,12,3,"{""src/autocmd.c"": {""insertions"": 0, ""deletions"": 9, ""lines"": 9}, ""src/proto/autocmd.pro"": {""insertions"": 0, ""deletions"": 1, ""lines"": 1}, ""src/version.c"": {""insertions"": 2, ""deletions"": 0, ""lines"": 2}}"
2020-06-12 20:09:01,37d1673ce007c46ec2338f3236ae1b7b0324bd25,Bram Moolenaar,15,5,20,4,"{""runtime/doc/autocmd.txt"": {""insertions"": 2, ""deletions"": 0, ""lines"": 2}, ""src/register.c"": {""insertions"": 2, ""deletions"": 0, ""lines"": 2}, ""src/testdir/test_autocmd.vim"": {""insertions"": 9, ""deletions"": 5, ""lines"": 14}, ""src/version.c"": {""insertions"": 2, ""deletions"": 0, ""lines"": 2}}"
2020-06-12 18:19:44,6c6be9e88d72a60ee279ccad73d018c534b71d66,Bram Moolenaar,49,4,53,5,"{""runtime/doc/options.txt"": {""insertions"": 0, ""deletions"": 2, ""lines"": 2}, ""runtime/doc/various.txt"": {""insertions"": 1, ""deletions"": 1, ""lines"": 2}, ""src/ops.c"": {""insertions"": 10, ""deletions"": 1, ""lines"": 11}, ""src/testdir/test_increment.vim"": {""insertions"": 36, ""deletions"": 0, ""lines"": 36}, ""src/version.c"": {""insertions"": 2, ""deletions"": 0, ""lines"": 2}}"
2020-06-12 18:11:55,f6e020b1225970d95e6848b79066f82d9e65b66c,Bram Moolenaar,10,0,10,2,"{""src/testdir/Makefile"": {""insertions"": 8, ""deletions"": 0, ""lines"": 8}, ""src/version.c"": {""insertions"": 2, ""deletions"": 0, ""lines"": 2}}"
2020-06-12 17:35:32,ec68028604b6ee799b2ef5fc861ec5163e82914f,Bram Moolenaar,98,47,145,4,"{""src/cmdexpand.c"": {""insertions"": 1, ""deletions"": 0, ""lines"": 1}, ""src/ex_cmds2.c"": {""insertions"": 88, ""deletions"": 36, ""lines"": 124}, ""src/testdir/test_cmdline.vim"": {""insertions"": 7, ""deletions"": 11, ""lines"": 18}, ""src/version.c"": {""insertions"": 2, ""deletions"": 0, ""lines"": 2}}"
2020-06-11 21:10:46,9721fb4ea3db2559aaf7f71458da8ddda30ff93e,Bram Moolenaar,91,25,116,5,"{""src/evalvars.c"": {""insertions"": 6, ""deletions"": 2, ""lines"": 8}, ""src/testdir/test_vim9_script.vim"": {""insertions"": 42, ""deletions"": 1, ""lines"": 43}, ""src/userfunc.c"": {""insertions"": 37, ""deletions"": 12, ""lines"": 49}, ""src/version.c"": {""insertions"": 2, ""deletions"": 0, ""lines"": 2}, ""src/vim9script.c"": {""insertions"": 4, ""deletions"": 10, ""lines"": 14}}"
2020-06-11 17:35:52,00e260bb6cc33ff5dbba15ac87ca7fd465aa49c0,Bram Moolenaar,112,68,180,4,"{""runtime/doc/quickfix.txt"": {""insertions"": 17, ""deletions"": 12, ""lines"": 29}, ""src/quickfix.c"": {""insertions"": 56, ""deletions"": 36, ""lines"": 92}, ""src/testdir/test_quickfix.vim"": {""insertions"": 37, ""deletions"": 20, ""lines"": 57}, ""src/version.c"": {""insertions"": 2, ""deletions"": 0, ""lines"": 2}}"
2020-06-11 17:22:43,1de5f7c81d5e78fb4d612134bd2dfa6ee9183fae,Bram Moolenaar,67,0,67,3,"{""src/testdir/test_backup.vim"": {""insertions"": 17, ""deletions"": 0, ""lines"": 17}, ""src/testdir/test_writefile.vim"": {""insertions"": 48, ""deletions"": 0, ""lines"": 48}, ""src/version.c"": {""insertions"": 2, ""deletions"": 0, ""lines"": 2}}"
2020-06-11 10:30:13,2d4070d3b02e775a6f3d5ef52265add270e09a4f,Bram Moolenaar,3,1,4,2,"{""src/spell.c"": {""insertions"": 1, ""deletions"": 1, ""lines"": 2}, ""src/version.c"": {""insertions"": 2, ""deletions"": 0, ""lines"": 2}}"
2020-06-10 20:17:58,e0ebeda4d8219a8955001b43ef7a9268452ef7f5,Bram Moolenaar,27,1,28,2,"{""src/spell.c"": {""insertions"": 25, ""deletions"": 1, ""lines"": 26}, ""src/version.c"": {""insertions"": 2, ""deletions"": 0, ""lines"": 2}}"
2020-06-10 20:12:04,215f49c4d720367be29f56168f363a0ee9eaf86b,Bram Moolenaar,3,0,3,2,"{""src/structs.h"": {""insertions"": 1, ""deletions"": 0, ""lines"": 1}, ""src/version.c"": {""insertions"": 2, ""deletions"": 0, ""lines"": 2}}"
2020-06-10 20:07:52,f1f0ff9557353c9a452aac8540411a88cf2da47c,Bram Moolenaar,4,2,6,3,"{""runtime/filetype.vim"": {""insertions"": 1, ""deletions"": 1, ""lines"": 2}, ""src/testdir/test_filetype.vim"": {""insertions"": 1, ""deletions"": 1, ""lines"": 2}, ""src/version.c"": {""insertions"": 2, ""deletions"": 0, ""lines"": 2}}"
2020-06-10 19:47:00,362b44bd4aa87a2aef0f8fd5a28d68dd09a7d909,Bram Moolenaar,45,0,45,10,"{""runtime/doc/options.txt"": {""insertions"": 10, ""deletions"": 0, ""lines"": 10}, ""runtime/doc/spell.txt"": {""insertions"": 3, ""deletions"": 0, ""lines"": 3}, ""src/buffer.c"": {""insertions"": 1, ""deletions"": 0, ""lines"": 1}, ""src/option.c"": {""insertions"": 3, ""deletions"": 0, ""lines"": 3}, ""src/option.h"": {""insertions"": 2, ""deletions"": 0, ""lines"": 2}, ""src/optiondefs.h"": {""insertions"": 11, ""deletions"": 0, ""lines"": 11}, ""src/optionstr.c"": {""insertions"": 7, ""deletions"": 0, ""lines"": 7}, ""src/testdir/gen_opt_test.vim"": {""insertions"": 1, ""deletions"": 0, ""lines"": 1}, ""src/testdir/test_spell.vim"": {""insertions"": 5, ""deletions"": 0, ""lines"": 5}, ""src/version.c"": {""insertions"": 2, ""deletions"": 0, ""lines"": 2}}"
2020-06-10 18:56:58,be5ee8686a50acf07b823bd293f9c765e533d213,Bram Moolenaar,67,6,73,8,"{""runtime/doc/autocmd.txt"": {""insertions"": 11, ""deletions"": 0, ""lines"": 11}, ""src/autocmd.c"": {""insertions"": 1, ""deletions"": 0, ""lines"": 1}, ""src/getchar.c"": {""insertions"": 7, ""deletions"": 0, ""lines"": 7}, ""src/globals.h"": {""insertions"": 8, ""deletions"": 3, ""lines"": 11}, ""src/os_unix.c"": {""insertions"": 24, ""deletions"": 3, ""lines"": 27}, ""src/testdir/test_autocmd.vim"": {""insertions"": 13, ""deletions"": 0, ""lines"": 13}, ""src/version.c"": {""insertions"": 2, ""deletions"": 0, ""lines"": 2}, ""src/vim.h"": {""insertions"": 1, ""deletions"": 0, ""lines"": 1}}"
2020-06-10 18:21:09,6ba24d87630b1ec2b8c7ff71550c9e41d143800e,Bram Moolenaar,2,1,3,2,"{""src/testdir/test_search_stat.vim"": {""insertions"": 0, ""deletions"": 1, ""lines"": 1}, ""src/version.c"": {""insertions"": 2, ""deletions"": 0, ""lines"": 2}}"
2020-06-10 15:13:48,13b8205b442f52f34deac98e3312a27dec14d8e2,Bram Moolenaar,3,1,4,2,"{""src/testdir/test_tagjump.vim"": {""insertions"": 1, ""deletions"": 1, ""lines"": 2}, ""src/version.c"": {""insertions"": 2, ""deletions"": 0, ""lines"": 2}}"
2020-06-10 14:54:13,ea1233fccf4f52f2b4eaab3788a087878d1336fc,Bram Moolenaar,7,0,7,3,"{""src/testdir/test_functions.vim"": {""insertions"": 4, ""deletions"": 0, ""lines"": 4}, ""src/time.c"": {""insertions"": 1, ""deletions"": 0, ""lines"": 1}, ""src/version.c"": {""insertions"": 2, ""deletions"": 0, ""lines"": 2}}"
2020-06-10 14:39:32,d281b7c227bc4c78813fdc297ccee4b2cad7e605,Bram Moolenaar,5,3,8,2,"{""src/testdir/test_spell.vim"": {""insertions"": 3, ""deletions"": 3, ""lines"": 6}, ""src/version.c"": {""insertions"": 2, ""deletions"": 0, ""lines"": 2}}"
2020-06-10 13:55:36,ab54032f297e9418b0d83970cbe3a414d6ef08c4,Bram Moolenaar,24,2,26,3,"{""src/fileio.c"": {""insertions"": 12, ""deletions"": 2, ""lines"": 14}, ""src/testdir/test_functions.vim"": {""insertions"": 10, ""deletions"": 0, ""lines"": 10}, ""src/version.c"": {""insertions"": 2, ""deletions"": 0, ""lines"": 2}}"
2020-06-10 13:45:57,eebd555733491cb55b9f30fe28772c0fd0ebacf7,Bram Moolenaar,17,3,20,3,"{""src/misc1.c"": {""insertions"": 3, ""deletions"": 3, ""lines"": 6}, ""src/testdir/test_functions.vim"": {""insertions"": 12, ""deletions"": 0, ""lines"": 12}, ""src/version.c"": {""insertions"": 2, ""deletions"": 0, ""lines"": 2}}"
2020-06-10 13:32:08,152e79e94bb935e75b866bd55479648cde11066a,Bram Moolenaar,105,14,119,7,"{""runtime/doc/eval.txt"": {""insertions"": 3, ""deletions"": 5, ""lines"": 8}, ""src/evalfunc.c"": {""insertions"": 44, ""deletions"": 2, ""lines"": 46}, ""src/globals.h"": {""insertions"": 3, ""deletions"": 0, ""lines"": 3}, ""src/spell.c"": {""insertions"": 1, ""deletions"": 1, ""lines"": 2}, ""src/spellsuggest.c"": {""insertions"": 12, ""deletions"": 1, ""lines"": 13}, ""src/testdir/test_spell.vim"": {""insertions"": 40, ""deletions"": 5, ""lines"": 45}, ""src/version.c"": {""insertions"": 2, ""deletions"": 0, ""lines"": 2}}"
2020-06-10 12:21:20,253ea9fa42278faa064f2590a5c0de46dc903a17,Bram Moolenaar,4,1,5,2,"{""src/testdir/test_xxd.vim"": {""insertions"": 2, ""deletions"": 1, ""lines"": 3}, ""src/version.c"": {""insertions"": 2, ""deletions"": 0, ""lines"": 2}}"
2020-06-10 12:16:49,32ee627750e8b7b3fa6516b893e72f6e6af54710,Bram Moolenaar,86,36,122,10,"{""src/charset.c"": {""insertions"": 35, ""deletions"": 29, ""lines"": 64}, ""src/drawline.c"": {""insertions"": 2, ""deletions"": 2, ""lines"": 4}, ""src/ex_cmds.c"": {""insertions"": 2, ""deletions"": 2, ""lines"": 4}, ""src/gui_beval.c"": {""insertions"": 1, ""deletions"": 1, ""lines"": 2}, ""src/message.c"": {""insertions"": 1, ""deletions"": 1, ""lines"": 2}, ""src/proto/charset.pro"": {""insertions"": 2, ""deletions"": 1, ""lines"": 3}, ""src/testdir/dumps/Test_display_unprintable_01.dump"": {""insertions"": 9, ""deletions"": 0, ""lines"": 9}, ""src/testdir/dumps/Test_display_unprintable_02.dump"": {""insertions"": 9, ""deletions"": 0, ""lines"": 9}, ""src/testdir/test_display.vim"": {""insertions"": 23, ""deletions"": 0, ""lines"": 23}, ""src/version.c"": {""insertions"": 2, ""deletions"": 0, ""lines"": 2}}"
2020-06-10 11:12:28,0e390f40e944036fb558a63b91238cfda128d95f,Bram Moolenaar,9,6,15,3,"{""src/filepath.c"": {""insertions"": 4, ""deletions"": 6, ""lines"": 10}, ""src/testdir/test_fnamemodify.vim"": {""insertions"": 3, ""deletions"": 0, ""lines"": 3}, ""src/version.c"": {""insertions"": 2, ""deletions"": 0, ""lines"": 2}}"
2020-06-10 10:15:51,517f00f78893087d2f9d45768a5ba4dc48cb6856,Bram Moolenaar,164,75,239,2,"{""src/term.c"": {""insertions"": 162, ""deletions"": 75, ""lines"": 237}, ""src/version.c"": {""insertions"": 2, ""deletions"": 0, ""lines"": 2}}"
2020-06-09 19:35:36,0ca8b5ba7ba72d739ee15d0d6534aa20f863f3c3,Bram Moolenaar,9,3,12,2,"{""src/term.c"": {""insertions"": 7, ""deletions"": 3, ""lines"": 10}, ""src/version.c"": {""insertions"": 2, ""deletions"": 0, ""lines"": 2}}"
2020-06-09 19:26:36,218cb0fb62d29fba552281c2e8ffeb4046d540c4,Bram Moolenaar,660,550,1210,2,"{""src/term.c"": {""insertions"": 658, ""deletions"": 550, ""lines"": 1208}, ""src/version.c"": {""insertions"": 2, ""deletions"": 0, ""lines"": 2}}"
2020-06-09 17:34:54,59de417b904bbd204e313f015839317b577bd124,Bram Moolenaar,30,8,38,5,"{""src/diff.c"": {""insertions"": 1, ""deletions"": 1, ""lines"": 2}, ""src/macros.h"": {""insertions"": 1, ""deletions"": 0, ""lines"": 1}, ""src/regexp_nfa.c"": {""insertions"": 7, ""deletions"": 7, ""lines"": 14}, ""src/testdir/test_regexp_utf8.vim"": {""insertions"": 19, ""deletions"": 0, ""lines"": 19}, ""src/version.c"": {""insertions"": 2, ""deletions"": 0, ""lines"": 2}}"
2020-06-09 15:30:04,dcf59c37d0e1517439c4c0c4a6a5ca09c90157ad,Bram Moolenaar,6,0,6,2,"{""src/list.c"": {""insertions"": 4, ""deletions"": 0, ""lines"": 4}, ""src/version.c"": {""insertions"": 2, ""deletions"": 0, ""lines"": 2}}"
2020-06-09 13:57:37,a45551a53557dba98973fdb3ff737dea2fffcda3,Bram Moolenaar,103,27,130,12,"{""src/main.c"": {""insertions"": 1, ""deletions"": 1, ""lines"": 2}, ""src/proto/term.pro"": {""insertions"": 1, ""deletions"": 1, ""lines"": 2}, ""src/term.c"": {""insertions"": 84, ""deletions"": 15, ""lines"": 99}, ""src/testdir/dumps/Test_balloon_eval_term_01.dump"": {""insertions"": 1, ""deletions"": 1, ""lines"": 2}, ""src/testdir/dumps/Test_balloon_eval_term_01a.dump"": {""insertions"": 1, ""deletions"": 1, ""lines"": 2}, ""src/testdir/dumps/Test_balloon_eval_term_02.dump"": {""insertions"": 1, ""deletions"": 1, ""lines"": 2}, ""src/testdir/dumps/Test_terminal_all_ansi_colors.dump"": {""insertions"": 1, ""deletions"": 1, ""lines"": 2}, ""src/testdir/term_util.vim"": {""insertions"": 9, ""deletions"": 1, ""lines"": 10}, ""src/testdir/test_quickfix.vim"": {""insertions"": 0, ""deletions"": 1, ""lines"": 1}, ""src/testdir/test_startup_utf8.vim"": {""insertions"": 2, ""deletions"": 1, ""lines"": 3}, ""src/testdir/test_terminal.vim"": {""insertions"": 0, ""deletions"": 3, ""lines"": 3}, ""src/version.c"": {""insertions"": 2, ""deletions"": 0, ""lines"": 2}}"
2020-06-08 18:50:43,077a1e670ad69ef4cefc22103ca6635bd269e764,Bram Moolenaar,198,1,199,8,"{""runtime/doc/eval.txt"": {""insertions"": 20, ""deletions"": 0, ""lines"": 20}, ""runtime/doc/usr_41.txt"": {""insertions"": 1, ""deletions"": 0, ""lines"": 1}, ""src/evalfunc.c"": {""insertions"": 1, ""deletions"": 0, ""lines"": 1}, ""src/list.c"": {""insertions"": 89, ""deletions"": 0, ""lines"": 89}, ""src/proto/list.pro"": {""insertions"": 2, ""deletions"": 1, ""lines"": 3}, ""src/testdir/Make_all.mak"": {""insertions"": 2, ""deletions"": 0, ""lines"": 2}, ""src/testdir/test_flatten.vim"": {""insertions"": 81, ""deletions"": 0, ""lines"": 81}, ""src/version.c"": {""insertions"": 2, ""deletions"": 0, ""lines"": 2}}"
2020-06-08 17:35:59,ec98e93a82379ca9289d8021aec374aa6798afef,Bram Moolenaar,23,2,25,3,"{""src/quickfix.c"": {""insertions"": 3, ""deletions"": 2, ""lines"": 5}, ""src/testdir/test_quickfix.vim"": {""insertions"": 18, ""deletions"": 0, ""lines"": 18}, ""src/version.c"": {""insertions"": 2, ""deletions"": 0, ""lines"": 2}}"
2020-06-08 17:20:27,7ba5a7eff335dcce25afaa154f32eeadb6014b61,Bram Moolenaar,25,9,34,4,"{""runtime/doc/quickfix.txt"": {""insertions"": 3, ""deletions"": 0, ""lines"": 3}, ""src/quickfix.c"": {""insertions"": 13, ""deletions"": 7, ""lines"": 20}, ""src/testdir/test_quickfix.vim"": {""insertions"": 7, ""deletions"": 2, ""lines"": 9}, ""src/version.c"": {""insertions"": 2, ""deletions"": 0, ""lines"": 2}}"
2020-06-08 16:54:49,f154f3ab2c1eea67afc20140c580ad003752dc72,Bram Moolenaar,7,5,12,4,"{""src/optionstr.c"": {""insertions"": 1, ""deletions"": 1, ""lines"": 2}, ""src/proto/spell.pro"": {""insertions"": 1, ""deletions"": 1, ""lines"": 2}, ""src/spell.c"": {""insertions"": 3, ""deletions"": 3, ""lines"": 6}, ""src/version.c"": {""insertions"": 2, ""deletions"": 0, ""lines"": 2}}"
2020-06-07 20:23:19,6938e27abd80715cf7beb9d3d579a63201f417a1,Bram Moolenaar,8,320,328,7,"{""READMEdir/README_extra.txt"": {""insertions"": 0, ""deletions"": 3, ""lines"": 3}, ""runtime/doc/options.txt"": {""insertions"": 0, ""deletions"": 1, ""lines"": 1}, ""runtime/doc/os_beos.txt"": {""insertions"": 4, ""deletions"": 311, ""lines"": 315}, ""runtime/doc/os_vms.txt"": {""insertions"": 0, ""deletions"": 1, ""lines"": 1}, ""runtime/doc/vi_diff.txt"": {""insertions"": 2, ""deletions"": 3, ""lines"": 5}, ""src/INSTALL"": {""insertions"": 0, ""deletions"": 1, ""lines"": 1}, ""src/version.c"": {""insertions"": 2, ""deletions"": 0, ""lines"": 2}}"
2020-06-07 19:58:54,b5e18f29fac9253b0ccf1fde5e74bff72fa1ba60,Bram Moolenaar,23,4,27,3,"{""runtime/scripts.vim"": {""insertions"": 4, ""deletions"": 2, ""lines"": 6}, ""src/testdir/test_filetype.vim"": {""insertions"": 17, ""deletions"": 2, ""lines"": 19}, ""src/version.c"": {""insertions"": 2, ""deletions"": 0, ""lines"": 2}}"
2020-06-07 19:31:18,cc613031b96f1cfa5a184253e745c26f1def9be4,Bram Moolenaar,76,0,76,3,"{""src/normal.c"": {""insertions"": 5, ""deletions"": 0, ""lines"": 5}, ""src/testdir/test_registers.vim"": {""insertions"": 69, ""deletions"": 0, ""lines"": 69}, ""src/version.c"": {""insertions"": 2, ""deletions"": 0, ""lines"": 2}}"
2020-06-07 19:07:18,acc224064033e5cea21ef7f1eefb356ca06ff11d,Bram Moolenaar,590,226,816,30,"{""runtime/doc/change.txt"": {""insertions"": 1, ""deletions"": 1, ""lines"": 2}, ""runtime/doc/channel.txt"": {""insertions"": 44, ""deletions"": 3, ""lines"": 47}, ""runtime/doc/editing.txt"": {""insertions"": 1, ""deletions"": 1, ""lines"": 2}, ""runtime/doc/eval.txt"": {""insertions"": 1, ""deletions"": 1, ""lines"": 2}, ""runtime/doc/gui_x11.txt"": {""insertions"": 4, ""deletions"": 1, ""lines"": 5}, ""runtime/doc/index.txt"": {""insertions"": 9, ""deletions"": 9, ""lines"": 18}, ""runtime/doc/intro.txt"": {""insertions"": 7, ""deletions"": 5, ""lines"": 12}, ""runtime/doc/options.txt"": {""insertions"": 3, ""deletions"": 3, ""lines"": 6}, ""runtime/doc/quickfix.txt"": {""insertions"": 1, ""deletions"": 1, ""lines"": 2}, ""runtime/doc/quickref.txt"": {""insertions"": 2, ""deletions"": 1, ""lines"": 3}, ""runtime/doc/syntax.txt"": {""insertions"": 7, ""deletions"": 2, ""lines"": 9}, ""runtime/doc/tags"": {""insertions"": 22, ""deletions"": 0, ""lines"": 22}, ""runtime/doc/terminal.txt"": {""insertions"": 3, ""deletions"": 2, ""lines"": 5}, ""runtime/doc/testing.txt"": {""insertions"": 1, ""deletions"": 1, ""lines"": 2}, ""runtime/doc/todo.txt"": {""insertions"": 30, ""deletions"": 101, ""lines"": 131}, ""runtime/doc/various.txt"": {""insertions"": 11, ""deletions"": 5, ""lines"": 16}, ""runtime/filetype.vim"": {""insertions"": 1, ""deletions"": 1, ""lines"": 2}, ""runtime/ftplugin/asm.vim"": {""insertions"": 11, ""deletions"": 0, ""lines"": 11}, ""runtime/ftplugin/elm.vim"": {""insertions"": 18, ""deletions"": 0, ""lines"": 18}, ""runtime/ftplugin/man.vim"": {""insertions"": 7, ""deletions"": 7, ""lines"": 14}, ""runtime/indent/elm.vim"": {""insertions"": 114, ""deletions"": 0, ""lines"": 114}, ""runtime/indent/sqlanywhere.vim"": {""insertions"": 43, ""deletions"": 37, ""lines"": 80}, ""runtime/indent/testdir/yaml.in"": {""insertions"": 5, ""deletions"": 0, ""lines"": 5}, ""runtime/indent/testdir/yaml.ok"": {""insertions"": 5, ""deletions"": 0, ""lines"": 5}, ""runtime/indent/yaml.vim"": {""insertions"": 6, ""deletions"": 5, ""lines"": 11}, ""runtime/optwin.vim"": {""insertions"": 4, ""deletions"": 2, ""lines"": 6}, ""runtime/spell/eu/main.aap"": {""insertions"": 81, ""deletions"": 0, ""lines"": 81}, ""runtime/spell/main.aap"": {""insertions"": 8, ""deletions"": 1, ""lines"": 9}, ""runtime/syntax/elm.vim"": {""insertions"": 105, ""deletions"": 0, ""lines"": 105}, ""runtime/syntax/vim.vim"": {""insertions"": 35, ""deletions"": 36, ""lines"": 71}}"
2020-06-07 18:49:05,df44a27b53586fccfc6a3aedc89061fdd9a515ff,Bram Moolenaar,22,20,42,13,"{""src/autocmd.c"": {""insertions"": 2, ""deletions"": 2, ""lines"": 4}, ""src/channel.c"": {""insertions"": 2, ""deletions"": 2, ""lines"": 4}, ""src/cmdexpand.c"": {""insertions"": 1, ""deletions"": 1, ""lines"": 2}, ""src/dict.c"": {""insertions"": 1, ""deletions"": 1, ""lines"": 2}, ""src/diff.c"": {""insertions"": 1, ""deletions"": 1, ""lines"": 2}, ""src/digraph.c"": {""insertions"": 2, ""deletions"": 2, ""lines"": 4}, ""src/eval.c"": {""insertions"": 1, ""deletions"": 1, ""lines"": 2}, ""src/evalfunc.c"": {""insertions"": 3, ""deletions"": 3, ""lines"": 6}, ""src/highlight.c"": {""insertions"": 1, ""deletions"": 1, ""lines"": 2}, ""src/misc2.c"": {""insertions"": 2, ""deletions"": 2, ""lines"": 4}, ""src/proto/misc2.pro"": {""insertions"": 2, ""deletions"": 2, ""lines"": 4}, ""src/syntax.c"": {""insertions"": 2, ""deletions"": 2, ""lines"": 4}, ""src/version.c"": {""insertions"": 2, ""deletions"": 0, ""lines"": 2}}"
2020-06-07 18:07:43,da84ac2a6f467d0b9eddcc8709433cda75d16a41,Bram Moolenaar,8,4,12,3,"{""runtime/filetype.vim"": {""insertions"": 4, ""deletions"": 2, ""lines"": 6}, ""src/testdir/test_filetype.vim"": {""insertions"": 2, ""deletions"": 2, ""lines"": 4}, ""src/version.c"": {""insertions"": 2, ""deletions"": 0, ""lines"": 2}}"
2020-06-07 17:38:10,951a2fb1b87af7e3be81e85a3769a17a13fd5040,Bram Moolenaar,23,21,44,2,"{""src/testdir/test_cmdline.vim"": {""insertions"": 21, ""deletions"": 21, ""lines"": 42}, ""src/version.c"": {""insertions"": 2, ""deletions"": 0, ""lines"": 2}}"
2020-06-07 16:45:14,1f1fd44ef796dd909ff5f3e5288b3fd79294dc71,Bram Moolenaar,65,29,94,4,"{""runtime/doc/eval.txt"": {""insertions"": 9, ""deletions"": 3, ""lines"": 12}, ""src/cmdexpand.c"": {""insertions"": 39, ""deletions"": 25, ""lines"": 64}, ""src/testdir/test_cmdline.vim"": {""insertions"": 15, ""deletions"": 1, ""lines"": 16}, ""src/version.c"": {""insertions"": 2, ""deletions"": 0, ""lines"": 2}}"
2020-06-07 16:16:36,bb861e293e0170455184079fa537278754b07911,Bram Moolenaar,241,9,250,8,"{""runtime/doc/eval.txt"": {""insertions"": 34, ""deletions"": 4, ""lines"": 38}, ""runtime/doc/usr_41.txt"": {""insertions"": 1, ""deletions"": 0, ""lines"": 1}, ""src/evalfunc.c"": {""insertions"": 122, ""deletions"": 4, ""lines"": 126}, ""src/proto/register.pro"": {""insertions"": 1, ""deletions"": 0, ""lines"": 1}, ""src/register.c"": {""insertions"": 9, ""deletions"": 0, ""lines"": 9}, ""src/testdir/test_eval_stuff.vim"": {""insertions"": 0, ""deletions"": 1, ""lines"": 1}, ""src/testdir/test_registers.vim"": {""insertions"": 72, ""deletions"": 0, ""lines"": 72}, ""src/version.c"": {""insertions"": 2, ""deletions"": 0, ""lines"": 2}}"
2020-06-07 15:30:33,c82dd86084581afa5113b0dd9ade7a631b89b4fc,Bram Moolenaar,5,3,8,2,"{""src/testdir/test_cmdline.vim"": {""insertions"": 3, ""deletions"": 3, ""lines"": 6}, ""src/version.c"": {""insertions"": 2, ""deletions"": 0, ""lines"": 2}}"
2020-06-07 15:20:02,48af321a3382008dc642362d3f54bb6a61ff36e4,Bram Moolenaar,2,2,4,2,"{""src/testdir/test_search.vim"": {""insertions"": 0, ""deletions"": 2, ""lines"": 2}, ""src/version.c"": {""insertions"": 2, ""deletions"": 0, ""lines"": 2}}"
2020-06-07 15:03:21,4fdb8bd0546ac8d90560a4fad359a48667089d43,Bram Moolenaar,24,0,24,3,"{""src/testdir/test_cmdline.vim"": {""insertions"": 21, ""deletions"": 0, ""lines"": 21}, ""src/version.c"": {""insertions"": 2, ""deletions"": 0, ""lines"": 2}, ""src/window.c"": {""insertions"": 1, ""deletions"": 0, ""lines"": 1}}"
2020-06-07 14:08:08,5b157fe2edfdce5f77080aeac2b4a03f39eb1c1a,Bram Moolenaar,52,2,54,3,"{""src/testdir/test_viminfo.vim"": {""insertions"": 22, ""deletions"": 0, ""lines"": 22}, ""src/version.c"": {""insertions"": 2, ""deletions"": 0, ""lines"": 2}, ""src/viminfo.c"": {""insertions"": 28, ""deletions"": 2, ""lines"": 30}}"
2020-06-07 13:46:11,673fc3e23f09095d17f0095c4323958041b2d0d2,Bram Moolenaar,32,11,43,3,"{""src/ex_getln.c"": {""insertions"": 2, ""deletions"": 0, ""lines"": 2}, ""src/getchar.c"": {""insertions"": 28, ""deletions"": 11, ""lines"": 39}, ""src/version.c"": {""insertions"": 2, ""deletions"": 0, ""lines"": 2}}"
2020-06-07 12:50:50,a9c010494767e43a51c443cac35ebc80d0831d0b,Bram Moolenaar,28,121,149,7,"{""src/eval.c"": {""insertions"": 12, ""deletions"": 0, ""lines"": 12}, ""src/evalfunc.c"": {""insertions"": 9, ""deletions"": 23, ""lines"": 32}, ""src/evalvars.c"": {""insertions"": 0, ""deletions"": 75, ""lines"": 75}, ""src/proto/eval.pro"": {""insertions"": 5, ""deletions"": 4, ""lines"": 9}, ""src/proto/evalvars.pro"": {""insertions"": 0, ""deletions"": 5, ""lines"": 5}, ""src/structs.h"": {""insertions"": 0, ""deletions"": 14, ""lines"": 14}, ""src/version.c"": {""insertions"": 2, ""deletions"": 0, ""lines"": 2}}"
2020-06-07 12:10:47,e928366de5deca359fad779a4f740db703296302,Bram Moolenaar,46,4,50,4,"{""runtime/doc/quickfix.txt"": {""insertions"": 6, ""deletions"": 1, ""lines"": 7}, ""src/quickfix.c"": {""insertions"": 8, ""deletions"": 3, ""lines"": 11}, ""src/testdir/test_quickfix.vim"": {""insertions"": 30, ""deletions"": 0, ""lines"": 30}, ""src/version.c"": {""insertions"": 2, ""deletions"": 0, ""lines"": 2}}"
2020-06-06 20:36:24,975a880a1389e8ce6dea8d66a7c109140b2f94ec,Bram Moolenaar,74,11,85,7,"{""src/edit.c"": {""insertions"": 1, ""deletions"": 1, ""lines"": 2}, ""src/getchar.c"": {""insertions"": 50, ""deletions"": 7, ""lines"": 57}, ""src/proto/getchar.pro"": {""insertions"": 1, ""deletions"": 1, ""lines"": 2}, ""src/proto/term.pro"": {""insertions"": 1, ""deletions"": 0, ""lines"": 1}, ""src/term.c"": {""insertions"": 2, ""deletions"": 2, ""lines"": 4}, ""src/testdir/test_termcodes.vim"": {""insertions"": 17, ""deletions"": 0, ""lines"": 17}, ""src/version.c"": {""insertions"": 2, ""deletions"": 0, ""lines"": 2}}"
2020-06-06 16:37:51,adc17a5f9d207fd1623fd923457a46efc9214777,Bram Moolenaar,212,11,223,7,"{""runtime/doc/eval.txt"": {""insertions"": 16, ""deletions"": 5, ""lines"": 21}, ""src/evalfunc.c"": {""insertions"": 49, ""deletions"": 6, ""lines"": 55}, ""src/evalvars.c"": {""insertions"": 75, ""deletions"": 0, ""lines"": 75}, ""src/proto/evalvars.pro"": {""insertions"": 5, ""deletions"": 0, ""lines"": 5}, ""src/structs.h"": {""insertions"": 15, ""deletions"": 0, ""lines"": 15}, ""src/testdir/test_syntax.vim"": {""insertions"": 50, ""deletions"": 0, ""lines"": 50}, ""src/version.c"": {""insertions"": 2, ""deletions"": 0, ""lines"": 2}}"
2020-06-06 14:18:46,d8df304c59040ef6689a1e4af1dac27ce566909e,Bram Moolenaar,19,4,23,2,"{""src/Make_mvc.mak"": {""insertions"": 17, ""deletions"": 4, ""lines"": 21}, ""src/version.c"": {""insertions"": 2, ""deletions"": 0, ""lines"": 2}}"
2020-06-06 13:58:03,439c036ed062de1c87cc7e3fe050a9569fb12089,Bram Moolenaar,24,17,41,5,"{""src/evalvars.c"": {""insertions"": 19, ""deletions"": 1, ""lines"": 20}, ""src/main.c"": {""insertions"": 1, ""deletions"": 6, ""lines"": 7}, ""src/normal.c"": {""insertions"": 1, ""deletions"": 10, ""lines"": 11}, ""src/proto/evalvars.pro"": {""insertions"": 1, ""deletions"": 0, ""lines"": 1}, ""src/version.c"": {""insertions"": 2, ""deletions"": 0, ""lines"": 2}}"
2020-06-06 13:23:26,11f1ffd18282c44ca4b74cf7cf336da6d09e396d,Bram Moolenaar,25,17,42,2,"{""src/testdir/test_cjk_linebreak.vim"": {""insertions"": 23, ""deletions"": 17, ""lines"": 40}, ""src/version.c"": {""insertions"": 2, ""deletions"": 0, ""lines"": 2}}"
2020-06-06 13:14:08,9b7cce28d568f0622d77c6c9878c2d4770c3b164,Bram Moolenaar,60,3,63,4,"{""src/ex_getln.c"": {""insertions"": 13, ""deletions"": 3, ""lines"": 16}, ""src/testdir/dumps/Test_cmdwin_interrupted.dump"": {""insertions"": 18, ""deletions"": 0, ""lines"": 18}, ""src/testdir/test_cmdline.vim"": {""insertions"": 27, ""deletions"": 0, ""lines"": 27}, ""src/version.c"": {""insertions"": 2, ""deletions"": 0, ""lines"": 2}}"
2020-06-06 11:25:31,87fda407f8ecf947ba6ce72ac21f69ff04d909cd,Bram Moolenaar,2,0,2,1,"{""src/version.c"": {""insertions"": 2, ""deletions"": 0, ""lines"": 2}}"
2020-06-06 11:17:59,fe712ced6e1509d1e16b12d2b5581f89d0f9f4df,Bram Moolenaar,0,4,4,1,"{""src/version.c"": {""insertions"": 0, ""deletions"": 4, ""lines"": 4}}"
2020-06-05 21:16:29,8f1dde5021d9623a951d1ccbc78cf1b1a55ccd7a,Bram Moolenaar,44,0,44,6,"{""src/Makefile"": {""insertions"": 1, ""deletions"": 0, ""lines"": 1}, ""src/auto/configure"": {""insertions"": 12, ""deletions"": 0, ""lines"": 12}, ""src/config.h.in"": {""insertions"": 3, ""deletions"": 0, ""lines"": 3}, ""src/config.mk.in"": {""insertions"": 4, ""deletions"": 0, ""lines"": 4}, ""src/configure.ac"": {""insertions"": 12, ""deletions"": 0, ""lines"": 12}, ""src/version.c"": {""insertions"": 12, ""deletions"": 0, ""lines"": 12}}"
2020-06-05 20:33:42,002bc79991286934a9593b80635c27d4238cdfc4,Bram Moolenaar,117,13,130,7,"{""runtime/doc/editing.txt"": {""insertions"": 8, ""deletions"": 0, ""lines"": 8}, ""src/ex_docmd.c"": {""insertions"": 38, ""deletions"": 13, ""lines"": 51}, ""src/filepath.c"": {""insertions"": 1, ""deletions"": 0, ""lines"": 1}, ""src/structs.h"": {""insertions"": 3, ""deletions"": 0, ""lines"": 3}, ""src/testdir/test_cd.vim"": {""insertions"": 63, ""deletions"": 0, ""lines"": 63}, ""src/version.c"": {""insertions"": 2, ""deletions"": 0, ""lines"": 2}, ""src/window.c"": {""insertions"": 2, ""deletions"": 0, ""lines"": 2}}"
2020-06-05 19:06:10,3fffa97159a427067b60c80ed4645e168cc5c4bd,Bram Moolenaar,67,31,98,3,"{""src/testdir/test_timers.vim"": {""insertions"": 25, ""deletions"": 0, ""lines"": 25}, ""src/userfunc.c"": {""insertions"": 40, ""deletions"": 31, ""lines"": 71}, ""src/version.c"": {""insertions"": 2, ""deletions"": 0, ""lines"": 2}}"
2020-06-05 18:03:16,07188fc5ef2366a3b1952e8686a4031b44152d59,Bram Moolenaar,19,1,20,3,"{""src/clipboard.c"": {""insertions"": 6, ""deletions"": 1, ""lines"": 7}, ""src/testdir/test_global.vim"": {""insertions"": 11, ""deletions"": 0, ""lines"": 11}, ""src/version.c"": {""insertions"": 2, ""deletions"": 0, ""lines"": 2}}"
2020-06-05 17:36:57,ea563cc22be043ff91dcbdf2878c3d1fd944e573,Bram Moolenaar,13,1,14,3,"{""src/highlight.c"": {""insertions"": 6, ""deletions"": 1, ""lines"": 7}, ""src/term.c"": {""insertions"": 5, ""deletions"": 0, ""lines"": 5}, ""src/version.c"": {""insertions"": 2, ""deletions"": 0, ""lines"": 2}}"
2020-06-04 20:46:04,e0c3c3d6cbb6f356058f28ecbdf3438411222083,Bram Moolenaar,19,0,19,3,"{""src/testdir/test_cmdline.vim"": {""insertions"": 16, ""deletions"": 0, ""lines"": 16}, ""src/testdir/test_ga.vim"": {""insertions"": 1, ""deletions"": 0, ""lines"": 1}, ""src/version.c"": {""insertions"": 2, ""deletions"": 0, ""lines"": 2}}"
2020-06-04 20:22:11,46cd43bda102c3782bba1c4c629836e010734d77,Bram Moolenaar,14,1,15,3,"{""src/getchar.c"": {""insertions"": 2, ""deletions"": 1, ""lines"": 3}, ""src/testdir/test_gui.vim"": {""insertions"": 10, ""deletions"": 0, ""lines"": 10}, ""src/version.c"": {""insertions"": 2, ""deletions"": 0, ""lines"": 2}}"
2020-06-04 19:32:49,852ea366d6432e719ffdd95e9fb7d49a9a960187,Bram Moolenaar,3,1,4,2,"{""src/Make_cyg_ming.mak"": {""insertions"": 1, ""deletions"": 1, ""lines"": 2}, ""src/version.c"": {""insertions"": 2, ""deletions"": 0, ""lines"": 2}}"
2020-06-04 18:56:09,442a85369f3eb9834dbab42add45f7c4106700f4,Bram Moolenaar,48,7,55,4,"{""src/search.c"": {""insertions"": 8, ""deletions"": 7, ""lines"": 15}, ""src/testdir/dumps/Test_searchstat_4.dump"": {""insertions"": 10, ""deletions"": 0, ""lines"": 10}, ""src/testdir/test_search_stat.vim"": {""insertions"": 28, ""deletions"": 0, ""lines"": 28}, ""src/version.c"": {""insertions"": 2, ""deletions"": 0, ""lines"": 2}}"
2020-06-04 16:22:13,e52702f00322c8a8861efd0bd6a3775e685e5685,Bram Moolenaar,329,9,338,9,"{""runtime/doc/change.txt"": {""insertions"": 4, ""deletions"": 0, ""lines"": 4}, ""src/mbyte.c"": {""insertions"": 152, ""deletions"": 0, ""lines"": 152}, ""src/ops.c"": {""insertions"": 4, ""deletions"": 1, ""lines"": 5}, ""src/option.h"": {""insertions"": 2, ""deletions"": 1, ""lines"": 3}, ""src/proto/mbyte.pro"": {""insertions"": 3, ""deletions"": 0, ""lines"": 3}, ""src/testdir/Make_all.mak"": {""insertions"": 2, ""deletions"": 0, ""lines"": 2}, ""src/testdir/test_cjk_linebreak.vim"": {""insertions"": 91, ""deletions"": 0, ""lines"": 91}, ""src/textformat.c"": {""insertions"": 69, ""deletions"": 7, ""lines"": 76}, ""src/version.c"": {""insertions"": 2, ""deletions"": 0, ""lines"": 2}}"
2020-06-04 15:19:05,9155825b2428ef6bf654204a534b033a6879c90d,Bram Moolenaar,4,3,7,2,"{""src/testdir/test_function_lists.vim"": {""insertions"": 2, ""deletions"": 3, ""lines"": 5}, ""src/version.c"": {""insertions"": 2, ""deletions"": 0, ""lines"": 2}}"
2020-06-04 14:52:40,30cc44a97f0ba1349e1a522dab22b11f47888183,Bram Moolenaar,52,8,60,3,"{""src/testdir/test_assert.vim"": {""insertions"": 9, ""deletions"": 2, ""lines"": 11}, ""src/testing.c"": {""insertions"": 41, ""deletions"": 6, ""lines"": 47}, ""src/version.c"": {""insertions"": 2, ""deletions"": 0, ""lines"": 2}}"
2020-06-04 13:52:25,6b0e528368415476bfc3a8414c9c70f9852b1517,Bram Moolenaar,109,0,109,3,"{""src/testdir/Make_all.mak"": {""insertions"": 2, ""deletions"": 0, ""lines"": 2}, ""src/testdir/test_function_lists.vim"": {""insertions"": 105, ""deletions"": 0, ""lines"": 105}, ""src/version.c"": {""insertions"": 2, ""deletions"": 0, ""lines"": 2}}"
2020-06-04 13:22:21,ebacddbc16b2d76bf5dad636d7ee5c529f0e8753,Bram Moolenaar,78,26,104,3,"{""runtime/doc/eval.txt"": {""insertions"": 21, ""deletions"": 20, ""lines"": 41}, ""runtime/doc/usr_41.txt"": {""insertions"": 55, ""deletions"": 6, ""lines"": 61}, ""src/version.c"": {""insertions"": 2, ""deletions"": 0, ""lines"": 2}}"
2020-06-03 20:57:39,14681627f39421cce289345d4ec9927c10fa3b1c,Bram Moolenaar,14,2,16,3,"{""src/search.c"": {""insertions"": 8, ""deletions"": 2, ""lines"": 10}, ""src/testdir/test_search_stat.vim"": {""insertions"": 4, ""deletions"": 0, ""lines"": 4}, ""src/version.c"": {""insertions"": 2, ""deletions"": 0, ""lines"": 2}}"
2020-06-03 20:15:45,408c23b0794540ee3c568a1569f21406c5ed3ab8,Bram Moolenaar,37,45,82,2,"{""src/spellfile.c"": {""insertions"": 35, ""deletions"": 45, ""lines"": 80}, ""src/version.c"": {""insertions"": 2, ""deletions"": 0, ""lines"": 2}}"
2020-06-03 18:51:11,59f88fbf24b21dbae114a79a15695fa2c3a09fca,Bram Moolenaar,36,18,54,2,"{""src/spellfile.c"": {""insertions"": 34, ""deletions"": 18, ""lines"": 52}, ""src/version.c"": {""insertions"": 2, ""deletions"": 0, ""lines"": 2}}"
2020-06-03 17:55:35,fb517bac2384798bb5142ed1f75f965f93984c0a,Bram Moolenaar,21,7,28,6,"{""runtime/doc/eval.txt"": {""insertions"": 3, ""deletions"": 2, ""lines"": 5}, ""runtime/doc/testing.txt"": {""insertions"": 1, ""deletions"": 3, ""lines"": 4}, ""src/evalfunc.c"": {""insertions"": 1, ""deletions"": 1, ""lines"": 2}, ""src/testdir/test_assert.vim"": {""insertions"": 4, ""deletions"": 0, ""lines"": 4}, ""src/testing.c"": {""insertions"": 10, ""deletions"": 1, ""lines"": 11}, ""src/version.c"": {""insertions"": 2, ""deletions"": 0, ""lines"": 2}}"
2020-06-03 16:55:38,c5acc0f7fed6b061d994fc5ac660dcc0312750bd,Bram Moolenaar,15,4,19,2,"{""src/regexp_nfa.c"": {""insertions"": 13, ""deletions"": 4, ""lines"": 17}, ""src/version.c"": {""insertions"": 2, ""deletions"": 0, ""lines"": 2}}"
2020-06-03 08:04:49,cc836556d962058d8b8fbc45c400b7e9d643976a,Bram Moolenaar,3,1,4,2,"{""src/highlight.c"": {""insertions"": 1, ""deletions"": 1, ""lines"": 2}, ""src/version.c"": {""insertions"": 2, ""deletions"": 0, ""lines"": 2}}"
2020-06-02 21:18:24,1e5f8f6d65b2ecff3d93d9fdbdd17c7a2ab9cc3d,Bram Moolenaar,5,0,5,2,"{""src/highlight.c"": {""insertions"": 3, ""deletions"": 0, ""lines"": 3}, ""src/version.c"": {""insertions"": 2, ""deletions"": 0, ""lines"": 2}}"
2020-06-02 20:24:36,791fb1bcda7cd1a388ad948cdef469a2744d6dff,Bram Moolenaar,30,38,68,2,"{""src/gui_xim.c"": {""insertions"": 28, ""deletions"": 38, ""lines"": 66}, ""src/version.c"": {""insertions"": 2, ""deletions"": 0, ""lines"": 2}}"
2020-06-02 20:19:50,441d60efd8f0e4a44d0cf4bca11cb72e6c830e47,Bram Moolenaar,7,3,10,3,"{""src/fileio.c"": {""insertions"": 1, ""deletions"": 1, ""lines"": 2}, ""src/testdir/test_functions.vim"": {""insertions"": 4, ""deletions"": 2, ""lines"": 6}, ""src/version.c"": {""insertions"": 2, ""deletions"": 0, ""lines"": 2}}"
2020-06-02 20:06:21,57f75a5a364ad4d8334fdf6b6b41420b48e08390,Bram Moolenaar,11,1,12,3,"{""src/search.c"": {""insertions"": 1, ""deletions"": 1, ""lines"": 2}, ""src/testdir/test_search_stat.vim"": {""insertions"": 8, ""deletions"": 0, ""lines"": 8}, ""src/version.c"": {""insertions"": 2, ""deletions"": 0, ""lines"": 2}}"
2020-06-02 19:38:22,c17e66c5c0acd5038f1eb3d7b3049b64bb6ea30b,Bram Moolenaar,48,20,68,7,"{""runtime/doc/eval.txt"": {""insertions"": 16, ""deletions"": 11, ""lines"": 27}, ""src/charset.c"": {""insertions"": 13, ""deletions"": 3, ""lines"": 16}, ""src/evalfunc.c"": {""insertions"": 1, ""deletions"": 1, ""lines"": 2}, ""src/testdir/test_eval_stuff.vim"": {""insertions"": 5, ""deletions"": 0, ""lines"": 5}, ""src/testdir/test_functions.vim"": {""insertions"": 5, ""deletions"": 0, ""lines"": 5}, ""src/version.c"": {""insertions"": 2, ""deletions"": 0, ""lines"": 2}, ""src/vim.h"": {""insertions"": 6, ""deletions"": 5, ""lines"": 11}}"
2020-06-02 18:25:36,3ac498c8a1c3570c296093a5d9425b2a3a7cdb29,Bram Moolenaar,5,1,6,2,"{""src/Makefile"": {""insertions"": 3, ""deletions"": 1, ""lines"": 4}, ""src/version.c"": {""insertions"": 2, ""deletions"": 0, ""lines"": 2}}"
2020-06-01 19:32:45,ea6561af92eeb26fa0b4966575da7cadd98af1cd,Bram Moolenaar,7,5,12,3,"{""src/search.c"": {""insertions"": 1, ""deletions"": 1, ""lines"": 2}, ""src/testdir/test_search_stat.vim"": {""insertions"": 4, ""deletions"": 4, ""lines"": 8}, ""src/version.c"": {""insertions"": 2, ""deletions"": 0, ""lines"": 2}}"
2020-06-01 19:13:11,5fbf3bc3f9d007ab91eb005f9e3da6570992cb43,Bram Moolenaar,3,0,3,2,"{""src/ex_docmd.c"": {""insertions"": 1, ""deletions"": 0, ""lines"": 1}, ""src/version.c"": {""insertions"": 2, ""deletions"": 0, ""lines"": 2}}"
2020-06-01 18:11:02,48b1c21809553d3463b5ed6c2b3bc6d335663bb6,Bram Moolenaar,22,13,35,2,"{""src/list.c"": {""insertions"": 20, ""deletions"": 13, ""lines"": 33}, ""src/version.c"": {""insertions"": 2, ""deletions"": 0, ""lines"": 2}}"
2020-06-01 17:14:12,d6a77f95ee1e8ab69366d4f2a3412beef4cec914,Bram Moolenaar,3,1,4,2,"{""src/ops.c"": {""insertions"": 1, ""deletions"": 1, ""lines"": 2}, ""src/version.c"": {""insertions"": 2, ""deletions"": 0, ""lines"": 2}}"
2020-06-01 17:08:54,109aece79d1b5f14f6a84ff2ac068cfffebeba80,Bram Moolenaar,3,0,3,2,"{""src/search.c"": {""insertions"": 1, ""deletions"": 0, ""lines"": 1}, ""src/version.c"": {""insertions"": 2, ""deletions"": 0, ""lines"": 2}}"
2020-06-01 16:56:03,f9ca08e95ff5b66a02c75334264dd86508b2a453,Bram Moolenaar,3,1,4,2,"{""src/search.c"": {""insertions"": 1, ""deletions"": 1, ""lines"": 2}, ""src/version.c"": {""insertions"": 2, ""deletions"": 0, ""lines"": 2}}"
2020-06-01 16:39:20,85629985b71035608a37ba3bde86968481490d46,Bram Moolenaar,163,0,163,7,"{""runtime/doc/eval.txt"": {""insertions"": 22, ""deletions"": 0, ""lines"": 22}, ""src/evalfunc.c"": {""insertions"": 1, ""deletions"": 0, ""lines"": 1}, ""src/globals.h"": {""insertions"": 1, ""deletions"": 0, ""lines"": 1}, ""src/list.c"": {""insertions"": 105, ""deletions"": 0, ""lines"": 105}, ""src/proto/list.pro"": {""insertions"": 1, ""deletions"": 0, ""lines"": 1}, ""src/testdir/test_listdict.vim"": {""insertions"": 31, ""deletions"": 0, ""lines"": 31}, ""src/version.c"": {""insertions"": 2, ""deletions"": 0, ""lines"": 2}}"
2020-06-01 15:28:35,e8f5ec0d30b629d7166f0ad03434065d8bc822df,Bram Moolenaar,475,79,554,7,"{""runtime/doc/eval.txt"": {""insertions"": 121, ""deletions"": 0, ""lines"": 121}, ""src/evalfunc.c"": {""insertions"": 1, ""deletions"": 0, ""lines"": 1}, ""src/macros.h"": {""insertions"": 1, ""deletions"": 0, ""lines"": 1}, ""src/proto/search.pro"": {""insertions"": 1, ""deletions"": 0, ""lines"": 1}, ""src/search.c"": {""insertions"": 283, ""deletions"": 78, ""lines"": 361}, ""src/testdir/test_search_stat.vim"": {""insertions"": 66, ""deletions"": 1, ""lines"": 67}, ""src/version.c"": {""insertions"": 2, ""deletions"": 0, ""lines"": 2}}"
2020-06-01 14:26:19,950587242cad52d067a15f0f0c83528a28f75731,Bram Moolenaar,36,4,40,4,"{""runtime/doc/editing.txt"": {""insertions"": 15, ""deletions"": 0, ""lines"": 15}, ""src/ex_docmd.c"": {""insertions"": 16, ""deletions"": 4, ""lines"": 20}, ""src/testdir/test_cd.vim"": {""insertions"": 3, ""deletions"": 0, ""lines"": 3}, ""src/version.c"": {""insertions"": 2, ""deletions"": 0, ""lines"": 2}}"
2020-06-01 14:09:41,6c9ba0428041d5316871245be38c13faa0107026,Bram Moolenaar,604,146,750,9,"{""runtime/doc/eval.txt"": {""insertions"": 57, ""deletions"": 2, ""lines"": 59}, ""runtime/doc/usr_41.txt"": {""insertions"": 1, ""deletions"": 0, ""lines"": 1}, ""src/evalfunc.c"": {""insertions"": 1, ""deletions"": 0, ""lines"": 1}, ""src/fileio.c"": {""insertions"": 381, ""deletions"": 103, ""lines"": 484}, ""src/filepath.c"": {""insertions"": 118, ""deletions"": 39, ""lines"": 157}, ""src/proto/fileio.pro"": {""insertions"": 1, ""deletions"": 1, ""lines"": 2}, ""src/proto/filepath.pro"": {""insertions"": 3, ""deletions"": 0, ""lines"": 3}, ""src/testdir/test_functions.vim"": {""insertions"": 40, ""deletions"": 1, ""lines"": 41}, ""src/version.c"": {""insertions"": 2, ""deletions"": 0, ""lines"": 2}}"
2020-06-01 13:05:19,d14fd5285e491a39028c4b4722ddbe7c9dfa9bb2,Bram Moolenaar,10,2,12,2,"{""src/testdir/test_signals.vim"": {""insertions"": 8, ""deletions"": 2, ""lines"": 10}, ""src/version.c"": {""insertions"": 2, ""deletions"": 0, ""lines"": 2}}"
2020-06-01 12:43:59,2891459b81a21dbd2802ef1ae106c6680f085899,Bram Moolenaar,7,4,11,3,"{""runtime/filetype.vim"": {""insertions"": 4, ""deletions"": 3, ""lines"": 7}, ""src/testdir/test_filetype.vim"": {""insertions"": 1, ""deletions"": 1, ""lines"": 2}, ""src/version.c"": {""insertions"": 2, ""deletions"": 0, ""lines"": 2}}"
2020-06-01 12:34:43,f15c8b6eb32fcfea88fd9ca42ef87bbee2c8fe2b,Bram Moolenaar,1822,1779,3601,12,"{""Filelist"": {""insertions"": 2, ""deletions"": 0, ""lines"": 2}, ""src/Make_cyg_ming.mak"": {""insertions"": 1, ""deletions"": 0, ""lines"": 1}, ""src/Make_morph.mak"": {""insertions"": 1, ""deletions"": 0, ""lines"": 1}, ""src/Make_mvc.mak"": {""insertions"": 4, ""deletions"": 0, ""lines"": 4}, ""src/Make_vms.mms"": {""insertions"": 6, ""deletions"": 0, ""lines"": 6}, ""src/Makefile"": {""insertions"": 11, ""deletions"": 0, ""lines"": 11}, ""src/gui_xim.c"": {""insertions"": 1777, ""deletions"": 0, ""lines"": 1777}, ""src/mbyte.c"": {""insertions"": 0, ""deletions"": 1764, ""lines"": 1764}, ""src/proto.h"": {""insertions"": 1, ""deletions"": 0, ""lines"": 1}, ""src/proto/gui_xim.pro"": {""insertions"": 17, ""deletions"": 0, ""lines"": 17}, ""src/proto/mbyte.pro"": {""insertions"": 0, ""deletions"": 15, ""lines"": 15}, ""src/version.c"": {""insertions"": 2, ""deletions"": 0, ""lines"": 2}}"
2020-06-01 12:14:44,f17e7ea67a798d0aa45ce24ea80c9e21d5164326,Bram Moolenaar,13,9,22,5,"{""runtime/doc/eval.txt"": {""insertions"": 2, ""deletions"": 0, ""lines"": 2}, ""src/evalfunc.c"": {""insertions"": 1, ""deletions"": 1, ""lines"": 2}, ""src/mark.c"": {""insertions"": 1, ""deletions"": 1, ""lines"": 2}, ""src/testdir/test_marks.vim"": {""insertions"": 7, ""deletions"": 7, ""lines"": 14}, ""src/version.c"": {""insertions"": 2, ""deletions"": 0, ""lines"": 2}}"
2020-06-01 12:07:49,ad772a63ec3bc86fe9d53cba783812f53470a313,Bram Moolenaar,7,0,7,2,"{""src/gui.c"": {""insertions"": 5, ""deletions"": 0, ""lines"": 5}, ""src/version.c"": {""insertions"": 2, ""deletions"": 0, ""lines"": 2}}"
2020-05-31 21:11:59,858ba06d5f577b187da0367b231f7fa9461cb32d,Bram Moolenaar,367,71,438,8,"{""runtime/doc/eval.txt"": {""insertions"": 9, ""deletions"": 3, ""lines"": 12}, ""runtime/doc/options.txt"": {""insertions"": 15, ""deletions"": 0, ""lines"": 15}, ""runtime/doc/quickfix.txt"": {""insertions"": 55, ""deletions"": 1, ""lines"": 56}, ""src/option.h"": {""insertions"": 1, ""deletions"": 0, ""lines"": 1}, ""src/optiondefs.h"": {""insertions"": 9, ""deletions"": 0, ""lines"": 9}, ""src/quickfix.c"": {""insertions"": 159, ""deletions"": 67, ""lines"": 226}, ""src/testdir/test_quickfix.vim"": {""insertions"": 117, ""deletions"": 0, ""lines"": 117}, ""src/version.c"": {""insertions"": 2, ""deletions"": 0, ""lines"": 2}}"
2020-05-31 20:20:36,2245ae18e3480057f98fc0e5d9f18091f32a5de0,Bram Moolenaar,81,35,116,4,"{""runtime/doc/eval.txt"": {""insertions"": 17, ""deletions"": 5, ""lines"": 22}, ""src/evalfunc.c"": {""insertions"": 55, ""deletions"": 30, ""lines"": 85}, ""src/testdir/test_functions.vim"": {""insertions"": 7, ""deletions"": 0, ""lines"": 7}, ""src/version.c"": {""insertions"": 2, ""deletions"": 0, ""lines"": 2}}"
2020-05-31 20:06:51,fccd93f0917234b962ce07d1df3adf9d7105936f,Bram Moolenaar,20,21,41,8,"{""runtime/doc/eval.txt"": {""insertions"": 2, ""deletions"": 2, ""lines"": 4}, ""src/misc2.c"": {""insertions"": 8, ""deletions"": 7, ""lines"": 15}, ""src/testdir/test_backspace_opt.vim"": {""insertions"": 2, ""deletions"": 2, ""lines"": 4}, ""src/testdir/test_mapping.vim"": {""insertions"": 3, ""deletions"": 3, ""lines"": 6}, ""src/testdir/test_messages.vim"": {""insertions"": 1, ""deletions"": 1, ""lines"": 2}, ""src/typval.c"": {""insertions"": 2, ""deletions"": 5, ""lines"": 7}, ""src/version.c"": {""insertions"": 2, ""deletions"": 0, ""lines"": 2}, ""src/vim.h"": {""insertions"": 0, ""deletions"": 1, ""lines"": 1}}"
2020-05-31 19:28:02,494e9069cb32620f7688a7cb128a3feff827639e,Bram Moolenaar,167,57,224,16,"{""src/testdir/test_arglist.vim"": {""insertions"": 2, ""deletions"": 3, ""lines"": 5}, ""src/testdir/test_match.vim"": {""insertions"": 2, ""deletions"": 6, ""lines"": 8}, ""src/testdir/test_messages.vim"": {""insertions"": 3, ""deletions"": 6, ""lines"": 9}, ""src/testdir/test_netbeans.py"": {""insertions"": 3, ""deletions"": 2, ""lines"": 5}, ""src/testdir/test_netbeans.vim"": {""insertions"": 11, ""deletions"": 1, ""lines"": 12}, ""src/testdir/test_search.vim"": {""insertions"": 1, ""deletions"": 3, ""lines"": 4}, ""src/testdir/test_signals.vim"": {""insertions"": 2, ""deletions"": 6, ""lines"": 8}, ""src/testdir/test_signs.vim"": {""insertions"": 1, ""deletions"": 3, ""lines"": 4}, ""src/testdir/test_startup.vim"": {""insertions"": 2, ""deletions"": 6, ""lines"": 8}, ""src/testdir/test_startup_utf8.vim"": {""insertions"": 1, ""deletions"": 3, ""lines"": 4}, ""src/testdir/test_syntax.vim"": {""insertions"": 1, ""deletions"": 3, ""lines"": 4}, ""src/testdir/test_tabpage.vim"": {""insertions"": 1, ""deletions"": 3, ""lines"": 4}, ""src/testdir/test_timers.vim"": {""insertions"": 1, ""deletions"": 3, ""lines"": 4}, ""src/testdir/test_vimscript.vim"": {""insertions"": 1, ""deletions"": 3, ""lines"": 4}, ""src/testdir/test_writefile.vim"": {""insertions"": 133, ""deletions"": 6, ""lines"": 139}, ""src/version.c"": {""insertions"": 2, ""deletions"": 0, ""lines"": 2}}"
2020-05-31 17:48:53,e35a52aee718c881bdfa69a47a1068df6ab6c60a,Bram Moolenaar,195,8,203,5,"{""runtime/doc/syntax.txt"": {""insertions"": 22, ""deletions"": 0, ""lines"": 22}, ""src/structs.h"": {""insertions"": 5, ""deletions"": 0, ""lines"": 5}, ""src/syntax.c"": {""insertions"": 82, ""deletions"": 7, ""lines"": 89}, ""src/testdir/test_syntax.vim"": {""insertions"": 84, ""deletions"": 1, ""lines"": 85}, ""src/version.c"": {""insertions"": 2, ""deletions"": 0, ""lines"": 2}}"
2020-05-31 15:49:30,d881b516da0184052d2f9d33c3f72c5c014316bd,Bram Moolenaar,58,4,62,5,"{""runtime/doc/indent.txt"": {""insertions"": 7, ""deletions"": 1, ""lines"": 8}, ""src/cindent.c"": {""insertions"": 12, ""deletions"": 3, ""lines"": 15}, ""src/structs.h"": {""insertions"": 1, ""deletions"": 0, ""lines"": 1}, ""src/testdir/test_cindent.vim"": {""insertions"": 36, ""deletions"": 0, ""lines"": 36}, ""src/version.c"": {""insertions"": 2, ""deletions"": 0, ""lines"": 2}}"
2020-05-31 14:42:30,e023e88bed3f2e0a7ea4cf10cac2de80bc9c271c,Bram Moolenaar,118,24,142,12,"{""runtime/doc/syntax.txt"": {""insertions"": 9, ""deletions"": 5, ""lines"": 14}, ""runtime/doc/term.txt"": {""insertions"": 2, ""deletions"": 0, ""lines"": 2}, ""src/globals.h"": {""insertions"": 2, ""deletions"": 0, ""lines"": 2}, ""src/highlight.c"": {""insertions"": 56, ""deletions"": 16, ""lines"": 72}, ""src/optiondefs.h"": {""insertions"": 2, ""deletions"": 0, ""lines"": 2}, ""src/proto/term.pro"": {""insertions"": 2, ""deletions"": 0, ""lines"": 2}, ""src/screen.c"": {""insertions"": 17, ""deletions"": 0, ""lines"": 17}, ""src/structs.h"": {""insertions"": 2, ""deletions"": 0, ""lines"": 2}, ""src/term.c"": {""insertions"": 19, ""deletions"": 2, ""lines"": 21}, ""src/term.h"": {""insertions"": 4, ""deletions"": 0, ""lines"": 4}, ""src/testdir/test_options.vim"": {""insertions"": 1, ""deletions"": 1, ""lines"": 2}, ""src/version.c"": {""insertions"": 2, ""deletions"": 0, ""lines"": 2}}"
2020-05-31 14:04:42,b10090928cb5283f867e8457b7eea0985470d8d4,Bram Moolenaar,15,8,23,3,"{""src/terminal.c"": {""insertions"": 3, ""deletions"": 3, ""lines"": 6}, ""src/testdir/test_terminal.vim"": {""insertions"": 10, ""deletions"": 5, ""lines"": 15}, ""src/version.c"": {""insertions"": 2, ""deletions"": 0, ""lines"": 2}}"
2020-05-31 13:41:57,cfb4b47de08e4437c692d382067dc1692cd83c23,Bram Moolenaar,171,0,171,7,"{""runtime/doc/eval.txt"": {""insertions"": 20, ""deletions"": 0, ""lines"": 20}, ""runtime/doc/usr_41.txt"": {""insertions"": 1, ""deletions"": 0, ""lines"": 1}, ""src/evalfunc.c"": {""insertions"": 1, ""deletions"": 0, ""lines"": 1}, ""src/mark.c"": {""insertions"": 121, ""deletions"": 0, ""lines"": 121}, ""src/proto/mark.pro"": {""insertions"": 1, ""deletions"": 0, ""lines"": 1}, ""src/testdir/test_marks.vim"": {""insertions"": 25, ""deletions"": 0, ""lines"": 25}, ""src/version.c"": {""insertions"": 2, ""deletions"": 0, ""lines"": 2}}"
2020-05-31 13:08:59,aaad995f8384a77a64efba6846c9c4ac99de0953,Bram Moolenaar,97,27,124,5,"{""runtime/doc/options.txt"": {""insertions"": 9, ""deletions"": 0, ""lines"": 9}, ""src/ops.c"": {""insertions"": 40, ""deletions"": 25, ""lines"": 65}, ""src/optionstr.c"": {""insertions"": 1, ""deletions"": 1, ""lines"": 2}, ""src/testdir/test_increment.vim"": {""insertions"": 45, ""deletions"": 1, ""lines"": 46}, ""src/version.c"": {""insertions"": 2, ""deletions"": 0, ""lines"": 2}}"
2020-05-31 12:25:22,f09715bc5c827dab4425736da9024727836997e5,Bram Moolenaar,1420,1,1421,12,"{""Filelist"": {""insertions"": 2, ""deletions"": 0, ""lines"": 2}, ""runtime/doc/Makefile"": {""insertions"": 17, ""deletions"": 1, ""lines"": 18}, ""runtime/doc/evim-tr.1"": {""insertions"": 48, ""deletions"": 0, ""lines"": 48}, ""runtime/doc/evim-tr.UTF-8.1"": {""insertions"": 48, ""deletions"": 0, ""lines"": 48}, ""runtime/doc/vim-tr.1"": {""insertions"": 544, ""deletions"": 0, ""lines"": 544}, ""runtime/doc/vim-tr.UTF-8.1"": {""insertions"": 544, ""deletions"": 0, ""lines"": 544}, ""runtime/doc/vimdiff-tr.1"": {""insertions"": 45, ""deletions"": 0, ""lines"": 45}, ""runtime/doc/vimdiff-tr.UTF-8.1"": {""insertions"": 45, ""deletions"": 0, ""lines"": 45}, ""runtime/doc/vimtutor-tr.1"": {""insertions"": 50, ""deletions"": 0, ""lines"": 50}, ""runtime/doc/vimtutor-tr.UTF-8.1"": {""insertions"": 50, ""deletions"": 0, ""lines"": 50}, ""src/Makefile"": {""insertions"": 25, ""deletions"": 0, ""lines"": 25}, ""src/version.c"": {""insertions"": 2, ""deletions"": 0, ""lines"": 2}}"
2020-05-31 12:08:12,788fbb47079e6df4d4815d27273faf8390395029,Bram Moolenaar,121,9,130,8,"{""Filelist"": {""insertions"": 1, ""deletions"": 0, ""lines"": 1}, ""src/if_lua.c"": {""insertions"": 95, ""deletions"": 9, ""lines"": 104}, ""src/optionstr.c"": {""insertions"": 5, ""deletions"": 0, ""lines"": 5}, ""src/proto/if_lua.pro"": {""insertions"": 1, ""deletions"": 0, ""lines"": 1}, ""src/testdir/test_lua.vim"": {""insertions"": 5, ""deletions"": 0, ""lines"": 5}, ""src/testdir/testluaplugin/lua/testluaplugin/hello.lua"": {""insertions"": 7, ""deletions"": 0, ""lines"": 7}, ""src/testdir/testluaplugin/lua/testluaplugin/init.lua"": {""insertions"": 5, ""deletions"": 0, ""lines"": 5}, ""src/version.c"": {""insertions"": 2, ""deletions"": 0, ""lines"": 2}}"
2020-05-31 11:53:04,5cd1cb9ff9d04979ff4cbc36ca8416d83364505d,Bram Moolenaar,4,1,5,2,"{""src/gui_gtk_x11.c"": {""insertions"": 2, ""deletions"": 1, ""lines"": 3}, ""src/version.c"": {""insertions"": 2, ""deletions"": 0, ""lines"": 2}}"
2020-05-31 11:09:47,928eec649b8af389de0fdb7aba2034d27df3e058,Bram Moolenaar,4,4,8,2,"{""src/os_unix.c"": {""insertions"": 2, ""deletions"": 4, ""lines"": 6}, ""src/version.c"": {""insertions"": 2, ""deletions"": 0, ""lines"": 2}}"
2020-05-30 19:52:54,ebe9d34aa07037cff2188a8dd424ee1f59cbb0bf,Bram Moolenaar,60,43,103,13,"{""runtime/doc/eval.txt"": {""insertions"": 3, ""deletions"": 0, ""lines"": 3}, ""src/gui_mac.c"": {""insertions"": 1, ""deletions"": 2, ""lines"": 3}, ""src/highlight.c"": {""insertions"": 1, ""deletions"": 2, ""lines"": 3}, ""src/misc2.c"": {""insertions"": 16, ""deletions"": 20, ""lines"": 36}, ""src/option.c"": {""insertions"": 2, ""deletions"": 1, ""lines"": 3}, ""src/proto/misc2.pro"": {""insertions"": 2, ""deletions"": 2, ""lines"": 4}, ""src/term.c"": {""insertions"": 3, ""deletions"": 2, ""lines"": 5}, ""src/testdir/test_backspace_opt.vim"": {""insertions"": 2, ""deletions"": 2, ""lines"": 4}, ""src/testdir/test_mapping.vim"": {""insertions"": 3, ""deletions"": 3, ""lines"": 6}, ""src/testdir/test_messages.vim"": {""insertions"": 1, ""deletions"": 1, ""lines"": 2}, ""src/typval.c"": {""insertions"": 17, ""deletions"": 8, ""lines"": 25}, ""src/version.c"": {""insertions"": 2, ""deletions"": 0, ""lines"": 2}, ""src/vim.h"": {""insertions"": 7, ""deletions"": 0, ""lines"": 7}}"
2020-05-30 18:50:25,363d6148dfc2cc17fb0d286c7a36c305f56f5813,Bram Moolenaar,52,3,55,3,"{""src/testdir/test_xxd.vim"": {""insertions"": 39, ""deletions"": 0, ""lines"": 39}, ""src/version.c"": {""insertions"": 2, ""deletions"": 0, ""lines"": 2}, ""src/xxd/xxd.c"": {""insertions"": 11, ""deletions"": 3, ""lines"": 14}}"
2020-05-30 18:30:46,ca70c07b72c24aae3d141e67d08f50361f051af5,Bram Moolenaar,52,50,102,22,"{""src/buffer.c"": {""insertions"": 2, ""deletions"": 2, ""lines"": 4}, ""src/change.c"": {""insertions"": 1, ""deletions"": 1, ""lines"": 2}, ""src/diff.c"": {""insertions"": 2, ""deletions"": 2, ""lines"": 4}, ""src/evalbuffer.c"": {""insertions"": 1, ""deletions"": 1, ""lines"": 2}, ""src/ex_cmds.c"": {""insertions"": 5, ""deletions"": 5, ""lines"": 10}, ""src/ex_docmd.c"": {""insertions"": 1, ""deletions"": 1, ""lines"": 2}, ""src/fileio.c"": {""insertions"": 4, ""deletions"": 4, ""lines"": 8}, ""src/if_lua.c"": {""insertions"": 1, ""deletions"": 1, ""lines"": 2}, ""src/if_mzsch.c"": {""insertions"": 3, ""deletions"": 3, ""lines"": 6}, ""src/if_perl.xs"": {""insertions"": 2, ""deletions"": 2, ""lines"": 4}, ""src/if_py_both.h"": {""insertions"": 3, ""deletions"": 3, ""lines"": 6}, ""src/if_ruby.c"": {""insertions"": 1, ""deletions"": 1, ""lines"": 2}, ""src/if_tcl.c"": {""insertions"": 2, ""deletions"": 2, ""lines"": 4}, ""src/memline.c"": {""insertions"": 4, ""deletions"": 4, ""lines"": 8}, ""src/normal.c"": {""insertions"": 1, ""deletions"": 1, ""lines"": 2}, ""src/popupmenu.c"": {""insertions"": 2, ""deletions"": 2, ""lines"": 4}, ""src/popupwin.c"": {""insertions"": 2, ""deletions"": 2, ""lines"": 4}, ""src/proto/memline.pro"": {""insertions"": 1, ""deletions"": 1, ""lines"": 2}, ""src/quickfix.c"": {""insertions"": 2, ""deletions"": 2, ""lines"": 4}, ""src/spell.c"": {""insertions"": 1, ""deletions"": 1, ""lines"": 2}, ""src/terminal.c"": {""insertions"": 9, ""deletions"": 9, ""lines"": 18}, ""src/version.c"": {""insertions"": 2, ""deletions"": 0, ""lines"": 2}}"
2020-05-30 18:05:02,d6cd5ffade84a1054fed23079133af3b837033bf,Bram Moolenaar,2,2,4,2,"{""src/os_unix.c"": {""insertions"": 0, ""deletions"": 2, ""lines"": 2}, ""src/version.c"": {""insertions"": 2, ""deletions"": 0, ""lines"": 2}}"
2020-05-30 17:52:46,f4ae6b245a54f11dd967d06b80f30e5abf55fb82,Bram Moolenaar,28,42,70,4,"{""src/getchar.c"": {""insertions"": 15, ""deletions"": 5, ""lines"": 20}, ""src/gui.c"": {""insertions"": 2, ""deletions"": 2, ""lines"": 4}, ""src/gui_gtk_x11.c"": {""insertions"": 9, ""deletions"": 35, ""lines"": 44}, ""src/version.c"": {""insertions"": 2, ""deletions"": 0, ""lines"": 2}}"
2020-05-30 16:37:55,95da136142628e06425f9d9eb2d1ca56a9e48feb,Bram Moolenaar,208,101,309,4,"{""runtime/doc/eval.txt"": {""insertions"": 1, ""deletions"": 1, ""lines"": 2}, ""src/os_win32.c"": {""insertions"": 181, ""deletions"": 100, ""lines"": 281}, ""src/testdir/test_functions.vim"": {""insertions"": 24, ""deletions"": 0, ""lines"": 24}, ""src/version.c"": {""insertions"": 2, ""deletions"": 0, ""lines"": 2}}"
2020-05-30 16:14:57,041c7107f23d3b49ab62c1d7e36af90421db8b63,Bram Moolenaar,17,364,381,19,"{""Filelist"": {""insertions"": 0, ""deletions"": 4, ""lines"": 4}, ""src/Makefile"": {""insertions"": 1, ""deletions"": 8, ""lines"": 9}, ""src/auto/configure"": {""insertions"": 0, ""deletions"": 10, ""lines"": 10}, ""src/configure.ac"": {""insertions"": 0, ""deletions"": 8, ""lines"": 8}, ""src/evalfunc.c"": {""insertions"": 0, ""deletions"": 7, ""lines"": 7}, ""src/normal.c"": {""insertions"": 0, ""deletions"": 8, ""lines"": 8}, ""src/os_beos.c"": {""insertions"": 0, ""deletions"": 200, ""lines"": 200}, ""src/os_beos.h"": {""insertions"": 0, ""deletions"": 27, ""lines"": 27}, ""src/os_beos.rsrc"": {""insertions"": 0, ""deletions"": 0, ""lines"": 0}, ""src/os_unix.c"": {""insertions"": 9, ""deletions"": 21, ""lines"": 30}, ""src/proto.h"": {""insertions"": 0, ""deletions"": 3, ""lines"": 3}, ""src/proto/os_beos.pro"": {""insertions"": 0, ""deletions"": 4, ""lines"": 4}, ""src/pty.c"": {""insertions"": 1, ""deletions"": 1, ""lines"": 2}, ""src/screen.c"": {""insertions"": 0, ""deletions"": 14, ""lines"": 14}, ""src/term.c"": {""insertions"": 2, ""deletions"": 29, ""lines"": 31}, ""src/testdir/test_functions.vim"": {""insertions"": 1, ""deletions"": 3, ""lines"": 4}, ""src/ui.c"": {""insertions"": 1, ""deletions"": 13, ""lines"": 14}, ""src/version.c"": {""insertions"": 2, ""deletions"": 0, ""lines"": 2}, ""src/vim.h"": {""insertions"": 0, ""deletions"": 4, ""lines"": 4}}"
2020-05-30 15:49:25,06b7b58455f9c09be3d1c36d174ffbfdf4efcd79,Bram Moolenaar,108,12,120,4,"{""src/os_win32.c"": {""insertions"": 94, ""deletions"": 11, ""lines"": 105}, ""src/proto/os_win32.pro"": {""insertions"": 2, ""deletions"": 0, ""lines"": 2}, ""src/term.c"": {""insertions"": 10, ""deletions"": 1, ""lines"": 11}, ""src/version.c"": {""insertions"": 2, ""deletions"": 0, ""lines"": 2}}"
2020-05-30 15:06:14,367d59e6ba65cf554d167933775fa17e40dcc6a7,Bram Moolenaar,1569,1534,3103,16,"{""Filelist"": {""insertions"": 3, ""deletions"": 0, ""lines"": 3}, ""src/Make_cyg_ming.mak"": {""insertions"": 1, ""deletions"": 0, ""lines"": 1}, ""src/Make_morph.mak"": {""insertions"": 1, ""deletions"": 0, ""lines"": 1}, ""src/Make_mvc.mak"": {""insertions"": 4, ""deletions"": 0, ""lines"": 4}, ""src/Make_vms.mms"": {""insertions"": 5, ""deletions"": 0, ""lines"": 5}, ""src/Makefile"": {""insertions"": 10, ""deletions"": 0, ""lines"": 10}, ""src/README.md"": {""insertions"": 1, ""deletions"": 0, ""lines"": 1}, ""src/eval.c"": {""insertions"": 0, ""deletions"": 1428, ""lines"": 1428}, ""src/evalfunc.c"": {""insertions"": 0, ""deletions"": 81, ""lines"": 81}, ""src/globals.h"": {""insertions"": 3, ""deletions"": 0, ""lines"": 3}, ""src/proto.h"": {""insertions"": 1, ""deletions"": 0, ""lines"": 1}, ""src/proto/eval.pro"": {""insertions"": 0, ""deletions"": 22, ""lines"": 22}, ""src/proto/evalfunc.pro"": {""insertions"": 0, ""deletions"": 3, ""lines"": 3}, ""src/proto/typval.pro"": {""insertions"": 30, ""deletions"": 0, ""lines"": 30}, ""src/typval.c"": {""insertions"": 1508, ""deletions"": 0, ""lines"": 1508}, ""src/version.c"": {""insertions"": 2, ""deletions"": 0, ""lines"": 2}}"
2020-05-30 14:17:33,d5c2c7763d73b91efd64a49da8221f9955debdd5,Bram Moolenaar,4,0,4,2,"{""src/undo.c"": {""insertions"": 2, ""deletions"": 0, ""lines"": 2}, ""src/version.c"": {""insertions"": 2, ""deletions"": 0, ""lines"": 2}}"
2020-05-30 13:32:02,87be9be1db6b6d8fb57ef14e05f23a84e5e8bea0,Bram Moolenaar,241,223,464,7,"{""src/memline.c"": {""insertions"": 16, ""deletions"": 16, ""lines"": 32}, ""src/ops.c"": {""insertions"": 21, ""deletions"": 30, ""lines"": 51}, ""src/proto/textprop.pro"": {""insertions"": 2, ""deletions"": 2, ""lines"": 4}, ""src/testdir/dumps/Test_textprop_01.dump"": {""insertions"": 1, ""deletions"": 1, ""lines"": 2}, ""src/testdir/test_textprop.vim"": {""insertions"": 25, ""deletions"": 0, ""lines"": 25}, ""src/textprop.c"": {""insertions"": 174, ""deletions"": 174, ""lines"": 348}, ""src/version.c"": {""insertions"": 2, ""deletions"": 0, ""lines"": 2}}"
2020-05-30 12:46:52,a9d4b84d97fb74061eeb42c1433e111fb58825dc,Bram Moolenaar,129,47,176,5,"{""src/memline.c"": {""insertions"": 75, ""deletions"": 44, ""lines"": 119}, ""src/proto/memline.pro"": {""insertions"": 2, ""deletions"": 0, ""lines"": 2}, ""src/structs.h"": {""insertions"": 9, ""deletions"": 0, ""lines"": 9}, ""src/undo.c"": {""insertions"": 41, ""deletions"": 3, ""lines"": 44}, ""src/version.c"": {""insertions"": 2, ""deletions"": 0, ""lines"": 2}}"
2020-05-30 11:15:14,0016fd2e29b7d4d4eef89a0516d14888a8651c61,Bram Moolenaar,6,0,6,3,"{""runtime/filetype.vim"": {""insertions"": 3, ""deletions"": 0, ""lines"": 3}, ""src/testdir/test_filetype.vim"": {""insertions"": 1, ""deletions"": 0, ""lines"": 1}, ""src/version.c"": {""insertions"": 2, ""deletions"": 0, ""lines"": 2}}"
2020-05-30 11:07:39,208534d9ae6e8dec5baff90440b58c63f0b37981,Bram Moolenaar,8,0,8,2,"{""src/channel.c"": {""insertions"": 6, ""deletions"": 0, ""lines"": 6}, ""src/version.c"": {""insertions"": 2, ""deletions"": 0, ""lines"": 2}}"
2020-05-29 21:03:09,823654bc06c847af20967d41db32d592aba416cb,Bram Moolenaar,6,5,11,3,"{""runtime/doc/options.txt"": {""insertions"": 3, ""deletions"": 1, ""lines"": 4}, ""src/ex_docmd.c"": {""insertions"": 1, ""deletions"": 4, ""lines"": 5}, ""src/version.c"": {""insertions"": 2, ""deletions"": 0, ""lines"": 2}}"
2020-05-29 20:49:43,6cb0726215519fe94103803e4aa77a355384bcf2,Bram Moolenaar,47,1,48,4,"{""src/search.c"": {""insertions"": 6, ""deletions"": 1, ""lines"": 7}, ""src/testdir/dumps/Test_searchstat_3.dump"": {""insertions"": 10, ""deletions"": 0, ""lines"": 10}, ""src/testdir/test_search_stat.vim"": {""insertions"": 29, ""deletions"": 0, ""lines"": 29}, ""src/version.c"": {""insertions"": 2, ""deletions"": 0, ""lines"": 2}}"
2020-05-29 20:41:41,b42c0d54279b1fdb79652db0c84171e213458809,Bram Moolenaar,50,14,64,8,"{""src/getchar.c"": {""insertions"": 28, ""deletions"": 8, ""lines"": 36}, ""src/globals.h"": {""insertions"": 6, ""deletions"": 1, ""lines"": 7}, ""src/message.c"": {""insertions"": 2, ""deletions"": 2, ""lines"": 4}, ""src/normal.c"": {""insertions"": 1, ""deletions"": 1, ""lines"": 2}, ""src/proto/getchar.pro"": {""insertions"": 1, ""deletions"": 1, ""lines"": 2}, ""src/terminal.c"": {""insertions"": 1, ""deletions"": 1, ""lines"": 2}, ""src/testdir/test_messages.vim"": {""insertions"": 9, ""deletions"": 0, ""lines"": 9}, ""src/version.c"": {""insertions"": 2, ""deletions"": 0, ""lines"": 2}}"
2020-05-29 19:42:55,09307e3bc1423d5e8a05464b94717a948d6c059a,Bram Moolenaar,3,1,4,2,"{""src/screen.c"": {""insertions"": 1, ""deletions"": 1, ""lines"": 2}, ""src/version.c"": {""insertions"": 2, ""deletions"": 0, ""lines"": 2}}"
2020-05-29 19:38:42,b60db8ba149b26024e6d871e8634d7fea639252a,Bram Moolenaar,3,3,6,2,"{""src/channel.c"": {""insertions"": 1, ""deletions"": 3, ""lines"": 4}, ""src/version.c"": {""insertions"": 2, ""deletions"": 0, ""lines"": 2}}"
2020-05-28 19:30:11,14798ab9a5ee4b94f6c12f1986207569356acfc8,Bram Moolenaar,33,13,46,3,"{""src/ex_cmds2.c"": {""insertions"": 6, ""deletions"": 0, ""lines"": 6}, ""src/testdir/test_cdo.vim"": {""insertions"": 25, ""deletions"": 13, ""lines"": 38}, ""src/version.c"": {""insertions"": 2, ""deletions"": 0, ""lines"": 2}}"
2020-05-28 19:03:53,c998370562425e70f4cf202a87112d638f5f7b38,Bram Moolenaar,17,1,18,3,"{""src/getchar.c"": {""insertions"": 10, ""deletions"": 1, ""lines"": 11}, ""src/gui_x11.c"": {""insertions"": 5, ""deletions"": 0, ""lines"": 5}, ""src/version.c"": {""insertions"": 2, ""deletions"": 0, ""lines"": 2}}"
2020-05-27 21:15:16,3f65c66df95445ef84f98de007c9b70ce23f54a0,Bram Moolenaar,8,0,8,3,"{""src/ex_cmds.c"": {""insertions"": 3, ""deletions"": 0, ""lines"": 3}, ""src/testdir/test_popupwin.vim"": {""insertions"": 3, ""deletions"": 0, ""lines"": 3}, ""src/version.c"": {""insertions"": 2, ""deletions"": 0, ""lines"": 2}}"
2020-05-27 20:08:34,ca5bc746073b6fd4b7651bc02f7a18b1b43bd4ca,Bram Moolenaar,4,0,4,2,"{""src/gui.c"": {""insertions"": 2, ""deletions"": 0, ""lines"": 2}, ""src/version.c"": {""insertions"": 2, ""deletions"": 0, ""lines"": 2}}"
2020-05-27 19:29:04,a55ba06f6904af3d6a78fc90358cf72d4f2e8450,Bram Moolenaar,3,1,4,2,"{""src/map.c"": {""insertions"": 1, ""deletions"": 1, ""lines"": 2}, ""src/version.c"": {""insertions"": 2, ""deletions"": 0, ""lines"": 2}}"
2020-05-27 19:22:14,f4b68e9056f8ddb64c3d7141df138fe099575abf,Bram Moolenaar,5,3,8,3,"{""src/libvterm/src/pen.c"": {""insertions"": 2, ""deletions"": 2, ""lines"": 4}, ""src/terminal.c"": {""insertions"": 1, ""deletions"": 1, ""lines"": 2}, ""src/version.c"": {""insertions"": 2, ""deletions"": 0, ""lines"": 2}}"
2020-05-26 20:14:27,80a20df86a1ceefa3506cc578ba0ba35da979e38,Bram Moolenaar,7,0,7,2,"{""src/gui_x11.c"": {""insertions"": 5, ""deletions"": 0, ""lines"": 5}, ""src/version.c"": {""insertions"": 2, ""deletions"": 0, ""lines"": 2}}"
2020-05-26 19:20:45,388a5d4f20b4b64341d1604aa238cab85827b892,Bram Moolenaar,349,148,497,25,"{""runtime/compiler/eslint.vim"": {""insertions"": 16, ""deletions"": 0, ""lines"": 16}, ""runtime/compiler/standard.vim"": {""insertions"": 16, ""deletions"": 0, ""lines"": 16}, ""runtime/doc/eval.txt"": {""insertions"": 8, ""deletions"": 3, ""lines"": 11}, ""runtime/doc/if_lua.txt"": {""insertions"": 1, ""deletions"": 1, ""lines"": 2}, ""runtime/doc/index.txt"": {""insertions"": 6, ""deletions"": 5, ""lines"": 11}, ""runtime/doc/makehtml.awk"": {""insertions"": 1, ""deletions"": 1, ""lines"": 2}, ""runtime/doc/os_haiku.txt"": {""insertions"": 1, ""deletions"": 4, ""lines"": 5}, ""runtime/doc/popup.txt"": {""insertions"": 1, ""deletions"": 1, ""lines"": 2}, ""runtime/doc/repeat.txt"": {""insertions"": 7, ""deletions"": 2, ""lines"": 9}, ""runtime/doc/tags"": {""insertions"": 7, ""deletions"": 0, ""lines"": 7}, ""runtime/doc/terminal.txt"": {""insertions"": 7, ""deletions"": 2, ""lines"": 9}, ""runtime/doc/todo.txt"": {""insertions"": 53, ""deletions"": 23, ""lines"": 76}, ""runtime/doc/vim9.txt"": {""insertions"": 25, ""deletions"": 64, ""lines"": 89}, ""runtime/ftplugin/vim.vim"": {""insertions"": 10, ""deletions"": 10, ""lines"": 20}, ""runtime/indent/sshconfig.vim"": {""insertions"": 34, ""deletions"": 0, ""lines"": 34}, ""runtime/indent/testdir/sshconfig.in"": {""insertions"": 53, ""deletions"": 0, ""lines"": 53}, ""runtime/indent/testdir/sshconfig.ok"": {""insertions"": 53, ""deletions"": 0, ""lines"": 53}, ""runtime/indent/tex.vim"": {""insertions"": 15, ""deletions"": 7, ""lines"": 22}, ""runtime/macros/less.vim"": {""insertions"": 3, ""deletions"": 3, ""lines"": 6}, ""runtime/pack/dist/opt/termdebug/plugin/termdebug.vim"": {""insertions"": 9, ""deletions"": 4, ""lines"": 13}, ""runtime/syntax/groovy.vim"": {""insertions"": 5, ""deletions"": 5, ""lines"": 10}, ""runtime/syntax/javascript.vim"": {""insertions"": 4, ""deletions"": 4, ""lines"": 8}, ""runtime/syntax/spec.vim"": {""insertions"": 4, ""deletions"": 1, ""lines"": 5}, ""runtime/syntax/tex.vim"": {""insertions"": 3, ""deletions"": 2, ""lines"": 5}, ""runtime/syntax/vim.vim"": {""insertions"": 7, ""deletions"": 6, ""lines"": 13}}"
2020-05-26 18:22:01,fcb0b61d15f66f0e9116a6bc56d9d8105bb913cf,Bram Moolenaar,5,3,8,3,"{""src/list.c"": {""insertions"": 1, ""deletions"": 1, ""lines"": 2}, ""src/testdir/test_filter_map.vim"": {""insertions"": 2, ""deletions"": 2, ""lines"": 4}, ""src/version.c"": {""insertions"": 2, ""deletions"": 0, ""lines"": 2}}"
2020-05-26 18:09:11,92c098d18e435a7a762409744ebe2dbb3746ed77,Bram Moolenaar,24,11,35,6,"{"".travis.yml"": {""insertions"": 10, ""deletions"": 6, ""lines"": 16}, ""ci/config.mk.clang.sed"": {""insertions"": 2, ""deletions"": 1, ""lines"": 3}, ""ci/config.mk.gcc.sed"": {""insertions"": 1, ""deletions"": 1, ""lines"": 2}, ""ci/config.mk.sed"": {""insertions"": 2, ""deletions"": 2, ""lines"": 4}, ""src/if_ruby.c"": {""insertions"": 7, ""deletions"": 1, ""lines"": 8}, ""src/version.c"": {""insertions"": 2, ""deletions"": 0, ""lines"": 2}}"
2020-05-26 09:37:26,285b189260e2d753454449e429f2caa17e1c39a5,Bram Moolenaar,3,0,3,2,"{""src/userfunc.c"": {""insertions"": 1, ""deletions"": 0, ""lines"": 1}, ""src/version.c"": {""insertions"": 2, ""deletions"": 0, ""lines"": 2}}"
2020-05-26 09:08:28,ebc3de634f4c2893f34e41b4f8da1d59212e59ea,Bram Moolenaar,14,1,15,2,"{""src/userfunc.c"": {""insertions"": 12, ""deletions"": 1, ""lines"": 13}, ""src/version.c"": {""insertions"": 2, ""deletions"": 0, ""lines"": 2}}"
2020-05-25 21:29:28,a14e6975478adeddcc2161edc1ec611016aa89f3,Bram Moolenaar,5,0,5,2,"{""src/userfunc.c"": {""insertions"": 3, ""deletions"": 0, ""lines"": 3}, ""src/version.c"": {""insertions"": 2, ""deletions"": 0, ""lines"": 2}}"
2020-05-25 21:01:42,1919371b2b9ddb1a645f40b59adbd89317530882,Bram Moolenaar,7,3,10,3,"{""src/eval.c"": {""insertions"": 4, ""deletions"": 3, ""lines"": 7}, ""src/testdir/test_functions.vim"": {""insertions"": 1, ""deletions"": 0, ""lines"": 1}, ""src/version.c"": {""insertions"": 2, ""deletions"": 0, ""lines"": 2}}"
2020-05-25 20:36:50,25e0f5863e9010a75a1ff0d04e8f886403968755,Bram Moolenaar,125,41,166,11,"{""src/ex_docmd.c"": {""insertions"": 3, ""deletions"": 3, ""lines"": 6}, ""src/ex_eval.c"": {""insertions"": 32, ""deletions"": 15, ""lines"": 47}, ""src/globals.h"": {""insertions"": 1, ""deletions"": 1, ""lines"": 2}, ""src/proto/scriptfile.pro"": {""insertions"": 2, ""deletions"": 1, ""lines"": 3}, ""src/scriptfile.c"": {""insertions"": 19, ""deletions"": 2, ""lines"": 21}, ""src/structs.h"": {""insertions"": 8, ""deletions"": 4, ""lines"": 12}, ""src/testdir/test_vim9_script.vim"": {""insertions"": 31, ""deletions"": 6, ""lines"": 37}, ""src/userfunc.c"": {""insertions"": 3, ""deletions"": 3, ""lines"": 6}, ""src/version.c"": {""insertions"": 2, ""deletions"": 0, ""lines"": 2}, ""src/vim9compile.c"": {""insertions"": 16, ""deletions"": 5, ""lines"": 21}, ""src/vim9execute.c"": {""insertions"": 8, ""deletions"": 1, ""lines"": 9}}"
2020-05-25 18:33:55,2eec37926db6d31beb36f162ac00357a30c093c8,Bram Moolenaar,9,77,86,7,"{""src/evalvars.c"": {""insertions"": 2, ""deletions"": 16, ""lines"": 18}, ""src/ex_cmds.h"": {""insertions"": 1, ""deletions"": 1, ""lines"": 2}, ""src/ex_docmd.c"": {""insertions"": 0, ""deletions"": 1, ""lines"": 1}, ""src/proto/evalvars.pro"": {""insertions"": 0, ""deletions"": 1, ""lines"": 1}, ""src/proto/scriptfile.pro"": {""insertions"": 0, ""deletions"": 2, ""lines"": 2}, ""src/scriptfile.c"": {""insertions"": 4, ""deletions"": 56, ""lines"": 60}, ""src/version.c"": {""insertions"": 2, ""deletions"": 0, ""lines"": 2}}"
2020-05-24 22:28:33,45a1508a229b1d1d2eb79cabe55a183dc18fd040,Bram Moolenaar,7,3,10,2,"{""src/version.c"": {""insertions"": 2, ""deletions"": 0, ""lines"": 2}, ""src/vim9compile.c"": {""insertions"": 5, ""deletions"": 3, ""lines"": 8}}"
2020-05-24 21:45:24,6ff71d8b7fbdf667a2f119a2487302e240961816,Bram Moolenaar,58,56,114,5,"{""src/proto/vim9compile.pro"": {""insertions"": 1, ""deletions"": 0, ""lines"": 1}, ""src/testdir/test_vim9_func.vim"": {""insertions"": 5, ""deletions"": 8, ""lines"": 13}, ""src/userfunc.c"": {""insertions"": 3, ""deletions"": 0, ""lines"": 3}, ""src/version.c"": {""insertions"": 2, ""deletions"": 0, ""lines"": 2}, ""src/vim9compile.c"": {""insertions"": 47, ""deletions"": 48, ""lines"": 95}}"
2020-05-24 21:14:23,f40e51a880a95f94dbbbecc9476559506c2cc345,Bram Moolenaar,2,1,3,2,"{""src/evalvars.c"": {""insertions"": 0, ""deletions"": 1, ""lines"": 1}, ""src/version.c"": {""insertions"": 2, ""deletions"": 0, ""lines"": 2}}"
2020-05-24 21:00:18,822ba24743af9ee1b5e7f656a7a61a38f3638bca,Bram Moolenaar,165,272,437,19,"{""src/eval.c"": {""insertions"": 2, ""deletions"": 1, ""lines"": 3}, ""src/evalvars.c"": {""insertions"": 9, ""deletions"": 28, ""lines"": 37}, ""src/ex_cmdidxs.h"": {""insertions"": 24, ""deletions"": 24, ""lines"": 48}, ""src/ex_cmds.h"": {""insertions"": 3, ""deletions"": 0, ""lines"": 3}, ""src/ex_docmd.c"": {""insertions"": 2, ""deletions"": 0, ""lines"": 2}, ""src/proto/evalvars.pro"": {""insertions"": 0, ""deletions"": 1, ""lines"": 1}, ""src/proto/userfunc.pro"": {""insertions"": 2, ""deletions"": 1, ""lines"": 3}, ""src/proto/vim9compile.pro"": {""insertions"": 1, ""deletions"": 2, ""lines"": 3}, ""src/structs.h"": {""insertions"": 4, ""deletions"": 1, ""lines"": 5}, ""src/testdir/test_vim9_disassemble.vim"": {""insertions"": 2, ""deletions"": 4, ""lines"": 6}, ""src/testdir/test_vim9_func.vim"": {""insertions"": 24, ""deletions"": 16, ""lines"": 40}, ""src/testdir/test_vim9_script.vim"": {""insertions"": 16, ""deletions"": 60, ""lines"": 76}, ""src/testdir/vim9.vim"": {""insertions"": 1, ""deletions"": 1, ""lines"": 2}, ""src/userfunc.c"": {""insertions"": 43, ""deletions"": 13, ""lines"": 56}, ""src/version.c"": {""insertions"": 2, ""deletions"": 0, ""lines"": 2}, ""src/vim.h"": {""insertions"": 0, ""deletions"": 1, ""lines"": 1}, ""src/vim9compile.c"": {""insertions"": 18, ""deletions"": 9, ""lines"": 27}, ""src/vim9execute.c"": {""insertions"": 12, ""deletions"": 1, ""lines"": 13}, ""src/vim9script.c"": {""insertions"": 0, ""deletions"": 109, ""lines"": 109}}"
2020-05-24 16:45:07,f7271e831614d15d173c7f562cc26f48c2554ce9,Bram Moolenaar,12,3,15,3,"{""src/eval.c"": {""insertions"": 8, ""deletions"": 3, ""lines"": 11}, ""src/testdir/test_functions.vim"": {""insertions"": 2, ""deletions"": 0, ""lines"": 2}, ""src/version.c"": {""insertions"": 2, ""deletions"": 0, ""lines"": 2}}"
2020-05-24 15:23:45,87202264f8e27f084c0e58f98aeb27fa5c6d5251,Bram Moolenaar,27,10,37,6,"{""src/channel.c"": {""insertions"": 6, ""deletions"": 0, ""lines"": 6}, ""src/globals.h"": {""insertions"": 3, ""deletions"": 0, ""lines"": 3}, ""src/gui.c"": {""insertions"": 1, ""deletions"": 1, ""lines"": 2}, ""src/term.c"": {""insertions"": 5, ""deletions"": 5, ""lines"": 10}, ""src/testdir/test_terminal.vim"": {""insertions"": 10, ""deletions"": 4, ""lines"": 14}, ""src/version.c"": {""insertions"": 2, ""deletions"": 0, ""lines"": 2}}"
2020-05-24 11:10:18,9c65253fe702ea010afec11aa971acd542c35de2,Bram Moolenaar,92,35,127,4,"{""runtime/doc/eval.txt"": {""insertions"": 13, ""deletions"": 6, ""lines"": 19}, ""src/map.c"": {""insertions"": 38, ""deletions"": 20, ""lines"": 58}, ""src/testdir/test_maparg.vim"": {""insertions"": 39, ""deletions"": 9, ""lines"": 48}, ""src/version.c"": {""insertions"": 2, ""deletions"": 0, ""lines"": 2}}"
2020-05-23 17:30:05,3718427ba3c28ccab30726880389e44070640d3b,Bram Moolenaar,4,2,6,2,"{""src/evalfunc.c"": {""insertions"": 2, ""deletions"": 2, ""lines"": 4}, ""src/version.c"": {""insertions"": 2, ""deletions"": 0, ""lines"": 2}}"
2020-05-22 20:06:06,591cec8366e87a172495c362477cbf5de8d399f0,Bram Moolenaar,170,164,334,14,"{""src/libvterm/include/vterm.h"": {""insertions"": 37, ""deletions"": 38, ""lines"": 75}, ""src/libvterm/src/encoding.c"": {""insertions"": 1, ""deletions"": 1, ""lines"": 2}, ""src/libvterm/src/keyboard.c"": {""insertions"": 10, ""deletions"": 9, ""lines"": 19}, ""src/libvterm/src/mouse.c"": {""insertions"": 1, ""deletions"": 1, ""lines"": 2}, ""src/libvterm/src/parser.c"": {""insertions"": 9, ""deletions"": 9, ""lines"": 18}, ""src/libvterm/src/pen.c"": {""insertions"": 3, ""deletions"": 3, ""lines"": 6}, ""src/libvterm/src/rect.h"": {""insertions"": 6, ""deletions"": 6, ""lines"": 12}, ""src/libvterm/src/screen.c"": {""insertions"": 29, ""deletions"": 28, ""lines"": 57}, ""src/libvterm/src/state.c"": {""insertions"": 19, ""deletions"": 17, ""lines"": 36}, ""src/libvterm/src/unicode.c"": {""insertions"": 24, ""deletions"": 23, ""lines"": 47}, ""src/libvterm/src/utf8.h"": {""insertions"": 2, ""deletions"": 2, ""lines"": 4}, ""src/libvterm/src/vterm.c"": {""insertions"": 17, ""deletions"": 17, ""lines"": 34}, ""src/libvterm/src/vterm_internal.h"": {""insertions"": 10, ""deletions"": 10, ""lines"": 20}, ""src/version.c"": {""insertions"": 2, ""deletions"": 0, ""lines"": 2}}"
2020-05-22 18:01:06,c94c1467b9b86156a6b7c8d3e41ff01c13d2be07,Bram Moolenaar,77,2,79,3,"{""src/map.c"": {""insertions"": 7, ""deletions"": 1, ""lines"": 8}, ""src/testdir/test_maparg.vim"": {""insertions"": 68, ""deletions"": 1, ""lines"": 69}, ""src/version.c"": {""insertions"": 2, ""deletions"": 0, ""lines"": 2}}"
2020-05-22 12:44:26,9cdcd1d0dc3bbea41b731639fd2431c2ef5cffaa,Bram Moolenaar,7,7,14,2,"{""src/testdir/test_terminal.vim"": {""insertions"": 5, ""deletions"": 7, ""lines"": 12}, ""src/version.c"": {""insertions"": 2, ""deletions"": 0, ""lines"": 2}}"
2020-05-22 12:10:36,2e61e2d08390623fcf933fd06646ac91f81fb772,Bram Moolenaar,10,1,11,3,"{""src/optiondefs.h"": {""insertions"": 1, ""deletions"": 1, ""lines"": 2}, ""src/testdir/test_options.vim"": {""insertions"": 7, ""deletions"": 0, ""lines"": 7}, ""src/version.c"": {""insertions"": 2, ""deletions"": 0, ""lines"": 2}}"
2020-05-22 11:38:18,5a80f8ad5dc0b2cc63400255dcf3c63f6c1a2ef9,Bram Moolenaar,8,7,15,2,"{""src/map.c"": {""insertions"": 6, ""deletions"": 7, ""lines"": 13}, ""src/version.c"": {""insertions"": 2, ""deletions"": 0, ""lines"": 2}}"
2020-05-22 11:34:01,98f1671cc0ab0ad6139cb9c6ce5262e7f646bc0a,Bram Moolenaar,41,19,60,4,"{""src/terminal.c"": {""insertions"": 1, ""deletions"": 1, ""lines"": 2}, ""src/testdir/test_gui.vim"": {""insertions"": 1, ""deletions"": 2, ""lines"": 3}, ""src/testdir/test_terminal.vim"": {""insertions"": 37, ""deletions"": 16, ""lines"": 53}, ""src/version.c"": {""insertions"": 2, ""deletions"": 0, ""lines"": 2}}"
2020-05-22 11:10:44,4c9243f9fb708c9010867d3cc8e928f36b58509a,Bram Moolenaar,231,61,292,6,"{""runtime/doc/eval.txt"": {""insertions"": 19, ""deletions"": 0, ""lines"": 19}, ""src/evalfunc.c"": {""insertions"": 1, ""deletions"": 0, ""lines"": 1}, ""src/map.c"": {""insertions"": 172, ""deletions"": 50, ""lines"": 222}, ""src/proto/map.pro"": {""insertions"": 1, ""deletions"": 0, ""lines"": 1}, ""src/testdir/test_maparg.vim"": {""insertions"": 36, ""deletions"": 11, ""lines"": 47}, ""src/version.c"": {""insertions"": 2, ""deletions"": 0, ""lines"": 2}}"
2020-05-21 19:50:58,74fae513f8032cfa9e129eedc33454f0bf68668b,Bram Moolenaar,14,1,15,3,"{""src/testdir/test_vim9_script.vim"": {""insertions"": 6, ""deletions"": 1, ""lines"": 7}, ""src/version.c"": {""insertions"": 2, ""deletions"": 0, ""lines"": 2}, ""src/vim9script.c"": {""insertions"": 6, ""deletions"": 0, ""lines"": 6}}"
2020-05-21 18:38:31,fe81389d606ae79415d208207295f41a4375c580,Bram Moolenaar,36,11,47,2,"{""src/testdir/test_terminal.vim"": {""insertions"": 34, ""deletions"": 11, ""lines"": 45}, ""src/version.c"": {""insertions"": 2, ""deletions"": 0, ""lines"": 2}}"
2020-05-21 18:10:04,e5886ccb5163873dd01fc67b09ab10e681351ee9,Bram Moolenaar,404,187,591,12,"{""src/libvterm/include/vterm.h"": {""insertions"": 114, ""deletions"": 7, ""lines"": 121}, ""src/libvterm/src/pen.c"": {""insertions"": 141, ""deletions"": 97, ""lines"": 238}, ""src/libvterm/src/screen.c"": {""insertions"": 7, ""deletions"": 2, ""lines"": 9}, ""src/libvterm/src/state.c"": {""insertions"": 0, ""deletions"": 2, ""lines"": 2}, ""src/libvterm/src/vterm_internal.h"": {""insertions"": 0, ""deletions"": 11, ""lines"": 11}, ""src/libvterm/t/26state_query.test"": {""insertions"": 4, ""deletions"": 4, ""lines"": 8}, ""src/libvterm/t/30state_pen.test"": {""insertions"": 16, ""deletions"": 16, ""lines"": 32}, ""src/libvterm/t/64screen_pen.test"": {""insertions"": 8, ""deletions"": 8, ""lines"": 16}, ""src/libvterm/t/harness.c"": {""insertions"": 34, ""deletions"": 5, ""lines"": 39}, ""src/term.c"": {""insertions"": 5, ""deletions"": 9, ""lines"": 14}, ""src/terminal.c"": {""insertions"": 73, ""deletions"": 26, ""lines"": 99}, ""src/version.c"": {""insertions"": 2, ""deletions"": 0, ""lines"": 2}}"
2020-05-20 17:30:19,83a52533b23c88f90be0dea01bc5e32ddadc1d6a,Bram Moolenaar,47,30,77,8,"{""src/Makefile"": {""insertions"": 1, ""deletions"": 1, ""lines"": 2}, ""src/libvterm/find-wide-chars.pl"": {""insertions"": 1, ""deletions"": 5, ""lines"": 6}, ""src/libvterm/src/fullwidth.inc"": {""insertions"": 22, ""deletions"": 15, ""lines"": 37}, ""src/libvterm/src/parser.c"": {""insertions"": 10, ""deletions"": 6, ""lines"": 16}, ""src/libvterm/src/vterm_internal.h"": {""insertions"": 2, ""deletions"": 2, ""lines"": 4}, ""src/libvterm/t/02parser.test"": {""insertions"": 8, ""deletions"": 0, ""lines"": 8}, ""src/libvterm/t/run-test.pl"": {""insertions"": 1, ""deletions"": 1, ""lines"": 2}, ""src/version.c"": {""insertions"": 2, ""deletions"": 0, ""lines"": 2}}"
2020-05-20 16:41:41,d863728913801c8fa6d633f6580edfcada533fd0,Bram Moolenaar,90,17,107,11,"{""src/libvterm/doc/seqs.txt"": {""insertions"": 2, ""deletions"": 0, ""lines"": 2}, ""src/libvterm/include/vterm.h"": {""insertions"": 13, ""deletions"": 5, ""lines"": 18}, ""src/libvterm/src/pen.c"": {""insertions"": 19, ""deletions"": 0, ""lines"": 19}, ""src/libvterm/src/screen.c"": {""insertions"": 11, ""deletions"": 1, ""lines"": 12}, ""src/libvterm/src/state.c"": {""insertions"": 17, ""deletions"": 1, ""lines"": 18}, ""src/libvterm/src/vterm.c"": {""insertions"": 1, ""deletions"": 0, ""lines"": 1}, ""src/libvterm/src/vterm_internal.h"": {""insertions"": 2, ""deletions"": 1, ""lines"": 3}, ""src/libvterm/t/12state_scroll.test"": {""insertions"": 7, ""deletions"": 1, ""lines"": 8}, ""src/libvterm/t/harness.c"": {""insertions"": 13, ""deletions"": 2, ""lines"": 15}, ""src/terminal.c"": {""insertions"": 3, ""deletions"": 6, ""lines"": 9}, ""src/version.c"": {""insertions"": 2, ""deletions"": 0, ""lines"": 2}}"
2020-05-19 21:11:00,eaa3e0dae53acc9a345f430ef014d65c105192c3,Bram Moolenaar,19,3,22,2,"{""src/terminal.c"": {""insertions"": 17, ""deletions"": 3, ""lines"": 20}, ""src/version.c"": {""insertions"": 2, ""deletions"": 0, ""lines"": 2}}"
2020-05-19 20:38:59,a09195f29ee8cd88411152cf311f4e4ab2f3b4b3,Bram Moolenaar,35,31,66,3,"{""src/json.c"": {""insertions"": 11, ""deletions"": 9, ""lines"": 20}, ""src/testdir/test_json.vim"": {""insertions"": 22, ""deletions"": 22, ""lines"": 44}, ""src/version.c"": {""insertions"": 2, ""deletions"": 0, ""lines"": 2}}"
2020-05-19 19:43:47,74c69636563310d1e941fec695ff2d74518fe743,Bram Moolenaar,5,3,8,2,"{""src/libvterm/src/state.c"": {""insertions"": 3, ""deletions"": 3, ""lines"": 6}, ""src/version.c"": {""insertions"": 2, ""deletions"": 0, ""lines"": 2}}"
2020-05-19 19:20:04,be593bf135f6967335b14ba188bd5f8f32175c75,Bram Moolenaar,396,312,708,14,"{""src/libvterm/include/vterm.h"": {""insertions"": 10, ""deletions"": 3, ""lines"": 13}, ""src/libvterm/src/parser.c"": {""insertions"": 138, ""deletions"": 140, ""lines"": 278}, ""src/libvterm/src/screen.c"": {""insertions"": 2, ""deletions"": 2, ""lines"": 4}, ""src/libvterm/src/state.c"": {""insertions"": 112, ""deletions"": 96, ""lines"": 208}, ""src/libvterm/src/vterm.c"": {""insertions"": 6, ""deletions"": 19, ""lines"": 25}, ""src/libvterm/src/vterm_internal.h"": {""insertions"": 28, ""deletions"": 19, ""lines"": 47}, ""src/libvterm/t/02parser.test"": {""insertions"": 18, ""deletions"": 8, ""lines"": 26}, ""src/libvterm/t/18state_termprops.test"": {""insertions"": 7, ""deletions"": 1, ""lines"": 8}, ""src/libvterm/t/29state_fallback.test"": {""insertions"": 2, ""deletions"": 2, ""lines"": 4}, ""src/libvterm/t/68screen_termprops.test"": {""insertions"": 1, ""deletions"": 1, ""lines"": 2}, ""src/libvterm/t/harness.c"": {""insertions"": 31, ""deletions"": 7, ""lines"": 38}, ""src/libvterm/t/run-test.pl"": {""insertions"": 14, ""deletions"": 3, ""lines"": 17}, ""src/terminal.c"": {""insertions"": 25, ""deletions"": 11, ""lines"": 36}, ""src/version.c"": {""insertions"": 2, ""deletions"": 0, ""lines"": 2}}"
2020-05-19 08:33:02,904e48a22be7e227a73c70e520cf9d8bc50fc1b2,Bram Moolenaar,3,2,5,2,"{""src/libvterm/src/state.c"": {""insertions"": 1, ""deletions"": 2, ""lines"": 3}, ""src/version.c"": {""insertions"": 2, ""deletions"": 0, ""lines"": 2}}"
2020-05-18 21:27:50,37ebd42f16734838ab68be91da291c4ec8610f47,Bram Moolenaar,5,3,8,2,"{""src/libvterm/src/state.c"": {""insertions"": 3, ""deletions"": 3, ""lines"": 6}, ""src/version.c"": {""insertions"": 2, ""deletions"": 0, ""lines"": 2}}"
2020-05-18 19:51:01,88d68de95da70d0f89a5246f58355d72e9c17db4,Bram Moolenaar,153,75,228,10,"{""src/libvterm/include/vterm.h"": {""insertions"": 3, ""deletions"": 2, ""lines"": 5}, ""src/libvterm/src/screen.c"": {""insertions"": 11, ""deletions"": 18, ""lines"": 29}, ""src/libvterm/src/state.c"": {""insertions"": 21, ""deletions"": 8, ""lines"": 29}, ""src/libvterm/t/32state_flow.test"": {""insertions"": 28, ""deletions"": 0, ""lines"": 28}, ""src/libvterm/t/60screen_ascii.test"": {""insertions"": 14, ""deletions"": 14, ""lines"": 28}, ""src/libvterm/t/62screen_damage.test"": {""insertions"": 2, ""deletions"": 2, ""lines"": 4}, ""src/libvterm/t/63screen_resize.test"": {""insertions"": 34, ""deletions"": 23, ""lines"": 57}, ""src/libvterm/t/harness.c"": {""insertions"": 22, ""deletions"": 1, ""lines"": 23}, ""src/libvterm/t/run-test.pl"": {""insertions"": 16, ""deletions"": 7, ""lines"": 23}, ""src/version.c"": {""insertions"": 2, ""deletions"": 0, ""lines"": 2}}"
2020-05-18 19:12:59,d098b824c10cc20dc55e18c22c4991f61826006e,Bram Moolenaar,87,44,131,7,"{""src/libvterm/include/vterm.h"": {""insertions"": 10, ""deletions"": 1, ""lines"": 11}, ""src/libvterm/src/screen.c"": {""insertions"": 8, ""deletions"": 10, ""lines"": 18}, ""src/libvterm/src/state.c"": {""insertions"": 52, ""deletions"": 31, ""lines"": 83}, ""src/libvterm/src/vterm_internal.h"": {""insertions"": 7, ""deletions"": 0, ""lines"": 7}, ""src/libvterm/t/67screen_dbl_wh.test"": {""insertions"": 6, ""deletions"": 0, ""lines"": 6}, ""src/libvterm/t/run-test.pl"": {""insertions"": 2, ""deletions"": 2, ""lines"": 4}, ""src/version.c"": {""insertions"": 2, ""deletions"": 0, ""lines"": 2}}"
2020-05-18 18:17:02,1e1d2e89fa460328883bb09fb13a24e26ef1ab31,Bram Moolenaar,5,2,7,2,"{""src/os_win32.c"": {""insertions"": 3, ""deletions"": 2, ""lines"": 5}, ""src/version.c"": {""insertions"": 2, ""deletions"": 0, ""lines"": 2}}"
2020-05-18 18:12:09,c33b3216c8ceac84130d627b20cb7034e5f831e6,Bram Moolenaar,4,0,4,2,"{""src/popupwin.c"": {""insertions"": 2, ""deletions"": 0, ""lines"": 2}, ""src/version.c"": {""insertions"": 2, ""deletions"": 0, ""lines"": 2}}"
2020-05-18 17:46:48,b5383b174b2436b556f76f14badb1c1f55d6d8f6,Bram Moolenaar,46,12,58,6,"{""runtime/doc/popup.txt"": {""insertions"": 1, ""deletions"": 1, ""lines"": 2}, ""src/ex_docmd.c"": {""insertions"": 6, ""deletions"": 2, ""lines"": 8}, ""src/popupwin.c"": {""insertions"": 26, ""deletions"": 0, ""lines"": 26}, ""src/testdir/test_popupwin.vim"": {""insertions"": 9, ""deletions"": 4, ""lines"": 13}, ""src/testdir/test_terminal.vim"": {""insertions"": 2, ""deletions"": 5, ""lines"": 7}, ""src/version.c"": {""insertions"": 2, ""deletions"": 0, ""lines"": 2}}"
2020-05-18 12:20:36,843700875e50c03c94245bef1b2de147b9b3b585,Bram Moolenaar,38,20,58,2,"{""src/testdir/test_vim9_script.vim"": {""insertions"": 36, ""deletions"": 20, ""lines"": 56}, ""src/version.c"": {""insertions"": 2, ""deletions"": 0, ""lines"": 2}}"
2020-05-18 11:38:02,66b3101672f7da32df2fd3962d7f14300e7a65f3,Bram Moolenaar,37,0,37,2,"{""src/testdir/test_vim9_expr.vim"": {""insertions"": 35, ""deletions"": 0, ""lines"": 35}, ""src/version.c"": {""insertions"": 2, ""deletions"": 0, ""lines"": 2}}"
2020-05-17 21:34:42,deb17451edd65e2af1d155bce0886e856a716591,Bram Moolenaar,10,0,10,2,"{""src/libvterm/src/vterm.c"": {""insertions"": 8, ""deletions"": 0, ""lines"": 8}, ""src/version.c"": {""insertions"": 2, ""deletions"": 0, ""lines"": 2}}"
2020-05-17 21:00:52,a2e408f5981b4da64426c3bda98d837ea36469bf,Bram Moolenaar,166,138,304,3,"{""Filelist"": {""insertions"": 1, ""deletions"": 0, ""lines"": 1}, ""src/libvterm/src/screen.c"": {""insertions"": 163, ""deletions"": 138, ""lines"": 301}, ""src/version.c"": {""insertions"": 2, ""deletions"": 0, ""lines"": 2}}"
2020-05-17 20:33:53,0b39ec3c7dd41852fa6f0430b3f963c59d0b50d8,Bram Moolenaar,6,1,7,3,"{""src/testdir/test_channel.py"": {""insertions"": 3, ""deletions"": 0, ""lines"": 3}, ""src/testdir/test_netbeans.vim"": {""insertions"": 1, ""deletions"": 1, ""lines"": 2}, ""src/version.c"": {""insertions"": 2, ""deletions"": 0, ""lines"": 2}}"
2020-05-17 20:27:55,6fc3b59ee914a0d1710c8b037a0c592e0a7c34d4,Bram Moolenaar,97,13,110,9,"{""src/libvterm/CONTRIBUTING"": {""insertions"": 22, ""deletions"": 0, ""lines"": 22}, ""src/libvterm/Makefile"": {""insertions"": 3, ""deletions"": 5, ""lines"": 8}, ""src/libvterm/doc/seqs.txt"": {""insertions"": 1, ""deletions"": 0, ""lines"": 1}, ""src/libvterm/include/vterm.h"": {""insertions"": 15, ""deletions"": 0, ""lines"": 15}, ""src/libvterm/src/pen.c"": {""insertions"": 26, ""deletions"": 7, ""lines"": 33}, ""src/libvterm/src/vterm.c"": {""insertions"": 17, ""deletions"": 0, ""lines"": 17}, ""src/libvterm/t/30state_pen.test"": {""insertions"": 8, ""deletions"": 0, ""lines"": 8}, ""src/libvterm/t/run-test.pl"": {""insertions"": 3, ""deletions"": 1, ""lines"": 4}, ""src/version.c"": {""insertions"": 2, ""deletions"": 0, ""lines"": 2}}"
2020-05-17 19:50:16,94d729cbe8f0f788d9d7539f733cff395e73b228,Bram Moolenaar,84,43,127,6,"{""src/libvterm/include/vterm.h"": {""insertions"": 7, ""deletions"": 0, ""lines"": 7}, ""src/libvterm/src/state.c"": {""insertions"": 30, ""deletions"": 13, ""lines"": 43}, ""src/libvterm/src/vterm.c"": {""insertions"": 19, ""deletions"": 30, ""lines"": 49}, ""src/libvterm/src/vterm_internal.h"": {""insertions"": 23, ""deletions"": 0, ""lines"": 23}, ""src/libvterm/t/harness.c"": {""insertions"": 3, ""deletions"": 0, ""lines"": 3}, ""src/version.c"": {""insertions"": 2, ""deletions"": 0, ""lines"": 2}}"
2020-05-17 18:52:45,c4c9f7e43e7229c78919a5618003ce8aac3e1785,Bram Moolenaar,67,52,119,10,"{""src/Make_cyg_ming.mak"": {""insertions"": 1, ""deletions"": 0, ""lines"": 1}, ""src/Make_mvc.mak"": {""insertions"": 1, ""deletions"": 0, ""lines"": 1}, ""src/Makefile"": {""insertions"": 1, ""deletions"": 0, ""lines"": 1}, ""src/libvterm/src/keyboard.c"": {""insertions"": 4, ""deletions"": 4, ""lines"": 8}, ""src/libvterm/src/vterm.c"": {""insertions"": 41, ""deletions"": 47, ""lines"": 88}, ""src/libvterm/src/vterm_internal.h"": {""insertions"": 3, ""deletions"": 0, ""lines"": 3}, ""src/libvterm/t/25state_input.test"": {""insertions"": 12, ""deletions"": 0, ""lines"": 12}, ""src/libvterm/t/26state_query.test"": {""insertions"": 1, ""deletions"": 1, ""lines"": 2}, ""src/libvterm/t/harness.c"": {""insertions"": 1, ""deletions"": 0, ""lines"": 1}, ""src/version.c"": {""insertions"": 2, ""deletions"": 0, ""lines"": 2}}"
2020-05-17 16:53:27,df1643a6a7886b9363c2a98438e61cbe1c803d41,Bram Moolenaar,5,0,5,2,"{""src/if_lua.c"": {""insertions"": 3, ""deletions"": 0, ""lines"": 3}, ""src/version.c"": {""insertions"": 2, ""deletions"": 0, ""lines"": 2}}"
2020-05-17 14:53:56,9309eb2f28e6ee346c2a5deaa6f9c2b36578522e,Bram Moolenaar,3,1,4,2,"{""src/if_lua.c"": {""insertions"": 1, ""deletions"": 1, ""lines"": 2}, ""src/version.c"": {""insertions"": 2, ""deletions"": 0, ""lines"": 2}}"
2020-05-17 14:29:47,2d2970ea599e83acabee56be548a54a8e6b21007,Bram Moolenaar,14,10,24,14,"{""Filelist"": {""insertions"": 11, ""deletions"": 10, ""lines"": 21}, ""src/libvterm/doc/seqs.txt"": {""insertions"": 1, ""deletions"": 0, ""lines"": 1}, ""src/libvterm/t/{30pen.test => 30state_pen.test}"": {""insertions"": 0, ""deletions"": 0, ""lines"": 0}, ""src/libvterm/t/{92lp1805050.test => 31state_rep.test}"": {""insertions"": 0, ""deletions"": 0, ""lines"": 0}, ""src/libvterm/t/{40screen_ascii.test => 60screen_ascii.test}"": {""insertions"": 0, ""deletions"": 0, ""lines"": 0}, ""src/libvterm/t/{41screen_unicode.test => 61screen_unicode.test}"": {""insertions"": 0, ""deletions"": 0, ""lines"": 0}, ""src/libvterm/t/{42screen_damage.test => 62screen_damage.test}"": {""insertions"": 0, ""deletions"": 0, ""lines"": 0}, ""src/libvterm/t/{43screen_resize.test => 63screen_resize.test}"": {""insertions"": 0, ""deletions"": 0, ""lines"": 0}, ""src/libvterm/t/{44screen_pen.test => 64screen_pen.test}"": {""insertions"": 0, ""deletions"": 0, ""lines"": 0}, ""src/libvterm/t/{45screen_protect.test => 65screen_protect.test}"": {""insertions"": 0, ""deletions"": 0, ""lines"": 0}, ""src/libvterm/t/{46screen_extent.test => 66screen_extent.test}"": {""insertions"": 0, ""deletions"": 0, ""lines"": 0}, ""src/libvterm/t/{47screen_dbl_wh.test => 67screen_dbl_wh.test}"": {""insertions"": 0, ""deletions"": 0, ""lines"": 0}, ""src/libvterm/t/{48screen_termprops.test => 68screen_termprops.test}"": {""insertions"": 0, ""deletions"": 0, ""lines"": 0}, ""src/version.c"": {""insertions"": 2, ""deletions"": 0, ""lines"": 2}}"
2020-05-17 14:10:11,f4e16ae041962555316a6953df30a45f4c45be6a,Bram Moolenaar,4,2,6,3,"{""src/proto/term.pro"": {""insertions"": 1, ""deletions"": 1, ""lines"": 2}, ""src/term.c"": {""insertions"": 1, ""deletions"": 1, ""lines"": 2}, ""src/version.c"": {""insertions"": 2, ""deletions"": 0, ""lines"": 2}}"
2020-05-17 14:04:44,d4a5f40c0cc45fdfac01df0e408d557006eb0206,Bram Moolenaar,161,3,164,6,"{""src/libvterm/Makefile"": {""insertions"": 1, ""deletions"": 1, ""lines"": 2}, ""src/libvterm/src/state.c"": {""insertions"": 20, ""deletions"": 1, ""lines"": 21}, ""src/libvterm/t/10state_putglyph.test"": {""insertions"": 7, ""deletions"": 0, ""lines"": 7}, ""src/libvterm/t/92lp1805050.test"": {""insertions"": 128, ""deletions"": 0, ""lines"": 128}, ""src/libvterm/t/run-test.pl"": {""insertions"": 3, ""deletions"": 1, ""lines"": 4}, ""src/version.c"": {""insertions"": 2, ""deletions"": 0, ""lines"": 2}}"
2020-05-17 13:17:26,ed37d9b3241abe7c302c7ac606df80037aecdb46,Bram Moolenaar,1,1,2,1,"{"".github/ISSUE_TEMPLATE/feature_request.md"": {""insertions"": 1, ""deletions"": 1, ""lines"": 2}}"
2020-05-17 13:09:27,79ea680e6b1dd02035fdf8a5521927cf1f98c2ed,Bram Moolenaar,6,4,10,2,"{""src/testdir/test_terminal.vim"": {""insertions"": 4, ""deletions"": 4, ""lines"": 8}, ""src/version.c"": {""insertions"": 2, ""deletions"": 0, ""lines"": 2}}"
2020-05-17 12:59:47,e178ba36546ec7805020280910306331f1ef4ed0,Bram Moolenaar,155,0,155,7,"{""Filelist"": {""insertions"": 2, ""deletions"": 0, ""lines"": 2}, ""src/libvterm/Makefile"": {""insertions"": 3, ""deletions"": 0, ""lines"": 3}, ""src/libvterm/README"": {""insertions"": 3, ""deletions"": 0, ""lines"": 3}, ""src/libvterm/find-wide-chars.pl"": {""insertions"": 34, ""deletions"": 0, ""lines"": 34}, ""src/libvterm/src/fullwidth.inc"": {""insertions"": 104, ""deletions"": 0, ""lines"": 104}, ""src/libvterm/src/unicode.c"": {""insertions"": 7, ""deletions"": 0, ""lines"": 7}, ""src/version.c"": {""insertions"": 2, ""deletions"": 0, ""lines"": 2}}"
2020-05-17 12:32:35,eb04f0893afe01faff272ef84c70d8cc16d8e80a,Bram Moolenaar,118,22,140,4,"{""runtime/doc/if_lua.txt"": {""insertions"": 9, ""deletions"": 0, ""lines"": 9}, ""src/if_lua.c"": {""insertions"": 75, ""deletions"": 2, ""lines"": 77}, ""src/testdir/test_lua.vim"": {""insertions"": 32, ""deletions"": 20, ""lines"": 52}, ""src/version.c"": {""insertions"": 2, ""deletions"": 0, ""lines"": 2}}"
2020-05-17 12:06:16,26e86445bf06ab7e7587dfdf75f33f7c70632b46,Bram Moolenaar,37,25,62,14,"{""src/globals.h"": {""insertions"": 1, ""deletions"": 1, ""lines"": 2}, ""src/os_amiga.c"": {""insertions"": 1, ""deletions"": 1, ""lines"": 2}, ""src/os_mswin.c"": {""insertions"": 1, ""deletions"": 1, ""lines"": 2}, ""src/os_unix.c"": {""insertions"": 13, ""deletions"": 10, ""lines"": 23}, ""src/os_vms.c"": {""insertions"": 1, ""deletions"": 1, ""lines"": 2}, ""src/os_win32.c"": {""insertions"": 1, ""deletions"": 1, ""lines"": 2}, ""src/proto/os_amiga.pro"": {""insertions"": 1, ""deletions"": 1, ""lines"": 2}, ""src/proto/os_mswin.pro"": {""insertions"": 1, ""deletions"": 1, ""lines"": 2}, ""src/proto/os_unix.pro"": {""insertions"": 1, ""deletions"": 1, ""lines"": 2}, ""src/proto/os_vms.pro"": {""insertions"": 1, ""deletions"": 1, ""lines"": 2}, ""src/proto/os_win32.pro"": {""insertions"": 1, ""deletions"": 1, ""lines"": 2}, ""src/term.c"": {""insertions"": 6, ""deletions"": 1, ""lines"": 7}, ""src/term.h"": {""insertions"": 6, ""deletions"": 4, ""lines"": 10}, ""src/version.c"": {""insertions"": 2, ""deletions"": 0, ""lines"": 2}}"
2020-05-16 21:15:08,3b1f18f785f67c6cd110498c366e4d0c0fe11f27,Bram Moolenaar,26,8,34,6,"{""src/os_amiga.c"": {""insertions"": 4, ""deletions"": 0, ""lines"": 4}, ""src/os_unix.c"": {""insertions"": 7, ""deletions"": 0, ""lines"": 7}, ""src/os_win32.c"": {""insertions"": 4, ""deletions"": 0, ""lines"": 4}, ""src/term.c"": {""insertions"": 5, ""deletions"": 5, ""lines"": 10}, ""src/term.h"": {""insertions"": 4, ""deletions"": 3, ""lines"": 7}, ""src/version.c"": {""insertions"": 2, ""deletions"": 0, ""lines"": 2}}"
2020-05-16 20:33:33,df671b4629a0c6451c067cafd2534b7261f41277,Bram Moolenaar,33,2,35,2,"{""src/testdir/test_vim9_script.vim"": {""insertions"": 31, ""deletions"": 2, ""lines"": 33}, ""src/version.c"": {""insertions"": 2, ""deletions"": 0, ""lines"": 2}}"
2020-05-16 19:20:12,6f5b6dfb16228c0ce1e4379b7bafed02eaddbab2,Bram Moolenaar,34,17,51,6,"{""src/eval.c"": {""insertions"": 2, ""deletions"": 1, ""lines"": 3}, ""src/proto/vim9execute.pro"": {""insertions"": 1, ""deletions"": 2, ""lines"": 3}, ""src/testdir/test_vim9_func.vim"": {""insertions"": 10, ""deletions"": 0, ""lines"": 10}, ""src/userfunc.c"": {""insertions"": 7, ""deletions"": 9, ""lines"": 16}, ""src/version.c"": {""insertions"": 2, ""deletions"": 0, ""lines"": 2}, ""src/vim9execute.c"": {""insertions"": 12, ""deletions"": 5, ""lines"": 17}}"
2020-05-16 16:57:53,aa5fc4ec51b00e91f174ac83c8ff68becf5f42bb,Bram Moolenaar,10,4,14,2,"{""src/gui_gtk_x11.c"": {""insertions"": 8, ""deletions"": 4, ""lines"": 12}, ""src/version.c"": {""insertions"": 2, ""deletions"": 0, ""lines"": 2}}"
2020-05-16 14:08:35,129d6bf6b3d120b0a4c69e18b5e8602a84e352bf,Bram Moolenaar,25,1,26,3,"{""src/main.c"": {""insertions"": 11, ""deletions"": 0, ""lines"": 11}, ""src/testdir/test_signals.vim"": {""insertions"": 12, ""deletions"": 1, ""lines"": 13}, ""src/version.c"": {""insertions"": 2, ""deletions"": 0, ""lines"": 2}}"
2020-05-16 13:43:31,e75ba268b35a9b3a1f8b47668e657259555fc5fa,Bram Moolenaar,3,1,4,2,"{""src/version.c"": {""insertions"": 2, ""deletions"": 0, ""lines"": 2}, ""src/vim9execute.c"": {""insertions"": 1, ""deletions"": 1, ""lines"": 2}}"
2020-05-16 13:05:04,645e3fe3fe2cfaf0615428207bbacc2963852eba,Bram Moolenaar,8,0,8,2,"{""src/term.c"": {""insertions"": 6, ""deletions"": 0, ""lines"": 6}, ""src/version.c"": {""insertions"": 2, ""deletions"": 0, ""lines"": 2}}"
2020-05-16 12:07:39,e882f7a73c8fa48707de71035eb0a7ccc6ac8548,Bram Moolenaar,55,0,55,3,"{""src/drawline.c"": {""insertions"": 6, ""deletions"": 0, ""lines"": 6}, ""src/testdir/test_breakindent.vim"": {""insertions"": 47, ""deletions"": 0, ""lines"": 47}, ""src/version.c"": {""insertions"": 2, ""deletions"": 0, ""lines"": 2}}"
2020-05-16 12:01:51,fd615a3c901f59abddca27c6a09940be552c0f4d,Bram Moolenaar,84,179,263,6,"{""src/gui_gtk_x11.c"": {""insertions"": 31, ""deletions"": 76, ""lines"": 107}, ""src/gui_mac.c"": {""insertions"": 2, ""deletions"": 2, ""lines"": 4}, ""src/gui_motif.c"": {""insertions"": 3, ""deletions"": 0, ""lines"": 3}, ""src/gui_w32.c"": {""insertions"": 2, ""deletions"": 2, ""lines"": 4}, ""src/gui_x11.c"": {""insertions"": 44, ""deletions"": 99, ""lines"": 143}, ""src/version.c"": {""insertions"": 2, ""deletions"": 0, ""lines"": 2}}"
2020-05-15 21:36:40,a6e67e4f41386c3e6eab7e047671c6d32f6cb0dc,Bram Moolenaar,14,9,23,4,"{""src/testdir/test_vim9_script.vim"": {""insertions"": 7, ""deletions"": 0, ""lines"": 7}, ""src/version.c"": {""insertions"": 2, ""deletions"": 0, ""lines"": 2}, ""src/vim9compile.c"": {""insertions"": 3, ""deletions"": 3, ""lines"": 6}, ""src/vim9execute.c"": {""insertions"": 2, ""deletions"": 6, ""lines"": 8}}"
2020-05-15 20:46:44,4457e1d98f78152311495b1aff6169383d330a75,Bram Moolenaar,3,0,3,2,"{""src/testdir/test_gui.vim"": {""insertions"": 1, ""deletions"": 0, ""lines"": 1}, ""src/version.c"": {""insertions"": 2, ""deletions"": 0, ""lines"": 2}}"
2020-05-15 20:30:38,76cb68309794def0fa7d1f2f72dd694b822186a5,Bram Moolenaar,31,0,31,3,"{""src/optionstr.c"": {""insertions"": 3, ""deletions"": 0, ""lines"": 3}, ""src/testdir/test_crypt.vim"": {""insertions"": 26, ""deletions"": 0, ""lines"": 26}, ""src/version.c"": {""insertions"": 2, ""deletions"": 0, ""lines"": 2}}"
2020-05-15 20:01:57,4aeeb6393824e375afad4d7291e8552917ad28b8,Bram Moolenaar,44,30,74,2,"{""src/testdir/test_vim9_expr.vim"": {""insertions"": 42, ""deletions"": 30, ""lines"": 72}, ""src/version.c"": {""insertions"": 2, ""deletions"": 0, ""lines"": 2}}"
2020-05-15 19:44:19,4dac32caf38f7c35b707b7df104df03591bf6b14,Bram Moolenaar,9,10,19,3,"{""src/testdir/test_vim9_expr.vim"": {""insertions"": 4, ""deletions"": 0, ""lines"": 4}, ""src/version.c"": {""insertions"": 2, ""deletions"": 0, ""lines"": 2}, ""src/vim9execute.c"": {""insertions"": 3, ""deletions"": 10, ""lines"": 13}}"
2020-05-15 19:42:53,270d0388d284c130b322b185497e437cfbbae412,Bram Moolenaar,26,19,45,2,"{""src/version.c"": {""insertions"": 2, ""deletions"": 0, ""lines"": 2}, ""src/vim9execute.c"": {""insertions"": 24, ""deletions"": 19, ""lines"": 43}}"
2020-05-15 18:53:00,cb7904016eb817e80760c394044740df8273c774,Bram Moolenaar,263,189,452,2,"{""src/testdir/test_vim9_disassemble.vim"": {""insertions"": 261, ""deletions"": 189, ""lines"": 450}, ""src/version.c"": {""insertions"": 2, ""deletions"": 0, ""lines"": 2}}"
2020-05-15 17:21:31,4902ab16cbb6e00f4fee8bbdf16f1383fd8ba42f,Bram Moolenaar,103,92,195,2,"{""src/testdir/test_vim9_disassemble.vim"": {""insertions"": 101, ""deletions"": 92, ""lines"": 193}, ""src/version.c"": {""insertions"": 2, ""deletions"": 0, ""lines"": 2}}"
2020-05-15 16:21:51,7e6f3fcc3ce89fc8ade85be39aa475e606c0b26c,Bram Moolenaar,6,3,9,2,"{""src/Make_mvc.mak"": {""insertions"": 4, ""deletions"": 3, ""lines"": 7}, ""src/version.c"": {""insertions"": 2, ""deletions"": 0, ""lines"": 2}}"
2020-05-15 16:17:28,227a69de1e0f9457a9fc9e098d999304faff55f8,Bram Moolenaar,47,11,58,4,"{""src/eval.c"": {""insertions"": 2, ""deletions"": 0, ""lines"": 2}, ""src/testdir/test_vim9_script.vim"": {""insertions"": 29, ""deletions"": 5, ""lines"": 34}, ""src/version.c"": {""insertions"": 2, ""deletions"": 0, ""lines"": 2}, ""src/vim9script.c"": {""insertions"": 14, ""deletions"": 6, ""lines"": 20}}"
2020-05-14 21:20:55,a5d0077efbced85fcc63f203937b13efd55d036f,Bram Moolenaar,25,0,25,2,"{""src/testdir/test_vim9_script.vim"": {""insertions"": 23, ""deletions"": 0, ""lines"": 23}, ""src/version.c"": {""insertions"": 2, ""deletions"": 0, ""lines"": 2}}"
2020-05-14 20:41:15,32e351179eacfc84f64cd5029e221582d400bb38,Bram Moolenaar,211,128,339,12,"{""src/dict.c"": {""insertions"": 7, ""deletions"": 5, ""lines"": 12}, ""src/eval.c"": {""insertions"": 81, ""deletions"": 64, ""lines"": 145}, ""src/evalfunc.c"": {""insertions"": 1, ""deletions"": 1, ""lines"": 2}, ""src/evalvars.c"": {""insertions"": 51, ""deletions"": 27, ""lines"": 78}, ""src/ex_eval.c"": {""insertions"": 2, ""deletions"": 1, ""lines"": 3}, ""src/list.c"": {""insertions"": 3, ""deletions"": 2, ""lines"": 5}, ""src/testdir/test_vim9_disassemble.vim"": {""insertions"": 1, ""deletions"": 1, ""lines"": 2}, ""src/testdir/test_vim9_script.vim"": {""insertions"": 45, ""deletions"": 15, ""lines"": 60}, ""src/userfunc.c"": {""insertions"": 10, ""deletions"": 8, ""lines"": 18}, ""src/version.c"": {""insertions"": 2, ""deletions"": 0, ""lines"": 2}, ""src/vim.h"": {""insertions"": 5, ""deletions"": 1, ""lines"": 6}, ""src/vim9compile.c"": {""insertions"": 3, ""deletions"": 3, ""lines"": 6}}"
2020-05-13 21:24:12,e06a28f5e30f439545ac125d54ffc4e6bd6daada,Bram Moolenaar,6,1,7,2,"{""src/testdir/test_popupwin.vim"": {""insertions"": 4, ""deletions"": 1, ""lines"": 5}, ""src/version.c"": {""insertions"": 2, ""deletions"": 0, ""lines"": 2}}"
2020-05-13 21:21:55,2b72821924ff514727b60fb0b647d5caae8336f7,Bram Moolenaar,2,0,2,1,"{""src/version.c"": {""insertions"": 2, ""deletions"": 0, ""lines"": 2}}"
2020-05-13 20:44:22,7e9f351b2e69b498c4ee5004d7459844e1ba191a,Bram Moolenaar,92,82,174,17,"{""src/channel.c"": {""insertions"": 3, ""deletions"": 3, ""lines"": 6}, ""src/eval.c"": {""insertions"": 1, ""deletions"": 1, ""lines"": 2}, ""src/evalbuffer.c"": {""insertions"": 1, ""deletions"": 1, ""lines"": 2}, ""src/evalfunc.c"": {""insertions"": 21, ""deletions"": 23, ""lines"": 44}, ""src/evalvars.c"": {""insertions"": 1, ""deletions"": 1, ""lines"": 2}, ""src/filepath.c"": {""insertions"": 1, ""deletions"": 1, ""lines"": 2}, ""src/highlight.c"": {""insertions"": 1, ""deletions"": 1, ""lines"": 2}, ""src/if_py_both.h"": {""insertions"": 4, ""deletions"": 4, ""lines"": 8}, ""src/insexpand.c"": {""insertions"": 2, ""deletions"": 2, ""lines"": 4}, ""src/json.c"": {""insertions"": 1, ""deletions"": 1, ""lines"": 2}, ""src/list.c"": {""insertions"": 17, ""deletions"": 17, ""lines"": 34}, ""src/macros.h"": {""insertions"": 6, ""deletions"": 0, ""lines"": 6}, ""src/misc2.c"": {""insertions"": 25, ""deletions"": 20, ""lines"": 45}, ""src/popupmenu.c"": {""insertions"": 1, ""deletions"": 1, ""lines"": 2}, ""src/popupwin.c"": {""insertions"": 5, ""deletions"": 5, ""lines"": 10}, ""src/proto/misc2.pro"": {""insertions"": 1, ""deletions"": 0, ""lines"": 1}, ""src/userfunc.c"": {""insertions"": 1, ""deletions"": 1, ""lines"": 2}}"
2020-05-13 15:16:04,37d1b4f9416973abe9f5a7c6b81540ca88fa8489,Bram Moolenaar,6,5,11,2,"{""src/testdir/test_netbeans.vim"": {""insertions"": 4, ""deletions"": 5, ""lines"": 9}, ""src/version.c"": {""insertions"": 2, ""deletions"": 0, ""lines"": 2}}"
2020-05-13 14:53:49,55ba4b844f1b0e44f0f2e1bd14d26e7ad2df9ffc,Bram Moolenaar,2,2,4,2,"{""src/testdir/test_signals.vim"": {""insertions"": 0, ""deletions"": 2, ""lines"": 2}, ""src/version.c"": {""insertions"": 2, ""deletions"": 0, ""lines"": 2}}"
2020-05-13 14:34:15,ef6b979bfae82f64781d8b0ce0194c57111243d4,Bram Moolenaar,43,3,46,8,"{""runtime/doc/eval.txt"": {""insertions"": 2, ""deletions"": 0, ""lines"": 2}, ""runtime/doc/popup.txt"": {""insertions"": 5, ""deletions"": 0, ""lines"": 5}, ""src/evalfunc.c"": {""insertions"": 1, ""deletions"": 0, ""lines"": 1}, ""src/popupwin.c"": {""insertions"": 19, ""deletions"": 0, ""lines"": 19}, ""src/proto/popupwin.pro"": {""insertions"": 1, ""deletions"": 0, ""lines"": 1}, ""src/testdir/runtest.vim"": {""insertions"": 2, ""deletions"": 1, ""lines"": 3}, ""src/testdir/test_popupwin.vim"": {""insertions"": 11, ""deletions"": 2, ""lines"": 13}, ""src/version.c"": {""insertions"": 2, ""deletions"": 0, ""lines"": 2}}"
2020-05-13 11:40:16,03a9f848175b182372fb33403998059724a8bf31,Bram Moolenaar,63,56,119,12,"{""runtime/doc/popup.txt"": {""insertions"": 8, ""deletions"": 1, ""lines"": 9}, ""src/channel.c"": {""insertions"": 2, ""deletions"": 2, ""lines"": 4}, ""src/evalfunc.c"": {""insertions"": 1, ""deletions"": 1, ""lines"": 2}, ""src/ex_cmds.c"": {""insertions"": 5, ""deletions"": 0, ""lines"": 5}, ""src/misc2.c"": {""insertions"": 2, ""deletions"": 6, ""lines"": 8}, ""src/popupwin.c"": {""insertions"": 28, ""deletions"": 16, ""lines"": 44}, ""src/proto/popupwin.pro"": {""insertions"": 3, ""deletions"": 3, ""lines"": 6}, ""src/tag.c"": {""insertions"": 1, ""deletions"": 1, ""lines"": 2}, ""src/testdir/runtest.vim"": {""insertions"": 2, ""deletions"": 2, ""lines"": 4}, ""src/testdir/test_terminal.vim"": {""insertions"": 8, ""deletions"": 20, ""lines"": 28}, ""src/version.c"": {""insertions"": 2, ""deletions"": 0, ""lines"": 2}, ""src/window.c"": {""insertions"": 1, ""deletions"": 4, ""lines"": 5}}"
2020-05-12 23:04:32,d502aa4c10771ec8eb570345ec5e124c4a4b7cd0,Bram Moolenaar,19,11,30,3,"{""src/popupwin.c"": {""insertions"": 15, ""deletions"": 9, ""lines"": 24}, ""src/proto/popupwin.pro"": {""insertions"": 2, ""deletions"": 2, ""lines"": 4}, ""src/version.c"": {""insertions"": 2, ""deletions"": 0, ""lines"": 2}}"
2020-05-12 21:45:16,06f0853cb0b10364b22e5607fdecd35b3936e9ea,Bram Moolenaar,11,7,18,3,"{""src/ex_cmds.c"": {""insertions"": 0, ""deletions"": 5, ""lines"": 5}, ""src/misc2.c"": {""insertions"": 9, ""deletions"": 2, ""lines"": 11}, ""src/version.c"": {""insertions"": 2, ""deletions"": 0, ""lines"": 2}}"
2020-05-12 20:49:12,47e13953ffdbb9f163b901196dec8c2100b72edd,Bram Moolenaar,579,2382,2961,55,"{""runtime/doc/editing.txt"": {""insertions"": 25, ""deletions"": 18, ""lines"": 43}, ""runtime/doc/index.txt"": {""insertions"": 4, ""deletions"": 4, ""lines"": 8}, ""runtime/doc/popup.txt"": {""insertions"": 2, ""deletions"": 1, ""lines"": 3}, ""runtime/doc/recover.txt"": {""insertions"": 7, ""deletions"": 7, ""lines"": 14}, ""runtime/doc/tags"": {""insertions"": 1, ""deletions"": 0, ""lines"": 1}, ""runtime/doc/todo.txt"": {""insertions"": 29, ""deletions"": 19, ""lines"": 48}, ""runtime/doc/vim9.txt"": {""insertions"": 16, ""deletions"": 13, ""lines"": 29}, ""runtime/doc/windows.txt"": {""insertions"": 10, ""deletions"": 9, ""lines"": 19}, ""runtime/ftplugin/masm.vim"": {""insertions"": 19, ""deletions"": 0, ""lines"": 19}, ""runtime/indent/python.vim"": {""insertions"": 17, ""deletions"": 7, ""lines"": 24}, ""runtime/plugin/gzip.vim"": {""insertions"": 5, ""deletions"": 1, ""lines"": 6}, ""runtime/syntax/gnuplot.vim"": {""insertions"": 2, ""deletions"": 2, ""lines"": 4}, ""runtime/syntax/masm.vim"": {""insertions"": 2, ""deletions"": 2, ""lines"": 4}, ""runtime/syntax/pamenv.vim"": {""insertions"": 28, ""deletions"": 0, ""lines"": 28}, ""runtime/syntax/php.vim"": {""insertions"": 14, ""deletions"": 11, ""lines"": 25}, ""runtime/syntax/sh.vim"": {""insertions"": 10, ""deletions"": 11, ""lines"": 21}, ""src/po/af.po"": {""insertions"": 8, ""deletions"": 8, ""lines"": 16}, ""src/po/ca.po"": {""insertions"": 15, ""deletions"": 18, ""lines"": 33}, ""src/po/cs.cp1250.po"": {""insertions"": 9, ""deletions"": 9, ""lines"": 18}, ""src/po/cs.po"": {""insertions"": 9, ""deletions"": 9, ""lines"": 18}, ""src/po/da.po"": {""insertions"": 14, ""deletions"": 17, ""lines"": 31}, ""src/po/de.po"": {""insertions"": 14, ""deletions"": 17, ""lines"": 31}, ""src/po/eo.po"": {""insertions"": 12, ""deletions"": 15, ""lines"": 27}, ""src/po/es.po"": {""insertions"": 8, ""deletions"": 1804, ""lines"": 1812}, ""src/po/fi.po"": {""insertions"": 13, ""deletions"": 16, ""lines"": 29}, ""src/po/fr.po"": {""insertions"": 10, ""deletions"": 13, ""lines"": 23}, ""src/po/ga.po"": {""insertions"": 14, ""deletions"": 17, ""lines"": 31}, ""src/po/it.po"": {""insertions"": 15, ""deletions"": 18, ""lines"": 33}, ""src/po/ja.euc-jp.po"": {""insertions"": 11, ""deletions"": 14, ""lines"": 25}, ""src/po/ja.po"": {""insertions"": 11, ""deletions"": 14, ""lines"": 25}, ""src/po/ja.sjis.po"": {""insertions"": 10, ""deletions"": 13, ""lines"": 23}, ""src/po/ko.UTF-8.po"": {""insertions"": 10, ""deletions"": 13, ""lines"": 23}, ""src/po/ko.po"": {""insertions"": 10, ""deletions"": 13, ""lines"": 23}, ""src/po/nb.po"": {""insertions"": 8, ""deletions"": 11, ""lines"": 19}, ""src/po/nl.po"": {""insertions"": 0, ""deletions"": 3, ""lines"": 3}, ""src/po/no.po"": {""insertions"": 8, ""deletions"": 11, ""lines"": 19}, ""src/po/pl.UTF-8.po"": {""insertions"": 9, ""deletions"": 11, ""lines"": 20}, ""src/po/pl.cp1250.po"": {""insertions"": 9, ""deletions"": 11, ""lines"": 20}, ""src/po/pl.po"": {""insertions"": 9, ""deletions"": 11, ""lines"": 20}, ""src/po/pt_BR.po"": {""insertions"": 14, ""deletions"": 17, ""lines"": 31}, ""src/po/ru.cp1251.po"": {""insertions"": 10, ""deletions"": 13, ""lines"": 23}, ""src/po/ru.po"": {""insertions"": 10, ""deletions"": 13, ""lines"": 23}, ""src/po/sk.cp1250.po"": {""insertions"": 10, ""deletions"": 13, ""lines"": 23}, ""src/po/sk.po"": {""insertions"": 10, ""deletions"": 13, ""lines"": 23}, ""src/po/sr.po"": {""insertions"": 14, ""deletions"": 17, ""lines"": 31}, ""src/po/sv.po"": {""insertions"": 8, ""deletions"": 11, ""lines"": 19}, ""src/po/tr.po"": {""insertions"": 10, ""deletions"": 13, ""lines"": 23}, ""src/po/uk.cp1251.po"": {""insertions"": 13, ""deletions"": 16, ""lines"": 29}, ""src/po/uk.po"": {""insertions"": 13, ""deletions"": 16, ""lines"": 29}, ""src/po/vi.po"": {""insertions"": 9, ""deletions"": 9, ""lines"": 18}, ""src/po/zh_CN.UTF-8.po"": {""insertions"": 6, ""deletions"": 9, ""lines"": 15}, ""src/po/zh_CN.cp936.po"": {""insertions"": 6, ""deletions"": 9, ""lines"": 15}, ""src/po/zh_CN.po"": {""insertions"": 6, ""deletions"": 9, ""lines"": 15}, ""src/po/zh_TW.UTF-8.po"": {""insertions"": 6, ""deletions"": 6, ""lines"": 12}, ""src/po/zh_TW.po"": {""insertions"": 7, ""deletions"": 7, ""lines"": 14}}"
2020-05-12 20:21:26,9e6ba8cbef2b2363f1d0a0e2c2a8d21c3b987416,Bram Moolenaar,3,1,4,2,"{""src/main.c"": {""insertions"": 1, ""deletions"": 1, ""lines"": 2}, ""src/version.c"": {""insertions"": 2, ""deletions"": 0, ""lines"": 2}}"
2020-05-12 20:02:21,5aed0ccb965dbad4b60f4c77c9c4455a9379e73c,Bram Moolenaar,19,0,19,4,"{""src/ex_cmds.c"": {""insertions"": 5, ""deletions"": 0, ""lines"": 5}, ""src/normal.c"": {""insertions"": 4, ""deletions"": 0, ""lines"": 4}, ""src/testdir/test_popupwin.vim"": {""insertions"": 8, ""deletions"": 0, ""lines"": 8}, ""src/version.c"": {""insertions"": 2, ""deletions"": 0, ""lines"": 2}}"
2020-05-12 12:42:02,48a687148c4649f6f55b36a1f4111041e7207235,Bram Moolenaar,48,0,48,2,"{""src/testdir/test_signals.vim"": {""insertions"": 46, ""deletions"": 0, ""lines"": 46}, ""src/version.c"": {""insertions"": 2, ""deletions"": 0, ""lines"": 2}}"
2020-05-12 11:08:07,c3fd98cf8e43d48a322402d08fa83444c2b0a4a6,Bram Moolenaar,61,59,120,3,"{""src/testdir/test86.ok"": {""insertions"": 32, ""deletions"": 32, ""lines"": 64}, ""src/testdir/test87.ok"": {""insertions"": 27, ""deletions"": 27, ""lines"": 54}, ""src/version.c"": {""insertions"": 2, ""deletions"": 0, ""lines"": 2}}"
2020-05-11 21:14:04,86181df9f5501ba735dcb75e0832c35ac1212ca6,Bram Moolenaar,19,17,36,4,"{""src/if_py_both.h"": {""insertions"": 13, ""deletions"": 13, ""lines"": 26}, ""src/if_tcl.c"": {""insertions"": 1, ""deletions"": 1, ""lines"": 2}, ""src/main.c"": {""insertions"": 3, ""deletions"": 3, ""lines"": 6}, ""src/version.c"": {""insertions"": 2, ""deletions"": 0, ""lines"": 2}}"
2020-05-11 20:13:28,b415168a9862023462b7193e83da948cb8d11893,Bram Moolenaar,17,3,20,4,"{"".travis.yml"": {""insertions"": 2, ""deletions"": 2, ""lines"": 4}, ""src/Makefile"": {""insertions"": 3, ""deletions"": 1, ""lines"": 4}, ""src/os_unix.c"": {""insertions"": 10, ""deletions"": 0, ""lines"": 10}, ""src/version.c"": {""insertions"": 2, ""deletions"": 0, ""lines"": 2}}"
2020-05-11 20:04:53,91689ea8ae01acb3daf8ba0ee91acd729af7c84c,Bram Moolenaar,270,22,292,5,"{""src/testdir/term_util.vim"": {""insertions"": 3, ""deletions"": 0, ""lines"": 3}, ""src/testdir/test_gui.vim"": {""insertions"": 18, ""deletions"": 0, ""lines"": 18}, ""src/testdir/test_modeless.vim"": {""insertions"": 22, ""deletions"": 22, ""lines"": 44}, ""src/testdir/test_terminal.vim"": {""insertions"": 225, ""deletions"": 0, ""lines"": 225}, ""src/version.c"": {""insertions"": 2, ""deletions"": 0, ""lines"": 2}}"
2020-05-11 18:54:42,5c3128efe6bc48cbd88da23973db389ad3b8ab63,Bram Moolenaar,28,6,34,2,"{""src/os_unix.c"": {""insertions"": 26, ""deletions"": 6, ""lines"": 32}, ""src/version.c"": {""insertions"": 2, ""deletions"": 0, ""lines"": 2}}"
2020-05-11 17:46:36,aacc6afdb8cdeb2558e6942dcd65ca0079bec1ee,Bram Moolenaar,4,2,6,3,"{""runtime/filetype.vim"": {""insertions"": 1, ""deletions"": 1, ""lines"": 2}, ""src/testdir/test_filetype.vim"": {""insertions"": 1, ""deletions"": 1, ""lines"": 2}, ""src/version.c"": {""insertions"": 2, ""deletions"": 0, ""lines"": 2}}"
2020-05-10 21:20:06,bc38f25c021dc4314c77d50a608329a328b0d988,Bram Moolenaar,12,8,20,2,"{""src/version.c"": {""insertions"": 2, ""deletions"": 0, ""lines"": 2}, ""src/vim9compile.c"": {""insertions"": 10, ""deletions"": 8, ""lines"": 18}}"
2020-05-10 21:11:53,04816717dfea6e2469ff4c9d40f68b59aaf03724,Bram Moolenaar,7,1,8,2,"{""src/scriptfile.c"": {""insertions"": 5, ""deletions"": 1, ""lines"": 6}, ""src/version.c"": {""insertions"": 2, ""deletions"": 0, ""lines"": 2}}"
2020-05-10 20:53:56,cb2bdb1c6d8b6df4a3d9cfb1ad9e602dace5d310,Bram Moolenaar,52,6,58,3,"{""src/testdir/test_vim9_func.vim"": {""insertions"": 20, ""deletions"": 0, ""lines"": 20}, ""src/version.c"": {""insertions"": 2, ""deletions"": 0, ""lines"": 2}, ""src/vim9compile.c"": {""insertions"": 30, ""deletions"": 6, ""lines"": 36}}"
2020-05-10 19:47:43,f163bd5e41e8ea1d32e7977e671598a9d6f7b23c,Bram Moolenaar,16,0,16,3,"{""src/testdir/test_vim9_cmd.vim"": {""insertions"": 12, ""deletions"": 0, ""lines"": 12}, ""src/version.c"": {""insertions"": 2, ""deletions"": 0, ""lines"": 2}, ""src/vim9execute.c"": {""insertions"": 2, ""deletions"": 0, ""lines"": 2}}"
2020-05-10 19:20:29,7e5bd91dc99e1ecb38c4220eaab1a906a69815c2,Bram Moolenaar,25,0,25,3,"{""src/testdir/test_vim9_script.vim"": {""insertions"": 17, ""deletions"": 0, ""lines"": 17}, ""src/version.c"": {""insertions"": 2, ""deletions"": 0, ""lines"": 2}, ""src/vim9script.c"": {""insertions"": 6, ""deletions"": 0, ""lines"": 6}}"
2020-05-10 17:10:31,1cc2a94f80ba982f83d1e2d37c4726867e36bd9f,Bram Moolenaar,462,166,628,8,"{""src/globals.h"": {""insertions"": 1, ""deletions"": 0, ""lines"": 1}, ""src/testdir/test_vim9_cmd.vim"": {""insertions"": 22, ""deletions"": 0, ""lines"": 22}, ""src/testdir/test_vim9_expr.vim"": {""insertions"": 2, ""deletions"": 2, ""lines"": 4}, ""src/testdir/test_vim9_script.vim"": {""insertions"": 1, ""deletions"": 1, ""lines"": 2}, ""src/version.c"": {""insertions"": 2, ""deletions"": 0, ""lines"": 2}, ""src/vim9.h"": {""insertions"": 4, ""deletions"": 1, ""lines"": 5}, ""src/vim9compile.c"": {""insertions"": 315, ""deletions"": 160, ""lines"": 475}, ""src/vim9execute.c"": {""insertions"": 115, ""deletions"": 2, ""lines"": 117}}"
2020-05-10 13:24:44,89483d40438830fb9e74a5ec6c92d2470b05e4c2,Bram Moolenaar,57,20,77,5,"{""src/dict.c"": {""insertions"": 15, ""deletions"": 6, ""lines"": 21}, ""src/proto/dict.pro"": {""insertions"": 1, ""deletions"": 0, ""lines"": 1}, ""src/scriptfile.c"": {""insertions"": 16, ""deletions"": 11, ""lines"": 27}, ""src/testdir/test_vim9_script.vim"": {""insertions"": 23, ""deletions"": 3, ""lines"": 26}, ""src/version.c"": {""insertions"": 2, ""deletions"": 0, ""lines"": 2}}"
2020-05-10 12:14:03,69212b11d18d9d8951968f6ca88e6ce046c90675,Bram Moolenaar,6,4,10,3,"{""src/misc1.c"": {""insertions"": 2, ""deletions"": 2, ""lines"": 4}, ""src/os_unix.c"": {""insertions"": 2, ""deletions"": 2, ""lines"": 4}, ""src/version.c"": {""insertions"": 2, ""deletions"": 0, ""lines"": 2}}"
2020-05-10 11:42:43,d695ba732de915fc227c1069a7a4e1d5049601bd,Bram Moolenaar,5,3,8,2,"{""src/version.c"": {""insertions"": 2, ""deletions"": 0, ""lines"": 2}, ""src/vim.h"": {""insertions"": 3, ""deletions"": 3, ""lines"": 6}}"
2020-05-09 21:20:20,3b6a6eb7b4e0ac5b75dd2518bd27bce2b13298a3,Bram Moolenaar,7,5,12,2,"{""src/version.c"": {""insertions"": 2, ""deletions"": 0, ""lines"": 2}, ""src/vim9execute.c"": {""insertions"": 5, ""deletions"": 5, ""lines"": 10}}"
2020-05-09 20:50:08,09689a02840be40fa7bb10b1921fb5bc5b2908f1,Bram Moolenaar,229,35,264,13,"{""src/evalvars.c"": {""insertions"": 12, ""deletions"": 5, ""lines"": 17}, ""src/proto/evalvars.pro"": {""insertions"": 1, ""deletions"": 0, ""lines"": 1}, ""src/proto/scriptfile.pro"": {""insertions"": 2, ""deletions"": 0, ""lines"": 2}, ""src/proto/userfunc.pro"": {""insertions"": 1, ""deletions"": 1, ""lines"": 2}, ""src/proto/vim9compile.pro"": {""insertions"": 1, ""deletions"": 0, ""lines"": 1}, ""src/scriptfile.c"": {""insertions"": 51, ""deletions"": 0, ""lines"": 51}, ""src/testdir/test_vim9_disassemble.vim"": {""insertions"": 25, ""deletions"": 0, ""lines"": 25}, ""src/userfunc.c"": {""insertions"": 5, ""deletions"": 4, ""lines"": 9}, ""src/version.c"": {""insertions"": 2, ""deletions"": 0, ""lines"": 2}, ""src/vim.h"": {""insertions"": 1, ""deletions"": 0, ""lines"": 1}, ""src/vim9compile.c"": {""insertions"": 30, ""deletions"": 23, ""lines"": 53}, ""src/vim9execute.c"": {""insertions"": 7, ""deletions"": 0, ""lines"": 7}, ""src/vim9script.c"": {""insertions"": 91, ""deletions"": 2, ""lines"": 93}}"
2020-05-09 16:44:56,396f3138ca83ce844679143861f544070683d479,Bram Moolenaar,8,0,8,2,"{""src/testdir/test_vim9_script.vim"": {""insertions"": 6, ""deletions"": 0, ""lines"": 6}, ""src/version.c"": {""insertions"": 2, ""deletions"": 0, ""lines"": 2}}"
2020-05-09 16:28:34,1c74721233dac057778f9aef9ae20f49d934ec22,Bram Moolenaar,33,4,37,3,"{""src/testdir/test_vim9_disassemble.vim"": {""insertions"": 10, ""deletions"": 0, ""lines"": 10}, ""src/version.c"": {""insertions"": 2, ""deletions"": 0, ""lines"": 2}, ""src/vim9compile.c"": {""insertions"": 21, ""deletions"": 4, ""lines"": 25}}"
2020-05-09 15:35:53,7f14155f422ffcc997fc5a0b635a20a4bafd2093,Bram Moolenaar,23,408,431,2,"{""src/version.c"": {""insertions"": 2, ""deletions"": 0, ""lines"": 2}, ""src/vim9compile.c"": {""insertions"": 21, ""deletions"": 408, ""lines"": 429}}"
2020-05-09 14:44:22,497f76bfbf9d5fe951221573d23696bb9e512c0b,Bram Moolenaar,6,0,6,2,"{""src/version.c"": {""insertions"": 2, ""deletions"": 0, ""lines"": 2}, ""src/vim9compile.c"": {""insertions"": 4, ""deletions"": 0, ""lines"": 4}}"
2020-05-09 14:11:33,b1062eb23e7a7a8b44f3416e79c3b28aa6c6c229,Bram Moolenaar,11,4,15,2,"{""src/os_unix.c"": {""insertions"": 9, ""deletions"": 4, ""lines"": 13}, ""src/version.c"": {""insertions"": 2, ""deletions"": 0, ""lines"": 2}}"
2020-05-09 13:44:01,a5565e4189b7c4d3f03d1f5405fc64d5dc00f717,Bram Moolenaar,450,279,729,4,"{""src/testdir/test_vim9_disassemble.vim"": {""insertions"": 58, ""deletions"": 48, ""lines"": 106}, ""src/testdir/test_vim9_expr.vim"": {""insertions"": 1, ""deletions"": 1, ""lines"": 2}, ""src/version.c"": {""insertions"": 2, ""deletions"": 0, ""lines"": 2}, ""src/vim9compile.c"": {""insertions"": 389, ""deletions"": 230, ""lines"": 619}}"
2020-05-09 11:06:24,7d3664df9008bd5f39f8a2555843d1b269946e4d,Bram Moolenaar,5,1,6,2,"{""src/evalvars.c"": {""insertions"": 3, ""deletions"": 1, ""lines"": 4}, ""src/version.c"": {""insertions"": 2, ""deletions"": 0, ""lines"": 2}}"
2020-05-08 17:10:34,7d131b071539e73e4f8a1e6ffbb4d7bfc69a57ec,Bram Moolenaar,183,136,319,3,"{""src/testdir/test_vim9_disassemble.vim"": {""insertions"": 10, ""deletions"": 0, ""lines"": 10}, ""src/version.c"": {""insertions"": 2, ""deletions"": 0, ""lines"": 2}, ""src/vim9compile.c"": {""insertions"": 171, ""deletions"": 136, ""lines"": 307}}"
2020-05-07 21:20:21,5c2fe644430efabf9dadfb89a9f1e82367eaf28d,Bram Moolenaar,17,4,21,2,"{""src/version.c"": {""insertions"": 2, ""deletions"": 0, ""lines"": 2}, ""src/vim9compile.c"": {""insertions"": 15, ""deletions"": 4, ""lines"": 19}}"
2020-05-07 20:23:58,cca34aa4bef5327eb4025850045c4c980ef4354b,Bram Moolenaar,4,0,4,2,"{""src/version.c"": {""insertions"": 2, ""deletions"": 0, ""lines"": 2}, ""src/vim9compile.c"": {""insertions"": 2, ""deletions"": 0, ""lines"": 2}}"
2020-05-07 20:19:01,f0eefce93bb06037a2d45e7ea8c0ad6f1f714151,Bram Moolenaar,165,61,226,3,"{""src/testdir/test_vim9_expr.vim"": {""insertions"": 2, ""deletions"": 3, ""lines"": 5}, ""src/version.c"": {""insertions"": 2, ""deletions"": 0, ""lines"": 2}, ""src/vim9compile.c"": {""insertions"": 161, ""deletions"": 58, ""lines"": 219}}"
2020-05-07 16:56:00,2cfb4a2a7248eeb40112bb482ab5b15f01b20433,Bram Moolenaar,106,43,149,10,"{""runtime/doc/options.txt"": {""insertions"": 1, ""deletions"": 1, ""lines"": 2}, ""runtime/doc/todo.txt"": {""insertions"": 17, ""deletions"": 14, ""lines"": 31}, ""runtime/doc/vim9.txt"": {""insertions"": 51, ""deletions"": 5, ""lines"": 56}, ""runtime/filetype.vim"": {""insertions"": 1, ""deletions"": 1, ""lines"": 2}, ""runtime/ftplugin/dosbatch.vim"": {""insertions"": 11, ""deletions"": 2, ""lines"": 13}, ""runtime/ftplugin/man.vim"": {""insertions"": 3, ""deletions"": 3, ""lines"": 6}, ""runtime/plugin/gzip.vim"": {""insertions"": 5, ""deletions"": 1, ""lines"": 6}, ""runtime/syntax/asciidoc.vim"": {""insertions"": 11, ""deletions"": 11, ""lines"": 22}, ""runtime/syntax/make.vim"": {""insertions"": 2, ""deletions"": 2, ""lines"": 4}, ""runtime/syntax/masm.vim"": {""insertions"": 4, ""deletions"": 3, ""lines"": 7}}"
2020-05-07 16:51:27,611548105394fdb76827cd431230c9fbfed39929,Bram Moolenaar,6,0,6,3,"{""runtime/filetype.vim"": {""insertions"": 3, ""deletions"": 0, ""lines"": 3}, ""src/testdir/test_filetype.vim"": {""insertions"": 1, ""deletions"": 0, ""lines"": 1}, ""src/version.c"": {""insertions"": 2, ""deletions"": 0, ""lines"": 2}}"
2020-05-07 16:43:44,0ff5dedf0f69e56320199db7a2aad46be2a1f9b7,Bram Moolenaar,83,0,83,5,"{""src/testdir/test_functions.vim"": {""insertions"": 16, ""deletions"": 0, ""lines"": 16}, ""src/testdir/test_options.vim"": {""insertions"": 1, ""deletions"": 0, ""lines"": 1}, ""src/testdir/test_system.vim"": {""insertions"": 38, ""deletions"": 0, ""lines"": 38}, ""src/testdir/test_termcodes.vim"": {""insertions"": 26, ""deletions"": 0, ""lines"": 26}, ""src/version.c"": {""insertions"": 2, ""deletions"": 0, ""lines"": 2}}"
2020-05-07 16:37:03,b2d0e51366dea6843f991f31a457f5456d162678,Bram Moolenaar,119,0,119,7,"{""src/auto/configure"": {""insertions"": 47, ""deletions"": 0, ""lines"": 47}, ""src/config.h.in"": {""insertions"": 6, ""deletions"": 0, ""lines"": 6}, ""src/configure.ac"": {""insertions"": 15, ""deletions"": 0, ""lines"": 15}, ""src/fileio.c"": {""insertions"": 42, ""deletions"": 0, ""lines"": 42}, ""src/globals.h"": {""insertions"": 3, ""deletions"": 0, ""lines"": 3}, ""src/os_unix.h"": {""insertions"": 4, ""deletions"": 0, ""lines"": 4}, ""src/version.c"": {""insertions"": 2, ""deletions"": 0, ""lines"": 2}}"
2020-05-07 16:16:35,4a070cc82e00618db279526797564cb2b4e9b060,Bram Moolenaar,5,0,5,2,"{""src/testdir/shared.vim"": {""insertions"": 3, ""deletions"": 0, ""lines"": 3}, ""src/version.c"": {""insertions"": 2, ""deletions"": 0, ""lines"": 2}}"
2020-05-07 15:46:59,ea554ca4faf4a0b96706ea24130c4f485b24b241,Bram Moolenaar,3,1,4,2,"{""src/channel.c"": {""insertions"": 1, ""deletions"": 1, ""lines"": 2}, ""src/version.c"": {""insertions"": 2, ""deletions"": 0, ""lines"": 2}}"
2020-05-07 14:58:17,61a89816996a0cad0d711c91e6e7cea9a9101211,Bram Moolenaar,1762,1613,3375,4,"{""src/testdir/test_vim9_disassemble.vim"": {""insertions"": 13, ""deletions"": 3, ""lines"": 16}, ""src/testdir/test_vim9_expr.vim"": {""insertions"": 4, ""deletions"": 2, ""lines"": 6}, ""src/version.c"": {""insertions"": 2, ""deletions"": 0, ""lines"": 2}, ""src/vim9compile.c"": {""insertions"": 1743, ""deletions"": 1608, ""lines"": 3351}}"
2020-05-07 12:37:19,f391586f3f6a304d3bb0160ab75bdd9d758bd2da,Bram Moolenaar,3,1,4,2,"{""src/testdir/test_vim9_func.vim"": {""insertions"": 1, ""deletions"": 1, ""lines"": 2}, ""src/version.c"": {""insertions"": 2, ""deletions"": 0, ""lines"": 2}}"
2020-05-07 12:07:25,8a1c1013153a7f08e014facac883a1987985d6db,Bram Moolenaar,6,9,15,4,"{""src/testdir/test_vim9_disassemble.vim"": {""insertions"": 2, ""deletions"": 0, ""lines"": 2}, ""src/testdir/test_vim9_script.vim"": {""insertions"": 0, ""deletions"": 7, ""lines"": 7}, ""src/version.c"": {""insertions"": 2, ""deletions"": 0, ""lines"": 2}, ""src/vim9execute.c"": {""insertions"": 2, ""deletions"": 2, ""lines"": 4}}"
2020-05-06 20:25:05,3657686a0e8fd07428a25c2cf9efcc8b5d33f895,Bram Moolenaar,4,2,6,3,"{"".cirrus.yml"": {""insertions"": 1, ""deletions"": 2, ""lines"": 3}, ""runtime/indent/testdir/runtest.vim"": {""insertions"": 1, ""deletions"": 0, ""lines"": 1}, ""src/version.c"": {""insertions"": 2, ""deletions"": 0, ""lines"": 2}}"
2020-05-06 20:18:17,f821ddaa0c27230012a6bffbec6fb0ab2f101171,Bram Moolenaar,29,1,30,2,"{""src/version.c"": {""insertions"": 2, ""deletions"": 0, ""lines"": 2}, ""src/vim9execute.c"": {""insertions"": 27, ""deletions"": 1, ""lines"": 28}}"
2020-05-06 19:06:30,b68b346e6db6d3f848e0a89905fcd7777b73c5d8,Bram Moolenaar,97,9,106,8,"{""src/eval.c"": {""insertions"": 4, ""deletions"": 2, ""lines"": 6}, ""src/structs.h"": {""insertions"": 1, ""deletions"": 0, ""lines"": 1}, ""src/testdir/test_vim9_disassemble.vim"": {""insertions"": 36, ""deletions"": 0, ""lines"": 36}, ""src/testdir/test_vim9_func.vim"": {""insertions"": 26, ""deletions"": 0, ""lines"": 26}, ""src/version.c"": {""insertions"": 2, ""deletions"": 0, ""lines"": 2}, ""src/vim9.h"": {""insertions"": 2, ""deletions"": 1, ""lines"": 3}, ""src/vim9compile.c"": {""insertions"": 10, ""deletions"": 3, ""lines"": 13}, ""src/vim9execute.c"": {""insertions"": 16, ""deletions"": 3, ""lines"": 19}}"
2020-05-06 17:38:30,54ed0dff2913f9c973f6ab04b3c96372bdf07406,Bram Moolenaar,4,0,4,2,"{""src/testdir/test_channel_pipe.py"": {""insertions"": 2, ""deletions"": 0, ""lines"": 2}, ""src/version.c"": {""insertions"": 2, ""deletions"": 0, ""lines"": 2}}"
2020-05-05 21:32:58,2a1381c305b32885c644cc300e4f6734292626a2,Bram Moolenaar,15,11,26,2,"{""src/testdir/test_vim9_script.vim"": {""insertions"": 13, ""deletions"": 11, ""lines"": 24}, ""src/version.c"": {""insertions"": 2, ""deletions"": 0, ""lines"": 2}}"
2020-05-05 20:08:26,40ee466c361b9698c2a452a36ff4d6c6e5382ed0,Bram Moolenaar,21,7,28,3,"{""src/testdir/test_vim9_script.vim"": {""insertions"": 19, ""deletions"": 1, ""lines"": 20}, ""src/version.c"": {""insertions"": 2, ""deletions"": 0, ""lines"": 2}, ""src/vim9execute.c"": {""insertions"": 0, ""deletions"": 6, ""lines"": 6}}"
2020-05-05 19:25:22,015f4267f4a28627c1872042078a95be7e06c4dc,Bram Moolenaar,50,26,76,5,"{""src/testdir/test_vim9_expr.vim"": {""insertions"": 17, ""deletions"": 17, ""lines"": 34}, ""src/testdir/test_vim9_func.vim"": {""insertions"": 17, ""deletions"": 0, ""lines"": 17}, ""src/testdir/vim9.vim"": {""insertions"": 8, ""deletions"": 8, ""lines"": 16}, ""src/version.c"": {""insertions"": 2, ""deletions"": 0, ""lines"": 2}, ""src/vim9execute.c"": {""insertions"": 6, ""deletions"": 1, ""lines"": 7}}"
2020-05-05 17:57:18,f9ab52e155dc13f59b654d754041fe78e17b9074,Bram Moolenaar,134,9,143,4,"{""src/testdir/test_edit.vim"": {""insertions"": 9, ""deletions"": 9, ""lines"": 18}, ""src/testdir/test_ins_complete.vim"": {""insertions"": 99, ""deletions"": 0, ""lines"": 99}, ""src/testdir/test_textformat.vim"": {""insertions"": 24, ""deletions"": 0, ""lines"": 24}, ""src/version.c"": {""insertions"": 2, ""deletions"": 0, ""lines"": 2}}"
2020-05-05 17:46:20,221fcc741a6660bfc3fd0d64937d0c15bb71f51d,Bram Moolenaar,30,4,34,3,"{""src/version.c"": {""insertions"": 2, ""deletions"": 0, ""lines"": 2}, ""src/vim9compile.c"": {""insertions"": 8, ""deletions"": 1, ""lines"": 9}, ""src/vim9execute.c"": {""insertions"": 20, ""deletions"": 3, ""lines"": 23}}"
2020-05-05 15:53:16,0e65d3de0aeff00aa42ea899f1afd11f8b22b93e,Bram Moolenaar,30,31,61,4,"{""src/testdir/test_vim9_func.vim"": {""insertions"": 3, ""deletions"": 0, ""lines"": 3}, ""src/version.c"": {""insertions"": 2, ""deletions"": 0, ""lines"": 2}, ""src/vim9compile.c"": {""insertions"": 25, ""deletions"": 26, ""lines"": 51}, ""src/vim9execute.c"": {""insertions"": 0, ""deletions"": 5, ""lines"": 5}}"
2020-05-04 21:24:44,04b12697838b232b8b17c553ccc74cf1f1bdb81c,Bram Moolenaar,167,72,239,6,"{""src/proto/userfunc.pro"": {""insertions"": 2, ""deletions"": 0, ""lines"": 2}, ""src/testdir/test_vim9_func.vim"": {""insertions"": 20, ""deletions"": 15, ""lines"": 35}, ""src/userfunc.c"": {""insertions"": 62, ""deletions"": 30, ""lines"": 92}, ""src/version.c"": {""insertions"": 2, ""deletions"": 0, ""lines"": 2}, ""src/vim9compile.c"": {""insertions"": 76, ""deletions"": 27, ""lines"": 103}, ""src/vim9execute.c"": {""insertions"": 5, ""deletions"": 0, ""lines"": 5}}"
2020-05-03 20:57:32,80a8d3889bf1341c47f1c88c59825f183b2b4753,Bram Moolenaar,81,24,105,5,"{""src/channel.c"": {""insertions"": 30, ""deletions"": 2, ""lines"": 32}, ""src/getchar.c"": {""insertions"": 1, ""deletions"": 1, ""lines"": 2}, ""src/gui_haiku.cc"": {""insertions"": 34, ""deletions"": 9, ""lines"": 43}, ""src/misc1.c"": {""insertions"": 14, ""deletions"": 12, ""lines"": 26}, ""src/version.c"": {""insertions"": 2, ""deletions"": 0, ""lines"": 2}}"
2020-05-03 20:30:49,2fd4cd755c3e87e733b7363ac13e5c0fe0297a80,Bram Moolenaar,82,38,120,3,"{""src/testdir/test_vim9_func.vim"": {""insertions"": 21, ""deletions"": 0, ""lines"": 21}, ""src/version.c"": {""insertions"": 2, ""deletions"": 0, ""lines"": 2}, ""src/vim9compile.c"": {""insertions"": 59, ""deletions"": 38, ""lines"": 97}}"
2020-05-03 16:21:04,4515bcdec8f3ba54f9d671cc37b9c9b3e19ea999,Bram Moolenaar,3,1,4,2,"{""src/testdir/test_startup.vim"": {""insertions"": 1, ""deletions"": 1, ""lines"": 2}, ""src/version.c"": {""insertions"": 2, ""deletions"": 0, ""lines"": 2}}"
2020-05-03 15:55:32,7779ee30d912e9dd5bd2371f8b27057bd249d53c,Bram Moolenaar,3,1,4,2,"{""src/testdir/test_startup.vim"": {""insertions"": 1, ""deletions"": 1, ""lines"": 2}, ""src/version.c"": {""insertions"": 2, ""deletions"": 0, ""lines"": 2}}"
2020-05-03 15:19:33,5125874951669944a5f6a4163d6e5d437ae6321e,Bram Moolenaar,61,1,62,3,"{""src/option.c"": {""insertions"": 3, ""deletions"": 1, ""lines"": 4}, ""src/testdir/test_modeline.vim"": {""insertions"": 56, ""deletions"": 0, ""lines"": 56}, ""src/version.c"": {""insertions"": 2, ""deletions"": 0, ""lines"": 2}}"
2020-05-03 15:03:29,a38b2b737e244eb2e4f199e070b05f86f4d433d4,Bram Moolenaar,6,2,8,2,"{""src/channel.c"": {""insertions"": 4, ""deletions"": 2, ""lines"": 6}, ""src/version.c"": {""insertions"": 2, ""deletions"": 0, ""lines"": 2}}"
2020-05-03 15:01:24,647a530b33d9d767f591159c24c62de48e57dad7,Bram Moolenaar,6,2,8,3,"{""runtime/doc/options.txt"": {""insertions"": 2, ""deletions"": 0, ""lines"": 2}, ""src/scriptfile.c"": {""insertions"": 2, ""deletions"": 2, ""lines"": 4}, ""src/version.c"": {""insertions"": 2, ""deletions"": 0, ""lines"": 2}}"
2020-05-03 14:29:50,41d4299f26cc98e253f9c63f8adc9dbb9d49ed5c,Bram Moolenaar,13,9,22,3,"{""src/testdir/test_quickfix.vim"": {""insertions"": 1, ""deletions"": 1, ""lines"": 2}, ""src/testdir/test_terminal.vim"": {""insertions"": 10, ""deletions"": 8, ""lines"": 18}, ""src/version.c"": {""insertions"": 2, ""deletions"": 0, ""lines"": 2}}"
2020-05-03 14:04:43,2eaeaf3c317a5145fb0bc926411561d50883019b,Bram Moolenaar,209,0,209,3,"{""src/testdir/test_normal.vim"": {""insertions"": 15, ""deletions"": 0, ""lines"": 15}, ""src/testdir/test_textformat.vim"": {""insertions"": 192, ""deletions"": 0, ""lines"": 192}, ""src/version.c"": {""insertions"": 2, ""deletions"": 0, ""lines"": 2}}"
2020-05-03 13:47:33,3df02f507f96a246366f96dcce156a0ae7b95611,Bram Moolenaar,5,17,22,2,"{""src/version.c"": {""insertions"": 2, ""deletions"": 0, ""lines"": 2}, ""src/vim9compile.c"": {""insertions"": 3, ""deletions"": 17, ""lines"": 20}}"
2020-05-03 13:38:16,f7779c63d4fe531e2483502d4441f24802342768,Bram Moolenaar,83,71,154,7,"{""src/eval.c"": {""insertions"": 27, ""deletions"": 0, ""lines"": 27}, ""src/structs.h"": {""insertions"": 23, ""deletions"": 0, ""lines"": 23}, ""src/testdir/test_vim9_func.vim"": {""insertions"": 2, ""deletions"": 8, ""lines"": 10}, ""src/userfunc.c"": {""insertions"": 5, ""deletions"": 8, ""lines"": 13}, ""src/version.c"": {""insertions"": 2, ""deletions"": 0, ""lines"": 2}, ""src/vim9.h"": {""insertions"": 0, ""deletions"": 20, ""lines"": 20}, ""src/vim9execute.c"": {""insertions"": 24, ""deletions"": 35, ""lines"": 59}}"
2020-05-02 21:12:58,5adc55cb746893c6ddf7865ff654582902dee2e3,Bram Moolenaar,84,6,90,6,"{""src/proto/vim9execute.pro"": {""insertions"": 2, ""deletions"": 1, ""lines"": 3}, ""src/testdir/test_vim9_func.vim"": {""insertions"": 44, ""deletions"": 0, ""lines"": 44}, ""src/userfunc.c"": {""insertions"": 5, ""deletions"": 0, ""lines"": 5}, ""src/version.c"": {""insertions"": 2, ""deletions"": 0, ""lines"": 2}, ""src/vim9compile.c"": {""insertions"": 8, ""deletions"": 3, ""lines"": 11}, ""src/vim9execute.c"": {""insertions"": 23, ""deletions"": 2, ""lines"": 25}}"
2020-05-02 17:04:58,1c0d44f8efae36c079cb8be395785827aa0b2737,Bram Moolenaar,7,0,7,3,"{""src/testdir/test_vim9_func.vim"": {""insertions"": 1, ""deletions"": 0, ""lines"": 1}, ""src/version.c"": {""insertions"": 2, ""deletions"": 0, ""lines"": 2}, ""src/vim9compile.c"": {""insertions"": 4, ""deletions"": 0, ""lines"": 4}}"
2020-05-02 16:33:25,0b6849e9e302286e906d97e4ba017dd66561a9ce,Bram Moolenaar,3,0,3,2,"{""src/screen.c"": {""insertions"": 1, ""deletions"": 0, ""lines"": 1}, ""src/version.c"": {""insertions"": 2, ""deletions"": 0, ""lines"": 2}}"
2020-05-02 16:14:37,01f731e97c92bee05927f5008b7cd34ce188632b,Bram Moolenaar,2,174,176,4,"{""src/auto/configure"": {""insertions"": 0, ""deletions"": 97, ""lines"": 97}, ""src/config.h.in"": {""insertions"": 0, ""deletions"": 6, ""lines"": 6}, ""src/configure.ac"": {""insertions"": 0, ""deletions"": 71, ""lines"": 71}, ""src/version.c"": {""insertions"": 2, ""deletions"": 0, ""lines"": 2}}"
2020-05-02 15:52:42,bf67ea1af05cbb30cd8f0b665fb567c0dca79796,Bram Moolenaar,258,63,321,6,"{""src/structs.h"": {""insertions"": 1, ""deletions"": 3, ""lines"": 4}, ""src/testdir/test_vim9_func.vim"": {""insertions"": 12, ""deletions"": 0, ""lines"": 12}, ""src/version.c"": {""insertions"": 2, ""deletions"": 0, ""lines"": 2}, ""src/vim9.h"": {""insertions"": 32, ""deletions"": 1, ""lines"": 33}, ""src/vim9compile.c"": {""insertions"": 23, ""deletions"": 1, ""lines"": 24}, ""src/vim9execute.c"": {""insertions"": 188, ""deletions"": 58, ""lines"": 246}}"
2020-05-02 12:52:57,d58a662f44dc11475f4cf5922a948635da934cc4,Bram Moolenaar,8,3,11,2,"{""src/popupmenu.c"": {""insertions"": 6, ""deletions"": 3, ""lines"": 9}, ""src/version.c"": {""insertions"": 2, ""deletions"": 0, ""lines"": 2}}"
2020-05-01 17:29:08,c8cd2b34d1027c93fbca90f3cdc8123fe22dfa25,Bram Moolenaar,223,126,349,8,"{""src/proto/vim9compile.pro"": {""insertions"": 1, ""deletions"": 1, ""lines"": 2}, ""src/structs.h"": {""insertions"": 17, ""deletions"": 0, ""lines"": 17}, ""src/testdir/test_vim9_func.vim"": {""insertions"": 9, ""deletions"": 0, ""lines"": 9}, ""src/userfunc.c"": {""insertions"": 1, ""deletions"": 14, ""lines"": 15}, ""src/version.c"": {""insertions"": 2, ""deletions"": 0, ""lines"": 2}, ""src/vim9.h"": {""insertions"": 1, ""deletions"": 0, ""lines"": 1}, ""src/vim9compile.c"": {""insertions"": 148, ""deletions"": 105, ""lines"": 253}, ""src/vim9execute.c"": {""insertions"": 44, ""deletions"": 6, ""lines"": 50}}"
2020-05-01 14:08:11,37addecc422c3b62a622b371246dc4ef0a2fa157,Bram Moolenaar,3,1,4,2,"{""Filelist"": {""insertions"": 1, ""deletions"": 1, ""lines"": 2}, ""src/version.c"": {""insertions"": 2, ""deletions"": 0, ""lines"": 2}}"
2020-05-01 14:07:38,7ceefb35c8110d87ced884275ddbe63d024a014f,Bram Moolenaar,296,182,478,22,"{""runtime/doc/change.txt"": {""insertions"": 4, ""deletions"": 4, ""lines"": 8}, ""runtime/doc/cmdline.txt"": {""insertions"": 2, ""deletions"": 1, ""lines"": 3}, ""runtime/doc/eval.txt"": {""insertions"": 4, ""deletions"": 4, ""lines"": 8}, ""runtime/doc/help.txt"": {""insertions"": 1, ""deletions"": 1, ""lines"": 2}, ""runtime/doc/index.txt"": {""insertions"": 3, ""deletions"": 4, ""lines"": 7}, ""runtime/doc/insert.txt"": {""insertions"": 2, ""deletions"": 2, ""lines"": 4}, ""runtime/doc/map.txt"": {""insertions"": 2, ""deletions"": 2, ""lines"": 4}, ""runtime/doc/os_haiku.txt"": {""insertions"": 4, ""deletions"": 3, ""lines"": 7}, ""runtime/doc/os_win32.txt"": {""insertions"": 1, ""deletions"": 1, ""lines"": 2}, ""runtime/doc/repeat.txt"": {""insertions"": 2, ""deletions"": 2, ""lines"": 4}, ""runtime/doc/tags"": {""insertions"": 4, ""deletions"": 0, ""lines"": 4}, ""runtime/doc/terminal.txt"": {""insertions"": 6, ""deletions"": 2, ""lines"": 8}, ""runtime/doc/textprop.txt"": {""insertions"": 3, ""deletions"": 3, ""lines"": 6}, ""runtime/doc/todo.txt"": {""insertions"": 66, ""deletions"": 30, ""lines"": 96}, ""runtime/doc/usr_08.txt"": {""insertions"": 1, ""deletions"": 1, ""lines"": 2}, ""runtime/doc/usr_10.txt"": {""insertions"": 1, ""deletions"": 1, ""lines"": 2}, ""runtime/doc/vim9.txt"": {""insertions"": 53, ""deletions"": 31, ""lines"": 84}, ""runtime/ftplugin/man.vim"": {""insertions"": 4, ""deletions"": 3, ""lines"": 7}, ""runtime/syntax/debchangelog.vim"": {""insertions"": 2, ""deletions"": 2, ""lines"": 4}, ""runtime/syntax/debsources.vim"": {""insertions"": 2, ""deletions"": 2, ""lines"": 4}, ""runtime/syntax/lex.vim"": {""insertions"": 123, ""deletions"": 78, ""lines"": 201}, ""runtime/syntax/man.vim"": {""insertions"": 6, ""deletions"": 5, ""lines"": 11}}"
2020-05-01 13:44:29,b84a381c75e50ca0e0a24cc3e152d0c70f8c2c7d,Bram Moolenaar,81,74,155,6,"{""src/evalvars.c"": {""insertions"": 8, ""deletions"": 8, ""lines"": 16}, ""src/ex_docmd.c"": {""insertions"": 2, ""deletions"": 2, ""lines"": 4}, ""src/proto/evalvars.pro"": {""insertions"": 1, ""deletions"": 1, ""lines"": 2}, ""src/proto/ex_docmd.pro"": {""insertions"": 2, ""deletions"": 2, ""lines"": 4}, ""src/version.c"": {""insertions"": 2, ""deletions"": 0, ""lines"": 2}, ""src/vim9compile.c"": {""insertions"": 66, ""deletions"": 61, ""lines"": 127}}"
2020-05-01 12:26:37,11abd095210fc84e5dcee87b9baed86061caefe4,Bram Moolenaar,1167,1176,2343,19,"{""Filelist"": {""insertions"": 2, ""deletions"": 0, ""lines"": 2}, ""src/Make_cyg_ming.mak"": {""insertions"": 1, ""deletions"": 0, ""lines"": 1}, ""src/Make_morph.mak"": {""insertions"": 1, ""deletions"": 0, ""lines"": 1}, ""src/Make_mvc.mak"": {""insertions"": 4, ""deletions"": 0, ""lines"": 4}, ""src/Make_vms.mms"": {""insertions"": 5, ""deletions"": 0, ""lines"": 5}, ""src/Makefile"": {""insertions"": 10, ""deletions"": 0, ""lines"": 10}, ""src/README.md"": {""insertions"": 1, ""deletions"": 0, ""lines"": 1}, ""src/edit.c"": {""insertions"": 0, ""deletions"": 567, ""lines"": 567}, ""src/getchar.c"": {""insertions"": 40, ""deletions"": 0, ""lines"": 40}, ""src/ops.c"": {""insertions"": 0, ""deletions"": 590, ""lines"": 590}, ""src/option.c"": {""insertions"": 0, ""deletions"": 12, ""lines"": 12}, ""src/proto.h"": {""insertions"": 1, ""deletions"": 0, ""lines"": 1}, ""src/proto/edit.pro"": {""insertions"": 0, ""deletions"": 2, ""lines"": 2}, ""src/proto/getchar.pro"": {""insertions"": 1, ""deletions"": 0, ""lines"": 1}, ""src/proto/ops.pro"": {""insertions"": 0, ""deletions"": 4, ""lines"": 4}, ""src/proto/option.pro"": {""insertions"": 0, ""deletions"": 1, ""lines"": 1}, ""src/proto/textformat.pro"": {""insertions"": 11, ""deletions"": 0, ""lines"": 11}, ""src/textformat.c"": {""insertions"": 1088, ""deletions"": 0, ""lines"": 1088}, ""src/version.c"": {""insertions"": 2, ""deletions"": 0, ""lines"": 2}}"
2020-05-01 12:14:07,4cfde1d273ec5fca68a983805af48ea37d3d94e5,Bram Moolenaar,3,1,4,2,"{""src/Makefile"": {""insertions"": 1, ""deletions"": 1, ""lines"": 2}, ""src/version.c"": {""insertions"": 2, ""deletions"": 0, ""lines"": 2}}"
2020-05-01 12:10:13,6ab0953fefe31fef91e40752a675ceb60fc2fe03,Bram Moolenaar,31,8,39,9,"{""src/evalvars.c"": {""insertions"": 1, ""deletions"": 1, ""lines"": 2}, ""src/testdir/test_lua.vim"": {""insertions"": 4, ""deletions"": 1, ""lines"": 5}, ""src/testdir/test_perl.vim"": {""insertions"": 4, ""deletions"": 1, ""lines"": 5}, ""src/testdir/test_python2.vim"": {""insertions"": 4, ""deletions"": 1, ""lines"": 5}, ""src/testdir/test_python3.vim"": {""insertions"": 4, ""deletions"": 1, ""lines"": 5}, ""src/testdir/test_pyx2.vim"": {""insertions"": 4, ""deletions"": 1, ""lines"": 5}, ""src/testdir/test_pyx3.vim"": {""insertions"": 4, ""deletions"": 1, ""lines"": 5}, ""src/testdir/test_ruby.vim"": {""insertions"": 4, ""deletions"": 1, ""lines"": 5}, ""src/version.c"": {""insertions"": 2, ""deletions"": 0, ""lines"": 2}}"
2020-04-30 20:51:01,9e175141f3437627c314257ebf894c29c71a9ded,Bram Moolenaar,6,36,42,4,"{"".gitignore"": {""insertions"": 1, ""deletions"": 0, ""lines"": 1}, ""src/gui.c"": {""insertions"": 2, ""deletions"": 1, ""lines"": 3}, ""src/gui_haiku.cc"": {""insertions"": 1, ""deletions"": 35, ""lines"": 36}, ""src/version.c"": {""insertions"": 2, ""deletions"": 0, ""lines"": 2}}"
2020-04-30 20:31:18,6adb9ea0a6ca01414f4b591f379b0f829a8273c0,Bram Moolenaar,67,43,110,18,"{""src/beval.c"": {""insertions"": 2, ""deletions"": 2, ""lines"": 4}, ""src/change.c"": {""insertions"": 2, ""deletions"": 2, ""lines"": 4}, ""src/edit.c"": {""insertions"": 5, ""deletions"": 4, ""lines"": 9}, ""src/eval.c"": {""insertions"": 5, ""deletions"": 5, ""lines"": 10}, ""src/ex_docmd.c"": {""insertions"": 1, ""deletions"": 1, ""lines"": 2}, ""src/ex_getln.c"": {""insertions"": 21, ""deletions"": 9, ""lines"": 30}, ""src/globals.h"": {""insertions"": 10, ""deletions"": 3, ""lines"": 13}, ""src/indent.c"": {""insertions"": 2, ""deletions"": 2, ""lines"": 4}, ""src/insexpand.c"": {""insertions"": 6, ""deletions"": 5, ""lines"": 11}, ""src/map.c"": {""insertions"": 2, ""deletions"": 2, ""lines"": 4}, ""src/proto/ex_getln.pro"": {""insertions"": 2, ""deletions"": 1, ""lines"": 3}, ""src/register.c"": {""insertions"": 2, ""deletions"": 2, ""lines"": 4}, ""src/testdir/test_edit.vim"": {""insertions"": 1, ""deletions"": 1, ""lines"": 2}, ""src/testdir/test_ins_complete.vim"": {""insertions"": 1, ""deletions"": 1, ""lines"": 2}, ""src/testdir/test_popup.vim"": {""insertions"": 1, ""deletions"": 1, ""lines"": 2}, ""src/undo.c"": {""insertions"": 1, ""deletions"": 1, ""lines"": 2}, ""src/version.c"": {""insertions"": 2, ""deletions"": 0, ""lines"": 2}, ""src/window.c"": {""insertions"": 1, ""deletions"": 1, ""lines"": 2}}"
2020-04-30 18:59:57,4e5534fab798ab7c95554da3bc80b08336aedc2b,Bram Moolenaar,386,50,436,3,"{""src/os_win32.c"": {""insertions"": 355, ""deletions"": 50, ""lines"": 405}, ""src/screen.c"": {""insertions"": 29, ""deletions"": 0, ""lines"": 29}, ""src/version.c"": {""insertions"": 2, ""deletions"": 0, ""lines"": 2}}"
2020-04-30 18:21:43,7f6f56f43c48f0b7288a4edd12b59fa7335f01d3,Bram Moolenaar,3,1,4,2,"{""src/version.c"": {""insertions"": 2, ""deletions"": 0, ""lines"": 2}, ""src/vim9execute.c"": {""insertions"": 1, ""deletions"": 1, ""lines"": 2}}"
2020-04-30 17:54:38,2c5c1638a9fe2ef34f2fd09ed69e10ef2e821f0a,Bram Moolenaar,32,21,53,6,"{""Filelist"": {""insertions"": 1, ""deletions"": 1, ""lines"": 2}, ""READMEdir/README_haiku.txt"": {""insertions"": 1, ""deletions"": 1, ""lines"": 2}, ""runtime/doc/os_haiku.txt"": {""insertions"": 17, ""deletions"": 15, ""lines"": 32}, ""src/Makefile"": {""insertions"": 10, ""deletions"": 2, ""lines"": 12}, ""src/{os_haiku.rdef => os_haiku.rdef.in}"": {""insertions"": 1, ""deletions"": 2, ""lines"": 3}, ""src/version.c"": {""insertions"": 2, ""deletions"": 0, ""lines"": 2}}"
2020-04-30 17:19:29,88e6cc253903c86d06abb59b35c85e6aef0152f3,Bram Moolenaar,16,14,30,4,"{""src/testdir/shared.vim"": {""insertions"": 12, ""deletions"": 0, ""lines"": 12}, ""src/testdir/test_messages.vim"": {""insertions"": 0, ""deletions"": 12, ""lines"": 12}, ""src/testdir/test_ruby.vim"": {""insertions"": 2, ""deletions"": 2, ""lines"": 4}, ""src/version.c"": {""insertions"": 2, ""deletions"": 0, ""lines"": 2}}"
2020-04-30 17:09:35,a161cb5dddd6d374899e46fde834ce9ba5c80c0b,Bram Moolenaar,23,15,38,3,"{""src/testdir/check.vim"": {""insertions"": 8, ""deletions"": 0, ""lines"": 8}, ""src/testdir/test_terminal.vim"": {""insertions"": 13, ""deletions"": 15, ""lines"": 28}, ""src/version.c"": {""insertions"": 2, ""deletions"": 0, ""lines"": 2}}"
2020-04-29 21:11:32,8dbafd0790eeaf8743298cccdbc2a13be52517b9,Bram Moolenaar,13,11,24,2,"{""src/Makefile"": {""insertions"": 11, ""deletions"": 11, ""lines"": 22}, ""src/version.c"": {""insertions"": 2, ""deletions"": 0, ""lines"": 2}}"
2020-04-29 21:02:40,512fe833c3988bfe0de22135aef67faf51927a0e,Bram Moolenaar,6,2,8,3,"{""runtime/filetype.vim"": {""insertions"": 3, ""deletions"": 1, ""lines"": 4}, ""src/testdir/test_filetype.vim"": {""insertions"": 1, ""deletions"": 1, ""lines"": 2}, ""src/version.c"": {""insertions"": 2, ""deletions"": 0, ""lines"": 2}}"
2020-04-29 20:30:13,dfc33a665d3b12689aa971575b8e7de4e5202d83,Bram Moolenaar,33,3,36,5,"{""src/evalfunc.c"": {""insertions"": 3, ""deletions"": 3, ""lines"": 6}, ""src/ex_getln.c"": {""insertions"": 8, ""deletions"": 0, ""lines"": 8}, ""src/globals.h"": {""insertions"": 3, ""deletions"": 0, ""lines"": 3}, ""src/testdir/test_channel.vim"": {""insertions"": 17, ""deletions"": 0, ""lines"": 17}, ""src/version.c"": {""insertions"": 2, ""deletions"": 0, ""lines"": 2}}"
2020-04-29 20:01:21,339d60c89bef0315343a6128a1b4826510b0efe4,Bram Moolenaar,169,127,296,7,"{""src/Makefile"": {""insertions"": 0, ""deletions"": 1, ""lines"": 1}, ""src/testdir/Make_all.mak"": {""insertions"": 1, ""deletions"": 3, ""lines"": 4}, ""src/testdir/Make_vms.mms"": {""insertions"": 1, ""deletions"": 4, ""lines"": 5}, ""src/testdir/test_eval.in"": {""insertions"": 0, ""deletions"": 119, ""lines"": 119}, ""src/testdir/test_eval.ok"": {""insertions"": 0, ""deletions"": 0, ""lines"": 0}, ""src/testdir/test_eval_stuff.vim"": {""insertions"": 165, ""deletions"": 0, ""lines"": 165}, ""src/version.c"": {""insertions"": 2, ""deletions"": 0, ""lines"": 2}}"
2020-04-29 19:04:15,ed8ce057b7a2fcd89b5f55680ae8f85d62a992a5,Bram Moolenaar,2020,1976,3996,13,"{""Filelist"": {""insertions"": 2, ""deletions"": 0, ""lines"": 2}, ""src/Make_cyg_ming.mak"": {""insertions"": 1, ""deletions"": 0, ""lines"": 1}, ""src/Make_morph.mak"": {""insertions"": 1, ""deletions"": 0, ""lines"": 1}, ""src/Make_mvc.mak"": {""insertions"": 4, ""deletions"": 0, ""lines"": 4}, ""src/Make_vms.mms"": {""insertions"": 5, ""deletions"": 0, ""lines"": 5}, ""src/Makefile"": {""insertions"": 22, ""deletions"": 12, ""lines"": 34}, ""src/README.md"": {""insertions"": 1, ""deletions"": 0, ""lines"": 1}, ""src/proto.h"": {""insertions"": 1, ""deletions"": 0, ""lines"": 1}, ""src/proto/search.pro"": {""insertions"": 0, ""deletions"": 13, ""lines"": 13}, ""src/proto/textobject.pro"": {""insertions"": 16, ""deletions"": 0, ""lines"": 16}, ""src/search.c"": {""insertions"": 0, ""deletions"": 1951, ""lines"": 1951}, ""src/textobject.c"": {""insertions"": 1965, ""deletions"": 0, ""lines"": 1965}, ""src/version.c"": {""insertions"": 2, ""deletions"": 0, ""lines"": 2}}"
2020-04-28 20:49:08,939b5db4808770d3a2ec35e3902a9d5165adc0cf,Bram Moolenaar,21,3,24,3,"{""src/testdir/test_vim9_expr.vim"": {""insertions"": 10, ""deletions"": 0, ""lines"": 10}, ""src/version.c"": {""insertions"": 2, ""deletions"": 0, ""lines"": 2}, ""src/vim9compile.c"": {""insertions"": 9, ""deletions"": 3, ""lines"": 12}}"
2020-04-28 19:58:29,affc8fd2cda77fbd47df2594da417a9f9a9bb9b6,Bram Moolenaar,3,1,4,2,"{""src/os_unix.c"": {""insertions"": 1, ""deletions"": 1, ""lines"": 2}, ""src/version.c"": {""insertions"": 2, ""deletions"": 0, ""lines"": 2}}"
2020-04-28 19:29:34,a0a9f43ab24928a0b01b6d91d084bf50a6dbefc2,Bram Moolenaar,42,6,48,4,"{""src/testdir/test_vim9_expr.vim"": {""insertions"": 6, ""deletions"": 0, ""lines"": 6}, ""src/testdir/test_vim9_script.vim"": {""insertions"": 3, ""deletions"": 0, ""lines"": 3}, ""src/version.c"": {""insertions"": 2, ""deletions"": 0, ""lines"": 2}, ""src/vim9compile.c"": {""insertions"": 31, ""deletions"": 6, ""lines"": 37}}"
2020-04-28 18:44:42,7ed8f59ae09278c666f1b43488351f9450097372,Bram Moolenaar,21,1,22,4,"{""src/drawscreen.c"": {""insertions"": 2, ""deletions"": 1, ""lines"": 3}, ""src/os_win32.c"": {""insertions"": 16, ""deletions"": 0, ""lines"": 16}, ""src/proto/os_win32.pro"": {""insertions"": 1, ""deletions"": 0, ""lines"": 1}, ""src/version.c"": {""insertions"": 2, ""deletions"": 0, ""lines"": 2}}"
2020-04-28 18:29:07,224a5f17c6ec9e98322a4c6792ce4f9bb31a4cce,Bram Moolenaar,551,103,654,10,"{""src/testdir/test_charsearch.vim"": {""insertions"": 23, ""deletions"": 0, ""lines"": 23}, ""src/testdir/test_gn.vim"": {""insertions"": 17, ""deletions"": 1, ""lines"": 18}, ""src/testdir/test_goto.vim"": {""insertions"": 44, ""deletions"": 15, ""lines"": 59}, ""src/testdir/test_ins_complete.vim"": {""insertions"": 20, ""deletions"": 0, ""lines"": 20}, ""src/testdir/test_normal.vim"": {""insertions"": 53, ""deletions"": 86, ""lines"": 139}, ""src/testdir/test_search.vim"": {""insertions"": 93, ""deletions"": 0, ""lines"": 93}, ""src/testdir/test_textformat.vim"": {""insertions"": 25, ""deletions"": 1, ""lines"": 26}, ""src/testdir/test_textobjects.vim"": {""insertions"": 251, ""deletions"": 0, ""lines"": 251}, ""src/testdir/test_visual.vim"": {""insertions"": 23, ""deletions"": 0, ""lines"": 23}, ""src/version.c"": {""insertions"": 2, ""deletions"": 0, ""lines"": 2}}"
2020-04-27 22:02:41,a14bb7e1132377af60910402f1a9e4796297f5df,Bram Moolenaar,3,1,4,2,"{""src/if_py_both.h"": {""insertions"": 1, ""deletions"": 1, ""lines"": 2}, ""src/version.c"": {""insertions"": 2, ""deletions"": 0, ""lines"": 2}}"
2020-04-27 21:39:30,03afdcf1f449d23c9b6bc56d8b61f31dd4e11836,Bram Moolenaar,18,18,36,3,"{""src/testdir/test_vim9_script.vim"": {""insertions"": 15, ""deletions"": 17, ""lines"": 32}, ""src/userfunc.c"": {""insertions"": 1, ""deletions"": 1, ""lines"": 2}, ""src/version.c"": {""insertions"": 2, ""deletions"": 0, ""lines"": 2}}"
2020-04-27 21:16:41,909ed7e902d97054262fb55b28f5e855428ab7fe,Bram Moolenaar,4,2,6,2,"{""src/userfunc.c"": {""insertions"": 2, ""deletions"": 2, ""lines"": 4}, ""src/version.c"": {""insertions"": 2, ""deletions"": 0, ""lines"": 2}}"
2020-04-27 20:51:33,57700ee4acee9b7c7f165360f09c07ec9376d989,Bram Moolenaar,2,2,4,2,"{""Filelist"": {""insertions"": 0, ""deletions"": 2, ""lines"": 2}, ""src/version.c"": {""insertions"": 2, ""deletions"": 0, ""lines"": 2}}"
2020-04-27 20:47:51,4c17ad94ecb0a0fb26d6fface2614bc5172dea18,Bram Moolenaar,219,81,300,12,"{""src/evalfunc.c"": {""insertions"": 5, ""deletions"": 15, ""lines"": 20}, ""src/proto/userfunc.pro"": {""insertions"": 4, ""deletions"": 3, ""lines"": 7}, ""src/scriptfile.c"": {""insertions"": 5, ""deletions"": 0, ""lines"": 5}, ""src/testdir/test_vim9_expr.vim"": {""insertions"": 17, ""deletions"": 17, ""lines"": 34}, ""src/testdir/test_vim9_func.vim"": {""insertions"": 2, ""deletions"": 2, ""lines"": 4}, ""src/testdir/test_vim9_script.vim"": {""insertions"": 90, ""deletions"": 6, ""lines"": 96}, ""src/testing.c"": {""insertions"": 1, ""deletions"": 1, ""lines"": 2}, ""src/userfunc.c"": {""insertions"": 85, ""deletions"": 30, ""lines"": 115}, ""src/version.c"": {""insertions"": 2, ""deletions"": 0, ""lines"": 2}, ""src/vim9compile.c"": {""insertions"": 2, ""deletions"": 2, ""lines"": 4}, ""src/vim9execute.c"": {""insertions"": 5, ""deletions"": 4, ""lines"": 9}, ""src/vim9script.c"": {""insertions"": 1, ""deletions"": 1, ""lines"": 2}}"
2020-04-27 18:18:31,db93495d276642f63f80471fbcb900b9aa1e9e42,Bram Moolenaar,20,2,22,3,"{""src/edit.c"": {""insertions"": 2, ""deletions"": 1, ""lines"": 3}, ""src/testdir/test_edit.vim"": {""insertions"": 16, ""deletions"": 1, ""lines"": 17}, ""src/version.c"": {""insertions"": 2, ""deletions"": 0, ""lines"": 2}}"
2020-04-27 17:29:01,0e71704b77a9891ccae9f5a9c7429e933078f232,Bram Moolenaar,17,2,19,3,"{""src/ex_docmd.c"": {""insertions"": 4, ""deletions"": 2, ""lines"": 6}, ""src/testdir/test_cmdline.vim"": {""insertions"": 11, ""deletions"": 0, ""lines"": 11}, ""src/version.c"": {""insertions"": 2, ""deletions"": 0, ""lines"": 2}}"
2020-04-26 17:00:07,bc970da80735bfd49c238cdf4bbc60c04dc12e0f,Bram Moolenaar,16,0,16,2,"{""src/os_win32.c"": {""insertions"": 14, ""deletions"": 0, ""lines"": 14}, ""src/version.c"": {""insertions"": 2, ""deletions"": 0, ""lines"": 2}}"
2020-04-26 14:52:49,759d81549c1340185f0d92524c563bb37697ea88,Bram Moolenaar,15,12,27,3,"{""src/os_unix.c"": {""insertions"": 1, ""deletions"": 6, ""lines"": 7}, ""src/term.c"": {""insertions"": 12, ""deletions"": 6, ""lines"": 18}, ""src/version.c"": {""insertions"": 2, ""deletions"": 0, ""lines"": 2}}"
2020-04-26 14:06:01,07b761a012958ca91fa420f9c86a33675ddca943,Bram Moolenaar,3,2,5,2,"{""src/terminal.c"": {""insertions"": 1, ""deletions"": 2, ""lines"": 3}, ""src/version.c"": {""insertions"": 2, ""deletions"": 0, ""lines"": 2}}"
2020-04-26 13:59:55,99fa721944dda9d07c53c907c33466728df5c271,Bram Moolenaar,116,10,126,18,"{""runtime/doc/eval.txt"": {""insertions"": 2, ""deletions"": 2, ""lines"": 4}, ""src/testdir/test_bufline.vim"": {""insertions"": 1, ""deletions"": 0, ""lines"": 1}, ""src/testdir/test_channel.vim"": {""insertions"": 6, ""deletions"": 1, ""lines"": 7}, ""src/testdir/test_clientserver.vim"": {""insertions"": 1, ""deletions"": 0, ""lines"": 1}, ""src/testdir/test_expr.vim"": {""insertions"": 1, ""deletions"": 0, ""lines"": 1}, ""src/testdir/test_functions.vim"": {""insertions"": 15, ""deletions"": 6, ""lines"": 21}, ""src/testdir/test_listener.vim"": {""insertions"": 5, ""deletions"": 0, ""lines"": 5}, ""src/testdir/test_match.vim"": {""insertions"": 3, ""deletions"": 1, ""lines"": 4}, ""src/testdir/test_menu.vim"": {""insertions"": 1, ""deletions"": 0, ""lines"": 1}, ""src/testdir/test_quickfix.vim"": {""insertions"": 1, ""deletions"": 0, ""lines"": 1}, ""src/testdir/test_registers.vim"": {""insertions"": 2, ""deletions"": 0, ""lines"": 2}, ""src/testdir/test_reltime.vim"": {""insertions"": 5, ""deletions"": 0, ""lines"": 5}, ""src/testdir/test_terminal.vim"": {""insertions"": 18, ""deletions"": 0, ""lines"": 18}, ""src/testdir/test_textprop.vim"": {""insertions"": 25, ""deletions"": 0, ""lines"": 25}, ""src/testdir/test_window_cmd.vim"": {""insertions"": 8, ""deletions"": 0, ""lines"": 8}, ""src/testdir/test_window_id.vim"": {""insertions"": 8, ""deletions"": 0, ""lines"": 8}, ""src/testdir/test_writefile.vim"": {""insertions"": 12, ""deletions"": 0, ""lines"": 12}, ""src/version.c"": {""insertions"": 2, ""deletions"": 0, ""lines"": 2}}"
2020-04-26 12:47:44,e297802d6ddbebbf36f9a2d01127c034fab88b3b,Bram Moolenaar,5,3,8,2,"{""src/terminal.c"": {""insertions"": 3, ""deletions"": 3, ""lines"": 6}, ""src/version.c"": {""insertions"": 2, ""deletions"": 0, ""lines"": 2}}"
2020-04-26 12:29:56,7d41aa8874a62eb399e13b94add7f0e5c4dd074b,Bram Moolenaar,6,2,8,3,"{""src/clientserver.c"": {""insertions"": 1, ""deletions"": 0, ""lines"": 1}, ""src/version.c"": {""insertions"": 2, ""deletions"": 0, ""lines"": 2}, ""src/vim9compile.c"": {""insertions"": 3, ""deletions"": 2, ""lines"": 5}}"
2020-04-26 11:50:41,6378c4fef37df05c99e8a43616063b4ddb692876,Bram Moolenaar,44,4,48,5,"{""src/ex_cmds.h"": {""insertions"": 3, ""deletions"": 1, ""lines"": 4}, ""src/testdir/test_vim9_cmd.vim"": {""insertions"": 25, ""deletions"": 0, ""lines"": 25}, ""src/version.c"": {""insertions"": 2, ""deletions"": 0, ""lines"": 2}, ""src/vim9compile.c"": {""insertions"": 12, ""deletions"": 3, ""lines"": 15}, ""src/vim9execute.c"": {""insertions"": 2, ""deletions"": 0, ""lines"": 2}}"
2020-04-25 18:02:55,cfe435d7feacf123ac060747b885f7c4328062ea,Bram Moolenaar,380,221,601,11,"{""Filelist"": {""insertions"": 1, ""deletions"": 0, ""lines"": 1}, ""src/testdir/Make_all.mak"": {""insertions"": 2, ""deletions"": 0, ""lines"": 2}, ""src/testdir/test_vim9_cmd.vim"": {""insertions"": 23, ""deletions"": 0, ""lines"": 23}, ""src/testdir/test_vim9_disassemble.vim"": {""insertions"": 26, ""deletions"": 0, ""lines"": 26}, ""src/testdir/test_vim9_expr.vim"": {""insertions"": 168, ""deletions"": 194, ""lines"": 362}, ""src/testdir/test_vim9_script.vim"": {""insertions"": 1, ""deletions"": 19, ""lines"": 20}, ""src/testdir/vim9.vim"": {""insertions"": 28, ""deletions"": 0, ""lines"": 28}, ""src/version.c"": {""insertions"": 2, ""deletions"": 0, ""lines"": 2}, ""src/vim9.h"": {""insertions"": 1, ""deletions"": 0, ""lines"": 1}, ""src/vim9compile.c"": {""insertions"": 85, ""deletions"": 8, ""lines"": 93}, ""src/vim9execute.c"": {""insertions"": 43, ""deletions"": 0, ""lines"": 43}}"
2020-04-25 15:13:56,49b2fb36ca94be14b98caf86420863d9bbe81a24,Bram Moolenaar,19,16,35,2,"{""src/testdir/test_messages.vim"": {""insertions"": 17, ""deletions"": 16, ""lines"": 33}, ""src/version.c"": {""insertions"": 2, ""deletions"": 0, ""lines"": 2}}"
2020-04-25 14:41:58,47a1a8baf9c8eb22b24f667e57a1dab579999a74,Bram Moolenaar,5,0,5,2,"{""src/testdir/test_messages.vim"": {""insertions"": 3, ""deletions"": 0, ""lines"": 3}, ""src/version.c"": {""insertions"": 2, ""deletions"": 0, ""lines"": 2}}"
2020-04-25 13:54:16,333015a46e916f566763ec44ae8669c0378767d9,Bram Moolenaar,18,2,20,4,"{""src/ex_getln.c"": {""insertions"": 3, ""deletions"": 1, ""lines"": 4}, ""src/testdir/dumps/Test_incsearch_sort_02.dump"": {""insertions"": 9, ""deletions"": 0, ""lines"": 9}, ""src/testdir/test_search.vim"": {""insertions"": 4, ""deletions"": 1, ""lines"": 5}, ""src/version.c"": {""insertions"": 2, ""deletions"": 0, ""lines"": 2}}"
2020-04-25 13:45:37,41f6918bf4545de6a80c96d8c80f5f509f9a647f,Bram Moolenaar,6,0,6,2,"{""src/message.c"": {""insertions"": 4, ""deletions"": 0, ""lines"": 4}, ""src/version.c"": {""insertions"": 2, ""deletions"": 0, ""lines"": 2}}"
2020-04-25 13:35:32,e93c968f520ee8d6bc29ccc6e18055ac65e832b3,Bram Moolenaar,3,1,4,2,"{""src/highlight.c"": {""insertions"": 1, ""deletions"": 1, ""lines"": 2}, ""src/version.c"": {""insertions"": 2, ""deletions"": 0, ""lines"": 2}}"
2020-04-25 13:24:44,92b83ccfda7a1d654ccaaf161a9c8a8e01fbcf76,Bram Moolenaar,136,5,141,20,"{""src/eval.c"": {""insertions"": 3, ""deletions"": 1, ""lines"": 4}, ""src/list.c"": {""insertions"": 3, ""deletions"": 0, ""lines"": 3}, ""src/testdir/test_blob.vim"": {""insertions"": 6, ""deletions"": 0, ""lines"": 6}, ""src/testdir/test_bufwintabinfo.vim"": {""insertions"": 1, ""deletions"": 0, ""lines"": 1}, ""src/testdir/test_cd.vim"": {""insertions"": 1, ""deletions"": 0, ""lines"": 1}, ""src/testdir/test_channel.vim"": {""insertions"": 4, ""deletions"": 0, ""lines"": 4}, ""src/testdir/test_cursor_func.vim"": {""insertions"": 1, ""deletions"": 0, ""lines"": 1}, ""src/testdir/test_eval_stuff.vim"": {""insertions"": 4, ""deletions"": 0, ""lines"": 4}, ""src/testdir/test_expr.vim"": {""insertions"": 2, ""deletions"": 1, ""lines"": 3}, ""src/testdir/test_filter_map.vim"": {""insertions"": 2, ""deletions"": 0, ""lines"": 2}, ""src/testdir/test_fnamemodify.vim"": {""insertions"": 4, ""deletions"": 0, ""lines"": 4}, ""src/testdir/test_functions.vim"": {""insertions"": 34, ""deletions"": 0, ""lines"": 34}, ""src/testdir/test_getvar.vim"": {""insertions"": 5, ""deletions"": 0, ""lines"": 5}, ""src/testdir/test_listdict.vim"": {""insertions"": 33, ""deletions"": 3, ""lines"": 36}, ""src/testdir/test_messages.vim"": {""insertions"": 3, ""deletions"": 0, ""lines"": 3}, ""src/testdir/test_partial.vim"": {""insertions"": 2, ""deletions"": 0, ""lines"": 2}, ""src/testdir/test_quickfix.vim"": {""insertions"": 12, ""deletions"": 0, ""lines"": 12}, ""src/testdir/test_tabpage.vim"": {""insertions"": 2, ""deletions"": 0, ""lines"": 2}, ""src/testdir/test_vimscript.vim"": {""insertions"": 12, ""deletions"": 0, ""lines"": 12}, ""src/version.c"": {""insertions"": 2, ""deletions"": 0, ""lines"": 2}}"
2020-04-24 20:47:31,9d8d0b5c644ea53364d04403740b3f23e57c1497,Bram Moolenaar,114,4,118,14,"{""src/eval.c"": {""insertions"": 6, ""deletions"": 2, ""lines"": 8}, ""src/testdir/test_blob.vim"": {""insertions"": 1, ""deletions"": 0, ""lines"": 1}, ""src/testdir/test_channel.vim"": {""insertions"": 3, ""deletions"": 0, ""lines"": 3}, ""src/testdir/test_eval_stuff.vim"": {""insertions"": 1, ""deletions"": 1, ""lines"": 2}, ""src/testdir/test_execute_func.vim"": {""insertions"": 3, ""deletions"": 1, ""lines"": 4}, ""src/testdir/test_expr.vim"": {""insertions"": 24, ""deletions"": 0, ""lines"": 24}, ""src/testdir/test_filter_map.vim"": {""insertions"": 4, ""deletions"": 0, ""lines"": 4}, ""src/testdir/test_fold.vim"": {""insertions"": 25, ""deletions"": 0, ""lines"": 25}, ""src/testdir/test_functions.vim"": {""insertions"": 2, ""deletions"": 0, ""lines"": 2}, ""src/testdir/test_let.vim"": {""insertions"": 25, ""deletions"": 0, ""lines"": 25}, ""src/testdir/test_listdict.vim"": {""insertions"": 2, ""deletions"": 0, ""lines"": 2}, ""src/testdir/test_partial.vim"": {""insertions"": 12, ""deletions"": 0, ""lines"": 12}, ""src/testdir/test_usercommands.vim"": {""insertions"": 4, ""deletions"": 0, ""lines"": 4}, ""src/version.c"": {""insertions"": 2, ""deletions"": 0, ""lines"": 2}}"
2020-04-24 20:19:00,92c461ef1b3b58c7dd4835bc881769f0f84e8ad0,Bram Moolenaar,6,0,6,2,"{""src/screen.c"": {""insertions"": 4, ""deletions"": 0, ""lines"": 4}, ""src/version.c"": {""insertions"": 2, ""deletions"": 0, ""lines"": 2}}"
2020-04-24 20:16:13,b52575f9cfcb5c9715ed08ccd552a55e0052370e,Bram Moolenaar,3399,3397,6796,2,"{""src/gui_haiku.cc"": {""insertions"": 3397, ""deletions"": 3397, ""lines"": 6794}, ""src/version.c"": {""insertions"": 2, ""deletions"": 0, ""lines"": 2}}"
2020-04-24 19:21:06,7714d7b31f0fc7c717c97abd4a8b5cbb13a3ad31,Bram Moolenaar,3,0,3,2,"{""src/Make_all.mak"": {""insertions"": 1, ""deletions"": 0, ""lines"": 1}, ""src/version.c"": {""insertions"": 2, ""deletions"": 0, ""lines"": 2}}"
2020-04-24 18:57:01,65d032c779a43b767497e15e6a32d04a6a8fa65d,Bram Moolenaar,22,3,25,3,"{""src/evalvars.c"": {""insertions"": 6, ""deletions"": 3, ""lines"": 9}, ""src/testdir/test_options.vim"": {""insertions"": 14, ""deletions"": 0, ""lines"": 14}, ""src/version.c"": {""insertions"": 2, ""deletions"": 0, ""lines"": 2}}"
2020-04-23 21:54:04,e71ebb46a252cd1cdfb075e6014c2b13c580bf3f,Bram Moolenaar,174,172,346,22,"{""runtime/lang/menu_ca_es.latin1.vim"": {""insertions"": 1, ""deletions"": 1, ""lines"": 2}, ""runtime/lang/menu_cs_cz.iso_8859-2.vim"": {""insertions"": 1, ""deletions"": 1, ""lines"": 2}, ""runtime/lang/menu_cs_cz.utf-8.vim"": {""insertions"": 1, ""deletions"": 1, ""lines"": 2}, ""runtime/lang/menu_czech_czech_republic.1250.vim"": {""insertions"": 1, ""deletions"": 1, ""lines"": 2}, ""runtime/lang/menu_czech_czech_republic.ascii.vim"": {""insertions"": 1, ""deletions"": 1, ""lines"": 2}, ""runtime/lang/menu_da.utf-8.vim"": {""insertions"": 6, ""deletions"": 6, ""lines"": 12}, ""runtime/lang/menu_fi_fi.latin1.vim"": {""insertions"": 4, ""deletions"": 4, ""lines"": 8}, ""runtime/lang/menu_hu_hu.iso_8859-2.vim"": {""insertions"": 2, ""deletions"": 2, ""lines"": 4}, ""runtime/lang/menu_hu_hu.utf-8.vim"": {""insertions"": 2, ""deletions"": 2, ""lines"": 4}, ""runtime/lang/menu_is_is.latin1.vim"": {""insertions"": 3, ""deletions"": 3, ""lines"": 6}, ""runtime/lang/menu_no_no.latin1.vim"": {""insertions"": 2, ""deletions"": 2, ""lines"": 4}, ""runtime/lang/menu_pt_br.vim"": {""insertions"": 10, ""deletions"": 10, ""lines"": 20}, ""runtime/lang/menu_pt_pt.vim"": {""insertions"": 2, ""deletions"": 2, ""lines"": 4}, ""runtime/lang/menu_sk_sk.iso_8859-2.vim"": {""insertions"": 8, ""deletions"": 8, ""lines"": 16}, ""runtime/lang/menu_sl_si.latin2.vim"": {""insertions"": 3, ""deletions"": 3, ""lines"": 6}, ""runtime/lang/menu_slovak_slovak_republic.1250.vim"": {""insertions"": 8, ""deletions"": 8, ""lines"": 16}, ""runtime/lang/menu_tr_tr.cp1254.vim"": {""insertions"": 37, ""deletions"": 37, ""lines"": 74}, ""runtime/lang/menu_tr_tr.iso_8859-9.vim"": {""insertions"": 37, ""deletions"": 37, ""lines"": 74}, ""runtime/lang/menu_tr_tr.utf-8.vim"": {""insertions"": 38, ""deletions"": 38, ""lines"": 76}, ""runtime/lang/menu_vi_vn.vim"": {""insertions"": 3, ""deletions"": 3, ""lines"": 6}, ""runtime/lang/menu_zh_cn.utf-8.vim"": {""insertions"": 2, ""deletions"": 2, ""lines"": 4}, ""src/version.c"": {""insertions"": 2, ""deletions"": 0, ""lines"": 2}}"
2020-04-23 20:23:14,b8ce6b0005573139fd101dc703ed30360940401b,Bram Moolenaar,3,1,4,2,"{""src/userfunc.c"": {""insertions"": 1, ""deletions"": 1, ""lines"": 2}, ""src/version.c"": {""insertions"": 2, ""deletions"": 0, ""lines"": 2}}"
2020-04-23 20:16:53,f93c7fea084a99848d512ff2732041d4b41d93c8,Bram Moolenaar,141,48,189,10,"{""src/eval.c"": {""insertions"": 2, ""deletions"": 4, ""lines"": 6}, ""src/globals.h"": {""insertions"": 6, ""deletions"": 0, ""lines"": 6}, ""src/testdir/test_vim9_disassemble.vim"": {""insertions"": 22, ""deletions"": 0, ""lines"": 22}, ""src/testdir/test_vim9_func.vim"": {""insertions"": 15, ""deletions"": 0, ""lines"": 15}, ""src/testdir/test_vim9_script.vim"": {""insertions"": 18, ""deletions"": 0, ""lines"": 18}, ""src/userfunc.c"": {""insertions"": 7, ""deletions"": 1, ""lines"": 8}, ""src/version.c"": {""insertions"": 2, ""deletions"": 0, ""lines"": 2}, ""src/vim9.h"": {""insertions"": 2, ""deletions"": 0, ""lines"": 2}, ""src/vim9compile.c"": {""insertions"": 30, ""deletions"": 41, ""lines"": 71}, ""src/vim9execute.c"": {""insertions"": 37, ""deletions"": 2, ""lines"": 39}}"
2020-04-23 16:13:23,1df8b3fb04ce8732a0be680273c95eb4e9f5e85d,Bram Moolenaar,40,18,58,4,"{""src/testdir/test_vim9_func.vim"": {""insertions"": 18, ""deletions"": 9, ""lines"": 27}, ""src/version.c"": {""insertions"": 2, ""deletions"": 0, ""lines"": 2}, ""src/vim9compile.c"": {""insertions"": 6, ""deletions"": 2, ""lines"": 8}, ""src/vim9execute.c"": {""insertions"": 14, ""deletions"": 7, ""lines"": 21}}"
2020-04-23 15:07:30,a72cfb80cd7aa589ad2a4fb8766ed6d30ea8ae33,Bram Moolenaar,94,13,107,5,"{""src/testdir/test_vim9_script.vim"": {""insertions"": 88, ""deletions"": 4, ""lines"": 92}, ""src/usercmd.c"": {""insertions"": 2, ""deletions"": 2, ""lines"": 4}, ""src/userfunc.c"": {""insertions"": 2, ""deletions"": 2, ""lines"": 4}, ""src/version.c"": {""insertions"": 2, ""deletions"": 0, ""lines"": 2}, ""src/vim9compile.c"": {""insertions"": 0, ""deletions"": 5, ""lines"": 5}}"
2020-04-23 13:46:35,f7b398c6a9476a2004a42555b731ebf47b866408,Bram Moolenaar,3,1,4,2,"{""src/testdir/test_listdict.vim"": {""insertions"": 1, ""deletions"": 1, ""lines"": 2}, ""src/version.c"": {""insertions"": 2, ""deletions"": 0, ""lines"": 2}}"
2020-04-23 13:41:49,beae4084fd34c56d43787be73588070ddc474251,Bram Moolenaar,33,10,43,8,"{""Filelist"": {""insertions"": 1, ""deletions"": 0, ""lines"": 1}, ""README.md"": {""insertions"": 3, ""deletions"": 2, ""lines"": 5}, ""READMEdir/README_haiku.txt"": {""insertions"": 13, ""deletions"": 0, ""lines"": 13}, ""src/Makefile"": {""insertions"": 2, ""deletions"": 2, ""lines"": 4}, ""src/beval.h"": {""insertions"": 4, ""deletions"": 0, ""lines"": 4}, ""src/gui_haiku.cc"": {""insertions"": 7, ""deletions"": 5, ""lines"": 12}, ""src/proto/gui_haiku.pro"": {""insertions"": 1, ""deletions"": 1, ""lines"": 2}, ""src/version.c"": {""insertions"": 2, ""deletions"": 0, ""lines"": 2}}"
2020-04-23 12:41:46,95a467e7eeab664a71446e320d328d1d7c52a35a,Bram Moolenaar,5,1,6,3,"{""src/Makefile"": {""insertions"": 2, ""deletions"": 1, ""lines"": 3}, ""src/testdir/Makefile"": {""insertions"": 1, ""deletions"": 0, ""lines"": 1}, ""src/version.c"": {""insertions"": 2, ""deletions"": 0, ""lines"": 2}}"
2020-04-23 11:58:12,0d6fe631f75effbfca92a4f61bbc2fab7385af09,Bram Moolenaar,11,9,20,3,"{""runtime/lang/menu_chinese_gb.936.vim"": {""insertions"": 4, ""deletions"": 4, ""lines"": 8}, ""runtime/lang/menu_it_it.latin1.vim"": {""insertions"": 5, ""deletions"": 5, ""lines"": 10}, ""src/version.c"": {""insertions"": 2, ""deletions"": 0, ""lines"": 2}}"
2020-04-23 11:38:02,ea04a6e8baff2f27da7cdd54bf70a5525994f76d,Bram Moolenaar,128,27,155,12,"{""src/dict.c"": {""insertions"": 5, ""deletions"": 4, ""lines"": 9}, ""src/eval.c"": {""insertions"": 6, ""deletions"": 1, ""lines"": 7}, ""src/testdir/test_blob.vim"": {""insertions"": 1, ""deletions"": 0, ""lines"": 1}, ""src/testdir/test_expr.vim"": {""insertions"": 0, ""deletions"": 7, ""lines"": 7}, ""src/testdir/test_filter_map.vim"": {""insertions"": 1, ""deletions"": 0, ""lines"": 1}, ""src/testdir/test_let.vim"": {""insertions"": 3, ""deletions"": 0, ""lines"": 3}, ""src/testdir/test_listdict.vim"": {""insertions"": 56, ""deletions"": 10, ""lines"": 66}, ""src/testdir/test_search.vim"": {""insertions"": 31, ""deletions"": 0, ""lines"": 31}, ""src/testdir/test_unlet.vim"": {""insertions"": 1, ""deletions"": 0, ""lines"": 1}, ""src/testdir/test_usercommands.vim"": {""insertions"": 5, ""deletions"": 5, ""lines"": 10}, ""src/testdir/test_vimscript.vim"": {""insertions"": 17, ""deletions"": 0, ""lines"": 17}, ""src/version.c"": {""insertions"": 2, ""deletions"": 0, ""lines"": 2}}"
2020-04-22 17:13:19,db950e4c0318c084c31bc7b50665284f4a47c285,Bram Moolenaar,5,1,6,3,"{""src/eval.c"": {""insertions"": 2, ""deletions"": 1, ""lines"": 3}, ""src/testdir/test_messages.vim"": {""insertions"": 1, ""deletions"": 0, ""lines"": 1}, ""src/version.c"": {""insertions"": 2, ""deletions"": 0, ""lines"": 2}}"
2020-04-22 12:30:31,d2662ad2de40e68999198150024531c91fece16c,Bram Moolenaar,4,2,6,2,"{""runtime/lang/menu_sv_se.latin1.vim"": {""insertions"": 2, ""deletions"": 2, ""lines"": 4}, ""src/version.c"": {""insertions"": 2, ""deletions"": 0, ""lines"": 2}}"
2020-04-21 20:23:15,e770598f31ad88fc98e40ead4b228ebc04afaa5d,Bram Moolenaar,4,2,6,2,"{""src/drawline.c"": {""insertions"": 2, ""deletions"": 2, ""lines"": 4}, ""src/version.c"": {""insertions"": 2, ""deletions"": 0, ""lines"": 2}}"
2020-04-21 20:19:45,ad48e6c1590842ab6d48e6caba3e9250734dae27,Bram Moolenaar,179,44,223,19,"{""src/evalbuffer.c"": {""insertions"": 8, ""deletions"": 0, ""lines"": 8}, ""src/testdir/Make_dos.mak"": {""insertions"": 5, ""deletions"": 4, ""lines"": 9}, ""src/testdir/Make_ming.mak"": {""insertions"": 5, ""deletions"": 3, ""lines"": 8}, ""src/testdir/Makefile"": {""insertions"": 10, ""deletions"": 10, ""lines"": 20}, ""src/testdir/bench_re_freeze.in"": {""insertions"": 0, ""deletions"": 13, ""lines"": 13}, ""src/testdir/bench_re_freeze.vim"": {""insertions"": 0, ""deletions"": 13, ""lines"": 13}, ""src/testdir/test_autocmd.vim"": {""insertions"": 2, ""deletions"": 0, ""lines"": 2}, ""src/testdir/test_bench_regexp.vim"": {""insertions"": 24, ""deletions"": 0, ""lines"": 24}, ""src/testdir/test_blob.vim"": {""insertions"": 1, ""deletions"": 0, ""lines"": 1}, ""src/testdir/test_bufline.vim"": {""insertions"": 31, ""deletions"": 0, ""lines"": 31}, ""src/testdir/test_channel.vim"": {""insertions"": 4, ""deletions"": 0, ""lines"": 4}, ""src/testdir/test_cmdline.vim"": {""insertions"": 3, ""deletions"": 0, ""lines"": 3}, ""src/testdir/test_functions.vim"": {""insertions"": 25, ""deletions"": 1, ""lines"": 26}, ""src/testdir/test_ins_complete.vim"": {""insertions"": 31, ""deletions"": 0, ""lines"": 31}, ""src/testdir/test_popupwin.vim"": {""insertions"": 14, ""deletions"": 0, ""lines"": 14}, ""src/testdir/test_prompt_buffer.vim"": {""insertions"": 1, ""deletions"": 0, ""lines"": 1}, ""src/testdir/test_tagjump.vim"": {""insertions"": 1, ""deletions"": 0, ""lines"": 1}, ""src/testdir/test_window_cmd.vim"": {""insertions"": 12, ""deletions"": 0, ""lines"": 12}, ""src/version.c"": {""insertions"": 2, ""deletions"": 0, ""lines"": 2}}"
2020-04-21 20:01:14,ff06f283e3e4b3ec43012dd3b83f8454c98f6639,Bram Moolenaar,62,42,104,12,"{""runtime/doc/insert.txt"": {""insertions"": 4, ""deletions"": 2, ""lines"": 6}, ""src/edit.c"": {""insertions"": 2, ""deletions"": 8, ""lines"": 10}, ""src/ex_getln.c"": {""insertions"": 1, ""deletions"": 1, ""lines"": 2}, ""src/globals.h"": {""insertions"": 3, ""deletions"": 2, ""lines"": 5}, ""src/insexpand.c"": {""insertions"": 14, ""deletions"": 8, ""lines"": 22}, ""src/testdir/test_edit.vim"": {""insertions"": 19, ""deletions"": 2, ""lines"": 21}, ""src/testdir/test_ex_mode.vim"": {""insertions"": 4, ""deletions"": 4, ""lines"": 8}, ""src/testdir/test_excmd.vim"": {""insertions"": 4, ""deletions"": 4, ""lines"": 8}, ""src/testdir/test_gf.vim"": {""insertions"": 4, ""deletions"": 4, ""lines"": 8}, ""src/testdir/test_popup.vim"": {""insertions"": 4, ""deletions"": 6, ""lines"": 10}, ""src/undo.c"": {""insertions"": 1, ""deletions"": 1, ""lines"": 2}, ""src/version.c"": {""insertions"": 2, ""deletions"": 0, ""lines"": 2}}"
2020-04-20 20:42:32,1966c248814d5195edcd1208ed0e51e664a61283,Bram Moolenaar,210,32,242,6,"{""runtime/lang/menu_de_de.latin1.vim"": {""insertions"": 1, ""deletions"": 1, ""lines"": 2}, ""src/highlight.c"": {""insertions"": 11, ""deletions"": 10, ""lines"": 21}, ""src/menu.c"": {""insertions"": 4, ""deletions"": 2, ""lines"": 6}, ""src/syntax.c"": {""insertions"": 22, ""deletions"": 19, ""lines"": 41}, ""src/testdir/test_vim9_script.vim"": {""insertions"": 170, ""deletions"": 0, ""lines"": 170}, ""src/version.c"": {""insertions"": 2, ""deletions"": 0, ""lines"": 2}}"
2020-04-20 17:52:53,2c7f8c574f1f8723d59adca3fec8fb89c41cf8c9,Bram Moolenaar,194,84,278,26,"{""runtime/doc/change.txt"": {""insertions"": 2, ""deletions"": 2, ""lines"": 4}, ""runtime/doc/develop.txt"": {""insertions"": 3, ""deletions"": 2, ""lines"": 5}, ""runtime/doc/eval.txt"": {""insertions"": 9, ""deletions"": 7, ""lines"": 16}, ""runtime/doc/netbeans.txt"": {""insertions"": 1, ""deletions"": 1, ""lines"": 2}, ""runtime/doc/popup.txt"": {""insertions"": 7, ""deletions"": 5, ""lines"": 12}, ""runtime/doc/tags"": {""insertions"": 2, ""deletions"": 0, ""lines"": 2}, ""runtime/doc/tagsrch.txt"": {""insertions"": 4, ""deletions"": 1, ""lines"": 5}, ""runtime/doc/term.txt"": {""insertions"": 2, ""deletions"": 1, ""lines"": 3}, ""runtime/doc/todo.txt"": {""insertions"": 25, ""deletions"": 10, ""lines"": 35}, ""runtime/doc/various.txt"": {""insertions"": 2, ""deletions"": 2, ""lines"": 4}, ""runtime/doc/vim9.txt"": {""insertions"": 33, ""deletions"": 3, ""lines"": 36}, ""runtime/filetype.vim"": {""insertions"": 1, ""deletions"": 1, ""lines"": 2}, ""runtime/ftplugin/fortran.vim"": {""insertions"": 4, ""deletions"": 3, ""lines"": 7}, ""runtime/ftplugin/perl.vim"": {""insertions"": 3, ""deletions"": 3, ""lines"": 6}, ""runtime/ftplugin/perl6.vim"": {""insertions"": 3, ""deletions"": 3, ""lines"": 6}, ""runtime/ftplugin/systemd.vim"": {""insertions"": 35, ""deletions"": 1, ""lines"": 36}, ""runtime/indent/fortran.vim"": {""insertions"": 4, ""deletions"": 3, ""lines"": 7}, ""runtime/indent/perl.vim"": {""insertions"": 3, ""deletions"": 3, ""lines"": 6}, ""runtime/indent/perl6.vim"": {""insertions"": 3, ""deletions"": 3, ""lines"": 6}, ""runtime/macros/life/life.vim"": {""insertions"": 2, ""deletions"": 1, ""lines"": 3}, ""runtime/syntax/fortran.vim"": {""insertions"": 4, ""deletions"": 3, ""lines"": 7}, ""runtime/syntax/man.vim"": {""insertions"": 8, ""deletions"": 3, ""lines"": 11}, ""runtime/syntax/perl.vim"": {""insertions"": 3, ""deletions"": 3, ""lines"": 6}, ""runtime/syntax/perl6.vim"": {""insertions"": 3, ""deletions"": 3, ""lines"": 6}, ""runtime/syntax/synload.vim"": {""insertions"": 5, ""deletions"": 3, ""lines"": 8}, ""runtime/syntax/vim.vim"": {""insertions"": 23, ""deletions"": 14, ""lines"": 37}}"
2020-04-20 17:42:10,2c5ed4e3300378ce76c8d9c3818d6f73e5119f68,Bram Moolenaar,96,19,115,9,"{""src/ex_cmds.c"": {""insertions"": 2, ""deletions"": 5, ""lines"": 7}, ""src/ex_eval.c"": {""insertions"": 7, ""deletions"": 4, ""lines"": 11}, ""src/gui.c"": {""insertions"": 2, ""deletions"": 2, ""lines"": 4}, ""src/highlight.c"": {""insertions"": 1, ""deletions"": 1, ""lines"": 2}, ""src/proto/regexp.pro"": {""insertions"": 2, ""deletions"": 1, ""lines"": 3}, ""src/regexp.c"": {""insertions"": 23, ""deletions"": 3, ""lines"": 26}, ""src/testdir/test_sort.vim"": {""insertions"": 1, ""deletions"": 1, ""lines"": 2}, ""src/testdir/test_vim9_script.vim"": {""insertions"": 56, ""deletions"": 2, ""lines"": 58}, ""src/version.c"": {""insertions"": 2, ""deletions"": 0, ""lines"": 2}}"
2020-04-20 15:46:14,faac410409a8d693a0326ad9db42dca85419a391,Bram Moolenaar,69,4,73,5,"{""src/eval.c"": {""insertions"": 1, ""deletions"": 1, ""lines"": 2}, ""src/evalvars.c"": {""insertions"": 2, ""deletions"": 2, ""lines"": 4}, ""src/ex_docmd.c"": {""insertions"": 1, ""deletions"": 1, ""lines"": 2}, ""src/testdir/test_vim9_script.vim"": {""insertions"": 63, ""deletions"": 0, ""lines"": 63}, ""src/version.c"": {""insertions"": 2, ""deletions"": 0, ""lines"": 2}}"
2020-04-20 14:50:00,08f4157c5cabc55bcb22f04dd7c717aba40caa34,Bram Moolenaar,178,106,284,15,"{""src/testdir/test_blob.vim"": {""insertions"": 3, ""deletions"": 0, ""lines"": 3}, ""src/testdir/test_cursor_func.vim"": {""insertions"": 2, ""deletions"": 0, ""lines"": 2}, ""src/testdir/test_eval.in"": {""insertions"": 0, ""deletions"": 92, ""lines"": 92}, ""src/testdir/test_eval.ok"": {""insertions"": 0, ""deletions"": 0, ""lines"": 0}, ""src/testdir/test_eval_func.vim"": {""insertions"": 0, ""deletions"": 10, ""lines"": 10}, ""src/testdir/test_eval_stuff.vim"": {""insertions"": 11, ""deletions"": 1, ""lines"": 12}, ""src/testdir/test_expr.vim"": {""insertions"": 1, ""deletions"": 0, ""lines"": 1}, ""src/testdir/test_filter_map.vim"": {""insertions"": 9, ""deletions"": 1, ""lines"": 10}, ""src/testdir/test_functions.vim"": {""insertions"": 19, ""deletions"": 0, ""lines"": 19}, ""src/testdir/test_listdict.vim"": {""insertions"": 43, ""deletions"": 1, ""lines"": 44}, ""src/testdir/test_sort.vim"": {""insertions"": 1, ""deletions"": 1, ""lines"": 2}, ""src/testdir/test_syntax.vim"": {""insertions"": 4, ""deletions"": 0, ""lines"": 4}, ""src/testdir/test_utf8.vim"": {""insertions"": 3, ""deletions"": 0, ""lines"": 3}, ""src/testdir/test_vimscript.vim"": {""insertions"": 80, ""deletions"": 0, ""lines"": 80}, ""src/version.c"": {""insertions"": 2, ""deletions"": 0, ""lines"": 2}}"
2020-04-20 14:21:53,ad4dc83389931a0354c3691b42f99a5bb98c766f,Bram Moolenaar,4,2,6,3,"{""src/auto/configure"": {""insertions"": 1, ""deletions"": 1, ""lines"": 2}, ""src/configure.ac"": {""insertions"": 1, ""deletions"": 1, ""lines"": 2}, ""src/version.c"": {""insertions"": 2, ""deletions"": 0, ""lines"": 2}}"
2020-04-20 14:12:09,4da6df40f5a637de42cad8e6939dfe8463b211db,Bram Moolenaar,3,1,4,2,"{""src/message_test.c"": {""insertions"": 1, ""deletions"": 1, ""lines"": 2}, ""src/version.c"": {""insertions"": 2, ""deletions"": 0, ""lines"": 2}}"
2020-04-19 20:57:44,2bb76accc66d17f2c027c04396082c46f410bfea,Bram Moolenaar,24,21,45,2,"{""src/evalvars.c"": {""insertions"": 22, ""deletions"": 21, ""lines"": 43}, ""src/version.c"": {""insertions"": 2, ""deletions"": 0, ""lines"": 2}}"
2020-04-19 16:31:25,fbf2122cf920a89274ffbefaaeb6c5eeacf5187b,Bram Moolenaar,47,50,97,2,"{""src/testdir/test_syntax.vim"": {""insertions"": 45, ""deletions"": 50, ""lines"": 95}, ""src/version.c"": {""insertions"": 2, ""deletions"": 0, ""lines"": 2}}"
2020-04-19 16:27:26,7bdaea6e0df849cf3dd7eaaf454eb88f637d1884,Bram Moolenaar,27,5,32,6,"{""src/testdir/test_vim9_disassemble.vim"": {""insertions"": 4, ""deletions"": 1, ""lines"": 5}, ""src/testdir/test_vim9_script.vim"": {""insertions"": 5, ""deletions"": 0, ""lines"": 5}, ""src/version.c"": {""insertions"": 2, ""deletions"": 0, ""lines"": 2}, ""src/vim9.h"": {""insertions"": 1, ""deletions"": 0, ""lines"": 1}, ""src/vim9compile.c"": {""insertions"": 7, ""deletions"": 4, ""lines"": 11}, ""src/vim9execute.c"": {""insertions"": 8, ""deletions"": 0, ""lines"": 8}}"
2020-04-19 16:13:19,eb58a2465825c258beafae96240824923f73779f,Bram Moolenaar,29,0,29,3,"{""src/ex_docmd.c"": {""insertions"": 5, ""deletions"": 0, ""lines"": 5}, ""src/testdir/test_terminal.vim"": {""insertions"": 22, ""deletions"": 0, ""lines"": 22}, ""src/version.c"": {""insertions"": 2, ""deletions"": 0, ""lines"": 2}}"
2020-04-19 15:46:53,f49e5640821d8ef752fb50d99edcf40bb62a4d4d,Bram Moolenaar,45,2,47,3,"{""src/auto/configure"": {""insertions"": 23, ""deletions"": 1, ""lines"": 24}, ""src/configure.ac"": {""insertions"": 20, ""deletions"": 1, ""lines"": 21}, ""src/version.c"": {""insertions"": 2, ""deletions"": 0, ""lines"": 2}}"
2020-04-19 15:24:53,7e0868efcf094f2cc59fa4e18af3a8dc7aedd64f,Bram Moolenaar,52,20,72,4,"{""src/evalvars.c"": {""insertions"": 35, ""deletions"": 20, ""lines"": 55}, ""src/globals.h"": {""insertions"": 1, ""deletions"": 0, ""lines"": 1}, ""src/testdir/test_vimscript.vim"": {""insertions"": 14, ""deletions"": 0, ""lines"": 14}, ""src/version.c"": {""insertions"": 2, ""deletions"": 0, ""lines"": 2}}"
2020-04-19 14:28:59,d72c1bf0a6784afdc8d8ceab4a007cd76d5b81e1,Bram Moolenaar,232,35,267,10,"{""src/eval.c"": {""insertions"": 5, ""deletions"": 3, ""lines"": 8}, ""src/evalvars.c"": {""insertions"": 28, ""deletions"": 26, ""lines"": 54}, ""src/proto/evalvars.pro"": {""insertions"": 1, ""deletions"": 0, ""lines"": 1}, ""src/proto/vim9compile.pro"": {""insertions"": 2, ""deletions"": 1, ""lines"": 3}, ""src/testdir/test_vim9_disassemble.vim"": {""insertions"": 19, ""deletions"": 0, ""lines"": 19}, ""src/testdir/test_vim9_script.vim"": {""insertions"": 53, ""deletions"": 5, ""lines"": 58}, ""src/version.c"": {""insertions"": 2, ""deletions"": 0, ""lines"": 2}, ""src/vim9.h"": {""insertions"": 9, ""deletions"": 0, ""lines"": 9}, ""src/vim9compile.c"": {""insertions"": 102, ""deletions"": 0, ""lines"": 102}, ""src/vim9execute.c"": {""insertions"": 11, ""deletions"": 0, ""lines"": 11}}"
2020-04-19 12:32:17,d3aac2917db38f8590648ee76eebfa178fc4c069,Bram Moolenaar,203,18,221,7,"{""src/testdir/test_vim9_disassemble.vim"": {""insertions"": 18, ""deletions"": 0, ""lines"": 18}, ""src/testdir/test_vim9_expr.vim"": {""insertions"": 0, ""deletions"": 5, ""lines"": 5}, ""src/testdir/test_vim9_script.vim"": {""insertions"": 38, ""deletions"": 0, ""lines"": 38}, ""src/version.c"": {""insertions"": 2, ""deletions"": 0, ""lines"": 2}, ""src/vim9.h"": {""insertions"": 6, ""deletions"": 0, ""lines"": 6}, ""src/vim9compile.c"": {""insertions"": 66, ""deletions"": 6, ""lines"": 72}, ""src/vim9execute.c"": {""insertions"": 73, ""deletions"": 7, ""lines"": 80}}"
2020-04-19 12:02:26,173d841e86cf205d8e398091b1da7bb4951714f9,Bram Moolenaar,788,49,837,7,"{""runtime/doc/netbeans.txt"": {""insertions"": 17, ""deletions"": 10, ""lines"": 27}, ""src/netbeans.c"": {""insertions"": 1, ""deletions"": 0, ""lines"": 1}, ""src/os_win32.c"": {""insertions"": 4, ""deletions"": 0, ""lines"": 4}, ""src/testdir/runtest.vim"": {""insertions"": 0, ""deletions"": 1, ""lines"": 1}, ""src/testdir/test_netbeans.py"": {""insertions"": 120, ""deletions"": 16, ""lines"": 136}, ""src/testdir/test_netbeans.vim"": {""insertions"": 644, ""deletions"": 22, ""lines"": 666}, ""src/version.c"": {""insertions"": 2, ""deletions"": 0, ""lines"": 2}}"
2020-04-18 21:20:37,61fbb3371ee1f6a02706f52fbe064608e159be7c,Bram Moolenaar,3,4,7,2,"{""src/testdir/test_eval_stuff.vim"": {""insertions"": 1, ""deletions"": 4, ""lines"": 5}, ""src/version.c"": {""insertions"": 2, ""deletions"": 0, ""lines"": 2}}"
2020-04-18 19:56:38,90455cfa87f84f16179c19241b034abbfa8b3c9a,Bram Moolenaar,122,38,160,4,"{""src/testdir/test_eval.in"": {""insertions"": 0, ""deletions"": 38, ""lines"": 38}, ""src/testdir/test_eval.ok"": {""insertions"": 0, ""deletions"": 0, ""lines"": 0}, ""src/testdir/test_eval_stuff.vim"": {""insertions"": 120, ""deletions"": 0, ""lines"": 120}, ""src/version.c"": {""insertions"": 2, ""deletions"": 0, ""lines"": 2}}"
2020-04-18 18:51:40,ec9749f33d26162fad40714a7d21978aea10fc69,Bram Moolenaar,3,1,4,3,"{""src/testdir/test_eval.ok"": {""insertions"": 0, ""deletions"": 0, ""lines"": 0}, ""src/userfunc.c"": {""insertions"": 1, ""deletions"": 1, ""lines"": 2}, ""src/version.c"": {""insertions"": 2, ""deletions"": 0, ""lines"": 2}}"
2020-04-18 17:53:28,a26b9700d73ebccd6c5459d0d66032a4249f6b72,Bram Moolenaar,122,15,137,10,"{""src/evalfunc.c"": {""insertions"": 11, ""deletions"": 0, ""lines"": 11}, ""src/ex_docmd.c"": {""insertions"": 7, ""deletions"": 2, ""lines"": 9}, ""src/proto/userfunc.pro"": {""insertions"": 1, ""deletions"": 0, ""lines"": 1}, ""src/testdir/test_vim9_disassemble.vim"": {""insertions"": 7, ""deletions"": 7, ""lines"": 14}, ""src/testdir/test_vim9_script.vim"": {""insertions"": 22, ""deletions"": 1, ""lines"": 23}, ""src/usercmd.c"": {""insertions"": 1, ""deletions"": 0, ""lines"": 1}, ""src/userfunc.c"": {""insertions"": 45, ""deletions"": 4, ""lines"": 49}, ""src/version.c"": {""insertions"": 2, ""deletions"": 0, ""lines"": 2}, ""src/vim9compile.c"": {""insertions"": 3, ""deletions"": 1, ""lines"": 4}, ""src/vim9execute.c"": {""insertions"": 23, ""deletions"": 0, ""lines"": 23}}"
2020-04-18 16:24:18,b6fb0516ec862a18fdffe06c9400d507a7193835,Bram Moolenaar,35,9,44,7,"{""src/Make_cyg_ming.mak"": {""insertions"": 3, ""deletions"": 0, ""lines"": 3}, ""src/Make_mvc.mak"": {""insertions"": 7, ""deletions"": 5, ""lines"": 12}, ""src/auto/configure"": {""insertions"": 11, ""deletions"": 0, ""lines"": 11}, ""src/channel.c"": {""insertions"": 10, ""deletions"": 4, ""lines"": 14}, ""src/config.h.in"": {""insertions"": 1, ""deletions"": 0, ""lines"": 1}, ""src/configure.ac"": {""insertions"": 1, ""deletions"": 0, ""lines"": 1}, ""src/version.c"": {""insertions"": 2, ""deletions"": 0, ""lines"": 2}}"
2020-04-18 15:45:38,a494f56f885876c98a276f7acfa386bfbb344680,Bram Moolenaar,14,8,22,3,"{""src/ex_cmds.h"": {""insertions"": 6, ""deletions"": 4, ""lines"": 10}, ""src/ex_docmd.c"": {""insertions"": 6, ""deletions"": 4, ""lines"": 10}, ""src/version.c"": {""insertions"": 2, ""deletions"": 0, ""lines"": 2}}"
