date,hexsha,author,insertions,deletions,lines,files,files_json
2020-08-23 14:29:11,430deb1945cbc7a17ed42c5c737fc08d2eef327a,Bram Moolenaar,8,2,10,3,
2020-08-23 13:21:55,8436773fad285215481c4ce2b32692e66fca599f,Bram Moolenaar,22,2,24,3,
2020-08-23 13:09:36,dc0cf1db3e8e0de349e4cc5b0a7ab6c8b7dc2ebb,Bram Moolenaar,4,1,5,2,
2020-08-23 12:28:37,0981c8729e09551f2e8e6c159bc29f2c1d04019c,Bram Moolenaar,41,26,67,12,
2020-08-22 20:37:20,69e44552c567ff25b363ba0790ad3d43fa0397a7,Bram Moolenaar,54,0,54,4,
2020-08-22 19:08:44,cd94277f72e29b740635da84bcd872c96e11bf67,Bram Moolenaar,36,2,38,3,
2020-08-22 17:02:02,5390099a9733f7952a612670693dd4ebf9e0e178,Bram Moolenaar,33,27,60,3,
2020-08-22 15:21:14,9943b3d97955ece99c747c959e0a7d493bb762bb,Bram Moolenaar,4,1,5,2,
2020-08-22 14:04:52,c63b72b6dc1347530ce906b462bb568994552c8b,Bram Moolenaar,95,0,95,2,
2020-08-22 13:19:18,51b6eb47b3c41b01a5559b099e65354c8897093e,Bram Moolenaar,8,6,14,4,
2020-08-22 13:06:35,d70840ed68296c1144d743e6335003c81c558c24,Bram Moolenaar,23,5,28,4,
2020-08-21 20:46:11,1b04ce2d400fda97410a961288c496bd8f445a9c,Bram Moolenaar,40,6,46,4,
2020-08-21 20:36:47,7cb6fc29d067ed97c0b0c1d2d5767125ef9ae1ab,Bram Moolenaar,65,39,104,11,
2020-08-21 19:55:43,81e17fbe00fd2ed93b262adc3ba41c86b02e7f46,Bram Moolenaar,23,0,23,3,
2020-08-21 19:32:50,122616d9c1b57f1e1f29f1151f8e26d24df9092a,Bram Moolenaar,13,4,17,4,
2020-08-21 18:43:17,3fc71285d5ae7c16cf7be5d997fd1fe140f196da,Bram Moolenaar,23,3,26,3,
2020-08-20 21:04:06,5d72ce69c8783fd8f1a0355c00806c5084010eec,Bram Moolenaar,25,3,28,3,
2020-08-20 20:29:12,ec65d77fa26cc87f7ce54a5a941a799e3a667c50,Bram Moolenaar,17,5,22,3,
2020-08-20 16:59:06,733d259a83bfdd3e1670cc1665e1bd56501799df,Bram Moolenaar,39,37,76,8,
2020-08-20 16:29:13,17f67547f36a06220ea4667aaee7bb130108f568,Bram Moolenaar,7,6,13,2,
2020-08-20 16:02:47,b8a9296cedb9fae35572041ef5cfa894f3ad9fbb,Bram Moolenaar,13,0,13,4,
2020-08-20 14:16:27,df2524bbb495c880d094d9542abf7c23d739cc53,Bram Moolenaar,3,2,5,2,
2020-08-20 13:52:21,825b54415f71beadd125b5703bed08332c053168,Bram Moolenaar,4,1,5,2,
2020-08-20 13:41:55,fc2a47ffc425777704b329c9edbe21163bedf63c,Bram Moolenaar,278,88,366,3,
2020-08-20 13:25:00,20b23c6358131baefb57b9083387fb4524d3ff24,Bram Moolenaar,20,18,38,3,
2020-08-20 13:02:42,66250c932e8a0e3c43e7c7c7b1dbede040b9c508,Bram Moolenaar,81,45,126,16,
2020-08-19 20:02:41,93ad14710bdf77591f927a2b244bba6a8cbc7706,Bram Moolenaar,27,22,49,3,
2020-08-19 19:20:49,191929b182ba38abe6bc431fb9d8d9507f408903,Bram Moolenaar,34,21,55,3,
2020-08-19 18:19:48,9dc1917f42b23277e143fc58bbe27482b0b76bad,Bram Moolenaar,19,1,20,4,
2020-08-19 17:46:12,a7c4e747639ad7642cd50ed577ff4c93db200df4,Bram Moolenaar,15,9,24,3,
2020-08-19 14:00:06,f8abbf37d66c41d980284e28e0e38a399890e918,Bram Moolenaar,41,37,78,3,
2020-08-19 11:55:01,af8822ce085e3bd8edeb52cbb7306ddd42427d39,Bram Moolenaar,12,0,12,3,
2020-08-18 21:24:13,9b02d64cff7664b9643205d6e23b08da688fe87a,Bram Moolenaar,4,1,5,2,
2020-08-18 20:50:38,165036ddba1318576a29f75d82fae8c326a48f18,Bram Moolenaar,3,1,4,2,
2020-08-18 20:32:03,aeb2bdd0de5ce5b566509dda5ba9ad6f976063b3,Bram Moolenaar,18,3,21,4,
2020-08-18 18:34:13,3affe7a6c6fc813f5d29857933ee6aca0b9c7bd6,Bram Moolenaar,306,297,603,4,
2020-08-18 17:11:38,e15eebd202e739ec7821a0e9c2aa72a445668bb8,Bram Moolenaar,22,1,23,5,
2020-08-18 11:41:50,1d634542cf5ebcd1d5d83bd124b3e1d5e7c96c58,Bram Moolenaar,56,15,71,9,
2020-08-18 11:04:15,558813314d63dd0263a7a86c0496c1e89b5c8cba,Bram Moolenaar,33,21,54,4,
2020-08-17 20:21:36,f39397e515067d5a314be99778e63fe0acf93c51,Bram Moolenaar,9,1,10,3,
2020-08-17 19:57:09,aa9675a61d510c4a56c3845d05b32b1ef780d119,Bram Moolenaar,3,1,4,2,
2020-08-17 19:41:02,36967b32fd02eaab4273c1a1e7a1210a5fe45d09,Bram Moolenaar,46,26,72,4,
2020-08-17 19:17:25,624b6eaf20f3e8c669425b6a32f17fb9ec2ebbd2,Bram Moolenaar,4,1,5,3,
2020-08-17 19:07:22,021bda56710d98c09a6b35610a476ab2dd8c58ad,Bram Moolenaar,60,24,84,5,
2020-08-17 17:34:10,7b22117c4ecf383b6f35acef041773a83ec28220,Bram Moolenaar,24,8,32,4,
2020-08-16 20:50:01,241572794f7e93d2f8b762de2300e5f7e4f07628,Bram Moolenaar,11,5,16,3,
2020-08-16 19:51:49,c0f8823ee4ca629db5446ba0a935f68d4a4fb193,Bram Moolenaar,168,1,169,2,
2020-08-16 19:29:05,0aae4809fd52b445531766411a9c963dc6274a04,Bram Moolenaar,56,26,82,3,
2020-08-16 16:42:53,f923571ec17b6caeeb7f4abfd7eec3f707ab9c45,Bram Moolenaar,10,1,11,3,
2020-08-16 16:29:35,e5abf7af08ff69e7e038c067497f080d4e44332c,Bram Moolenaar,22,10,32,4,
2020-08-16 15:33:35,cc673e746ab98566556ff964d7a76f2fb46d7f84,Bram Moolenaar,410,205,615,11,
2020-08-16 12:48:19,56acb0943ede35cd9d2f6667cde2442819ccbf59,Bram Moolenaar,71,67,138,9,
2020-08-15 20:48:48,829ac868b7615d73dbfb536f7fcd44fc7c5b7c1d,Bram Moolenaar,2,1,3,2,
2020-08-15 20:14:53,ed5918771fcf9877d8445e74c62ab1ce6b8e28c1,Bram Moolenaar,175,57,232,9,
2020-08-15 19:10:16,11107bab7ead9124f46a7ddf6aa3bb66b43a8246,Bram Moolenaar,183,24,207,9,
2020-08-15 16:55:18,3d1cde8a2f28dce2c82d2b2b4c5e35e6662030e0,Bram Moolenaar,9035,137,9172,39,
2020-08-15 16:39:05,e3c37d8ebf9dbbf210fde4a5fb28eb1f2a492a34,Bram Moolenaar,78,24,102,6,
2020-08-15 14:33:28,451c2e3536a3cb77d07faf3cb2b834512e174351,Bram Moolenaar,369,182,551,18,
2020-08-15 12:31:20,53b29e4845857d76ca7df1ff2fd0e03c3eeb82e1,Bram Moolenaar,14,1,15,3,
2020-08-15 12:07:23,9a5c553f790f74e4c36295ce5d46c1aa7d13eae6,Bram Moolenaar,6,3,9,3,
2020-08-15 11:49:17,793dcc540d96557919ae7dff9b2b3e21386a2e88,Bram Moolenaar,7,0,7,2,
2020-08-14 21:08:22,1623619119547142d94ddee4a75adc92304e55e9,Bram Moolenaar,6,4,10,2,
2020-08-14 20:44:25,d1103587cf339feb8c77d282f7f7e92b7cff5add,Bram Moolenaar,12,2,14,3,
2020-08-14 20:16:33,79e8db9a218ef111934594024a5cd8b1f93acada,Bram Moolenaar,17,1,18,4,
2020-08-14 19:49:08,8de2f44ac6af2276587a2e44a0d5fe1dc6789eb3,Bram Moolenaar,3,0,3,2,
2020-08-14 19:42:54,8d56622944d563a79676e99532bd372b2bc6fa1f,Bram Moolenaar,2,11,13,2,
2020-08-14 19:27:37,41fab3eac80893fd203663fc6a7ded09b04b633f,Bram Moolenaar,55,2,57,3,
2020-08-14 18:52:28,7d6997015d533604f18756e59b4a2a1266a66a97,Bram Moolenaar,38,0,38,2,
2020-08-14 17:20:23,32a23ac61570365eff35097691d9b218b8539383,Bram Moolenaar,3,13,16,5,
2020-08-14 17:11:03,4ac97f476157ee0a3600e90f79f04813c418c172,Bram Moolenaar,7,1,8,2,
2020-08-14 16:56:45,32f335f75c5860baa452144f63ab7a4a3dd83134,Bram Moolenaar,8,1,9,3,
2020-08-14 16:35:07,7517ffdbb564250de72ee3ef64fecf4a486df519,Bram Moolenaar,44,1,45,3,
2020-08-14 15:08:15,c4ce36d48698669f81ec90f7c9dc9ab8c362e538,Bram Moolenaar,28,1,29,3,
2020-08-13 20:47:35,bc4c505166dc82911553206bb0c2133c6ac94aa1,Bram Moolenaar,345,310,655,18,
2020-08-13 19:40:18,cdd70f09a5340c3d7ae873f1aaaf9847f27410cc,Bram Moolenaar,11,8,19,2,
2020-08-13 19:05:39,be7529e8890f6e8a656efee8bc60c125dc8c2002,Bram Moolenaar,8,27,35,9,
2020-08-13 17:42:39,c771908681bc9ee7689d83e09104cf4c6f984326,Bram Moolenaar,4,1,5,3,
2020-08-13 17:20:04,16c6232cad40af37f37dc9c561392b7761b9e229,Bram Moolenaar,110,80,190,3,
2020-08-13 16:59:55,b96a32ef1a95dd4ebf9413d686bccb1b4645f74b,Bram Moolenaar,606,213,819,33,
2020-08-12 20:22:09,7ac616cb0a52bc72b449e19cf9db93bee116c15a,Bram Moolenaar,125,0,125,2,
2020-08-12 20:18:23,c9edd6b58218d25bfc5389af901021dc0eb82578,Bram Moolenaar,20,0,20,3,
2020-08-12 19:58:12,66e0014ba651208ab7579797866ab0e4bd9e2b49,Bram Moolenaar,8,6,14,5,
2020-08-12 19:34:49,418f1df54763b79600db1c91c880fbc1007b2e1f,Bram Moolenaar,157,12,169,10,
2020-08-12 17:42:01,fd77748df2ba7d5f38aab649cb630374620462d7,Bram Moolenaar,18,0,18,3,
2020-08-12 17:15:33,ba60cc45e786166767ca80f3dea6236d993c7971,Bram Moolenaar,24,5,29,3,
2020-08-12 16:50:36,6d91bcb4d23b5c6a0be72c384beaf385e2d9d606,Bram Moolenaar,942,873,1815,159,
2020-08-12 16:34:28,c3d6e8a46a8fc5de622e8df9dbd25edd03e00c5b,Bram Moolenaar,20,1,21,4,
2020-08-12 16:01:53,db199216e81865350a8d56a603bb86cab672bfad,Bram Moolenaar,41,3,44,5,
2020-08-12 15:35:58,17a836cbee6b8d8ff555f8e307f48a779908db41,Bram Moolenaar,17,4,21,4,
2020-08-12 14:38:10,ed677f5587af366f185f8922b7dde4a98c884328,Bram Moolenaar,29,4,33,3,
2020-08-12 13:48:55,7c5ad34878a338f1db57337b5ca9f68c0c39424e,Bram Moolenaar,34,15,49,3,
2020-08-12 13:21:22,a177344dc0c337e5b272c1c59d13964a8318bcfa,Bram Moolenaar,45,4,49,5,
2020-08-12 12:21:11,575f24b3f3d8cd8bfc2da402c2938c0c7ace7877,Bram Moolenaar,16,1,17,3,
2020-08-11 21:08:48,040f975fc1de14ada5e0a7324bb5e51e461be2dd,Bram Moolenaar,38,13,51,5,
2020-08-11 20:30:42,035d6e91bd83574cab5a913c5c3a924d9011696b,Bram Moolenaar,13,2,15,3,
2020-08-11 19:58:20,097148e849136b49052b1b5123c714fb1d74db9b,Bram Moolenaar,48,7264,7312,26,
2020-08-11 18:51:08,4301a729eabafee388aaf8465cf780d3f84cec95,Bram Moolenaar,11,7,18,2,
2020-08-11 18:42:19,f7c4d83609acdfe0e4d0fec9413697ac97c0c3f9,Bram Moolenaar,561,1682,2243,17,
2020-08-10 21:09:37,59eccb92e3c68f65525e08d2113213ff7d7ed00a,Bram Moolenaar,35,16,51,3,
2020-08-10 20:40:56,8294d49937b99067522fda8a9399bb9533e3c44e,Bram Moolenaar,14,2,16,3,
2020-08-10 20:15:30,efb6482949580ab89e6d7c5e1cb8d744ddd6ef80,Bram Moolenaar,2025,2513,4538,4,
2020-08-10 19:57:54,3e06a1e2a8c0854c881574f33363e00264db1f1d,Bram Moolenaar,49,28,77,4,
2020-08-10 19:19:23,6f8f7337c1211692d508239eb4cbc8a6f67de497,Bram Moolenaar,44,0,44,4,
2020-08-10 18:39:17,bf61fdd00808bfa7cc61a82c719fc220bba50ba3,Bram Moolenaar,45,18,63,5,
2020-08-10 17:21:15,94f4ffa7704921a3634e56b878e6dc362bc3d508,Bram Moolenaar,49,6,55,5,
2020-08-09 20:17:55,6e4cfffe809a894ea831fc8011527714481d2857,Bram Moolenaar,33,1,34,3,
2020-08-09 19:45:52,a9a47d157ab1946d1e286c9695bc68d71305af68,Bram Moolenaar,17,2,19,4,
2020-08-09 18:05:41,7f7a8888699bca6df0a45a16db5f0e313383b5f1,Bram Moolenaar,30,2,32,3,
2020-08-09 17:32:39,1e91eafc2e19b84ea44347ea929d2791d2fdd5e3,Bram Moolenaar,9,1,10,3,
2020-08-09 17:02:50,64d662d5fc2ff8af4dbf399ff02aa9d711cc9312,Bram Moolenaar,107,2,109,5,
2020-08-09 15:22:04,127542bcebeb6480493b09d75a3be1d98a5f7797,Bram Moolenaar,91,17,108,6,
2020-08-09 14:37:48,a1b9b0cc011ef15869ac25cb93e1b4baa0cb7f38,Bram Moolenaar,76,6,82,5,
2020-08-09 13:25:14,a7cc9e697b9140da66a09f71cdf839d08e32f5fb,Bram Moolenaar,956,901,1857,10,
2020-08-09 12:43:58,b3ca98240761d8f320c5a49e077d1aac6496bb21,Bram Moolenaar,15,6,21,2,
2020-08-09 12:33:55,3896a105eb3697b1a399255ac31c742c8840bd69,Bram Moolenaar,36,3,39,3,
2020-08-09 12:07:52,94f6c06ac54401ea34a07f8c45242f11bd1e1e3a,Bram Moolenaar,9,6,15,2,
2020-08-09 12:04:42,62a232506d06f6d1b3b7271801c907d6294dfe84,Bram Moolenaar,107,5,112,10,
2020-08-09 11:02:10,730b24833952f0f4a9a17b7815b0d9f87c609eb8,Bram Moolenaar,9,7,16,2,
2020-08-08 20:16:00,efa94447e85eacce62c1fcf6b63e7f3431e2cb1b,Bram Moolenaar,45,9,54,5,
2020-08-08 19:33:21,daa2f36573db3e1df7eb1fdbc3a09a2815644048,Bram Moolenaar,7,2,9,3,
2020-08-08 15:55:49,4a6d1b660fcea67931202527ad2852da55d26d49,Bram Moolenaar,25,1,26,3,
2020-08-08 14:47:30,5a849da57c5fb54ffcffd436a9e00ef40fdf094c,Bram Moolenaar,57,15,72,3,
2020-08-08 13:46:01,98b4f145eb89405021e23a4a37db51d60a75a1d0,Bram Moolenaar,20,10,30,8,
2020-08-08 13:10:27,2dd0a2c39a3b3fbffc94d0676e472c78d02ebdbd,Bram Moolenaar,35,11,46,4,
2020-08-08 12:41:52,b7f4fa517793b0fe1a4895781b4cba451d60d7c2,Bram Moolenaar,276,10,286,2,
2020-08-08 12:26:31,bf8feb5aeb71c8f56897845c4134793201aa459a,Bram Moolenaar,55,0,55,3,
2020-08-07 20:00:26,fa211f3c6d27cf962b28f10e3c18b12dde4d20c3,Bram Moolenaar,16,0,16,3,
2020-08-07 19:28:34,1c199f9c70446933677d5210f34d2b86eefa2a43,Bram Moolenaar,8,1,9,3,
2020-08-07 18:47:39,74d95b5b58a36697975c48192e84be808b2512a8,Bram Moolenaar,3,0,3,2,
2020-08-07 18:46:20,dd29f1b0569cca253c80856eda2e85e04c1e0627,Bram Moolenaar,77,32,109,3,
2020-08-07 17:54:59,e7b1ea0276cc83cd5c612f3189a174a60d57b5ed,Bram Moolenaar,400,162,562,38,
2020-08-07 17:28:08,95dd9f2571f09a915674133c73b471b0ebbdcdbf,Bram Moolenaar,28,6,34,3,
2020-08-07 17:12:41,994b89d28dc54c896e00eba66e247addb0540272,Bram Moolenaar,15,3,18,3,
2020-08-07 16:33:19,de6804d871def4d8973ef3ca3eece4155a5c3ab1,Bram Moolenaar,35,15,50,2,
2020-08-07 16:12:18,8ce4b7ed85a7c6499bea5eb1312c85ee7a00e364,Bram Moolenaar,44,1,45,4,
2020-08-07 14:49:11,9470a4d88acf948af1596101527b3a505f8c14e9,Bram Moolenaar,1187,1219,2406,4,
2020-08-06 20:11:06,8e1986e3896cc8c2a05fc6291a39ebb275e1cebf,Bram Moolenaar,33,1,34,3,
2020-08-06 19:47:11,56b8dc331dc7f499c8221ed7d1c7795ad5e3bdeb,Bram Moolenaar,51,1,52,4,
2020-08-06 19:26:59,3d945cc925dddb99a1ee86ec194b5b95221c72d7,Bram Moolenaar,18,1,19,3,
2020-08-06 14:38:12,ae95a3946b012d4e68bcb20b28f691f6d3b9caaf,Bram Moolenaar,25,1,26,3,
2020-08-06 09:23:36,bbd3e3c357487f7a5bdc704a819f63a7dd0dd66e,Bram Moolenaar,15,1,16,4,
2020-08-05 20:07:26,b8d732e93e4b70ad992a12f761bc6a1279dd495b,Bram Moolenaar,4,0,4,2,
2020-08-05 14:20:03,803af686e23c7bb17273bb0c78ff0bf97e8d23f4,Bram Moolenaar,34,2,36,3,
2020-08-05 13:43:44,c5da1fb7ea4126b6c70426cf0add51e720b7cd3f,Bram Moolenaar,5,3,8,3,
2020-08-05 13:11:03,a71e2633207557c31432c954194078cb6062d04f,Bram Moolenaar,25,6,31,3,
2020-08-05 12:34:14,f9b2b49663226235f94f08230fe9023caf80a6e9,Bram Moolenaar,68,36,104,5,
2020-08-05 10:44:41,fdac71c5075062f97f77044e9619fa5c907e0327,Bram Moolenaar,61,4,65,3,
2020-08-05 10:32:38,3c1c9fd94bc80871119a8519f3b881595082a6c0,Bram Moolenaar,64,0,64,3,
2020-08-05 10:10:50,c753478b82613df37b145764e27f5514542edb97,Bram Moolenaar,11,1,12,2,
2020-08-05 10:02:40,14ddd226daa324831e1872c352452f202fd6068c,Bram Moolenaar,3,1,4,2,
2020-08-05 09:51:30,ff1cd39cfe62d5089d5e703f4eb290694751ace3,Bram Moolenaar,53,5,58,3,
2020-08-05 09:36:52,b4caa163ff7bfacd4bec00e4baa55b5669ff1191,Bram Moolenaar,56,5,61,3,
2020-08-05 09:23:13,a6296200bd5191bab7efcdcc16c9e79eb498e8e0,Bram Moolenaar,1835,1752,3587,5,
2020-08-05 08:53:21,bb1b5e24ecc0abe1fee164e9de13796989eff784,Bram Moolenaar,80,26,106,7,
2020-08-04 19:46:18,282f9c64e570e832d3eba12950da15c9f1a40f06,Bram Moolenaar,4,2,6,2,
2020-08-04 19:04:57,e46a2ed0d8471b93a8b9edd98280d5de4a02c623,Bram Moolenaar,4,0,4,2,
2020-08-04 18:17:31,ecd34bf55d72f530859e290ac02ee41f9fb27cce,Bram Moolenaar,19,0,19,3,
2020-08-04 13:53:01,6a25026262e2cdbbd8738361c5bd6ebef8862d87,Bram Moolenaar,6,0,6,3,
2020-08-03 20:39:28,f96e9dec636d7d105b015680d8c5d6b47d936e01,Bram Moolenaar,4,1,5,3,
2020-08-02 18:40:43,83144546488b544a1fe4e2a4f8be954b98c696fc,Bram Moolenaar,24,3,27,3,
2020-08-02 18:03:25,434d72cbf2170d54cb4f8acbe995a9a55cceb92a,Bram Moolenaar,8,1,9,2,
2020-08-02 16:58:54,658217276fccb5e53cdf4ba0f023bca80e0a8fed,Bram Moolenaar,24,6,30,4,
2020-08-02 15:33:26,7226e5b19bd6e081043cbcc32541ef72bbdf667d,Bram Moolenaar,12,1,13,3,
2020-08-02 14:59:00,c2ee44cc382d4b097f51ea3251f00fb35493ea4f,Bram Moolenaar,36,48,84,4,
2020-08-02 14:10:39,aa970abd0a987de96321d33db82f70bbceac931b,Bram Moolenaar,780,932,1712,8,
2020-08-02 13:05:05,8b89614e69b9b2330539d0482e44f4724053e780,Bram Moolenaar,23,1,24,3,
2020-08-01 21:22:18,ad486a0f0dd194826fdb733516bf0f35382c9dd7,Bram Moolenaar,23,1,24,3,
2020-08-01 20:35:13,bcbf41395f93aabd577a17dc4fbabe523d0a7ce8,Bram Moolenaar,11,1,12,3,
2020-08-01 20:23:20,b9a2cac3ef293bfdfe80dea6c6d16d02b7af5435,Bram Moolenaar,15,0,15,2,
2020-08-01 20:16:43,eef2102e20d24f5fbd1c9f53c7a35df61585c5ab,Bram Moolenaar,66,10,76,5,
2020-08-01 19:11:38,e4218b9416bdcd78b9779a06258198573a0c369e,Bram Moolenaar,3,1,4,2,
2020-08-01 18:45:11,909443028b57d7514ce3c71f00e9d808f2126b4f,Bram Moolenaar,38,7,45,4,
2020-08-01 17:23:43,491799be5084dde7aa3367462f306e7b71dbc4a5,Bram Moolenaar,4,1,5,2,
2020-08-01 17:14:13,f8992d47cd50494c64bb733329067c9de3c75200,Bram Moolenaar,38,3,41,4,
2020-08-01 16:57:52,2c79e9d14dc0e61d8c357946d01107ec23ec0fe2,Bram Moolenaar,15,0,15,2,
2020-08-01 16:53:07,333894b195479c9304a19f4e6ec1a9c09ecf07e4,Bram Moolenaar,32,9,41,3,
2020-08-01 15:00:03,f5a48010ef9e47319185f1aaac1bc6d45cd4d47a,Bram Moolenaar,22,11,33,6,
2020-08-01 14:35:08,2ec208172c37b06a6177e32359214e5e02bfbed5,Bram Moolenaar,3,0,3,2,
2020-08-01 14:08:19,b86abadf87bd0f85f800077171ec4b98aefff776,Bram Moolenaar,57,45,102,7,
2020-08-01 13:53:19,2caa1594e72be7a876c21ed5c2df252d3537cfa7,Bram Moolenaar,41,5,46,3,
2020-08-01 13:38:38,8e4c8c853e3ffbd9258f89180692879ec6bce72b,Bram Moolenaar,57,21,78,4,
2020-08-01 12:06:38,586268721dd5d6e50903a8a457f02e0dda901856,Bram Moolenaar,8,13,21,3,
2020-08-01 11:22:10,af50e899e70ee34d5356846afbea7d75701cb22b,Bram Moolenaar,6,1,7,2,
2020-08-01 11:10:14,4e1d8bd79b87b120bd40afe0eba54a419f8c3aee,Bram Moolenaar,52,15,67,6,
2020-08-01 10:26:04,b53da7918c643ef4de1256c37bc8b92413e6dcec,Bram Moolenaar,9,3,12,2,
2020-07-31 22:03:09,af8edbb8dc551aaf2105a4d77b3d8495da239ef0,Bram Moolenaar,21,18,39,3,
2020-07-31 21:47:12,ce6583568ff5b3e0e6438b37ede2c80bedffba10,Bram Moolenaar,49,25,74,5,
2020-07-31 20:38:17,badd8486f7442bfcf55e0234ece80488958e7114,Bram Moolenaar,11,1,12,3,
2020-07-31 20:17:32,3a53ec8bdddccf06a0e9db263277c50a6015294d,Bram Moolenaar,25,10,35,2,
2020-07-31 20:05:04,38ddf333f6b2806b0ea2dd052ee1cd50dd7f4525,Bram Moolenaar,237,12,249,11,
2020-07-30 20:14:33,4d4d1cd5c8b61ef0296bd6190ca2a0b2d6d96ba7,Bram Moolenaar,17,2,19,4,
2020-07-30 18:18:08,f4ee528086dcff2b8744544c440853f177956261,Bram Moolenaar,12,4,16,3,
2020-07-30 18:08:50,9d489566815d7913afc5dfc2a772bacede3970fb,Bram Moolenaar,62,37,99,11,
2020-07-29 20:11:05,ea2d8d25718836bf627b67b7fcd28a1e528bb7b9,Bram Moolenaar,23,3,26,4,
2020-07-29 19:37:43,c7e44a7e4caedc1bc33f5c8e481109c0ae002823,Bram Moolenaar,24,2,26,3,
2020-07-29 19:20:41,696ba23149eb5a7226e606e3fe6f15fdd064c5f7,Bram Moolenaar,38,41,79,5,
2020-07-29 18:00:38,1040956292a9f2c3d02fc08febd5acf349c85590,Bram Moolenaar,17,3,20,4,
2020-07-29 17:29:23,7b7f78f51dc5a2c307330af0d4e53faced34726f,Bram Moolenaar,4,0,4,2,
2020-07-29 17:18:00,33afa2447bdb0bdd15253c69a2cf6f9903685815,Bram Moolenaar,38,7,45,3,
2020-07-29 15:43:55,ac7bf8c4bfcbb157a2db6b939927bf11edb6ba7b,Bram Moolenaar,4,2,6,3,
2020-07-29 15:34:33,ed3c7e633944cf70754bc05504a7cd724fdca178,Bram Moolenaar,3,0,3,2,
2020-07-29 14:32:21,f9a343f8bda8fbe17ff045bef7342ffd6179e2f5,Bram Moolenaar,230,34,264,5,
2020-07-29 14:08:21,b61ef01cce2afd70fbfa2805336a26643109dfb7,Bram Moolenaar,133,143,276,9,
2020-07-29 13:03:01,45df2a01a79d562b59949383f79625bb8bd89a69,Bram Moolenaar,12,4,16,2,
2020-07-29 12:40:25,9898107f54a330c6d9629976250a393169c698ca,Bram Moolenaar,10,3,13,3,
2020-07-28 20:38:37,b5ed266037dea49024e00c4e1f9c89f3a9ebaa60,Bram Moolenaar,108,67,175,3,
2020-07-28 19:40:27,066b12e36c32a87725303c0f71e968eb3f9a9f32,Bram Moolenaar,8,3,11,2,
2020-07-28 19:15:07,68e30449a2954557d6542fdc2ccea32d4f8ddf9d,Bram Moolenaar,13,10,23,2,
2020-07-28 19:03:37,bd7f7c123db58dd7f50f4d1391577686d2f1bcc6,Bram Moolenaar,4,2,6,3,
2020-07-28 18:25:47,461f21242a8fc7f2fe9d1c723741eeda45f0ac72,Bram Moolenaar,8,2,10,3,
2020-07-28 18:07:27,ae616494d77e9930da703d65d12ac0abf6dc425f,Bram Moolenaar,79,27,106,8,
2020-07-27 20:40:37,0aac67a4314d72a29d3fbee91b6f0ba89e950462,Bram Moolenaar,43,6,49,4,
2020-07-27 19:43:28,b13ab99908097d54e21ab5adad22f4ad2a8ec688,Bram Moolenaar,40,10,50,7,
2020-07-27 18:02:41,622b3568fa1baf07671d31390815fb0a55a99891,Bram Moolenaar,190,198,388,12,
2020-07-27 17:47:07,6ca6ca48898750dd55cad13c88a9c1dfd7fdaad5,Bram Moolenaar,453,6,459,3,
2020-07-26 20:20:54,6d585f4c5c8d120f768dd61bfd32f6e57ad562a7,Bram Moolenaar,16,2,18,3,
2020-07-26 16:33:09,01865ade85d2508639e24aaca5948b09fb284a82,Bram Moolenaar,29,5,34,3,
2020-07-26 16:16:58,ace6132aa8c5fce9d4965e1f2e3a42071815b9de,Bram Moolenaar,17,0,17,3,
2020-07-26 15:56:25,4fc224ca1cf2a8991c5ea17682a742c6ad5ad0f3,Bram Moolenaar,37,11,48,6,
2020-07-26 15:00:44,2547aa930b59f5e2bcb70e81d5a57ed461e59b4f,Bram Moolenaar,768,474,1242,45,
2020-07-26 13:55:25,d3bb6a82a51d549bbd597bb4e94d8f074009be2a,Bram Moolenaar,6,4,10,2,
2020-07-26 13:51:06,cb4f69c2fd9ea81331c4aa54877fde612d182a51,Bram Moolenaar,3,1,4,2,
2020-07-26 13:37:02,a5d0423fa16f18b4576a2a07e50034e489587a7d,Bram Moolenaar,102,69,171,10,
2020-07-26 11:27:16,d66cdcd43a598825add743bc95642cd8ed705252,Bram Moolenaar,22,1,23,2,
2020-07-26 10:52:59,7d40b8a532fa2ce768f200ab118870d17875a7fe,Bram Moolenaar,130,205,335,9,
2020-07-25 17:38:18,37394ff75270877a032422abcd079a6732a29730,Bram Moolenaar,338,325,663,3,
2020-07-25 17:30:59,2d6b20d6a9a034b39f79a7dbb889fb5d859583ae,Bram Moolenaar,35,1,36,3,
2020-07-25 14:53:12,2afc3b4f776a4fe2bb22d0a79e77012d79b4ec1e,Bram Moolenaar,6,0,6,3,
2020-07-25 14:33:02,24aa48b7a265c24e18f0f978dfe0255e138e2b90,Bram Moolenaar,70,2,72,3,
2020-07-25 13:41:11,925e9fd6339981c1015410e1b6a6dd19e34f36cc,Bram Moolenaar,59,6,65,3,
2020-07-25 12:11:55,c841afff6a89592f23710c6da5b0fea89b240937,Bram Moolenaar,4,11,15,2,
2020-07-24 16:47:22,13e12b8a3c0fec29017f2dbdc6f57e372f8a7efd,Bram Moolenaar,12,1,13,3,
2020-07-23 20:41:43,40f4f7a48cae491f83bd3cdbf7e9b5a23ed870ef,Bram Moolenaar,17,7,24,4,
2020-07-23 19:14:43,43e969d3f98766824c18d20b84f2fab00feef683,Bram Moolenaar,19,0,19,3,
2020-07-23 18:56:04,b8070e31736decfcdf8dd47997882cb8f5a64c9d,Bram Moolenaar,34,0,34,3,
2020-07-23 18:09:10,bfba8651a51b66fdc52848f32c77aa925586e250,Bram Moolenaar,13,1,14,3,
2020-07-23 17:06:23,637cd7d1c9fa0ee47951ccdc310a388cb7ecfada,Bram Moolenaar,6,2,8,3,
2020-07-23 16:26:30,6c4bfe4b31e8c5d3c4809536ab6e4835d50f0f67,Bram Moolenaar,17,8,25,3,
2020-07-23 15:16:18,2d06bfde29bd3a62fc85823d2aa719ef943bd319,Bram Moolenaar,24,22,46,13,
2020-07-23 14:37:03,8930caaa1a283092aca81fdbc3fcf15c7eadb197,Bram Moolenaar,79,61,140,7,
2020-07-23 13:50:40,8d5f6af5e5a5edfd3fa95f33540c204f4e74331e,Bram Moolenaar,5,3,8,2,
2020-07-23 13:38:03,dd1a9af00f6954b176c5875af0a91acde72572c8,Bram Moolenaar,16,6,22,4,
2020-07-23 12:59:07,7a87b4e3fe91c18a616536fe49154c4bb3da0a93,Bram Moolenaar,10,8,18,2,
2020-07-23 12:51:02,4cc45a367363f7754dedd280cd7a065b7a220394,Bram Moolenaar,6,4,10,2,
2020-07-23 12:39:47,5a67c37a554daa7627bdf0c8e7ddd5f1b597f978,Bram Moolenaar,4,2,6,2,
2020-07-23 11:11:37,63be3d4ba01d565e645d8bf7f4dc900fc9011534,Bram Moolenaar,36,10,46,5,
2020-07-22 20:23:40,c69950ac17225d07f973b39d5b0eb94291077808,Bram Moolenaar,9,0,9,2,
2020-07-22 19:45:14,4cdb13ce81309b62b636f2c614241959174d3fef,Bram Moolenaar,105,74,179,7,
2020-07-22 18:16:11,0f60e80f9b6d778e460b4dc8333cd8e17c1b620b,Bram Moolenaar,37,0,37,3,
2020-07-22 17:30:06,2f1980f7b74a6a47d72f9c56417bc4ad47c6b66c,Bram Moolenaar,36,15,51,3,
2020-07-22 17:11:19,054f14bbe58fece17f1a74ca63f0b37518f0b4de,Bram Moolenaar,601,561,1162,14,
2020-07-22 16:17:08,e7e4838f25ac39177f3c3150ee53af8d6e8a0f28,Bram Moolenaar,40,4,44,3,
2020-07-22 16:14:58,2690b5aed8b6b6070430b05dcae296cd9479c942,Bram Moolenaar,7,0,7,2,
2020-07-21 20:34:41,bc6fcbe4ce52bc48c3d77b24086acc61ed3333bc,Bram Moolenaar,9,7,16,2,
2020-07-21 20:25:51,7d5e744162c1e971e5a863e89787cadc8e56051c,Bram Moolenaar,5,2,7,2,
2020-07-21 19:48:58,420952175a652372affc78c0017d6049f20063c3,Bram Moolenaar,5,6,11,2,
2020-07-21 19:31:00,c71f36a889897aca4ac2ad3828926e3801728336,Bram Moolenaar,43,16,59,5,
2020-07-21 19:07:20,f868ba89039045b25efe83d12ca501d657e170e8,Bram Moolenaar,1344,1346,2690,14,
2020-07-21 18:55:50,c7db57788b661a5da0b375d4fffdf10721550141,Bram Moolenaar,29,3,32,4,
2020-07-21 17:44:47,7591116acffc45b5880c49244646651badac1629,Bram Moolenaar,31,27,58,4,
2020-07-21 17:25:18,f56c95fdad5af521887f8cd7bc15729b5355231d,Bram Moolenaar,33,1,34,3,
2020-07-20 21:10:56,08815a1d0350fbcc007aea5dd1272454c03fab4f,Bram Moolenaar,8,1,9,2,
2020-07-20 20:37:44,b31be3f909e074214b7f346888209c866faed56f,Bram Moolenaar,26,3,29,3,
2020-07-20 20:09:34,7892b953e0e496408008434ae3505293c0c93af1,Bram Moolenaar,12,3,15,3,
2020-07-20 19:31:32,d43906d2e5969288f239df851f5ad7b1dc2c7251,Bram Moolenaar,224,57,281,11,
2020-07-20 19:21:30,470adb827f3d9e6cf62f685738d2db216daf3738,Bram Moolenaar,5,0,5,2,
2020-07-19 21:06:05,b146e01a7e41bf5787a2b5ccc6c340ed6001f308,Bram Moolenaar,4,1,5,2,
2020-07-19 20:09:06,54c3fcd852f9d986f81547429e850b3364f058d6,Bram Moolenaar,43,21,64,3,
2020-07-19 18:48:59,682d0a15462f3d4f9404e98a56b340ae131cbb09,Bram Moolenaar,13,7,20,4,
2020-07-19 17:47:35,2f8ce0ae8a8247563be0a77a308130e767e0566e,Bram Moolenaar,147,40,187,6,
2020-07-19 16:38:37,747f11ad6ecad4dd85ce386a0a539cb853fec41a,Bram Moolenaar,24,1,25,2,
2020-07-19 16:24:32,956501594e6c64f28a01fa649ad9016f3b25f05b,Bram Moolenaar,159,143,302,2,
2020-07-19 15:55:44,bf9d8c3765a5255c0a0b577ca2e25d70a8bcb688,Bram Moolenaar,63,5,68,5,
2020-07-19 15:17:02,b209750b5e907003568c20856215122670ee22d2,Bram Moolenaar,21,3,24,3,
2020-07-19 14:32:09,f398238a37522fed9a2e7915741d1ab14ccc81a0,Bram Moolenaar,10,2,12,2,
2020-07-19 13:49:49,6802cce407b8b181bcf3eafe701fa9f8a91f7a73,Bram Moolenaar,31,9,40,3,
2020-07-19 12:41:58,75783bd84e42e8431e4a62dfbabc9be1a1e56901,Bram Moolenaar,13,4,17,5,
2020-07-19 12:03:09,65b9545f4494abcb455400c08e51de27bc305866,Bram Moolenaar,61,0,61,5,
2020-07-18 20:24:22,6434fc574dfbde11461e70e5a62712370edf38e6,Bram Moolenaar,10,2,12,4,
2020-07-18 20:03:11,10e1d01aaf5504675fd9197c75d1da0de0e5b429,Bram Moolenaar,9,0,9,2,
2020-07-18 19:40:41,de2396fc875837c47b1c13f5e80e0a1200c5eb61,Bram Moolenaar,26,1,27,5,
2020-07-18 16:13:02,d032f34a51c6722101626c4167dffecc427ac343,Bram Moolenaar,82,36,118,3,
2020-07-18 14:07:16,447bfba24b231777a79bf53cdb33f44d9691e47e,Bram Moolenaar,42,3,45,7,
2020-07-18 13:17:02,e859312e748297bde67a053fd3c486fc2c14b532,Bram Moolenaar,113,19,132,4,
2020-07-18 10:59:19,2764d06ab7140c95b6317e344d853e4a32c76e9a,Bram Moolenaar,271,26,297,3,
2020-07-18 10:50:35,066e7da3cd0e3af438ff878a90ff1678363ce2a2,Bram Moolenaar,10,2,12,2,
2020-07-17 21:03:17,f0b9f43c3169037b7f2cd70e4939ba1ef26ada1c,Bram Moolenaar,71,24,95,3,
2020-07-17 20:26:53,b68ced5f07a3cd6c01cf8fa2156f2e2949d2d4f1,Bram Moolenaar,20,4,24,2,
2020-07-17 20:17:03,945c857844b74866f90be20714aefc3149d2a991,Bram Moolenaar,6,15,21,3,
2020-07-17 20:06:44,68d130c618f363821761f231c4122a0b9b764b71,Bram Moolenaar,55,2,57,3,
2020-07-17 18:47:51,6e36b1c18e636549f3424546f2c20101604a2d33,Bram Moolenaar,4,3,7,3,
2020-07-17 18:43:43,203ec7760d255d9f92950c8779ddfc587d7896e0,Bram Moolenaar,144,2,146,16,
2020-07-17 18:36:00,f5be8cdb77786f93c23237d7d8162feca92067e2,Bram Moolenaar,167,126,293,9,
2020-07-16 20:30:31,98af99f2d79b310e81003f5e27862a7b522d8372,Bram Moolenaar,23,38,61,2,
2020-07-16 20:15:53,ee1b93169d21896e5401a54a5189c9465abb7bc9,Bram Moolenaar,39,3,42,2,
2020-07-15 20:38:56,a90afb9a590c92d537faeb16f9ccd282fc78aeff,Bram Moolenaar,40,2,42,3,
2020-07-15 17:48:20,e30f64b4b551bb00318dc09c2f13ecd3d711119a,Bram Moolenaar,11,1,12,3,
2020-07-15 16:29:18,657a826c07b4ea3f8846b6acb2c50b82c2d81e50,Bram Moolenaar,3,1,4,2,
2020-07-15 16:27:08,02f9e6a60f9851046154ccf2ac170f25a0b3cc7d,Bram Moolenaar,7,0,7,2,
2020-07-15 15:38:21,452143c6bf0dcf76ef415281b0e4fbc3edff4b6b,Bram Moolenaar,89,19,108,7,
2020-07-15 13:30:05,5966ea105ea86e52a734e04267956e11efffc92d,Bram Moolenaar,41,9,50,3,
2020-07-15 12:15:52,3d48e25dcb661eb09ccdaa73d4e2559201ff2eb1,Bram Moolenaar,57,25,82,4,
2020-07-15 09:19:11,1e1f612bd42085becb2208b9a95ed3ed0d272ee8,Bram Moolenaar,20,9,29,2,
2020-07-14 23:37:36,b6e4e4c6f7b4f7eadcc4c2397bfa57e0734e005f,Bram Moolenaar,5,3,8,2,
2020-07-14 21:02:44,e3f915d12c8fe0466918a29ab4eaef153f71a2cd,Bram Moolenaar,47,453,500,13,
2020-07-14 20:24:40,ceb56ddbafbca01e52ff4291d9480bf83d739793,Bram Moolenaar,22,25,47,2,
2020-07-14 20:11:04,297bec07311e512ef625a48b0af8bdca8118f131,Bram Moolenaar,439,4,443,2,
2020-07-14 19:54:28,5551b131daef3a621a28dcbbe118920f5b9fabe6,Bram Moolenaar,12,1,13,2,
2020-07-14 19:22:30,8455c5ed31c9cb2919f5e62693bab6b09bf60df2,Bram Moolenaar,23,0,23,3,
2020-07-14 19:08:49,1f22cc5cdb2da867d6bbf54dd371f279c38a2f56,Bram Moolenaar,26,27,53,3,
2020-07-14 14:15:34,21c16f868d725fffc8fa36620cba33dd5f2ed576,Bram Moolenaar,5,0,5,2,
2020-07-14 13:47:23,49fe0d6b289ee640cf5c49b1704bbbd641a0237d,Bram Moolenaar,3,0,3,2,
2020-07-14 13:01:05,7ce85be63b37ab4ec791dde93a380e8a4d8a04dd,Bram Moolenaar,10,10,20,3,
2020-07-13 21:22:54,1bce831e13c42daa3563c7f90432d9bd9b959b81,Bram Moolenaar,6,2,8,2,
2020-07-13 20:29:02,8c34ea54ad1ba3ea9a604ba0495669bdd1393d9a,Bram Moolenaar,134,30,164,3,
2020-07-13 19:59:33,5d2eb0fff0fbe905da2c57fd73f7f127a73d1c99,Bram Moolenaar,31,2,33,3,
2020-07-13 19:28:03,3ac9c4701a5f1e39303ca2885956db92215966db,Bram Moolenaar,24,13,37,2,
2020-07-13 18:41:08,08f7a41b0a280e5901eb4ee4bbfe682113863492,Bram Moolenaar,41,3,44,3,
2020-07-13 16:55:48,f1a2368d81fc3f70dfcf7d577957185da6ccf0b6,Bram Moolenaar,18,1,19,3,
2020-07-13 16:18:00,bfd65589d9b6bd5fd2c8ee768d1427469bd61ead,Bram Moolenaar,23,1,24,3,
2020-07-12 21:09:20,7177da9dd4d9a521c6141c6fbf7e9a4d6296ab05,Bram Moolenaar,54,5,59,3,
2020-07-12 19:38:29,a4b442614c5ca4ebf32acf5cf0b7b718496f1c94,Bram Moolenaar,46,44,90,3,
2020-07-12 18:49:29,c212dd0a346d57f62013094ea6861eb28e33023c,Bram Moolenaar,4,2,6,2,
2020-07-12 18:44:37,83e7450053399942e1c9efa802c568b51d948541,Bram Moolenaar,4,0,4,2,
2020-07-12 18:00:24,4d57ba02029071e5947a54766e9f5d42e3bb3008,Bram Moolenaar,6,2,8,2,
2020-07-12 17:52:36,a4dc6f92bb29b00783f8945bbe1101e837b6ad3c,Bram Moolenaar,5,2,7,4,
2020-07-12 17:24:10,35910f2d54bd670a0d83b3474b4c23faa94252d3,Bram Moolenaar,76,13,89,5,
2020-07-12 16:33:53,b898a029b01866b1dbe07521e153d54917b9527d,Bram Moolenaar,14,4,18,2,
2020-07-12 15:31:09,985116ae0b7b3ef17e0c0ea2669068dd6b3b39c7,Bram Moolenaar,17,0,17,4,
2020-07-12 15:07:05,eb6880b6eb7c4631f6103575c0d1336b149348c1,Bram Moolenaar,26,28,54,9,
2020-07-12 14:32:19,8af81d656a4c501611f6211b6379ea9dd650c545,Bram Moolenaar,141,109,250,3,
2020-07-12 12:34:00,6d3a7213f58da834b0fc869d05f87e86010c66cf,Bram Moolenaar,8,5,13,3,
2020-07-12 12:09:23,c85156bb897085d7f5a8e4e180287f87bf19b948,Bram Moolenaar,37,29,66,2,
2020-07-12 11:47:42,13c046316b2e651871701ed81e2ba4763b19b67d,Bram Moolenaar,51,51,102,2,
2020-07-11 20:49:59,ecdd14a427108aa6f133c00655788f6ae80ad463,Bram Moolenaar,11,8,19,3,
2020-07-11 20:25:57,2b6ef856fb89f703714f3f1f567d9bd7c81079f3,Bram Moolenaar,10,12,22,4,
2020-07-11 20:14:59,9b7bf9e98f06ece595fed7a3ff53ecce89797a53,Bram Moolenaar,227,154,381,53,
2020-07-11 13:20:48,914e7eaa67f8d816e15fb4a1180e6bece88d9742,Bram Moolenaar,16,3,19,4,
2020-07-11 12:26:08,21e5bdd271fa4d0ff4511cf74b160315e1d17cff,Bram Moolenaar,23,0,23,2,
2020-07-11 12:08:04,1e624c912dff19e889c9398b56fe537952c02fef,Bram Moolenaar,4,1,5,2,
2020-07-11 12:04:28,f65927fc8d0102ef2d0fea776381caedf4c51e32,Bram Moolenaar,4,0,4,2,
2020-07-11 11:40:45,b074e8b8d4d3cefefc675dfaf3982d388ee07772,Bram Moolenaar,14,1,15,4,
2020-07-11 11:09:36,18aa13d13b69c090dbe186cd4939896488c433e3,Bram Moolenaar,1000,976,1976,6,
2020-07-10 20:45:38,543e6f3467f208930a5d7fadb82133334bf31356,Bram Moolenaar,41,3,44,5,
2020-07-10 20:00:53,7ff78465f7057a672a6de0d75d56286da253501b,Bram Moolenaar,690,420,1110,21,
2020-07-10 19:50:41,a7eedf317a806fceec1ddd8f9bebed6e00be0ed2,Bram Moolenaar,32,4,36,3,
2020-07-10 19:17:51,11a5b19a8ce543c258832ac53d771047f4e1061d,Bram Moolenaar,16,0,16,2,
2020-07-10 18:45:31,40043152924827fa8c4064951065ff507c610164,Bram Moolenaar,6,0,6,2,
2020-07-10 18:40:23,08fc48492acc07259d91293df12bf66447819443,Bram Moolenaar,4,2,6,3,
2020-07-10 18:30:12,58bb61cf5ee008254eb331bc3574eac87d2dcc4a,Bram Moolenaar,4,0,4,2,
2020-07-10 18:24:07,ef85a9b2d9e992ab594e089af3883e381cfad426,Bram Moolenaar,21,1,22,3,
2020-07-10 18:03:03,97d2f34c8763ab3a46c9f43284cc17bad3cf9568,Bram Moolenaar,4,1,5,2,
2020-07-09 20:53:30,92053ce59ecf93838f4d6e3019eef1bc47be4184,Bram Moolenaar,3,1,4,2,
2020-07-09 19:20:47,389df259c49d1ca4f7aa129b702f6083985b1e73,Bram Moolenaar,94,10,104,7,
2020-07-09 17:16:35,ae97b94176062d30ea8c68bb83cde034c5150c78,Bram Moolenaar,7,4,11,3,
2020-07-09 16:49:23,e4358906fdbd0b2df1889dad49c79a9c8cee5ac4,Bram Moolenaar,57,2,59,2,
2020-07-08 21:09:28,96916ac67ad9ed5d79ce87b099f9d01aa4c13745,Bram Moolenaar,15,0,15,4,
2020-07-08 20:36:17,6e13530ca03dd9cad245221177dd65f712211448,Bram Moolenaar,3,1,4,2,
2020-07-08 20:24:09,efaaaa683b7b0cebc128be5c0c257b9d6578ac96,Bram Moolenaar,4,2,6,2,
2020-07-08 20:01:49,8e2730a315b8b06192f5fc822dc218dbb3cff7ae,Bram Moolenaar,67,33,100,6,
2020-07-08 17:35:21,6110e79a5872dd6c5529f909d1bd670e3325927b,Bram Moolenaar,13,5,18,5,
2020-07-08 16:38:08,6b7a0a8c201bbace7e69fe0709f72b95092193df,Bram Moolenaar,11,1,12,4,
2020-07-08 16:34:57,b335b29e1c3428fd475026412297d5aa63b623e6,Bram Moolenaar,3,1,4,2,
2020-07-08 16:30:06,0a47e0970a0e5d99aa7089169e0bcca0401decce,Bram Moolenaar,22,1,23,3,
2020-07-08 15:47:57,002262f4dee452964190b0d022aa7443f602b288,Bram Moolenaar,7,1,8,3,
2020-07-08 15:36:21,7a4b8980ea5ecaea061caae7816ea62cc4940011,Bram Moolenaar,115,63,178,6,
2020-07-08 13:16:19,c620c055ce8505596a7208ba696a32b8a3be4f4b,Bram Moolenaar,84,20,104,7,
2020-07-07 21:31:36,bed36b939a4c66f41d1f24e32cfa521b10f22b82,Bram Moolenaar,3,1,4,2,
2020-07-07 20:50:12,fe465a01cfbbbae5d870d6108e0ad0947f03b0c4,Bram Moolenaar,37,1,38,3,
2020-07-07 18:50:39,0ab55d62012c1fb38c4b540a4233421820a59389,Bram Moolenaar,52,0,52,3,
2020-07-07 18:12:54,bb790dcc46b74e6f9a1c4126be8a575f9fe73444,Bram Moolenaar,24,17,41,4,
2020-07-06 21:04:49,007f9d6ed597bd212acb95be9d0767c97d2a1438,Bram Moolenaar,31,14,45,3,
2020-07-06 19:53:17,cbb6bdcd8967edc8ad123746d27ec30ccc7c1718,Bram Moolenaar,5,3,8,4,
2020-07-06 19:24:57,27321dbeedf8bb833c48b01bf18536125794f65e,Bram Moolenaar,93,35,128,3,
2020-07-06 19:03:06,ab5894638413748fcedfe28691e6c27893924520,Bram Moolenaar,634,134,768,6,
2020-07-05 19:38:11,0ad3e894d75236915e67dfbbcc821b6bb3c05d91,Bram Moolenaar,50,5,55,4,
2020-07-05 19:10:24,67627355accff4af4f2a7e727c77ea8df675636e,Bram Moolenaar,12,1,13,3,
2020-07-05 18:55:29,ad7c24932725b9ab37b65fe359a41f8ba3e3dfcf,Bram Moolenaar,23,1,24,3,
2020-07-05 18:47:18,252e88a78535d239ec4b764d8e3f04aad5a94a76,Bram Moolenaar,12,1,13,3,
2020-07-05 18:16:41,0d94ad69586972e7522ec6ca1441a517af2ade7a,Bram Moolenaar,12,1,13,3,
2020-07-05 18:08:39,b3c019cbc32e2e9250ac668bf77d61ebd89c13f2,Bram Moolenaar,12,1,13,3,
2020-07-05 16:48:23,8f510afcd616fc62291fb41f9dd03ce298f1c601,Bram Moolenaar,6,4,10,2,
2020-07-05 16:41:08,a66ba01a5fbbd72375ef6982b901d6552da2414f,Bram Moolenaar,20,2,22,3,
2020-07-05 16:18:42,47e7d70b58e8bfc1daaf6d35569ef2dbd0339ddc,Bram Moolenaar,61,27,88,6,
2020-07-05 15:04:13,846178a72ca0860073d47fc0dc95f98d15f1d921,Bram Moolenaar,23,1,24,3,
2020-07-05 14:51:26,50788ef34947aeb1729604cd3876845afbd15e3c,Bram Moolenaar,13,3,16,3,
2020-07-05 14:42:13,435d89789ef4dd329938edbe17c646db9f0ea772,Bram Moolenaar,14,2,16,3,
2020-07-05 14:07:21,fce82b3aa7dd87f9e15a4c12eda2c65de285d99a,Bram Moolenaar,9,1,10,3,
2020-07-05 14:01:56,9978d473e32cee928d6f901a5eb9a297a2970132,Bram Moolenaar,12,2,14,3,
2020-07-05 13:52:19,05a5551a86e013e35d1dfa10fd0d811c587f9c88,Bram Moolenaar,16,4,20,3,
2020-07-05 13:32:17,788123c00c4b7acc4e6ba3e9f1cc8b175ae9aae8,Bram Moolenaar,11,1,12,3,
2020-07-05 12:57:51,e9f262bdff2defa248e5d40b6520251799581ea4,Bram Moolenaar,66,2,68,3,
2020-07-05 12:10:13,3f40ce78f5c178d15871bd784ed878c78f0b8a44,Bram Moolenaar,13,11,24,9,
2020-07-04 17:19:43,fb9d5c51c8b5b44863f974e1adbee9ae330e75ff,Bram Moolenaar,10,1,11,3,
2020-07-04 15:39:10,eeb27bfe28ad6f889c52628268acbe30a7584e30,Bram Moolenaar,9,1,10,3,
2020-07-04 12:15:00,962d7213194647e90f9bdc608f693d39dd07cbd5,Bram Moolenaar,15,26,41,6,
2020-07-04 11:15:31,1c991144c502ade477e1a32fdfd0f78b6299fdc7,Bram Moolenaar,179,91,270,5,
2020-07-03 19:17:34,effb0cd75de647a2a0bf95cb26eaa2feee8068d9,Bram Moolenaar,3358,3231,6589,8,
2020-07-03 19:09:52,442af2f89e29fb60790bffde2def9cd74a081780,Bram Moolenaar,59,3,62,3,
2020-07-03 16:15:06,743d0620203388bf87dc611cea544b485e4b9f85,Bram Moolenaar,15,9,24,3,
2020-07-03 16:00:05,92fdd1e75db3048516a93a18cc53ed984813c9e5,Bram Moolenaar,3368,3167,6535,7,
2020-07-02 20:50:37,5289783e0b07cfc3f92ee933261ca4c4acdca007,Bram Moolenaar,6,4,10,3,
2020-07-02 19:23:42,810af5ea460eab820cc5899892067d8c242be688,Bram Moolenaar,2,2,4,2,
2020-07-02 19:17:57,a9a8e5f0dc22aaa9e53578b5b2d7569279e6cb94,Bram Moolenaar,4,0,4,2,
2020-07-02 19:11:34,d2ef6b320bf2e2f3fcc0bb858b16898e6f74b4d9,Bram Moolenaar,19,12,31,3,
2020-07-02 18:59:05,c19fd917be656b127c5619080f866a23ce1fe755,Bram Moolenaar,4,2,6,2,
2020-07-01 19:53:50,1112c0febb509d0cb219f3a2479fd36833507167,Bram Moolenaar,1581,1563,3144,6,
2020-07-01 18:19:37,a0d072ef8203b225bd46bcd826cb3d2e3c3b941a,Bram Moolenaar,13,0,13,2,
2020-07-01 18:07:14,5f195938d4d489aa288bdb54ee6112a34aed1df9,Bram Moolenaar,50,21,71,5,
2020-07-01 16:29:55,9a78e6df17033223ebdf499f2b02b2538601c52d,Bram Moolenaar,55,50,105,12,
2020-07-01 15:28:33,e6b5324e3a3d354363f3c48e784c42ce3e77453f,Bram Moolenaar,80,32,112,10,
2020-07-01 14:00:44,086eb18ba16164ca5258068cff9c4b2db742f2ef,Bram Moolenaar,3,1,4,2,
2020-07-01 13:49:29,d58d4f90aeb381045000ea46493b5bd9b9d1fa23,Bram Moolenaar,89,22,111,6,
2020-07-01 13:12:44,ef8c617b9c4dc262ed34598d7e382237696c3d61,Bram Moolenaar,7,8,15,4,
2020-07-01 12:38:12,8e6cbb72324b6fb25d1a9abd6cc4d102d0e5f14e,Bram Moolenaar,21,1,22,3,
2020-07-01 11:52:55,e49b8e8d7589e85e75aedefab7ce97da47adbf74,Bram Moolenaar,171,18,189,3,
2020-07-01 11:15:24,11b6600c88165c70d9ccbbdd4d9c96e8266e365f,Bram Moolenaar,4,1,5,2,
2020-07-01 11:07:37,e707c882b23a53d2c1f0d1f7fc3a7be247aca614,Bram Moolenaar,3,1,4,2,
2020-07-01 11:04:05,90049492215aa458b90215b8e0fc50f04d5ad270,Bram Moolenaar,10,6,16,2,
2020-06-30 20:11:44,be7a50c22f63478a6e64fe6b932a847830191b95,Bram Moolenaar,13,0,13,3,
2020-06-30 20:02:02,47e880d6c13c3ec2888398fd9ba1f5a7180d791a,Bram Moolenaar,50,4,54,3,
2020-06-30 19:18:36,37c837119579ff70b005a4e54c2e26ca42b74022,Bram Moolenaar,36,23,59,3,
2020-06-30 18:55:15,006ad48b8a15c3bace741d8caaf3195e592fbe78,Bram Moolenaar,26,2,28,3,
2020-06-30 18:38:27,e46a4405056276b4cbdacee76b11f85c8ea1830b,Bram Moolenaar,650,839,1489,7,
2020-06-30 16:45:43,de8f0f47f653ff10bd8cc12b3e0817ed5bdf64ea,Bram Moolenaar,50,0,50,3,
2020-06-30 11:38:01,f151ad1c70825a91afb112e611db5c712e2656ef,Bram Moolenaar,44,2,46,3,
2020-06-29 21:18:42,6b949615edac2dd33d5e865be8328561f296b045,Bram Moolenaar,6,3,9,2,
2020-06-29 21:14:02,a53618dd1dd91c7bb67b5dfc83dc29371b47f55b,Bram Moolenaar,3,2,5,2,
2020-06-29 21:07:44,de19b745eee06a8a204988ae9989d97143caece9,Bram Moolenaar,2,1,3,2,
2020-06-29 21:02:21,cf070112ca2a6ac9ec5466be1cdc667f6abe8fd0,Bram Moolenaar,5,2,7,2,
2020-06-29 20:40:42,d034220c54c63daaa2841e97b653842a47f5e90e,Bram Moolenaar,4,0,4,2,
2020-06-29 20:31:36,9b5384b97e832958573ffdcd3c1e230635b434e4,Bram Moolenaar,5,1,6,2,
2020-06-29 20:24:56,927b7dd0fe9a0a82b39d600779edb4390ecdeda6,Bram Moolenaar,4,3,7,2,
2020-06-29 19:32:06,6378b21d6dd38cc0f80aa6d31d747db6c287483b,Bram Moolenaar,9,3,12,2,
2020-06-29 19:14:51,566cc8c72bb8036f015a435800f28ef9f6a9a3b6,Bram Moolenaar,8,1,9,2,
2020-06-29 18:40:37,cf30643ae607ae1a97b50e19c622dc8303723fa2,Bram Moolenaar,12,6,18,2,
2020-06-29 18:23:32,6d90c61c5a6437ff5058b6c5874ba71bff574e60,Bram Moolenaar,7,5,12,2,
2020-06-29 18:20:33,7d2ac92ebc36049f9ce2f4ce08b8a80ca212ace2,Bram Moolenaar,4,15,19,2,
2020-06-29 18:09:36,fda20c4cc59008264676a6deb6a3095ed0c248e0,Bram Moolenaar,23,13,36,3,
2020-06-29 17:55:58,91639195eff7b29213a0a3c279ac46e46ac76edd,Bram Moolenaar,6,4,10,2,
2020-06-28 20:41:26,a1f9f8666ed3a462eb8a518e78418c57dc41bbd4,Bram Moolenaar,64,11,75,4,
2020-06-28 16:43:40,b7a78f7a6713f07d2fcad0b27dea22925c7b1cdf,Bram Moolenaar,101,23,124,8,
2020-06-28 13:51:16,d5053d015a957b343ad9c9e45e0abd2978f10cf0,Bram Moolenaar,113,45,158,8,
2020-06-28 11:17:26,06cf97e714fd8bf9b35ff5f8a6f2302c79acdd03,Bram Moolenaar,1396,1359,2755,13,
2020-06-28 11:10:22,75e15670b8749845cde2962ddb738dd5c6e73191,Bram Moolenaar,100,2,102,5,
2020-06-27 21:07:36,faf8626b79e380fe81e7ae2439a535ed7619d27b,Bram Moolenaar,73,12,85,5,
2020-06-27 19:56:17,7e8967fdcdf45caf08753bb791dc3779e78b34c8,Bram Moolenaar,26,0,26,3,
2020-06-27 19:18:00,9215f01218b2ed2cfe49c1f43fcf342bd9ffdded,Bram Moolenaar,67,49,116,7,
2020-06-27 18:46:29,7a4981b93642b5b62018cd8150b3fb0dfa2417d4,Bram Moolenaar,28,0,28,3,
2020-06-27 16:13:10,a0a0c4147fd966e0cd923a2bbfb84b14b15a297e,Bram Moolenaar,22,4,26,3,
2020-06-27 16:06:45,e40fbc2ca9fda07332a4da5af1fcaba91bed865b,Bram Moolenaar,160,56,216,12,
2020-06-27 15:04:05,ab19d495fd880b25a38d58cbeb5b21e4d0ee5835,Bram Moolenaar,3,0,3,2,
2020-06-27 14:36:05,e6e031739c9d0c4140e371031b58a249db0eb572,Bram Moolenaar,11,1,12,2,
2020-06-27 12:11:53,8ea9390b78da9e34a20e7418712921397c0c1989,Bram Moolenaar,82,15,97,6,
2020-06-27 11:11:50,0b1cd52ff6bf690388f892be686a91721a082e55,Bram Moolenaar,38,18,56,7,
2020-06-27 10:32:57,bd84617d1a6766efd59c94aabebb044bef805b99,Bram Moolenaar,32,16,48,4,
2020-06-26 20:46:27,7147820cb978f5b179cfec2f9d8b7774e28d43e0,Bram Moolenaar,70,31,101,8,
2020-06-26 20:00:38,e6536aa766e95b6c64489678eb029e6909ee6a35,Bram Moolenaar,44,1,45,3,
2020-06-26 19:38:51,be7ee488761a5582a5605197c3951a17f20d072e,Bram Moolenaar,60,2,62,3,
2020-06-26 19:28:25,793648fb563359396a23740c72a6e04cb64df3a9,Bram Moolenaar,35,2,37,3,
2020-06-26 18:41:39,5d3c9f8c2a0fc29ba4ac8e0f052378b64d9e3dd3,Bram Moolenaar,352,5,357,10,
2020-06-26 18:23:45,5f36d5fbb836e6fdeb9e3b2c26edb88e45150db4,Bram Moolenaar,4,2,6,3,
2020-06-26 17:44:06,cf8441704d6e517bda1899f4afa82c6b4eecbaec,Bram Moolenaar,32,2,34,5,
2020-06-25 20:23:48,fc838d6cb0f22c77a6ee2befd034b593e1c5ea06,Bram Moolenaar,41,0,41,4,
2020-06-25 18:56:42,1e4c7d0ed272201fa3a7cf34a462abb139170759,Bram Moolenaar,12,0,12,2,
2020-06-25 18:07:04,211dd3fd82216ca879fe7f917ea345b3ae366ce1,Bram Moolenaar,87,27,114,4,
2020-06-25 17:53:24,73b4465ba7f170c5a1701ad908144970e758b1f5,Bram Moolenaar,31,2,33,3,
2020-06-25 17:27:56,801ab069341c8652680d63c174530fd4feb2911e,Bram Moolenaar,213,1,214,7,
2020-06-25 17:01:36,832adf9bb8cd39d8e982d8a35ed8a6d39b974494,Bram Moolenaar,81,6,87,4,
2020-06-24 21:02:40,7acde51832f383f9a6d2e740cd0420b433ea841a,Bram Moolenaar,4,2,6,2,
2020-06-24 20:07:46,ca275a05d8b79f6a9101604fdede2373d0dea44e,Bram Moolenaar,17,2,19,3,
2020-06-24 19:00:25,65a8ed37f7bc61fbe5c612a7b0eb0dfc16ad3e11,Bram Moolenaar,5,0,5,2,
2020-06-24 18:34:03,b171fb179053fa631fec74911b5fb9374cb6a8a1,Bram Moolenaar,90,55,145,23,
2020-06-24 17:05:29,9d40c63c7dc8c3eb3886c58dcd334bc7f37eceba,Bram Moolenaar,6,0,6,2,
2020-06-24 16:37:35,5409f5d8c95007216ae1190565a7a8ee9ebd7100,Bram Moolenaar,300,111,411,15,
2020-06-24 11:37:35,b7e2483655d9b68df0c7349918027d800051a28a,Bram Moolenaar,487,272,759,7,
2020-06-23 20:26:05,67fbdfefd26a237831c3838f799d3e6198c8a34a,Bram Moolenaar,121,28,149,3,
2020-06-23 19:01:38,ef6d86c173becdf82b7a9a1329342c9368340def,Bram Moolenaar,5,2,7,3,
2020-06-23 18:00:50,4014e2ceb03b8aeb947a0c671a099b677c8f2d5d,Bram Moolenaar,13,1,14,2,
2020-06-22 21:02:51,df069eec3b90401e880e9b0e258146d8f36c474d,Bram Moolenaar,59,25,84,7,
2020-06-22 20:10:06,7eaafe65eef88493c789b160914c8e2e8e42d4a7,Bram Moolenaar,3,1,4,2,
2020-06-22 19:34:30,bdd2c290d3cda69e0046c42f0c651f60bc510a16,Bram Moolenaar,251,48,299,7,
2020-06-22 18:30:27,25fd2672875351ff56a925284a03a900081f70c0,Bram Moolenaar,22,2,24,3,
2020-06-22 18:22:19,b2b218d89b3a6f450e65afd5e59ac234a5fa1eb7,Bram Moolenaar,3,2,5,2,
2020-06-22 17:39:03,acd4c5e914f8a06745624ba585f3d06d5faf4ddd,Bram Moolenaar,17,1,18,3,
2020-06-22 17:24:23,373c65104e0991724cb57910dfb3e5c276e2d7e7,Bram Moolenaar,5,1,6,2,
2020-06-22 17:10:56,7633fe595e6a27d6bb376548ff89f0dcce481600,Bram Moolenaar,71,36,107,3,
2020-06-21 20:17:18,38041da1c263f5840f21e15484d7ccb30999ed62,Bram Moolenaar,4,2,6,2,
2020-06-21 20:12:03,73fef33014dbf21fc59e7e47fb091117868d82fb,Bram Moolenaar,105,59,164,15,
2020-06-21 18:39:37,8d9437968b6693ecb14e7375bcb242e657e75266,Bram Moolenaar,13,1,14,2,
2020-06-21 18:38:28,7fe875583bb474d03d281ca59af3320e7e176953,Bram Moolenaar,11,7,18,3,
2020-06-21 18:06:54,f5433fbfe4324fd443664fb924116b5ed675bef5,Bram Moolenaar,21,0,21,2,
2020-06-21 15:57:32,da58134eedf43ae4b9013c93ecbdf55e4da4b8a3,Bram Moolenaar,18,10,28,3,
2020-06-21 14:58:13,23c55273739b2fb09912140e2e03a4b8ff15dd04,Bram Moolenaar,89,56,145,3,
2020-06-21 13:52:59,e55b1c098d9dc04c960e6575bb554b5130af8989,Bram Moolenaar,75,23,98,7,
2020-06-21 13:09:14,820ffa567c5a4bc0d3517c79c91d63d8062c358e,Bram Moolenaar,12,6,18,3,
2020-06-21 12:12:17,a3b7fdc1bb227897f41b8f2958a48d0a26292ff7,Bram Moolenaar,30,4,34,3,
2020-06-21 11:23:45,8c524f76ebd43f006e765534765b595de7095f12,Bram Moolenaar,81,1,82,3,
2020-06-20 20:50:47,6797966dfc0219313886be55767e53d5a388b5c5,Bram Moolenaar,33,13,46,10,
2020-06-20 16:19:09,0cb5bcf5836de83f7d64fb01d3ce708caacaf66c,Bram Moolenaar,57,37,94,8,
2020-06-20 14:05:32,845e0ee59430eac07e74b6cb92020e420d17953d,Bram Moolenaar,330,11,341,15,
2020-06-20 14:00:25,a190548e9165bbae75144a3e47f01d7708b29073,Bram Moolenaar,23,0,23,2,
2020-06-20 13:03:38,b326edf5b30813b2ccdee3ac07ee6495ca5187ff,Bram Moolenaar,7,1,8,2,
2020-06-20 12:43:23,ef6746f637adbdb6860b4fa0266c43c49fa498bc,Bram Moolenaar,32,14,46,5,
2020-06-20 11:29:03,280b0dc815a31b99dafc384baa415072e5f2bec1,Bram Moolenaar,10,8,18,2,
2020-06-19 20:37:47,1089374130862e5c19745d3ff4314f0c5690baf1,Bram Moolenaar,7,1,8,2,
2020-06-19 20:35:44,7e380030c15d961421a3fcda6cc358e2d112f4f8,Bram Moolenaar,3,0,3,2,
2020-06-19 19:46:52,20298ce679dbf21c07c8fe2161724a12424f1e69,Bram Moolenaar,19,6,25,4,
2020-06-19 17:30:53,1e0b7b11db61bd906266d3174fee0bbaf20a101f,Bram Moolenaar,25,24,49,2,
2020-06-19 17:10:59,ec9b017b879cb744393aadd3d105ee5da1332437,Bram Moolenaar,11,13,24,2,
2020-06-19 17:01:43,3b74b6b4bb9a022f8c6f6e544360d628e10df1ab,Bram Moolenaar,39,2,41,4,
2020-06-19 16:34:15,c785b9a7f471f12825a1d6d2041c144c74242b7c,Bram Moolenaar,32,21,53,7,
2020-06-19 15:20:41,128d3079635ae62786a13adc435d0063a64a014a,Bram Moolenaar,3,1,4,2,
2020-06-18 20:43:27,c5b1c20b6b1968873ea31edac1db659773b3b93d,Bram Moolenaar,24,5,29,3,
2020-06-18 20:18:18,0779fab2979d6d055ba3c464f1c2b9d90dc9e49f,Bram Moolenaar,38,0,38,2,
2020-06-18 19:14:30,c8cb883015619cfe6db931ac2d6e15b0be5c56ed,Bram Moolenaar,26,0,26,3,
2020-06-18 18:50:10,efd885559405e1561d577e1b0e6fa827705d285e,Bram Moolenaar,128,31,159,4,
2020-06-18 17:31:08,9b68c82b7ca768100f3eb4223d100c62c5429e53,Bram Moolenaar,38,28,66,2,
2020-06-18 17:15:27,511feec6f0a9e954f1d7353425fa51232b1a8e88,Bram Moolenaar,90,3,93,6,
2020-06-18 16:45:49,865af6b990f058fab10c9ff10c77eb0e3bd48ad5,Bram Moolenaar,16,1,17,3,
2020-06-18 16:33:59,ceb2e7751089bd417c6250d63e28616483b5796b,Bram Moolenaar,8,4,12,2,
2020-06-18 16:26:24,72abcf42d4b28719863c3bdf72b4c05d147a7d83,Bram Moolenaar,71,38,109,3,
2020-06-18 15:28:39,158ea175a99fc23eae1b0a5ee9a81cdd973854a6,Bram Moolenaar,15,1,16,3,
2020-06-18 13:33:25,2f03e5a0a9cfaabb01c57dd3348a05e86c26623c,Bram Moolenaar,28,0,28,3,
2020-06-17 20:58:35,3d9207ad2fc98b4f92f77b5a3d52a3a4d25b9561,Bram Moolenaar,71,0,71,2,
2020-06-17 19:47:23,856c1110c1cf0d6e44e387b70732ca4b4c8ef0f2,Bram Moolenaar,169,1,170,4,
2020-06-17 19:41:35,40a019f157c549dcdc17c33f082975485567bb06,Bram Moolenaar,5,3,8,4,
2020-06-17 18:30:44,e17f8817a1713a1ef20257c777a483b7ab57a841,Bram Moolenaar,21,0,21,2,
2020-06-17 18:03:36,9bb3eb3e02a942fb71a4c1ce913f938d0ddf82d5,Bram Moolenaar,14,6,20,2,
2020-06-17 10:04:54,f7d267ef20a38eb316915b91cb5a89021555f9d8,Bram Moolenaar,9,8,17,2,
2020-06-16 21:18:51,101f4810e27e432970bc8809e18f018e1795937f,Bram Moolenaar,44,12,56,4,
2020-06-16 20:42:04,0fe937fd8616fcd24b1b1ef2ab9f1657615dd22c,Bram Moolenaar,36,3,39,5,
2020-06-16 20:27:39,a1bc6f12936a9f621238b940d5c6e97837809447,Bram Moolenaar,4,2,6,3,
2020-06-16 18:58:07,a6e8bf2d8929ef52eeda495e0e0c3d2bff8f5830,Bram Moolenaar,19,0,19,3,
2020-06-16 18:03:43,84cf6bd81bec93b49166cd48fccc7087fdbaa6fc,Bram Moolenaar,272,32,304,17,
2020-06-16 09:34:42,9af78769eeae0318e07aa8b6af4d6e2244481ca7,Bram Moolenaar,161,17,178,8,
2020-06-15 21:18:12,c70222d12a2f8552273c0de48a3bf7138d649175,Bram Moolenaar,6,2,8,2,
2020-06-15 19:41:56,fdcbe3c3fedf48a43b22938c9331addb2f1182f1,Bram Moolenaar,17,1,18,3,
2020-06-15 19:19:08,ab176ce982ac67f7cfcfa1fa885f9117ef8bbafe,Bram Moolenaar,35,5,40,3,
2020-06-15 18:24:58,ad72350360d1a68d251da62a6e8610950926278c,Bram Moolenaar,5,2,7,3,
2020-06-15 17:51:56,b340baed9f7fc1c19a0742e2214d54982190c15e,Bram Moolenaar,196,3,199,9,
2020-06-14 21:05:10,47a519a933e8bcaf703a5feaac5c01491a658ee3,Bram Moolenaar,741,558,1299,8,
2020-06-14 18:04:32,a65d8b5bb9e9267c6e4500c67d26c839a64f30eb,Bram Moolenaar,4,1,5,3,
2020-06-14 15:29:55,65e0d77a66b7e50beb562ad554ace46c32ef8f0f,Bram Moolenaar,626,229,855,25,
2020-06-14 14:43:47,8e20f75e58f4879308b0011b468ef928a3f93085,Bram Moolenaar,4,1,5,2,
2020-06-14 13:35:58,0c8059e0b673a11f878acf4067a4b92679f1e0e5,Bram Moolenaar,3,1,4,2,
2020-06-14 12:34:16,8dff4cbf6d917e20322821e8e866ffc1c1175258,Bram Moolenaar,10,2,12,3,
2020-06-14 11:50:55,df7df59d85e7e56a796912dc865488a75d3f0e53,Bram Moolenaar,301,81,382,5,
2020-06-14 10:50:24,984dddbef421eda6b8ad60936f380c5f00aebb96,Bram Moolenaar,27,3,30,3,
2020-06-13 17:56:38,f3decc5830ef8d8d94902b76114935283dd4142e,Bram Moolenaar,5,0,5,2,
2020-06-13 17:00:10,34db91f7a47b7bd4aabf1e1dfbaa8a08278bf78d,Bram Moolenaar,51,8,59,7,
2020-06-13 16:09:19,c82a5b5da5eab15bc35115545b639fb590272ad7,Bram Moolenaar,92,5,97,7,
2020-06-13 14:39:31,142499de3352e1edb2ab6cc2bf3b82441c8e5f4f,Bram Moolenaar,9,1,10,2,
2020-06-13 13:47:25,0c0eddd3ddd266bcc2036362fae7b2b8b9d2c7bf,Bram Moolenaar,172,5,177,11,
2020-06-13 13:13:38,4a021dfbeee88ac09d07e257912485314ecdcabe,Bram Moolenaar,99,2,101,3,
2020-06-13 11:20:48,c9630d2658af9dcaa01913e899b201bfdef7b536,Bram Moolenaar,631,110,741,5,
2020-06-12 20:59:11,71ccd03ee8a43b20000214a9c99dcc90f039edca,Bram Moolenaar,66,64,130,31,
2020-06-12 20:31:00,722e505d1a55dfde5ab62241d10da91d2e10c3c1,Bram Moolenaar,15,5,20,7,
2020-06-12 20:15:31,5055c56cfbedc6326c607d40c7a1241682f7675e,Bram Moolenaar,2,10,12,3,
2020-06-12 20:09:01,37d1673ce007c46ec2338f3236ae1b7b0324bd25,Bram Moolenaar,15,5,20,4,
2020-06-12 18:19:44,6c6be9e88d72a60ee279ccad73d018c534b71d66,Bram Moolenaar,49,4,53,5,
2020-06-12 18:11:55,f6e020b1225970d95e6848b79066f82d9e65b66c,Bram Moolenaar,10,0,10,2,
2020-06-12 17:35:32,ec68028604b6ee799b2ef5fc861ec5163e82914f,Bram Moolenaar,98,47,145,4,
2020-06-11 21:10:46,9721fb4ea3db2559aaf7f71458da8ddda30ff93e,Bram Moolenaar,91,25,116,5,
2020-06-11 17:35:52,00e260bb6cc33ff5dbba15ac87ca7fd465aa49c0,Bram Moolenaar,112,68,180,4,
2020-06-11 17:22:43,1de5f7c81d5e78fb4d612134bd2dfa6ee9183fae,Bram Moolenaar,67,0,67,3,
2020-06-11 10:30:13,2d4070d3b02e775a6f3d5ef52265add270e09a4f,Bram Moolenaar,3,1,4,2,
2020-06-10 20:17:58,e0ebeda4d8219a8955001b43ef7a9268452ef7f5,Bram Moolenaar,27,1,28,2,
2020-06-10 20:12:04,215f49c4d720367be29f56168f363a0ee9eaf86b,Bram Moolenaar,3,0,3,2,
2020-06-10 20:07:52,f1f0ff9557353c9a452aac8540411a88cf2da47c,Bram Moolenaar,4,2,6,3,
2020-06-10 19:47:00,362b44bd4aa87a2aef0f8fd5a28d68dd09a7d909,Bram Moolenaar,45,0,45,10,
2020-06-10 18:56:58,be5ee8686a50acf07b823bd293f9c765e533d213,Bram Moolenaar,67,6,73,8,
2020-06-10 18:21:09,6ba24d87630b1ec2b8c7ff71550c9e41d143800e,Bram Moolenaar,2,1,3,2,
2020-06-10 15:13:48,13b8205b442f52f34deac98e3312a27dec14d8e2,Bram Moolenaar,3,1,4,2,
2020-06-10 14:54:13,ea1233fccf4f52f2b4eaab3788a087878d1336fc,Bram Moolenaar,7,0,7,3,
2020-06-10 14:39:32,d281b7c227bc4c78813fdc297ccee4b2cad7e605,Bram Moolenaar,5,3,8,2,
2020-06-10 13:55:36,ab54032f297e9418b0d83970cbe3a414d6ef08c4,Bram Moolenaar,24,2,26,3,
2020-06-10 13:45:57,eebd555733491cb55b9f30fe28772c0fd0ebacf7,Bram Moolenaar,17,3,20,3,
2020-06-10 13:32:08,152e79e94bb935e75b866bd55479648cde11066a,Bram Moolenaar,105,14,119,7,
2020-06-10 12:21:20,253ea9fa42278faa064f2590a5c0de46dc903a17,Bram Moolenaar,4,1,5,2,
2020-06-10 12:16:49,32ee627750e8b7b3fa6516b893e72f6e6af54710,Bram Moolenaar,86,36,122,10,
2020-06-10 11:12:28,0e390f40e944036fb558a63b91238cfda128d95f,Bram Moolenaar,9,6,15,3,
2020-06-10 10:15:51,517f00f78893087d2f9d45768a5ba4dc48cb6856,Bram Moolenaar,164,75,239,2,
2020-06-09 19:35:36,0ca8b5ba7ba72d739ee15d0d6534aa20f863f3c3,Bram Moolenaar,9,3,12,2,
2020-06-09 19:26:36,218cb0fb62d29fba552281c2e8ffeb4046d540c4,Bram Moolenaar,660,550,1210,2,
2020-06-09 17:34:54,59de417b904bbd204e313f015839317b577bd124,Bram Moolenaar,30,8,38,5,
2020-06-09 15:30:04,dcf59c37d0e1517439c4c0c4a6a5ca09c90157ad,Bram Moolenaar,6,0,6,2,
2020-06-09 13:57:37,a45551a53557dba98973fdb3ff737dea2fffcda3,Bram Moolenaar,103,27,130,12,
2020-06-08 18:50:43,077a1e670ad69ef4cefc22103ca6635bd269e764,Bram Moolenaar,198,1,199,8,
2020-06-08 17:35:59,ec98e93a82379ca9289d8021aec374aa6798afef,Bram Moolenaar,23,2,25,3,
2020-06-08 17:20:27,7ba5a7eff335dcce25afaa154f32eeadb6014b61,Bram Moolenaar,25,9,34,4,
2020-06-08 16:54:49,f154f3ab2c1eea67afc20140c580ad003752dc72,Bram Moolenaar,7,5,12,4,
2020-06-07 20:23:19,6938e27abd80715cf7beb9d3d579a63201f417a1,Bram Moolenaar,8,320,328,7,
2020-06-07 19:58:54,b5e18f29fac9253b0ccf1fde5e74bff72fa1ba60,Bram Moolenaar,23,4,27,3,
2020-06-07 19:31:18,cc613031b96f1cfa5a184253e745c26f1def9be4,Bram Moolenaar,76,0,76,3,
2020-06-07 19:07:18,acc224064033e5cea21ef7f1eefb356ca06ff11d,Bram Moolenaar,590,226,816,30,
2020-06-07 18:49:05,df44a27b53586fccfc6a3aedc89061fdd9a515ff,Bram Moolenaar,22,20,42,13,
2020-06-07 18:07:43,da84ac2a6f467d0b9eddcc8709433cda75d16a41,Bram Moolenaar,8,4,12,3,
2020-06-07 17:38:10,951a2fb1b87af7e3be81e85a3769a17a13fd5040,Bram Moolenaar,23,21,44,2,
2020-06-07 16:45:14,1f1fd44ef796dd909ff5f3e5288b3fd79294dc71,Bram Moolenaar,65,29,94,4,
2020-06-07 16:16:36,bb861e293e0170455184079fa537278754b07911,Bram Moolenaar,241,9,250,8,
2020-06-07 15:30:33,c82dd86084581afa5113b0dd9ade7a631b89b4fc,Bram Moolenaar,5,3,8,2,
2020-06-07 15:20:02,48af321a3382008dc642362d3f54bb6a61ff36e4,Bram Moolenaar,2,2,4,2,
2020-06-07 15:03:21,4fdb8bd0546ac8d90560a4fad359a48667089d43,Bram Moolenaar,24,0,24,3,
2020-06-07 14:08:08,5b157fe2edfdce5f77080aeac2b4a03f39eb1c1a,Bram Moolenaar,52,2,54,3,
2020-06-07 13:46:11,673fc3e23f09095d17f0095c4323958041b2d0d2,Bram Moolenaar,32,11,43,3,
2020-06-07 12:50:50,a9c010494767e43a51c443cac35ebc80d0831d0b,Bram Moolenaar,28,121,149,7,
2020-06-07 12:10:47,e928366de5deca359fad779a4f740db703296302,Bram Moolenaar,46,4,50,4,
2020-06-06 20:36:24,975a880a1389e8ce6dea8d66a7c109140b2f94ec,Bram Moolenaar,74,11,85,7,
2020-06-06 16:37:51,adc17a5f9d207fd1623fd923457a46efc9214777,Bram Moolenaar,212,11,223,7,
2020-06-06 14:18:46,d8df304c59040ef6689a1e4af1dac27ce566909e,Bram Moolenaar,19,4,23,2,
2020-06-06 13:58:03,439c036ed062de1c87cc7e3fe050a9569fb12089,Bram Moolenaar,24,17,41,5,
2020-06-06 13:23:26,11f1ffd18282c44ca4b74cf7cf336da6d09e396d,Bram Moolenaar,25,17,42,2,
2020-06-06 13:14:08,9b7cce28d568f0622d77c6c9878c2d4770c3b164,Bram Moolenaar,60,3,63,4,
2020-06-06 11:25:31,87fda407f8ecf947ba6ce72ac21f69ff04d909cd,Bram Moolenaar,2,0,2,1,
2020-06-06 11:17:59,fe712ced6e1509d1e16b12d2b5581f89d0f9f4df,Bram Moolenaar,0,4,4,1,
2020-06-05 21:16:29,8f1dde5021d9623a951d1ccbc78cf1b1a55ccd7a,Bram Moolenaar,44,0,44,6,
2020-06-05 20:33:42,002bc79991286934a9593b80635c27d4238cdfc4,Bram Moolenaar,117,13,130,7,
2020-06-05 19:06:10,3fffa97159a427067b60c80ed4645e168cc5c4bd,Bram Moolenaar,67,31,98,3,
2020-06-05 18:03:16,07188fc5ef2366a3b1952e8686a4031b44152d59,Bram Moolenaar,19,1,20,3,
2020-06-05 17:36:57,ea563cc22be043ff91dcbdf2878c3d1fd944e573,Bram Moolenaar,13,1,14,3,
2020-06-04 20:46:04,e0c3c3d6cbb6f356058f28ecbdf3438411222083,Bram Moolenaar,19,0,19,3,
2020-06-04 20:22:11,46cd43bda102c3782bba1c4c629836e010734d77,Bram Moolenaar,14,1,15,3,
2020-06-04 19:32:49,852ea366d6432e719ffdd95e9fb7d49a9a960187,Bram Moolenaar,3,1,4,2,
2020-06-04 18:56:09,442a85369f3eb9834dbab42add45f7c4106700f4,Bram Moolenaar,48,7,55,4,
2020-06-04 16:22:13,e52702f00322c8a8861efd0bd6a3775e685e5685,Bram Moolenaar,329,9,338,9,
2020-06-04 15:19:05,9155825b2428ef6bf654204a534b033a6879c90d,Bram Moolenaar,4,3,7,2,
2020-06-04 14:52:40,30cc44a97f0ba1349e1a522dab22b11f47888183,Bram Moolenaar,52,8,60,3,
2020-06-04 13:52:25,6b0e528368415476bfc3a8414c9c70f9852b1517,Bram Moolenaar,109,0,109,3,
2020-06-04 13:22:21,ebacddbc16b2d76bf5dad636d7ee5c529f0e8753,Bram Moolenaar,78,26,104,3,
2020-06-03 20:57:39,14681627f39421cce289345d4ec9927c10fa3b1c,Bram Moolenaar,14,2,16,3,
2020-06-03 20:15:45,408c23b0794540ee3c568a1569f21406c5ed3ab8,Bram Moolenaar,37,45,82,2,
2020-06-03 18:51:11,59f88fbf24b21dbae114a79a15695fa2c3a09fca,Bram Moolenaar,36,18,54,2,
2020-06-03 17:55:35,fb517bac2384798bb5142ed1f75f965f93984c0a,Bram Moolenaar,21,7,28,6,
2020-06-03 16:55:38,c5acc0f7fed6b061d994fc5ac660dcc0312750bd,Bram Moolenaar,15,4,19,2,
2020-06-03 08:04:49,cc836556d962058d8b8fbc45c400b7e9d643976a,Bram Moolenaar,3,1,4,2,
2020-06-02 21:18:24,1e5f8f6d65b2ecff3d93d9fdbdd17c7a2ab9cc3d,Bram Moolenaar,5,0,5,2,
2020-06-02 20:24:36,791fb1bcda7cd1a388ad948cdef469a2744d6dff,Bram Moolenaar,30,38,68,2,
2020-06-02 20:19:50,441d60efd8f0e4a44d0cf4bca11cb72e6c830e47,Bram Moolenaar,7,3,10,3,
2020-06-02 20:06:21,57f75a5a364ad4d8334fdf6b6b41420b48e08390,Bram Moolenaar,11,1,12,3,
2020-06-02 19:38:22,c17e66c5c0acd5038f1eb3d7b3049b64bb6ea30b,Bram Moolenaar,48,20,68,7,
2020-06-02 18:25:36,3ac498c8a1c3570c296093a5d9425b2a3a7cdb29,Bram Moolenaar,5,1,6,2,
2020-06-01 19:32:45,ea6561af92eeb26fa0b4966575da7cadd98af1cd,Bram Moolenaar,7,5,12,3,
2020-06-01 19:13:11,5fbf3bc3f9d007ab91eb005f9e3da6570992cb43,Bram Moolenaar,3,0,3,2,
2020-06-01 18:11:02,48b1c21809553d3463b5ed6c2b3bc6d335663bb6,Bram Moolenaar,22,13,35,2,
2020-06-01 17:14:12,d6a77f95ee1e8ab69366d4f2a3412beef4cec914,Bram Moolenaar,3,1,4,2,
2020-06-01 17:08:54,109aece79d1b5f14f6a84ff2ac068cfffebeba80,Bram Moolenaar,3,0,3,2,
2020-06-01 16:56:03,f9ca08e95ff5b66a02c75334264dd86508b2a453,Bram Moolenaar,3,1,4,2,
2020-06-01 16:39:20,85629985b71035608a37ba3bde86968481490d46,Bram Moolenaar,163,0,163,7,
2020-06-01 15:28:35,e8f5ec0d30b629d7166f0ad03434065d8bc822df,Bram Moolenaar,475,79,554,7,
2020-06-01 14:26:19,950587242cad52d067a15f0f0c83528a28f75731,Bram Moolenaar,36,4,40,4,
2020-06-01 14:09:41,6c9ba0428041d5316871245be38c13faa0107026,Bram Moolenaar,604,146,750,9,
2020-06-01 13:05:19,d14fd5285e491a39028c4b4722ddbe7c9dfa9bb2,Bram Moolenaar,10,2,12,2,
2020-06-01 12:43:59,2891459b81a21dbd2802ef1ae106c6680f085899,Bram Moolenaar,7,4,11,3,
2020-06-01 12:34:43,f15c8b6eb32fcfea88fd9ca42ef87bbee2c8fe2b,Bram Moolenaar,1822,1779,3601,12,
2020-06-01 12:14:44,f17e7ea67a798d0aa45ce24ea80c9e21d5164326,Bram Moolenaar,13,9,22,5,
2020-06-01 12:07:49,ad772a63ec3bc86fe9d53cba783812f53470a313,Bram Moolenaar,7,0,7,2,
2020-05-31 21:11:59,858ba06d5f577b187da0367b231f7fa9461cb32d,Bram Moolenaar,367,71,438,8,
2020-05-31 20:20:36,2245ae18e3480057f98fc0e5d9f18091f32a5de0,Bram Moolenaar,81,35,116,4,
2020-05-31 20:06:51,fccd93f0917234b962ce07d1df3adf9d7105936f,Bram Moolenaar,20,21,41,8,
2020-05-31 19:28:02,494e9069cb32620f7688a7cb128a3feff827639e,Bram Moolenaar,167,57,224,16,
2020-05-31 17:48:53,e35a52aee718c881bdfa69a47a1068df6ab6c60a,Bram Moolenaar,195,8,203,5,
2020-05-31 15:49:30,d881b516da0184052d2f9d33c3f72c5c014316bd,Bram Moolenaar,58,4,62,5,
2020-05-31 14:42:30,e023e88bed3f2e0a7ea4cf10cac2de80bc9c271c,Bram Moolenaar,118,24,142,12,
2020-05-31 14:04:42,b10090928cb5283f867e8457b7eea0985470d8d4,Bram Moolenaar,15,8,23,3,
2020-05-31 13:41:57,cfb4b47de08e4437c692d382067dc1692cd83c23,Bram Moolenaar,171,0,171,7,
2020-05-31 13:08:59,aaad995f8384a77a64efba6846c9c4ac99de0953,Bram Moolenaar,97,27,124,5,
2020-05-31 12:25:22,f09715bc5c827dab4425736da9024727836997e5,Bram Moolenaar,1420,1,1421,12,
2020-05-31 12:08:12,788fbb47079e6df4d4815d27273faf8390395029,Bram Moolenaar,121,9,130,8,
2020-05-31 11:53:04,5cd1cb9ff9d04979ff4cbc36ca8416d83364505d,Bram Moolenaar,4,1,5,2,
2020-05-31 11:09:47,928eec649b8af389de0fdb7aba2034d27df3e058,Bram Moolenaar,4,4,8,2,
2020-05-30 19:52:54,ebe9d34aa07037cff2188a8dd424ee1f59cbb0bf,Bram Moolenaar,60,43,103,13,
2020-05-30 18:50:25,363d6148dfc2cc17fb0d286c7a36c305f56f5813,Bram Moolenaar,52,3,55,3,
2020-05-30 18:30:46,ca70c07b72c24aae3d141e67d08f50361f051af5,Bram Moolenaar,52,50,102,22,
2020-05-30 18:05:02,d6cd5ffade84a1054fed23079133af3b837033bf,Bram Moolenaar,2,2,4,2,
2020-05-30 17:52:46,f4ae6b245a54f11dd967d06b80f30e5abf55fb82,Bram Moolenaar,28,42,70,4,
2020-05-30 16:37:55,95da136142628e06425f9d9eb2d1ca56a9e48feb,Bram Moolenaar,208,101,309,4,
2020-05-30 16:14:57,041c7107f23d3b49ab62c1d7e36af90421db8b63,Bram Moolenaar,17,364,381,19,
2020-05-30 15:49:25,06b7b58455f9c09be3d1c36d174ffbfdf4efcd79,Bram Moolenaar,108,12,120,4,
2020-05-30 15:06:14,367d59e6ba65cf554d167933775fa17e40dcc6a7,Bram Moolenaar,1569,1534,3103,16,
2020-05-30 14:17:33,d5c2c7763d73b91efd64a49da8221f9955debdd5,Bram Moolenaar,4,0,4,2,
2020-05-30 13:32:02,87be9be1db6b6d8fb57ef14e05f23a84e5e8bea0,Bram Moolenaar,241,223,464,7,
2020-05-30 12:46:52,a9d4b84d97fb74061eeb42c1433e111fb58825dc,Bram Moolenaar,129,47,176,5,
2020-05-30 11:15:14,0016fd2e29b7d4d4eef89a0516d14888a8651c61,Bram Moolenaar,6,0,6,3,
2020-05-30 11:07:39,208534d9ae6e8dec5baff90440b58c63f0b37981,Bram Moolenaar,8,0,8,2,
2020-05-29 21:03:09,823654bc06c847af20967d41db32d592aba416cb,Bram Moolenaar,6,5,11,3,
2020-05-29 20:49:43,6cb0726215519fe94103803e4aa77a355384bcf2,Bram Moolenaar,47,1,48,4,
2020-05-29 20:41:41,b42c0d54279b1fdb79652db0c84171e213458809,Bram Moolenaar,50,14,64,8,
2020-05-29 19:42:55,09307e3bc1423d5e8a05464b94717a948d6c059a,Bram Moolenaar,3,1,4,2,
2020-05-29 19:38:42,b60db8ba149b26024e6d871e8634d7fea639252a,Bram Moolenaar,3,3,6,2,
2020-05-28 19:30:11,14798ab9a5ee4b94f6c12f1986207569356acfc8,Bram Moolenaar,33,13,46,3,
2020-05-28 19:03:53,c998370562425e70f4cf202a87112d638f5f7b38,Bram Moolenaar,17,1,18,3,
2020-05-27 21:15:16,3f65c66df95445ef84f98de007c9b70ce23f54a0,Bram Moolenaar,8,0,8,3,
2020-05-27 20:08:34,ca5bc746073b6fd4b7651bc02f7a18b1b43bd4ca,Bram Moolenaar,4,0,4,2,
2020-05-27 19:29:04,a55ba06f6904af3d6a78fc90358cf72d4f2e8450,Bram Moolenaar,3,1,4,2,
2020-05-27 19:22:14,f4b68e9056f8ddb64c3d7141df138fe099575abf,Bram Moolenaar,5,3,8,3,
2020-05-26 20:14:27,80a20df86a1ceefa3506cc578ba0ba35da979e38,Bram Moolenaar,7,0,7,2,
2020-05-26 19:20:45,388a5d4f20b4b64341d1604aa238cab85827b892,Bram Moolenaar,349,148,497,25,
2020-05-26 18:22:01,fcb0b61d15f66f0e9116a6bc56d9d8105bb913cf,Bram Moolenaar,5,3,8,3,
2020-05-26 18:09:11,92c098d18e435a7a762409744ebe2dbb3746ed77,Bram Moolenaar,24,11,35,6,
2020-05-26 09:37:26,285b189260e2d753454449e429f2caa17e1c39a5,Bram Moolenaar,3,0,3,2,
2020-05-26 09:08:28,ebc3de634f4c2893f34e41b4f8da1d59212e59ea,Bram Moolenaar,14,1,15,2,
2020-05-25 21:29:28,a14e6975478adeddcc2161edc1ec611016aa89f3,Bram Moolenaar,5,0,5,2,
2020-05-25 21:01:42,1919371b2b9ddb1a645f40b59adbd89317530882,Bram Moolenaar,7,3,10,3,
2020-05-25 20:36:50,25e0f5863e9010a75a1ff0d04e8f886403968755,Bram Moolenaar,125,41,166,11,
2020-05-25 18:33:55,2eec37926db6d31beb36f162ac00357a30c093c8,Bram Moolenaar,9,77,86,7,
2020-05-24 22:28:33,45a1508a229b1d1d2eb79cabe55a183dc18fd040,Bram Moolenaar,7,3,10,2,
2020-05-24 21:45:24,6ff71d8b7fbdf667a2f119a2487302e240961816,Bram Moolenaar,58,56,114,5,
2020-05-24 21:14:23,f40e51a880a95f94dbbbecc9476559506c2cc345,Bram Moolenaar,2,1,3,2,
2020-05-24 21:00:18,822ba24743af9ee1b5e7f656a7a61a38f3638bca,Bram Moolenaar,165,272,437,19,
2020-05-24 16:45:07,f7271e831614d15d173c7f562cc26f48c2554ce9,Bram Moolenaar,12,3,15,3,
2020-05-24 15:23:45,87202264f8e27f084c0e58f98aeb27fa5c6d5251,Bram Moolenaar,27,10,37,6,
2020-05-24 11:10:18,9c65253fe702ea010afec11aa971acd542c35de2,Bram Moolenaar,92,35,127,4,
2020-05-23 17:30:05,3718427ba3c28ccab30726880389e44070640d3b,Bram Moolenaar,4,2,6,2,
2020-05-22 20:06:06,591cec8366e87a172495c362477cbf5de8d399f0,Bram Moolenaar,170,164,334,14,
2020-05-22 18:01:06,c94c1467b9b86156a6b7c8d3e41ff01c13d2be07,Bram Moolenaar,77,2,79,3,
2020-05-22 12:44:26,9cdcd1d0dc3bbea41b731639fd2431c2ef5cffaa,Bram Moolenaar,7,7,14,2,
2020-05-22 12:10:36,2e61e2d08390623fcf933fd06646ac91f81fb772,Bram Moolenaar,10,1,11,3,
2020-05-22 11:38:18,5a80f8ad5dc0b2cc63400255dcf3c63f6c1a2ef9,Bram Moolenaar,8,7,15,2,
2020-05-22 11:34:01,98f1671cc0ab0ad6139cb9c6ce5262e7f646bc0a,Bram Moolenaar,41,19,60,4,
2020-05-22 11:10:44,4c9243f9fb708c9010867d3cc8e928f36b58509a,Bram Moolenaar,231,61,292,6,
2020-05-21 19:50:58,74fae513f8032cfa9e129eedc33454f0bf68668b,Bram Moolenaar,14,1,15,3,
2020-05-21 18:38:31,fe81389d606ae79415d208207295f41a4375c580,Bram Moolenaar,36,11,47,2,
2020-05-21 18:10:04,e5886ccb5163873dd01fc67b09ab10e681351ee9,Bram Moolenaar,404,187,591,12,
2020-05-20 17:30:19,83a52533b23c88f90be0dea01bc5e32ddadc1d6a,Bram Moolenaar,47,30,77,8,
2020-05-20 16:41:41,d863728913801c8fa6d633f6580edfcada533fd0,Bram Moolenaar,90,17,107,11,
2020-05-19 21:11:00,eaa3e0dae53acc9a345f430ef014d65c105192c3,Bram Moolenaar,19,3,22,2,
2020-05-19 20:38:59,a09195f29ee8cd88411152cf311f4e4ab2f3b4b3,Bram Moolenaar,35,31,66,3,
2020-05-19 19:43:47,74c69636563310d1e941fec695ff2d74518fe743,Bram Moolenaar,5,3,8,2,
2020-05-19 19:20:04,be593bf135f6967335b14ba188bd5f8f32175c75,Bram Moolenaar,396,312,708,14,
2020-05-19 08:33:02,904e48a22be7e227a73c70e520cf9d8bc50fc1b2,Bram Moolenaar,3,2,5,2,
2020-05-18 21:27:50,37ebd42f16734838ab68be91da291c4ec8610f47,Bram Moolenaar,5,3,8,2,
2020-05-18 19:51:01,88d68de95da70d0f89a5246f58355d72e9c17db4,Bram Moolenaar,153,75,228,10,
2020-05-18 19:12:59,d098b824c10cc20dc55e18c22c4991f61826006e,Bram Moolenaar,87,44,131,7,
2020-05-18 18:17:02,1e1d2e89fa460328883bb09fb13a24e26ef1ab31,Bram Moolenaar,5,2,7,2,
2020-05-18 18:12:09,c33b3216c8ceac84130d627b20cb7034e5f831e6,Bram Moolenaar,4,0,4,2,
2020-05-18 17:46:48,b5383b174b2436b556f76f14badb1c1f55d6d8f6,Bram Moolenaar,46,12,58,6,
2020-05-18 12:20:36,843700875e50c03c94245bef1b2de147b9b3b585,Bram Moolenaar,38,20,58,2,
2020-05-18 11:38:02,66b3101672f7da32df2fd3962d7f14300e7a65f3,Bram Moolenaar,37,0,37,2,
2020-05-17 21:34:42,deb17451edd65e2af1d155bce0886e856a716591,Bram Moolenaar,10,0,10,2,
2020-05-17 21:00:52,a2e408f5981b4da64426c3bda98d837ea36469bf,Bram Moolenaar,166,138,304,3,
2020-05-17 20:33:53,0b39ec3c7dd41852fa6f0430b3f963c59d0b50d8,Bram Moolenaar,6,1,7,3,
2020-05-17 20:27:55,6fc3b59ee914a0d1710c8b037a0c592e0a7c34d4,Bram Moolenaar,97,13,110,9,
2020-05-17 19:50:16,94d729cbe8f0f788d9d7539f733cff395e73b228,Bram Moolenaar,84,43,127,6,
2020-05-17 18:52:45,c4c9f7e43e7229c78919a5618003ce8aac3e1785,Bram Moolenaar,67,52,119,10,
2020-05-17 16:53:27,df1643a6a7886b9363c2a98438e61cbe1c803d41,Bram Moolenaar,5,0,5,2,
2020-05-17 14:53:56,9309eb2f28e6ee346c2a5deaa6f9c2b36578522e,Bram Moolenaar,3,1,4,2,
2020-05-17 14:29:47,2d2970ea599e83acabee56be548a54a8e6b21007,Bram Moolenaar,14,10,24,14,
2020-05-17 14:10:11,f4e16ae041962555316a6953df30a45f4c45be6a,Bram Moolenaar,4,2,6,3,
2020-05-17 14:04:44,d4a5f40c0cc45fdfac01df0e408d557006eb0206,Bram Moolenaar,161,3,164,6,
2020-05-17 13:17:26,ed37d9b3241abe7c302c7ac606df80037aecdb46,Bram Moolenaar,1,1,2,1,
2020-05-17 13:09:27,79ea680e6b1dd02035fdf8a5521927cf1f98c2ed,Bram Moolenaar,6,4,10,2,
2020-05-17 12:59:47,e178ba36546ec7805020280910306331f1ef4ed0,Bram Moolenaar,155,0,155,7,
2020-05-17 12:32:35,eb04f0893afe01faff272ef84c70d8cc16d8e80a,Bram Moolenaar,118,22,140,4,
2020-05-17 12:06:16,26e86445bf06ab7e7587dfdf75f33f7c70632b46,Bram Moolenaar,37,25,62,14,
2020-05-16 21:15:08,3b1f18f785f67c6cd110498c366e4d0c0fe11f27,Bram Moolenaar,26,8,34,6,
2020-05-16 20:33:33,df671b4629a0c6451c067cafd2534b7261f41277,Bram Moolenaar,33,2,35,2,
2020-05-16 19:20:12,6f5b6dfb16228c0ce1e4379b7bafed02eaddbab2,Bram Moolenaar,34,17,51,6,
2020-05-16 16:57:53,aa5fc4ec51b00e91f174ac83c8ff68becf5f42bb,Bram Moolenaar,10,4,14,2,
2020-05-16 14:08:35,129d6bf6b3d120b0a4c69e18b5e8602a84e352bf,Bram Moolenaar,25,1,26,3,
2020-05-16 13:43:31,e75ba268b35a9b3a1f8b47668e657259555fc5fa,Bram Moolenaar,3,1,4,2,
2020-05-16 13:05:04,645e3fe3fe2cfaf0615428207bbacc2963852eba,Bram Moolenaar,8,0,8,2,
2020-05-16 12:07:39,e882f7a73c8fa48707de71035eb0a7ccc6ac8548,Bram Moolenaar,55,0,55,3,
2020-05-16 12:01:51,fd615a3c901f59abddca27c6a09940be552c0f4d,Bram Moolenaar,84,179,263,6,
2020-05-15 21:36:40,a6e67e4f41386c3e6eab7e047671c6d32f6cb0dc,Bram Moolenaar,14,9,23,4,
2020-05-15 20:46:44,4457e1d98f78152311495b1aff6169383d330a75,Bram Moolenaar,3,0,3,2,
2020-05-15 20:30:38,76cb68309794def0fa7d1f2f72dd694b822186a5,Bram Moolenaar,31,0,31,3,
2020-05-15 20:01:57,4aeeb6393824e375afad4d7291e8552917ad28b8,Bram Moolenaar,44,30,74,2,
2020-05-15 19:44:19,4dac32caf38f7c35b707b7df104df03591bf6b14,Bram Moolenaar,9,10,19,3,
2020-05-15 19:42:53,270d0388d284c130b322b185497e437cfbbae412,Bram Moolenaar,26,19,45,2,
2020-05-15 18:53:00,cb7904016eb817e80760c394044740df8273c774,Bram Moolenaar,263,189,452,2,
2020-05-15 17:21:31,4902ab16cbb6e00f4fee8bbdf16f1383fd8ba42f,Bram Moolenaar,103,92,195,2,
2020-05-15 16:21:51,7e6f3fcc3ce89fc8ade85be39aa475e606c0b26c,Bram Moolenaar,6,3,9,2,
2020-05-15 16:17:28,227a69de1e0f9457a9fc9e098d999304faff55f8,Bram Moolenaar,47,11,58,4,
2020-05-14 21:20:55,a5d0077efbced85fcc63f203937b13efd55d036f,Bram Moolenaar,25,0,25,2,
2020-05-14 20:41:15,32e351179eacfc84f64cd5029e221582d400bb38,Bram Moolenaar,211,128,339,12,
2020-05-13 21:24:12,e06a28f5e30f439545ac125d54ffc4e6bd6daada,Bram Moolenaar,6,1,7,2,
2020-05-13 21:21:55,2b72821924ff514727b60fb0b647d5caae8336f7,Bram Moolenaar,2,0,2,1,
2020-05-13 20:44:22,7e9f351b2e69b498c4ee5004d7459844e1ba191a,Bram Moolenaar,92,82,174,17,
2020-05-13 15:16:04,37d1b4f9416973abe9f5a7c6b81540ca88fa8489,Bram Moolenaar,6,5,11,2,
2020-05-13 14:53:49,55ba4b844f1b0e44f0f2e1bd14d26e7ad2df9ffc,Bram Moolenaar,2,2,4,2,
2020-05-13 14:34:15,ef6b979bfae82f64781d8b0ce0194c57111243d4,Bram Moolenaar,43,3,46,8,
2020-05-13 11:40:16,03a9f848175b182372fb33403998059724a8bf31,Bram Moolenaar,63,56,119,12,
2020-05-12 23:04:32,d502aa4c10771ec8eb570345ec5e124c4a4b7cd0,Bram Moolenaar,19,11,30,3,
2020-05-12 21:45:16,06f0853cb0b10364b22e5607fdecd35b3936e9ea,Bram Moolenaar,11,7,18,3,
2020-05-12 20:49:12,47e13953ffdbb9f163b901196dec8c2100b72edd,Bram Moolenaar,579,2382,2961,55,
2020-05-12 20:21:26,9e6ba8cbef2b2363f1d0a0e2c2a8d21c3b987416,Bram Moolenaar,3,1,4,2,
2020-05-12 20:02:21,5aed0ccb965dbad4b60f4c77c9c4455a9379e73c,Bram Moolenaar,19,0,19,4,
2020-05-12 12:42:02,48a687148c4649f6f55b36a1f4111041e7207235,Bram Moolenaar,48,0,48,2,
2020-05-12 11:08:07,c3fd98cf8e43d48a322402d08fa83444c2b0a4a6,Bram Moolenaar,61,59,120,3,
2020-05-11 21:14:04,86181df9f5501ba735dcb75e0832c35ac1212ca6,Bram Moolenaar,19,17,36,4,
2020-05-11 20:13:28,b415168a9862023462b7193e83da948cb8d11893,Bram Moolenaar,17,3,20,4,
2020-05-11 20:04:53,91689ea8ae01acb3daf8ba0ee91acd729af7c84c,Bram Moolenaar,270,22,292,5,
2020-05-11 18:54:42,5c3128efe6bc48cbd88da23973db389ad3b8ab63,Bram Moolenaar,28,6,34,2,
2020-05-11 17:46:36,aacc6afdb8cdeb2558e6942dcd65ca0079bec1ee,Bram Moolenaar,4,2,6,3,
2020-05-10 21:20:06,bc38f25c021dc4314c77d50a608329a328b0d988,Bram Moolenaar,12,8,20,2,
2020-05-10 21:11:53,04816717dfea6e2469ff4c9d40f68b59aaf03724,Bram Moolenaar,7,1,8,2,
2020-05-10 20:53:56,cb2bdb1c6d8b6df4a3d9cfb1ad9e602dace5d310,Bram Moolenaar,52,6,58,3,
2020-05-10 19:47:43,f163bd5e41e8ea1d32e7977e671598a9d6f7b23c,Bram Moolenaar,16,0,16,3,
2020-05-10 19:20:29,7e5bd91dc99e1ecb38c4220eaab1a906a69815c2,Bram Moolenaar,25,0,25,3,
2020-05-10 17:10:31,1cc2a94f80ba982f83d1e2d37c4726867e36bd9f,Bram Moolenaar,462,166,628,8,
2020-05-10 13:24:44,89483d40438830fb9e74a5ec6c92d2470b05e4c2,Bram Moolenaar,57,20,77,5,
2020-05-10 12:14:03,69212b11d18d9d8951968f6ca88e6ce046c90675,Bram Moolenaar,6,4,10,3,
2020-05-10 11:42:43,d695ba732de915fc227c1069a7a4e1d5049601bd,Bram Moolenaar,5,3,8,2,
2020-05-09 21:20:20,3b6a6eb7b4e0ac5b75dd2518bd27bce2b13298a3,Bram Moolenaar,7,5,12,2,
2020-05-09 20:50:08,09689a02840be40fa7bb10b1921fb5bc5b2908f1,Bram Moolenaar,229,35,264,13,
2020-05-09 16:44:56,396f3138ca83ce844679143861f544070683d479,Bram Moolenaar,8,0,8,2,
2020-05-09 16:28:34,1c74721233dac057778f9aef9ae20f49d934ec22,Bram Moolenaar,33,4,37,3,
2020-05-09 15:35:53,7f14155f422ffcc997fc5a0b635a20a4bafd2093,Bram Moolenaar,23,408,431,2,
2020-05-09 14:44:22,497f76bfbf9d5fe951221573d23696bb9e512c0b,Bram Moolenaar,6,0,6,2,
2020-05-09 14:11:33,b1062eb23e7a7a8b44f3416e79c3b28aa6c6c229,Bram Moolenaar,11,4,15,2,
2020-05-09 13:44:01,a5565e4189b7c4d3f03d1f5405fc64d5dc00f717,Bram Moolenaar,450,279,729,4,
2020-05-09 11:06:24,7d3664df9008bd5f39f8a2555843d1b269946e4d,Bram Moolenaar,5,1,6,2,
2020-05-08 17:10:34,7d131b071539e73e4f8a1e6ffbb4d7bfc69a57ec,Bram Moolenaar,183,136,319,3,
2020-05-07 21:20:21,5c2fe644430efabf9dadfb89a9f1e82367eaf28d,Bram Moolenaar,17,4,21,2,
2020-05-07 20:23:58,cca34aa4bef5327eb4025850045c4c980ef4354b,Bram Moolenaar,4,0,4,2,
2020-05-07 20:19:01,f0eefce93bb06037a2d45e7ea8c0ad6f1f714151,Bram Moolenaar,165,61,226,3,
2020-05-07 16:56:00,2cfb4a2a7248eeb40112bb482ab5b15f01b20433,Bram Moolenaar,106,43,149,10,
2020-05-07 16:51:27,611548105394fdb76827cd431230c9fbfed39929,Bram Moolenaar,6,0,6,3,
2020-05-07 16:43:44,0ff5dedf0f69e56320199db7a2aad46be2a1f9b7,Bram Moolenaar,83,0,83,5,
2020-05-07 16:37:03,b2d0e51366dea6843f991f31a457f5456d162678,Bram Moolenaar,119,0,119,7,
2020-05-07 16:16:35,4a070cc82e00618db279526797564cb2b4e9b060,Bram Moolenaar,5,0,5,2,
2020-05-07 15:46:59,ea554ca4faf4a0b96706ea24130c4f485b24b241,Bram Moolenaar,3,1,4,2,
2020-05-07 14:58:17,61a89816996a0cad0d711c91e6e7cea9a9101211,Bram Moolenaar,1762,1613,3375,4,
2020-05-07 12:37:19,f391586f3f6a304d3bb0160ab75bdd9d758bd2da,Bram Moolenaar,3,1,4,2,
2020-05-07 12:07:25,8a1c1013153a7f08e014facac883a1987985d6db,Bram Moolenaar,6,9,15,4,
2020-05-06 20:25:05,3657686a0e8fd07428a25c2cf9efcc8b5d33f895,Bram Moolenaar,4,2,6,3,
2020-05-06 20:18:17,f821ddaa0c27230012a6bffbec6fb0ab2f101171,Bram Moolenaar,29,1,30,2,
2020-05-06 19:06:30,b68b346e6db6d3f848e0a89905fcd7777b73c5d8,Bram Moolenaar,97,9,106,8,
2020-05-06 17:38:30,54ed0dff2913f9c973f6ab04b3c96372bdf07406,Bram Moolenaar,4,0,4,2,
2020-05-05 21:32:58,2a1381c305b32885c644cc300e4f6734292626a2,Bram Moolenaar,15,11,26,2,
2020-05-05 20:08:26,40ee466c361b9698c2a452a36ff4d6c6e5382ed0,Bram Moolenaar,21,7,28,3,
2020-05-05 19:25:22,015f4267f4a28627c1872042078a95be7e06c4dc,Bram Moolenaar,50,26,76,5,
2020-05-05 17:57:18,f9ab52e155dc13f59b654d754041fe78e17b9074,Bram Moolenaar,134,9,143,4,
2020-05-05 17:46:20,221fcc741a6660bfc3fd0d64937d0c15bb71f51d,Bram Moolenaar,30,4,34,3,
2020-05-05 15:53:16,0e65d3de0aeff00aa42ea899f1afd11f8b22b93e,Bram Moolenaar,30,31,61,4,
2020-05-04 21:24:44,04b12697838b232b8b17c553ccc74cf1f1bdb81c,Bram Moolenaar,167,72,239,6,
2020-05-03 20:57:32,80a8d3889bf1341c47f1c88c59825f183b2b4753,Bram Moolenaar,81,24,105,5,
2020-05-03 20:30:49,2fd4cd755c3e87e733b7363ac13e5c0fe0297a80,Bram Moolenaar,82,38,120,3,
2020-05-03 16:21:04,4515bcdec8f3ba54f9d671cc37b9c9b3e19ea999,Bram Moolenaar,3,1,4,2,
2020-05-03 15:55:32,7779ee30d912e9dd5bd2371f8b27057bd249d53c,Bram Moolenaar,3,1,4,2,
2020-05-03 15:19:33,5125874951669944a5f6a4163d6e5d437ae6321e,Bram Moolenaar,61,1,62,3,
2020-05-03 15:03:29,a38b2b737e244eb2e4f199e070b05f86f4d433d4,Bram Moolenaar,6,2,8,2,
2020-05-03 15:01:24,647a530b33d9d767f591159c24c62de48e57dad7,Bram Moolenaar,6,2,8,3,
2020-05-03 14:29:50,41d4299f26cc98e253f9c63f8adc9dbb9d49ed5c,Bram Moolenaar,13,9,22,3,
2020-05-03 14:04:43,2eaeaf3c317a5145fb0bc926411561d50883019b,Bram Moolenaar,209,0,209,3,
2020-05-03 13:47:33,3df02f507f96a246366f96dcce156a0ae7b95611,Bram Moolenaar,5,17,22,2,
2020-05-03 13:38:16,f7779c63d4fe531e2483502d4441f24802342768,Bram Moolenaar,83,71,154,7,
2020-05-02 21:12:58,5adc55cb746893c6ddf7865ff654582902dee2e3,Bram Moolenaar,84,6,90,6,
2020-05-02 17:04:58,1c0d44f8efae36c079cb8be395785827aa0b2737,Bram Moolenaar,7,0,7,3,
2020-05-02 16:33:25,0b6849e9e302286e906d97e4ba017dd66561a9ce,Bram Moolenaar,3,0,3,2,
2020-05-02 16:14:37,01f731e97c92bee05927f5008b7cd34ce188632b,Bram Moolenaar,2,174,176,4,
2020-05-02 15:52:42,bf67ea1af05cbb30cd8f0b665fb567c0dca79796,Bram Moolenaar,258,63,321,6,
2020-05-02 12:52:57,d58a662f44dc11475f4cf5922a948635da934cc4,Bram Moolenaar,8,3,11,2,
2020-05-01 17:29:08,c8cd2b34d1027c93fbca90f3cdc8123fe22dfa25,Bram Moolenaar,223,126,349,8,
2020-05-01 14:08:11,37addecc422c3b62a622b371246dc4ef0a2fa157,Bram Moolenaar,3,1,4,2,
2020-05-01 14:07:38,7ceefb35c8110d87ced884275ddbe63d024a014f,Bram Moolenaar,296,182,478,22,
2020-05-01 13:44:29,b84a381c75e50ca0e0a24cc3e152d0c70f8c2c7d,Bram Moolenaar,81,74,155,6,
2020-05-01 12:26:37,11abd095210fc84e5dcee87b9baed86061caefe4,Bram Moolenaar,1167,1176,2343,19,
2020-05-01 12:14:07,4cfde1d273ec5fca68a983805af48ea37d3d94e5,Bram Moolenaar,3,1,4,2,
2020-05-01 12:10:13,6ab0953fefe31fef91e40752a675ceb60fc2fe03,Bram Moolenaar,31,8,39,9,
2020-04-30 20:51:01,9e175141f3437627c314257ebf894c29c71a9ded,Bram Moolenaar,6,36,42,4,
2020-04-30 20:31:18,6adb9ea0a6ca01414f4b591f379b0f829a8273c0,Bram Moolenaar,67,43,110,18,
2020-04-30 18:59:57,4e5534fab798ab7c95554da3bc80b08336aedc2b,Bram Moolenaar,386,50,436,3,
2020-04-30 18:21:43,7f6f56f43c48f0b7288a4edd12b59fa7335f01d3,Bram Moolenaar,3,1,4,2,
2020-04-30 17:54:38,2c5c1638a9fe2ef34f2fd09ed69e10ef2e821f0a,Bram Moolenaar,32,21,53,6,
2020-04-30 17:19:29,88e6cc253903c86d06abb59b35c85e6aef0152f3,Bram Moolenaar,16,14,30,4,
2020-04-30 17:09:35,a161cb5dddd6d374899e46fde834ce9ba5c80c0b,Bram Moolenaar,23,15,38,3,
2020-04-29 21:11:32,8dbafd0790eeaf8743298cccdbc2a13be52517b9,Bram Moolenaar,13,11,24,2,
2020-04-29 21:02:40,512fe833c3988bfe0de22135aef67faf51927a0e,Bram Moolenaar,6,2,8,3,
2020-04-29 20:30:13,dfc33a665d3b12689aa971575b8e7de4e5202d83,Bram Moolenaar,33,3,36,5,
2020-04-29 20:01:21,339d60c89bef0315343a6128a1b4826510b0efe4,Bram Moolenaar,169,127,296,7,
2020-04-29 19:04:15,ed8ce057b7a2fcd89b5f55680ae8f85d62a992a5,Bram Moolenaar,2020,1976,3996,13,
2020-04-28 20:49:08,939b5db4808770d3a2ec35e3902a9d5165adc0cf,Bram Moolenaar,21,3,24,3,
2020-04-28 19:58:29,affc8fd2cda77fbd47df2594da417a9f9a9bb9b6,Bram Moolenaar,3,1,4,2,
2020-04-28 19:29:34,a0a9f43ab24928a0b01b6d91d084bf50a6dbefc2,Bram Moolenaar,42,6,48,4,
2020-04-28 18:44:42,7ed8f59ae09278c666f1b43488351f9450097372,Bram Moolenaar,21,1,22,4,
2020-04-28 18:29:07,224a5f17c6ec9e98322a4c6792ce4f9bb31a4cce,Bram Moolenaar,551,103,654,10,
2020-04-27 22:02:41,a14bb7e1132377af60910402f1a9e4796297f5df,Bram Moolenaar,3,1,4,2,
2020-04-27 21:39:30,03afdcf1f449d23c9b6bc56d8b61f31dd4e11836,Bram Moolenaar,18,18,36,3,
2020-04-27 21:16:41,909ed7e902d97054262fb55b28f5e855428ab7fe,Bram Moolenaar,4,2,6,2,
2020-04-27 20:51:33,57700ee4acee9b7c7f165360f09c07ec9376d989,Bram Moolenaar,2,2,4,2,
2020-04-27 20:47:51,4c17ad94ecb0a0fb26d6fface2614bc5172dea18,Bram Moolenaar,219,81,300,12,
2020-04-27 18:18:31,db93495d276642f63f80471fbcb900b9aa1e9e42,Bram Moolenaar,20,2,22,3,
2020-04-27 17:29:01,0e71704b77a9891ccae9f5a9c7429e933078f232,Bram Moolenaar,17,2,19,3,
2020-04-26 17:00:07,bc970da80735bfd49c238cdf4bbc60c04dc12e0f,Bram Moolenaar,16,0,16,2,
2020-04-26 14:52:49,759d81549c1340185f0d92524c563bb37697ea88,Bram Moolenaar,15,12,27,3,
2020-04-26 14:06:01,07b761a012958ca91fa420f9c86a33675ddca943,Bram Moolenaar,3,2,5,2,
2020-04-26 13:59:55,99fa721944dda9d07c53c907c33466728df5c271,Bram Moolenaar,116,10,126,18,
2020-04-26 12:47:44,e297802d6ddbebbf36f9a2d01127c034fab88b3b,Bram Moolenaar,5,3,8,2,
2020-04-26 12:29:56,7d41aa8874a62eb399e13b94add7f0e5c4dd074b,Bram Moolenaar,6,2,8,3,
2020-04-26 11:50:41,6378c4fef37df05c99e8a43616063b4ddb692876,Bram Moolenaar,44,4,48,5,
2020-04-25 18:02:55,cfe435d7feacf123ac060747b885f7c4328062ea,Bram Moolenaar,380,221,601,11,
2020-04-25 15:13:56,49b2fb36ca94be14b98caf86420863d9bbe81a24,Bram Moolenaar,19,16,35,2,
2020-04-25 14:41:58,47a1a8baf9c8eb22b24f667e57a1dab579999a74,Bram Moolenaar,5,0,5,2,
2020-04-25 13:54:16,333015a46e916f566763ec44ae8669c0378767d9,Bram Moolenaar,18,2,20,4,
2020-04-25 13:45:37,41f6918bf4545de6a80c96d8c80f5f509f9a647f,Bram Moolenaar,6,0,6,2,
2020-04-25 13:35:32,e93c968f520ee8d6bc29ccc6e18055ac65e832b3,Bram Moolenaar,3,1,4,2,
2020-04-25 13:24:44,92b83ccfda7a1d654ccaaf161a9c8a8e01fbcf76,Bram Moolenaar,136,5,141,20,
2020-04-24 20:47:31,9d8d0b5c644ea53364d04403740b3f23e57c1497,Bram Moolenaar,114,4,118,14,
2020-04-24 20:19:00,92c461ef1b3b58c7dd4835bc881769f0f84e8ad0,Bram Moolenaar,6,0,6,2,
2020-04-24 20:16:13,b52575f9cfcb5c9715ed08ccd552a55e0052370e,Bram Moolenaar,3399,3397,6796,2,
2020-04-24 19:21:06,7714d7b31f0fc7c717c97abd4a8b5cbb13a3ad31,Bram Moolenaar,3,0,3,2,
2020-04-24 18:57:01,65d032c779a43b767497e15e6a32d04a6a8fa65d,Bram Moolenaar,22,3,25,3,
2020-04-23 21:54:04,e71ebb46a252cd1cdfb075e6014c2b13c580bf3f,Bram Moolenaar,174,172,346,22,
2020-04-23 20:23:14,b8ce6b0005573139fd101dc703ed30360940401b,Bram Moolenaar,3,1,4,2,
2020-04-23 20:16:53,f93c7fea084a99848d512ff2732041d4b41d93c8,Bram Moolenaar,141,48,189,10,
2020-04-23 16:13:23,1df8b3fb04ce8732a0be680273c95eb4e9f5e85d,Bram Moolenaar,40,18,58,4,
2020-04-23 15:07:30,a72cfb80cd7aa589ad2a4fb8766ed6d30ea8ae33,Bram Moolenaar,94,13,107,5,
2020-04-23 13:46:35,f7b398c6a9476a2004a42555b731ebf47b866408,Bram Moolenaar,3,1,4,2,
2020-04-23 13:41:49,beae4084fd34c56d43787be73588070ddc474251,Bram Moolenaar,33,10,43,8,
2020-04-23 12:41:46,95a467e7eeab664a71446e320d328d1d7c52a35a,Bram Moolenaar,5,1,6,3,
2020-04-23 11:58:12,0d6fe631f75effbfca92a4f61bbc2fab7385af09,Bram Moolenaar,11,9,20,3,
2020-04-23 11:38:02,ea04a6e8baff2f27da7cdd54bf70a5525994f76d,Bram Moolenaar,128,27,155,12,
2020-04-22 17:13:19,db950e4c0318c084c31bc7b50665284f4a47c285,Bram Moolenaar,5,1,6,3,
2020-04-22 12:30:31,d2662ad2de40e68999198150024531c91fece16c,Bram Moolenaar,4,2,6,2,
2020-04-21 20:23:15,e770598f31ad88fc98e40ead4b228ebc04afaa5d,Bram Moolenaar,4,2,6,2,
2020-04-21 20:19:45,ad48e6c1590842ab6d48e6caba3e9250734dae27,Bram Moolenaar,179,44,223,19,
2020-04-21 20:01:14,ff06f283e3e4b3ec43012dd3b83f8454c98f6639,Bram Moolenaar,62,42,104,12,
2020-04-20 20:42:32,1966c248814d5195edcd1208ed0e51e664a61283,Bram Moolenaar,210,32,242,6,
2020-04-20 17:52:53,2c7f8c574f1f8723d59adca3fec8fb89c41cf8c9,Bram Moolenaar,194,84,278,26,
2020-04-20 17:42:10,2c5ed4e3300378ce76c8d9c3818d6f73e5119f68,Bram Moolenaar,96,19,115,9,
2020-04-20 15:46:14,faac410409a8d693a0326ad9db42dca85419a391,Bram Moolenaar,69,4,73,5,
2020-04-20 14:50:00,08f4157c5cabc55bcb22f04dd7c717aba40caa34,Bram Moolenaar,178,106,284,15,
2020-04-20 14:21:53,ad4dc83389931a0354c3691b42f99a5bb98c766f,Bram Moolenaar,4,2,6,3,
2020-04-20 14:12:09,4da6df40f5a637de42cad8e6939dfe8463b211db,Bram Moolenaar,3,1,4,2,
2020-04-19 20:57:44,2bb76accc66d17f2c027c04396082c46f410bfea,Bram Moolenaar,24,21,45,2,
2020-04-19 16:31:25,fbf2122cf920a89274ffbefaaeb6c5eeacf5187b,Bram Moolenaar,47,50,97,2,
2020-04-19 16:27:26,7bdaea6e0df849cf3dd7eaaf454eb88f637d1884,Bram Moolenaar,27,5,32,6,
2020-04-19 16:13:19,eb58a2465825c258beafae96240824923f73779f,Bram Moolenaar,29,0,29,3,
2020-04-19 15:46:53,f49e5640821d8ef752fb50d99edcf40bb62a4d4d,Bram Moolenaar,45,2,47,3,
2020-04-19 15:24:53,7e0868efcf094f2cc59fa4e18af3a8dc7aedd64f,Bram Moolenaar,52,20,72,4,
2020-04-19 14:28:59,d72c1bf0a6784afdc8d8ceab4a007cd76d5b81e1,Bram Moolenaar,232,35,267,10,
2020-04-19 12:32:17,d3aac2917db38f8590648ee76eebfa178fc4c069,Bram Moolenaar,203,18,221,7,
2020-04-19 12:02:26,173d841e86cf205d8e398091b1da7bb4951714f9,Bram Moolenaar,788,49,837,7,
2020-04-18 21:20:37,61fbb3371ee1f6a02706f52fbe064608e159be7c,Bram Moolenaar,3,4,7,2,
2020-04-18 19:56:38,90455cfa87f84f16179c19241b034abbfa8b3c9a,Bram Moolenaar,122,38,160,4,
2020-04-18 18:51:40,ec9749f33d26162fad40714a7d21978aea10fc69,Bram Moolenaar,3,1,4,3,
2020-04-18 17:53:28,a26b9700d73ebccd6c5459d0d66032a4249f6b72,Bram Moolenaar,122,15,137,10,
2020-04-18 16:24:18,b6fb0516ec862a18fdffe06c9400d507a7193835,Bram Moolenaar,35,9,44,7,
2020-04-18 15:45:38,a494f56f885876c98a276f7acfa386bfbb344680,Bram Moolenaar,14,8,22,3,
2020-04-17 19:13:01,2695de63e370235c4d3d73e3fe07cc1006de3460,Bram Moolenaar,6,0,6,2,
2020-04-17 18:48:57,aa82259fef8d08326029c580282b417790230e93,Bram Moolenaar,4,2,6,3,
2020-04-17 17:41:21,aa0489e12d227d24752cf16e4e97058ac32edcc1,Bram Moolenaar,67,9,76,8,
2020-04-17 17:23:06,0fc1288aefce25da0a2fb2a0aab75b0bd314403f,Bram Moolenaar,5,3,8,3,
2020-04-17 14:40:31,314ca7cbb4b5a26959abb641a5aa265bee47abe5,Bram Moolenaar,14,3,17,2,
2020-04-16 21:01:50,21cfe500f322a0bea3367c677943ea6c57c282b9,Bram Moolenaar,3,1,4,2,
2020-04-16 20:54:32,4a8d9f2ed8c0079732e35d72656a000641353b94,Bram Moolenaar,40,1,41,3,
2020-04-16 20:10:49,7a09224583b2ad0d9d0648b53cc2d989d45ae96e,Bram Moolenaar,105,15,120,6,
2020-04-16 19:04:41,c5f33db888d14225e5a3851563c9a7fc0b5a5564,Bram Moolenaar,3,1,4,2,
2020-04-16 11:00:29,cb711abf0f71d8c743cf73c76077f52e17732a8c,Bram Moolenaar,51,30,81,3,
2020-04-15 19:44:11,b4a549fb161a390834371db8370b1f75695e25d0,Bram Moolenaar,56,10,66,2,
2020-04-15 19:05:30,81ccbf199f0d553efdd57bec9bb8e23d91d2fb0d,Bram Moolenaar,9,13,22,2,
2020-04-15 18:05:47,edd327cc070d9a05c12e88bc5c43a1e2a3086ae6,Bram Moolenaar,35,1,36,3,
2020-04-14 18:56:31,4d5d0dfe9438bd5f2daa41ebbe6ac9a76d165af0,Bram Moolenaar,6,3,9,2,
2020-04-14 18:15:49,6c2b7b8055b96463f78abb70f58c4c6d6d4b9d55,Bram Moolenaar,2093,1926,4019,22,
2020-04-13 19:16:21,7a1637f4c00ac3d0cbf894803ada1586a1717470,Bram Moolenaar,98,33,131,6,
2020-04-13 17:55:50,067297e16a516838dbc46aaa9d8b1a507afec28d,Bram Moolenaar,19,0,19,5,
2020-04-13 17:46:43,e3242346cf1c2ff8b0315cb2cb98e731bfa952c0,Bram Moolenaar,14,0,14,2,
2020-04-13 17:04:21,352f554b854da1c45209bcb3db8ba943da1969f0,Bram Moolenaar,9,1,10,2,
2020-04-13 16:25:33,278e83863b2c7329f6712b8809e4aa5e6a50e13f,Bram Moolenaar,30,13,43,5,
2020-04-13 16:13:33,df1956075d9ff7b5869fb548734bc2a7be2bce44,Bram Moolenaar,3,4,7,2,
2020-04-13 15:44:47,0015795baafaf7983875f979f92339375fe5d8e2,Bram Moolenaar,6,0,6,3,
2020-04-13 15:21:00,6e949784be29bfaea6e49a9d8231481eae10fab6,Bram Moolenaar,30,12,42,7,
2020-04-13 13:06:53,fbda69b309ca1c9748eaac38ab85b9e3425bf834,Bram Moolenaar,4,0,4,2,
2020-04-13 12:58:37,55b0fb7001ae42a58c10ad93a9157113f77a43d2,Bram Moolenaar,26,4,30,3,
2020-04-13 12:41:35,2c330432cfb12181c61d698b5459bfd73d2610df,Bram Moolenaar,93,27,120,7,
2020-04-12 21:09:25,1a2f4bf6c80d750615f19c34e5baddd21310c9c9,Bram Moolenaar,4,2,6,2,
2020-04-12 20:53:54,675f716efb534798a3bdb651cdb272302127602a,Bram Moolenaar,502,499,1001,4,
2020-04-12 20:22:31,23e032523e377d367e06441e88c67692a8c6c3e9,Bram Moolenaar,32,1,33,3,
2020-04-12 19:53:00,5e774c7579a4a00d3f44fdcfcb56861bd73372e4,Bram Moolenaar,69,12,81,6,
2020-04-12 18:55:20,9c7e6dd653b62f54324f3c00d69cb348d8611a9f,Bram Moolenaar,120,32,152,5,
2020-04-12 18:19:16,e6085c53506e38d07334faa1002ee90b1933b128,Bram Moolenaar,75,47,122,4,
2020-04-12 18:01:11,2196bce56fcd56b0eaece50c079bac99f5bc31af,Bram Moolenaar,4,2,6,2,
2020-04-12 17:37:17,a80faa8930ed5a554beeb2727762538873135e83,Bram Moolenaar,170,169,339,55,
2020-04-12 16:02:06,82de464f763d6e6d89229be03ce7c6d02fd5fb59,Bram Moolenaar,3,6,9,3,
2020-04-12 15:53:12,bfe13ccc58ccb96f243a58309800410db1ccb52c,Bram Moolenaar,546,192,738,21,
2020-04-12 15:11:27,c5f1ef53c24cc0c9f7b2131609e916f913634feb,Bram Moolenaar,4,2,6,2,
2020-04-12 14:38:57,4fdae9996fb9a9bc1291a61e7b85cb360feb7599,Bram Moolenaar,111,15,126,5,
2020-04-12 13:11:06,acc770a10f65107131473ea2ab4ae5d429dfe172,Bram Moolenaar,9,1,10,5,
2020-04-12 12:50:26,cd630becc8849bf4647f04eeb02a4883bf46140e,Bram Moolenaar,3,1,4,2,
2020-04-12 12:39:53,99aaf0ce7cc23b0e759eab2369e266cdc8d46af8,Bram Moolenaar,60,5,65,3,
2020-04-12 11:50:26,1363a30cef382b912bf092969e040333c5c293c6,Bram Moolenaar,141,1,142,5,
2020-04-12 11:38:57,88c1ee84d64d4f2cc25a95a6ccd573f8dc16b073,Bram Moolenaar,21,14,35,2,
2020-04-12 10:54:52,3b922f11380c7dbf94ee45bc09d688b772d9707f,Bram Moolenaar,8,4,12,3,
2020-04-11 21:17:17,08938eeba463e98d23ba7b88e81bd252c981d235,Bram Moolenaar,30,9,39,3,
2020-04-11 20:38:34,e7f234120f71a75f0c7c2a67e0b70c6450c50a02,Bram Moolenaar,15,7,22,2,
2020-04-11 20:31:27,fe270817247b73a9315bb10f0a51b6eca406d300,Bram Moolenaar,52,69,121,3,
2020-04-11 19:42:48,d19a8f97ad58055a5e99cca8498d01e450ae37b2,Bram Moolenaar,20,36,56,2,
2020-04-11 19:31:28,880e4d9117ea990e66d867aefad0f73ba89bda82,Bram Moolenaar,3,0,3,2,
2020-04-11 18:50:33,1378fbc4591b77186c90beda37bdac628add4cb6,Bram Moolenaar,195,76,271,5,
2020-04-11 16:36:38,8832a3457831707286dd2d9252ba14a5f9fd4c60,Bram Moolenaar,10,3,13,2,
2020-04-11 16:01:41,81ea1dfb97af6622c9ad3efdbad317ec965ebaeb,Bram Moolenaar,54,14,68,8,
2020-04-11 15:09:31,004a6781b3cf15ca5dd632c38cc09bb3b253d1f8,Bram Moolenaar,311,95,406,11,
2020-04-10 20:10:56,d1caa941d876181aae0ebebc6ea954045bf0da24,Bram Moolenaar,187,88,275,24,
2020-04-09 19:33:22,7b293c730b07d1586688e622b8d9cbbb4a52379b,Bram Moolenaar,10,2,12,3,
2020-04-09 19:08:09,9c8bb7c0e251be2cca409055bd415266f57f013a,Bram Moolenaar,4,48,52,4,
2020-04-09 18:10:55,cab2767874dca019083aa371a1f3b45385dbd037,Bram Moolenaar,21,0,21,3,
2020-04-09 17:34:43,5da356e07359a59cf2d682908ba8592a72d5d9cd,Bram Moolenaar,38,13,51,5,
2020-04-09 16:42:11,4d23c52824dd2f4577eb980e7d91feed34052755,Bram Moolenaar,166,21,187,5,
2020-04-08 20:56:34,25d57009520f0e590920b9f953b1cbbb358e72a2,Bram Moolenaar,3,1,4,2,
2020-04-08 19:50:25,6a2c5a7dd5c9215cc030d5ea6e4616d782c091dd,Bram Moolenaar,175,167,342,36,
2020-04-08 18:03:52,7035fd9d909c49cf5105a53753c1772c193d05b8,Bram Moolenaar,6,2,8,4,
2020-04-08 17:48:56,476a613135bdc94e61c1dce8a9cbb4ab0b6dc2d1,Bram Moolenaar,357,160,517,6,
2020-04-08 09:31:48,a65c28813425dc1c04424ee18980d1733e982604,Bram Moolenaar,7,1,8,2,
2020-04-07 20:45:00,49cf7cc8d2df1509cbe23647166c6cc954d59513,Bram Moolenaar,28,5,33,4,
2020-04-07 20:05:08,0b76b42d0a09fb6f1ed79cfc153da4edd6154c89,Bram Moolenaar,58,2,60,4,
2020-04-07 18:53:39,ec5929d0fe7e90f953fa5b019486c0c4e5826d92,Bram Moolenaar,101,36,137,6,
2020-04-07 17:57:29,86b9a3e8cd24335195dbe377b98bed1ba291268d,Bram Moolenaar,5,1,6,2,
2020-04-06 21:49:50,40655d501649e0b73e12f940b56f462dee44e06c,Bram Moolenaar,5,4,9,2,
2020-04-06 20:56:28,c74fbfedfa2df384cca5f6763e2c9e5c0ca6d513,Bram Moolenaar,17,18,35,2,
2020-04-06 20:13:01,00d253e2b2f435a5386582c3f857008e7ac355c2,Bram Moolenaar,72,44,116,19,
2020-04-06 19:35:05,ee4e0c1e9a81cb5d96e0060203a9033c2f28588e,Bram Moolenaar,243,41,284,21,
2020-04-06 19:12:42,15352dc6ec43fd50cc3be4f4fd1ad74d5619da20,Bram Moolenaar,16,11,27,3,
2020-04-05 21:04:57,6c307dcd554a1ce14c4279a3c2ede29f972bdb23,Bram Moolenaar,3,1,4,2,
2020-04-05 20:14:54,8922860afb2cf9e89417c0c1417f1fb4458d3b44,Bram Moolenaar,24,3,27,3,
2020-04-05 19:42:12,5ba8d3578c835edcfb7e3b132e623c12e62f250b,Bram Moolenaar,10,1,11,2,
2020-04-05 19:38:23,4c68375057c25e99656bc996d3fa5c6b0b6a7e6a,Bram Moolenaar,88,29,117,13,
2020-04-05 18:21:03,f87a0400fd81862c33d6ad2291a56e178db7dddd,Bram Moolenaar,1047,1001,2048,14,
2020-04-05 17:09:05,b8ed3aa9e708ec0af4e9ee8921ad198f0e949c0d,Bram Moolenaar,9,6,15,2,
2020-04-05 16:56:05,bdff012f4416c75e65950a19688533c4def5abf6,Bram Moolenaar,13,12,25,10,
2020-04-05 16:20:45,5d905c2b9612314f6d8616560800665056050adc,Bram Moolenaar,16,7,23,2,
2020-04-05 15:08:17,5deeb3f1f9db4eabd36e99cbf857fe376eb37e10,Bram Moolenaar,733,459,1192,13,
2020-04-05 13:36:16,d7ffc0ba8ccb039dd19b255368302d9bfe0e010b,Bram Moolenaar,55,29,84,2,
2020-04-04 12:50:32,8d4ed11da635a1abe0ef2d795b4d48824c54d0e7,Bram Moolenaar,14,10,24,3,
2020-04-04 12:00:39,cde0ff39da2459b16007fef701ebaa449fb6fe9d,Bram Moolenaar,452,15,467,14,
2020-04-03 19:59:57,d77a8525d5438cae49f670eb473ef60d87ca5f54,Bram Moolenaar,247,115,362,9,
2020-04-03 16:43:35,5259275347667a90fb88d8ea74331f88ad68edfc,Bram Moolenaar,19,2,21,3,
2020-04-03 16:13:57,d1e9dc272355fe3ab112af5f04b0516b2e9a4fa6,Bram Moolenaar,3,1,4,2,
2020-04-03 10:56:17,01603a9970421272621f7c1ecdc560b522c92e61,Bram Moolenaar,45,10,55,2,
2020-04-02 20:57:36,3cca299520a4980fd1b124564bd67782ca977c15,Bram Moolenaar,31,0,31,2,
2020-04-02 20:33:21,585fea7b98b79f2c6d92fa8a2340e461aff805c8,Bram Moolenaar,70,31,101,3,
2020-04-02 19:13:25,e8c4abbbd711af8fd3ed85ea69e9ac3d63a0d879,Bram Moolenaar,104,32,136,16,
2020-04-02 17:12:08,2c869deeb7658b6b02e525ff9412fc4a0c968688,Bram Moolenaar,8,4,12,2,
2020-04-02 16:50:46,aeea72151c31d686bcbb7b06d895006d7363585c,Bram Moolenaar,176,141,317,34,
2020-04-02 16:34:35,f10806b25090879fdc1a86cc0da2f4f34fd21921,Bram Moolenaar,60,29,89,2,
2020-04-02 14:00:04,4227c789ffe667b74affab38a1b8bea27cd69b36,Bram Moolenaar,3,1,4,2,
2020-04-02 13:17:32,e5bae13da327235836b505ee47224b465713ad75,Bram Moolenaar,3,1,4,2,
2020-04-02 11:50:27,a4d4cf490e2974843c80598e6f40f83aae658fd3,Bram Moolenaar,43,1,44,2,
2020-04-01 21:05:18,80c34ca312506c2c65eef6b119e214f7e6f87eb9,Bram Moolenaar,67,20,87,3,
2020-04-01 20:36:49,ea94fbe83bca69eda4f03e92ecf581d0343c7b47,Bram Moolenaar,4,1,5,2,
2020-04-01 20:11:01,e69f6d044c420d41dced9ba96a3b90f25788e39a,Bram Moolenaar,80,11,91,10,
2020-04-01 19:17:24,a8c1770469504ae66c80bbdb03b6b31641215848,Bram Moolenaar,66,17,83,5,
2020-04-01 17:22:12,2da0f0c445da3c9b35b2a0cd595d10e81ad2a6f9,Bram Moolenaar,9,4,13,4,
2020-04-01 16:29:10,0afdcf8601792ee751984265b49fc2ca6f8ea858,Bram Moolenaar,8,0,8,2,
2020-04-01 14:34:17,25b70c780a7e6063544e7f93c368fe403076f34e,Bram Moolenaar,39,7,46,4,
2020-03-31 21:32:31,05afceeddc4afbbca60e4e6a729a50d33d4b19f7,Bram Moolenaar,36,23,59,3,
2020-03-31 21:13:10,bd5da371aafe5a2207065643502f4d1ff6b286c7,Bram Moolenaar,72,22,94,6,
2020-03-30 20:51:24,9be61bbb170ed3df0e408c8ac12516e772dc0b75,Bram Moolenaar,60,7,67,5,
2020-03-30 19:28:39,01b3862956260fdb5fb81b81a28f4749a92699c0,Bram Moolenaar,6,2,8,2,
2020-03-30 19:22:56,92dba36fc8742fdb51b16d9bb967ef184b4babc1,Bram Moolenaar,11,0,11,2,
2020-03-30 19:05:45,d25ec2cfa0c25c3b00b7f8963b8aea799df1f20a,Bram Moolenaar,14,2,16,3,
2020-03-30 17:32:53,ca68ae13114619df3e4c195b41ad0575516f5ff6,Bram Moolenaar,488,31,519,15,
2020-03-30 17:13:29,7d333a900d260b8e8caa0fb159c85023fc8795bd,Bram Moolenaar,37,32,69,3,
2020-03-29 19:38:15,0b37a2f379f36d097e7fa90a3e86da6a29ed2aaa,Bram Moolenaar,40,2,42,3,
2020-03-29 18:51:07,2027973b5be693577bea0731b50ea4904d19ea8b,Bram Moolenaar,3,75,78,7,
2020-03-29 18:08:45,5908fdf72fa1995735e38c46f254ddde81a87c1f,Bram Moolenaar,16,4,20,3,
2020-03-29 16:40:30,c58164c5cff9845f3bf7cfcd75ace43208829388,Bram Moolenaar,29,1,30,3,
2020-03-29 15:50:48,52ea92b19d2bc992dd4570add64c12d98eab9db2,Bram Moolenaar,7,3,10,2,
2020-03-29 14:18:58,bf54dbeb5ccd2cfb9cc0687fd71ac3b3eddce0da,Bram Moolenaar,9,2,11,2,
2020-03-29 14:06:29,0fff44152d06e6b662ad4bef172af07a041d2f3f,Bram Moolenaar,50,4,54,3,
2020-03-29 13:12:15,8601545338581c01e328cdc3a72c0b12d92c54cf,Bram Moolenaar,13,12,25,2,
2020-03-28 21:37:14,360bdbda817920657a2ec8bf329c96a749dd7224,Bram Moolenaar,2,2,4,2,
2020-03-28 21:06:23,a30590d3e78aed3f6039edc642fb7532c40ea54e,Bram Moolenaar,6,1,7,2,
2020-03-28 20:48:55,7b1b36b1cb744e87adfbef88b7ce26c863b0594a,Bram Moolenaar,3,1,4,2,
2020-03-28 20:38:06,ee619e5bc0992e818f2d9540b093b769b9c27651,Bram Moolenaar,15,2,17,6,
2020-03-28 19:44:41,7c003aa314337ce732e18c541fa93d71cafedf03,Bram Moolenaar,17,22,39,4,
2020-03-28 18:41:33,33fa29cf74ea314f89cfa58ec9ffc2d6781a59d4,Bram Moolenaar,61,7,68,6,
2020-03-28 17:06:31,09c569038c42dcbdaa5c9b35fc9d1afbe5072cb4,Bram Moolenaar,34,30,64,2,
2020-03-28 13:53:20,599c89c82fe3c85378e8077b4e589f0ee4218da2,Bram Moolenaar,54,6,60,3,
2020-03-27 19:59:54,495282b6e7e418d072a8ab53c9056b269dc308b7,Bram Moolenaar,0,2,2,1,
2020-03-27 19:58:37,14285cb801c5ba965fdb89c44e8c27d912edfe4b,Bram Moolenaar,25,15,40,7,
2020-03-27 19:52:45,2d9d409ad4fab1ae7ceaecc0ef0e9b511d868374,Bram Moolenaar,4,6,10,3,
2020-03-27 19:42:43,191acfdecabfbd2a74867e77004196fb3b4a8c14,Bram Moolenaar,614,320,934,12,
2020-03-27 19:24:14,37bb030cd9088ee66dc2d41c2d3602d1e5f4a7ef,Bram Moolenaar,10,4,14,3,
2020-03-27 18:41:02,9207d1f523c2e2fb1c8749ec6f84ab5ecc2c62f4,Bram Moolenaar,4,0,4,2,
2020-03-26 22:13:34,bd5e622bfa12bd80a5ce9406704205400e3faa6a,Bram Moolenaar,4,2,6,2,
2020-03-26 21:16:48,15c476023f3c5fb32eb1936c5eb5f0f5f413f3c7,Bram Moolenaar,308,214,522,5,
2020-03-26 21:09:52,bea9023d4260349c130faf447aa8d4cbadeffab2,Bram Moolenaar,5,0,5,2,
2020-03-26 20:11:58,26bde6e2eb307898ab7ed42bf8e7e2ccde979e02,Bram Moolenaar,4,1,5,2,
2020-03-26 19:51:43,72749f062f15c7147f512bc581695c25ad78fb4e,Bram Moolenaar,8,3,11,2,
2020-03-26 19:34:00,83d4790a04780328c9c7ad22d18f404a27c11601,Bram Moolenaar,194,32,226,8,
2020-03-26 15:50:57,3ed9efc2b15b624268bcce4e4d312fb35840a12b,Bram Moolenaar,22,10,32,3,
2020-03-26 15:27:38,7851b1ca992222880df1314684a790f293e11896,Bram Moolenaar,16,6,22,3,
2020-03-26 15:03:45,a9c3a30891edd7347d94298c48ea68bb5c165fd7,Bram Moolenaar,13,2,15,2,
2020-03-26 14:39:53,82e743c5b343847d88b958594ad3433213ef9405,Bram Moolenaar,8,0,8,2,
2020-03-26 13:11:58,7d941ee032c02a4b682201881eb5c1f1958f17ee,Bram Moolenaar,165,83,248,4,
2020-03-26 12:15:42,cf3f8bf4ddfbc0f5ce53f0c9270dc15567f4feea,Bram Moolenaar,8,3,11,3,
2020-03-25 21:23:46,0e05de46226eb4e5ea580beefa71831f92d613d3,Bram Moolenaar,190,1,191,26,
2020-03-25 20:27:22,bfcfd5784a2fe950d8e58d1d534bbbb4824524eb,Bram Moolenaar,11,6,17,2,
2020-03-25 20:13:46,a07e31af545b91925362854a48c42fee16dd8c28,Bram Moolenaar,27,0,27,2,
2020-03-25 19:17:00,f66ca9f1df535c8042292ce20f4260cafc877670,Bram Moolenaar,8,6,14,2,
2020-03-24 20:44:51,d36ef573b2fad620824495f5423cb649cde55e03,Bram Moolenaar,9,5,14,2,
2020-03-24 20:42:01,45fffdf10b7cb6e59794e76e9b8a2930fcb4b192,Bram Moolenaar,2462,2432,4894,17,
2020-03-24 19:35:19,71658f74ae64c366b2d35b82c0a2eadb1317f028,Bram Moolenaar,11,10,21,2,
2020-03-24 11:12:30,f3710ee22d0039cea2f970452b5faf56e89a6ab0,Bram Moolenaar,7,4,11,2,
2020-03-24 09:33:00,d06dbf3f42c8a8a3967905dd2f2a31077af15438,Bram Moolenaar,7,2,9,2,
2020-03-23 21:53:22,1082772f4c29bceebf5eb06f7e1f01bd143a2131,Bram Moolenaar,18,10,28,2,
2020-03-23 21:46:44,d7b7770f11c16cfac707b5048c61e722dcc903a6,Bram Moolenaar,4,1,5,2,
2020-03-23 21:17:11,0df541963d406edd69d3ebe8de3912eb87b05414,Bram Moolenaar,31,70,101,2,
2020-03-23 21:12:22,db99f9f29a248b84742b6779c3343123f72065e7,Bram Moolenaar,32,30,62,9,
2020-03-23 21:01:17,dbbb0ef729e392e313ccc63c247bff1b828a214d,Bram Moolenaar,5,1,6,2,
2020-03-23 20:45:29,a8bd3496380ceb32e544dfe39cb4d52e4943068c,Bram Moolenaar,5,0,5,2,
2020-03-23 19:54:32,bad8804cdd739a5a7321b8411ad7fd4f45741b54,Bram Moolenaar,34,7,41,6,
2020-03-23 18:28:44,ab505b1a4868b3e21356f95a275537551700c955,Bram Moolenaar,23,19,42,6,
2020-03-23 18:17:29,56ba21a156c723d92a1929e2c500be7295efb0a8,Bram Moolenaar,3,1,4,2,
2020-03-22 20:23:47,5080b0a0470511bae6176a704d4591d1caba0d07,Bram Moolenaar,110,14,124,3,
2020-03-22 19:13:39,c5a8fdc42dbd304598b2d73db754c7b97665b182,Bram Moolenaar,5,0,5,2,
2020-03-22 18:25:50,d5bc32df207eae408263ae6ab737771365d0bca1,Bram Moolenaar,12,2,14,2,
2020-03-22 15:17:14,7929651e05b081fe55e0e745725a7ad78c51be16,Bram Moolenaar,1008,312,1320,5,
2020-03-22 13:41:22,9b9be007e7d674f49fc2b650f840d08532b180ad,Bram Moolenaar,47,3,50,6,
2020-03-22 13:08:59,515545e11f523d14343b1e588dc0b9bd3d362bc2,Bram Moolenaar,856,343,1199,12,
2020-03-22 12:44:28,97acfc781bdb7fa2838dc6e0e7f9952ea61bb2fd,Bram Moolenaar,16,7,23,3,
2020-03-21 14:17:20,ce436de5a9b94886baf023b3d22193cc68d0e9d1,Bram Moolenaar,43,8,51,2,
2020-03-20 20:15:51,0f1563ffee4397f5b379517c41b7c9a977fd2e22,Bram Moolenaar,16,1,17,3,
2020-03-20 19:48:49,9645e2d9fc8a591f1db30383caccf71d40e0810c,Bram Moolenaar,28,13,41,4,
2020-03-20 18:37:47,f1ec378b014efb9897422c40369a6462163a512a,Bram Moolenaar,25,9,34,4,
2020-03-20 17:39:46,20431c9dbb592ebe0666bf042af7d2b373107372,Bram Moolenaar,177,35,212,9,
2020-03-20 17:20:51,8b633135106dda8605463b780573c45b00c22afe,Bram Moolenaar,228,53,281,18,
2020-03-20 17:12:59,98be7fecac80b30c5a323b67903eb1d0094007ea,Bram Moolenaar,26,27,53,3,
2020-03-19 19:37:11,ff78155aa1755aced96a3b343e81939c94aac721,Bram Moolenaar,104,53,157,15,
2020-03-19 19:33:33,95e59a355bea9d6234fead07d855880e822a8eaf,Bram Moolenaar,4,0,4,2,
2020-03-19 19:32:01,40d235e7305ce6ff696e8301c62a41f1f07f8aca,Bram Moolenaar,8,2,10,3,
2020-03-19 18:44:32,373a876d0cac5f8aff352e8ca42fdac88a1a7c3b,Bram Moolenaar,8,32,40,4,
2020-03-19 17:46:57,5e94a29ebbde10dd973d58f1adba9a2fc83877d1,Bram Moolenaar,118,49,167,7,
2020-03-19 16:13:40,37f471df6ee422beb4d08ee4ccda35f8279e3bb7,Bram Moolenaar,18,15,33,2,
2020-03-19 15:28:44,24e9b6fe4b5d09bcced1318c6c1b92d807e96ac7,Bram Moolenaar,3,4,7,2,
2020-03-19 15:22:44,3696839ef1165804159e28f50cb6113acc3d519d,Bram Moolenaar,4,1,5,2,
2020-03-19 14:05:28,b68df220c5278365792b8f94d8d6f34d329b7746,Bram Moolenaar,60,90,150,2,
2020-03-19 13:52:20,22da5596d00222c889b548daa2df5a289583a5fb,Bram Moolenaar,3,1,4,2,
2020-03-19 13:37:30,2d10cd478047df8ba144d4b0fcc46480993af57f,Bram Moolenaar,12,6,18,4,
2020-03-19 12:55:03,e32848780cc07c368ba2e088cdefdbb8c3b827c2,Bram Moolenaar,43,0,43,2,
2020-03-19 12:36:56,3fa5e1326290e181215f805db17793f42cf73079,Bram Moolenaar,7,4,11,2,
2020-03-19 12:08:45,18a2b87ca27c378a555b20f14a284d2ce3511427,Bram Moolenaar,6,1,7,3,
2020-03-19 11:38:34,a3a9c8ef697bbf6f640cde99710b6f534f29f77d,Bram Moolenaar,13,6,19,3,
2020-03-18 20:10:44,30d53e2c11e670845830bdfc29bf8c1615df61a8,Bram Moolenaar,6,4,10,4,
2020-03-18 18:32:26,8dfcce3a78ccb520cc9d09081f998091494c50bf,Bram Moolenaar,274,12,286,12,
2020-03-18 18:18:10,3cdcb090a664e182078f7cc0ca3e4e5a94bbb784,Bram Moolenaar,17,4,21,5,
2020-03-18 14:23:16,292b90d4fa11022661f449dd3efb73d5ac737313,Bram Moolenaar,29,4,33,7,
2020-03-17 19:57:09,a21df1db3ca619afdcb47931af042508a6bbc8e5,Bram Moolenaar,16,12,28,2,
2020-03-16 21:08:45,5715b3147bfc8ddfe905339f6fd224fd3a5a3ba1,Bram Moolenaar,9,2,11,2,
2020-03-16 20:25:24,24ebd83e030e1c6f9a6be1f06232756ba4d00a8c,Bram Moolenaar,197,14,211,5,
2020-03-16 20:08:31,a2cbdea9685f9592ee22bda7b58953d2bbaa4c47,Bram Moolenaar,4,0,4,2,
2020-03-16 19:27:38,7f009dfa064240d9024b76212535a35231912511,Bram Moolenaar,3,1,4,2,
2020-03-16 19:07:16,c0300633292ee648c7154a7828eb1c76637bd9af,Bram Moolenaar,9,6,15,2,
2020-03-16 19:04:41,56cb3378727783da2d246b9c5091784821666cfa,Bram Moolenaar,23,17,40,2,
2020-03-16 11:09:30,b2e1f8a28fab71c7ef38d39226967be8c3559590,Bram Moolenaar,8,3,11,2,
2020-03-15 19:33:40,ddbfe238a50dc846f2f722e9d870fc0dff5a2764,Bram Moolenaar,10,6,16,5,
2020-03-15 18:17:50,e4fc746d13f5b6a0b5c3a8efdff7de1454c3297d,Bram Moolenaar,3,1,4,2,
2020-03-15 17:27:43,833805a4867cf5f93b3ef91227d1f1a98f553dff,Bram Moolenaar,52,23,75,3,
2020-03-15 17:15:03,bb65a5690c24ccfce37e210316bf1d0964c91359,Bram Moolenaar,17,10,27,2,
2020-03-15 15:51:40,0bdbc10e8a74e7dd447cd975fb1445bbdcbb4f37,Bram Moolenaar,3,11,14,2,
2020-03-15 15:13:53,0eabd4dc8ff50658f0ea0e92c7918a42242f6b80,Bram Moolenaar,721,31,752,10,
2020-03-15 14:10:11,5e4d1eba9579ea6b876ad699d77742e657505d35,Bram Moolenaar,11,7,18,2,
2020-03-15 13:53:35,4f32f9c90e5710627467d74b415b3dc46fcc593a,Bram Moolenaar,3,1,4,2,
2020-03-15 13:19:26,353c351bd22e4dac4c3ae9cd7731032348f248c4,Bram Moolenaar,24,20,44,14,
2020-03-14 16:21:34,2573af3519ad062ddad647b97e32090f106f2ac1,Bram Moolenaar,30,1,31,3,
2020-03-14 14:28:08,193982650960f8411df51f3b3b0d44a75e1ac034,Bram Moolenaar,69,3,72,4,
2020-03-14 07:19:51,b17893aa940dc7d45421f875f5d90855880aad27,Bram Moolenaar,253,119,372,14,
2020-03-14 06:46:40,965fd8d4dc5e84f612d8fc1efeaa78bd17842c9b,Bram Moolenaar,4,1,5,2,
2020-03-13 20:36:40,346f18e5fe12e6aaba5a6a18f6d0deb55eb7a9e8,Bram Moolenaar,21,7,28,3,
2020-03-13 14:44:49,d47e6f0b4cc82e3ccdc4605bb1811861a5b2d115,Bram Moolenaar,21,4,25,2,
2020-03-13 13:55:23,fa5d8a191d0f2deacffebf62dced5c2198cc0880,Bram Moolenaar,3,1,4,2,
2020-03-13 13:34:38,8210693795d6d0d51bf5b70674d4539cdde0330b,Bram Moolenaar,29,21,50,2,
2020-03-12 18:15:45,8a677a37d03692db274c8b00cb20dbba9604505e,Bram Moolenaar,3,1,4,2,
2020-03-11 18:30:01,3a05ce63feae040cd817be289e84c2a7e653d59d,Bram Moolenaar,8,3,11,3,
2020-03-11 18:15:52,66b98854d86f641db036fd1e6cf20f7b8905344e,Bram Moolenaar,44,26,70,3,
2020-03-11 13:19:58,cee52204ca030ce7814844e4dab8b4ed897ba3cc,Bram Moolenaar,53,2,55,6,
2020-03-11 12:01:40,e49b4bb89505fad28cf89f0891aef3e2d397919e,Bram Moolenaar,13,0,13,3,
2020-03-10 06:48:13,1671f4488105ee12a6a8558ae351436c26ab55fc,Bram Moolenaar,442,50,492,18,
2020-03-09 18:25:27,5269bd2a724fdb8c16c9635ef744a670f1bc8bd5,Bram Moolenaar,63,7,70,6,
2020-03-09 15:40:41,3a2505cc183b3c5f4852ae8a945172582fbc650f,Bram Moolenaar,6,0,6,3,
2020-03-09 11:13:27,2e09634a7880f55a61cb6b959dd89c51972866af,Bram Moolenaar,127,44,171,2,
2020-03-09 07:17:52,283e5f4e69b204e0eafd408548e69b7ca9b4871b,Bram Moolenaar,21,11,32,3,
2020-03-08 17:41:09,693e80e93897aff3b07a1ef12b68a6527702f3d7,Bram Moolenaar,14,4,18,2,
2020-03-08 04:13:15,f5f1e10d0d39890298cdf27f664d466c8872b87e,Bram Moolenaar,296,25,321,9,
2020-03-07 16:24:59,d0d440f702d1c6fef36386f8b91d074d0f3e4718,Bram Moolenaar,10,3,13,2,
2020-03-07 15:59:25,14e57909e662a43a42438e2701654af48af49b03,Bram Moolenaar,15,4,19,3,
2020-03-06 21:25:56,8eab73132838e977092d7b46f70b4ecf6274fd6a,Bram Moolenaar,7,0,7,3,
2020-03-06 20:43:17,ba2920fe976b37326933afa820616523b509495f,Bram Moolenaar,18,2,20,3,
2020-03-06 19:36:04,bd7206e02c957f0619e68e1628e2a3e91dd41e06,Bram Moolenaar,188,0,188,8,
2020-03-05 20:52:55,49b79bd4888341d527c95f2aa73ed953203ce2b6,Bram Moolenaar,30,1,31,4,
2020-03-04 22:21:35,8f027fe470555252b258508c455e93700a969cb1,Bram Moolenaar,49,31,80,4,
2020-03-04 21:20:26,a471eeae75cda982bb6ddffbb0cbb71d868b97bf,Bram Moolenaar,13,11,24,4,
2020-03-04 21:06:07,a65bb53514a1af1ec0dc5c4831dfaef69f139a48,Bram Moolenaar,2,1,3,2,
2020-03-04 20:50:46,d0df1aacd81000d95815bea397257d8dc0d2c72d,Bram Moolenaar,40,22,62,2,
2020-03-03 22:06:48,36ddf9383181f93b080eb26121bdff37e394d2db,Bram Moolenaar,16,17,33,4,
2020-03-03 21:56:39,3e919d2924c87eb8fee62603788fcc3ced2a0031,Bram Moolenaar,3,0,3,2,
2020-03-03 20:53:32,080457c02d51f87e7d61ebd3e3aeef4468be939c,Bram Moolenaar,232,136,368,2,
2020-03-03 18:02:12,6d69bf602b4ebdb195f02953a0b33c91ec08e599,Bram Moolenaar,104,0,104,2,
2020-03-02 21:53:32,5381c7a1628eeca81a46b811158be4cd47ba5815,Bram Moolenaar,50,16,66,5,
2020-03-02 19:54:22,91ffc8a5f5c7b1c6979b3352a12ed779d11173a9,Bram Moolenaar,120,10,130,7,
2020-03-01 22:32:25,61a6d4e48b4778bdbc741af8ac59519b70f65db8,Bram Moolenaar,70,13,83,6,
2020-03-01 19:34:26,815eb83b09914ecff32193913a373cb385868421,Bram Moolenaar,4,0,4,2,
2020-03-01 18:41:43,ab55c6826f9080477fea6d5593f0b77931acfc1d,Bram Moolenaar,3,0,3,2,
2020-03-01 18:06:45,eab6dff19f387469a200011bc6cf3508f5e43a4a,Bram Moolenaar,460,150,610,12,
2020-03-01 16:55:14,f51cb4e08ef904d137c27fe7cddb4702d8dcb2a2,Bram Moolenaar,64,2,66,5,
2020-03-01 15:53:09,0546d7df13b041833121b2d56036e1c62ea3b0c1,Bram Moolenaar,60,1,61,5,
2020-03-01 15:22:40,41fe061753923986e6676424132960d970bb2a76,Bram Moolenaar,20,2,22,3,
2020-03-01 14:36:42,087d2e15184bea3bf455dd266bd6ed66a45396e5,Bram Moolenaar,47,9,56,5,
2020-03-01 13:04:46,fbdd08ed9b1798885915c7f27c94786906d258e4,Bram Moolenaar,628,519,1147,7,
2020-03-01 12:01:16,f4f190d8219fc93c6e58e54ce7c1ac15af07840f,Bram Moolenaar,6,0,6,2,
2020-03-01 00:05:53,b54b8e0c86b0590394803157818c72412a6f0b6a,Bram Moolenaar,3,1,4,2,
2020-02-29 22:23:47,42a480bf7243ea8bce498264911e187931d083e5,Bram Moolenaar,176,13,189,6,
2020-02-29 21:06:30,cc390ff5b2c8725c55b961b24322c470659ede9f,Bram Moolenaar,35,0,35,4,
2020-02-29 16:38:12,dd58923c6bcb026de7134d9874e69e0a2b01682d,Bram Moolenaar,30,13,43,7,
2020-02-29 15:09:16,57c339569e96725e24e79944bf99f70c50afb5b1,Bram Moolenaar,10,9,19,3,
2020-02-29 13:23:58,d30ae2fc4acb3861fc7dc9618c1f90eee997d412,Bram Moolenaar,71,5,76,3,
2020-02-29 12:43:27,7c215c58936cbebd4132ad6112d04db54b7c153e,Bram Moolenaar,15,2,17,4,
2020-02-28 21:51:54,57c732ed782607ce6a8c4f9eeb65b95a00e37701,Bram Moolenaar,4,0,4,2,
2020-02-28 21:44:47,ec084d3356cc2a23f2f44707810c38ab590d2e66,Bram Moolenaar,30,4,34,3,
2020-02-28 21:20:10,e52e0c89d1a6305beca3c01f89a4892dcb43bc71,Bram Moolenaar,126,34,160,10,
2020-02-28 18:11:18,80ae880f5fed8022c69d05dd1efee49259929cb5,Bram Moolenaar,38,3,41,3,
2020-02-27 20:48:51,d5aec0ced17f8f60761128bff32e54ad2d1d57ef,Bram Moolenaar,3,1,4,2,
2020-02-27 20:32:51,578fe947e3ad0cc7313c798cf76cc43dbf9b4ea6,Bram Moolenaar,200,3,203,6,
2020-02-26 21:06:00,12f20038714928bfecdeee31ed1f927324542034,Bram Moolenaar,76,39,115,5,
2020-02-26 20:24:23,7eeefd4a395fe3d7c7a2a0879467cf7ed4c29fe6,Bram Moolenaar,72,12,84,4,
2020-02-26 19:15:18,b35efa5ed040162f5c988c71dfc1159045e47585,Bram Moolenaar,27,12,39,4,
2020-02-26 17:23:43,ad39c094d261109a695aba2c4f19fe336736cc55,Bram Moolenaar,157,3,160,6,
2020-02-26 15:16:53,b3f740695a0199d22cd97aee314f06c7ae32d2ea,Bram Moolenaar,6312,151,6463,41,
2020-02-26 12:43:51,d672dde584effd55702ee15efec4cb2a8c77bf85,Bram Moolenaar,7,4,11,5,
2020-02-26 12:36:21,bc93cebb692f47488d66f078d1728031e9be35e7,Bram Moolenaar,464,177,641,12,
2020-02-25 21:58:29,0c2ca58ef06ac49d40330bbe1ee70c3d8af7a648,Bram Moolenaar,20,2,22,5,
2020-02-25 21:04:55,703ea9eaefd3628d75c8c2fa19f934f6832638f1,Bram Moolenaar,8,3,11,2,
2020-02-25 20:47:45,8d588ccee57390aa01c2395fc599bbe6506ee13a,Bram Moolenaar,163,1,164,6,
2020-02-25 20:26:49,c593bec4120f122e8a9129ec461968f1bd214435,Bram Moolenaar,13,5,18,3,
2020-02-24 20:37:54,e010c720b2024d8c6df45c60c6001c3b4f157de1,Bram Moolenaar,10,0,10,3,
2020-02-23 21:35:05,fa29c8abd62c2733d5505563600ea35dddf73dca,Bram Moolenaar,55,7,62,3,
2020-02-23 20:25:54,f2d5c240a56853c0bbbc7979e9bff095de6c73ec,Bram Moolenaar,159,72,231,5,
2020-02-23 17:08:33,750802b55c6edda4d3bc78c41ad0a25a3450a557,Bram Moolenaar,27,0,27,3,
2020-02-23 15:16:26,8fb1b47a5e24892b23c3923a07d8a850d99b14b2,Bram Moolenaar,9,5,14,2,
