date,hexsha,author,insertions,deletions,lines,files,files_json
2022-02-27 14:28:31,5c52be40fbab14e050d7494d85be9039f07f7f8f,Bram Moolenaar,27,0,27,4,"{""src/cmdexpand.c"": {""insertions"": 4, ""deletions"": 0, ""lines"": 4}, ""src/testdir/dumps/Test_wildmenu_pum_41.dump"": {""insertions"": 10, ""deletions"": 0, ""lines"": 10}, ""src/testdir/test_cmdline.vim"": {""insertions"": 11, ""deletions"": 0, ""lines"": 11}, ""src/version.c"": {""insertions"": 2, ""deletions"": 0, ""lines"": 2}}"
2022-02-27 12:31:52,cbef12e60b2c5a4f026172ab9873deaab2e70cf2,xtkoba,5,1,6,2,"{""src/os_unix.c"": {""insertions"": 3, ""deletions"": 1, ""lines"": 4}, ""src/version.c"": {""insertions"": 2, ""deletions"": 0, ""lines"": 2}}"
2022-02-27 12:07:30,6caeda2fce4bccac2dd43ca9fee1d32ee96b708d,Yegappan Lakshmanan,139,28,167,6,"{""src/cmdexpand.c"": {""insertions"": 8, ""deletions"": 6, ""lines"": 14}, ""src/map.c"": {""insertions"": 75, ""deletions"": 19, ""lines"": 94}, ""src/proto/map.pro"": {""insertions"": 1, ""deletions"": 1, ""lines"": 2}, ""src/search.c"": {""insertions"": 1, ""deletions"": 1, ""lines"": 2}, ""src/testdir/test_cmdline.vim"": {""insertions"": 52, ""deletions"": 1, ""lines"": 53}, ""src/version.c"": {""insertions"": 2, ""deletions"": 0, ""lines"": 2}}"
2022-02-26 16:05:08,00333cb3b341499df8729b9345f0bbad968cda0b,Yegappan Lakshmanan,18,6,24,3,"{""src/cmdexpand.c"": {""insertions"": 12, ""deletions"": 6, ""lines"": 18}, ""src/testdir/test_cmdline.vim"": {""insertions"": 4, ""deletions"": 0, ""lines"": 4}, ""src/version.c"": {""insertions"": 2, ""deletions"": 0, ""lines"": 2}}"
2022-02-26 15:52:08,29ab6ce9f36660cffaad3c8789e71162e5db5d2f,Bram Moolenaar,9,12,21,2,"{""src/cmdexpand.c"": {""insertions"": 7, ""deletions"": 12, ""lines"": 19}, ""src/version.c"": {""insertions"": 2, ""deletions"": 0, ""lines"": 2}}"
2022-02-26 12:25:45,c51cf0329809c7ae946c59d6f56699227efc9d1b,Bram Moolenaar,27082,8728,35810,44,"{""runtime/autoload/dist/ft.vim"": {""insertions"": 1, ""deletions"": 1, ""lines"": 2}, ""runtime/doc/Makefile"": {""insertions"": 2, ""deletions"": 0, ""lines"": 2}, ""runtime/doc/autocmd.txt"": {""insertions"": 2, ""deletions"": 2, ""lines"": 4}, ""runtime/doc/builtin.txt"": {""insertions"": 53, ""deletions"": 53, ""lines"": 106}, ""runtime/doc/change.txt"": {""insertions"": 2, ""deletions"": 2, ""lines"": 4}, ""runtime/doc/channel.txt"": {""insertions"": 3, ""deletions"": 3, ""lines"": 6}, ""runtime/doc/cmdline.txt"": {""insertions"": 1, ""deletions"": 1, ""lines"": 2}, ""runtime/doc/diff.txt"": {""insertions"": 6, ""deletions"": 6, ""lines"": 12}, ""runtime/doc/editing.txt"": {""insertions"": 2, ""deletions"": 2, ""lines"": 4}, ""runtime/doc/eval.txt"": {""insertions"": 32, ""deletions"": 30, ""lines"": 62}, ""runtime/doc/fold.txt"": {""insertions"": 1, ""deletions"": 1, ""lines"": 2}, ""runtime/doc/ft_raku.txt"": {""insertions"": 12, ""deletions"": 12, ""lines"": 24}, ""runtime/doc/ft_rust.txt"": {""insertions"": 2, ""deletions"": 2, ""lines"": 4}, ""runtime/doc/ft_sql.txt"": {""insertions"": 6, ""deletions"": 6, ""lines"": 12}, ""runtime/doc/gui.txt"": {""insertions"": 2, ""deletions"": 2, ""lines"": 4}, ""runtime/doc/help.txt"": {""insertions"": 2, ""deletions"": 1, ""lines"": 3}, ""runtime/doc/if_pyth.txt"": {""insertions"": 6, ""deletions"": 2, ""lines"": 8}, ""runtime/doc/insert.txt"": {""insertions"": 4, ""deletions"": 4, ""lines"": 8}, ""runtime/doc/map.txt"": {""insertions"": 4, ""deletions"": 4, ""lines"": 8}, ""runtime/doc/motion.txt"": {""insertions"": 1, ""deletions"": 1, ""lines"": 2}, ""runtime/doc/options.txt"": {""insertions"": 12, ""deletions"": 12, ""lines"": 24}, ""runtime/doc/os_vms.txt"": {""insertions"": 4, ""deletions"": 4, ""lines"": 8}, ""runtime/doc/pattern.txt"": {""insertions"": 1, ""deletions"": 1, ""lines"": 2}, ""runtime/doc/pi_netrw.txt"": {""insertions"": 3, ""deletions"": 3, ""lines"": 6}, ""runtime/doc/print.txt"": {""insertions"": 8, ""deletions"": 8, ""lines"": 16}, ""runtime/doc/quickfix.txt"": {""insertions"": 21, ""deletions"": 3, ""lines"": 24}, ""runtime/doc/sign.txt"": {""insertions"": 1, ""deletions"": 1, ""lines"": 2}, ""runtime/doc/spell.txt"": {""insertions"": 2, ""deletions"": 2, ""lines"": 4}, ""runtime/doc/starting.txt"": {""insertions"": 1, ""deletions"": 1, ""lines"": 2}, ""runtime/doc/syntax.txt"": {""insertions"": 5, ""deletions"": 5, ""lines"": 10}, ""runtime/doc/tabpage.txt"": {""insertions"": 9, ""deletions"": 9, ""lines"": 18}, ""runtime/doc/tags"": {""insertions"": 16, ""deletions"": 2, ""lines"": 18}, ""runtime/doc/tagsrch.txt"": {""insertions"": 1, ""deletions"": 1, ""lines"": 2}, ""runtime/doc/term.txt"": {""insertions"": 1, ""deletions"": 1, ""lines"": 2}, ""runtime/doc/terminal.txt"": {""insertions"": 2, ""deletions"": 2, ""lines"": 4}, ""runtime/doc/tips.txt"": {""insertions"": 14, ""deletions"": 14, ""lines"": 28}, ""runtime/doc/undo.txt"": {""insertions"": 2, ""deletions"": 2, ""lines"": 4}, ""runtime/doc/usr_05.txt"": {""insertions"": 1, ""deletions"": 1, ""lines"": 2}, ""runtime/doc/various.txt"": {""insertions"": 2, ""deletions"": 2, ""lines"": 4}, ""runtime/doc/version8.txt"": {""insertions"": 2, ""deletions"": 8503, ""lines"": 8505}, ""runtime/doc/version9.txt"": {""insertions"": 26799, ""deletions"": 0, ""lines"": 26799}, ""runtime/doc/vim9.txt"": {""insertions"": 12, ""deletions"": 3, ""lines"": 15}, ""runtime/doc/windows.txt"": {""insertions"": 7, ""deletions"": 7, ""lines"": 14}, ""runtime/indent/vim.vim"": {""insertions"": 12, ""deletions"": 6, ""lines"": 18}}"
2022-02-26 11:46:13,e41c1dd8890d3f701253255993f4e9af2d12225c,=?UTF-8?q?Dundar=20G=C3=B6c?=,7,5,12,4,"{""src/testdir/test_expr.vim"": {""insertions"": 1, ""deletions"": 1, ""lines"": 2}, ""src/testdir/test_vim9_expr.vim"": {""insertions"": 3, ""deletions"": 3, ""lines"": 6}, ""src/testdir/test_vimscript.vim"": {""insertions"": 1, ""deletions"": 1, ""lines"": 2}, ""src/version.c"": {""insertions"": 2, ""deletions"": 0, ""lines"": 2}}"
2022-02-26 11:04:42,4df5b33f206210fec2a0297aea27e7db8b5173c0,Yegappan Lakshmanan,29,7,36,3,"{""src/cmdexpand.c"": {""insertions"": 15, ""deletions"": 7, ""lines"": 22}, ""src/testdir/test_cmdline.vim"": {""insertions"": 12, ""deletions"": 0, ""lines"": 12}, ""src/version.c"": {""insertions"": 2, ""deletions"": 0, ""lines"": 2}}"
2022-02-26 10:31:32,5a2d4a3ecb67942d47615507a163ffcd5863c073,Yegappan Lakshmanan,183,39,222,5,"{""src/alloc.h"": {""insertions"": 30, ""deletions"": 19, ""lines"": 49}, ""src/quickfix.c"": {""insertions"": 17, ""deletions"": 13, ""lines"": 30}, ""src/testdir/test_quickfix.vim"": {""insertions"": 132, ""deletions"": 7, ""lines"": 139}, ""src/version.c"": {""insertions"": 2, ""deletions"": 0, ""lines"": 2}, ""src/vim.h"": {""insertions"": 2, ""deletions"": 0, ""lines"": 2}}"
2022-02-25 21:47:48,416b5f4894196947ea87eea2ed4fda3504674f72,Bram Moolenaar,4,0,4,2,"{""src/spellfile.c"": {""insertions"": 2, ""deletions"": 0, ""lines"": 2}, ""src/version.c"": {""insertions"": 2, ""deletions"": 0, ""lines"": 2}}"
2022-02-25 21:35:17,9383a3afb6a2b7ba6a2739a66a68cc8e1162f389,Bram Moolenaar,3,1,4,2,"{""src/userfunc.c"": {""insertions"": 1, ""deletions"": 1, ""lines"": 2}, ""src/version.c"": {""insertions"": 2, ""deletions"": 0, ""lines"": 2}}"
2022-02-25 21:10:53,62628d97c4690462ca54781fd16bbfc7ad31477b,Bram Moolenaar,3,1,4,2,"{""src/version.c"": {""insertions"": 2, ""deletions"": 0, ""lines"": 2}, ""src/vim9cmds.c"": {""insertions"": 1, ""deletions"": 1, ""lines"": 2}}"
2022-02-25 21:05:36,ae49aa8434f325f476245ccf5ef119f49c609877,Bram Moolenaar,3,1,4,2,"{""src/drawline.c"": {""insertions"": 1, ""deletions"": 1, ""lines"": 2}, ""src/version.c"": {""insertions"": 2, ""deletions"": 0, ""lines"": 2}}"
2022-02-25 20:57:11,05c1734c4f70a0d7fb2f06444e26afda018f8795,Bram Moolenaar,3,1,4,2,"{""src/ex_getln.c"": {""insertions"": 1, ""deletions"": 1, ""lines"": 2}, ""src/version.c"": {""insertions"": 2, ""deletions"": 0, ""lines"": 2}}"
2022-02-25 20:48:26,68afde4c9b4379b757cc72112c33df9cf221eba8,Bram Moolenaar,3,0,3,2,"{""src/terminal.c"": {""insertions"": 1, ""deletions"": 0, ""lines"": 1}, ""src/version.c"": {""insertions"": 2, ""deletions"": 0, ""lines"": 2}}"
2022-02-25 17:45:04,0e71b7d4ce3e1210150ce772e1af6956057a71ed,Bram Moolenaar,1,0,1,1,"{""src/testdir/test_filetype.vim"": {""insertions"": 1, ""deletions"": 0, ""lines"": 1}}"
2022-02-25 17:42:23,5c6edf41f9beffea21ce45d658822cc4c0745fdb,Cam Sinclair,6,1,7,3,"{""src/dosinst.c"": {""insertions"": 1, ""deletions"": 1, ""lines"": 2}, ""src/testdir/test_filetype.vim"": {""insertions"": 1, ""deletions"": 0, ""lines"": 1}, ""src/version.c"": {""insertions"": 4, ""deletions"": 0, ""lines"": 4}}"
2022-02-25 15:24:24,5ec633b9b0400519db60253cb5846e50394218b4,Yegappan Lakshmanan,63,33,96,4,"{""src/cmdexpand.c"": {""insertions"": 41, ""deletions"": 32, ""lines"": 73}, ""src/search.c"": {""insertions"": 1, ""deletions"": 1, ""lines"": 2}, ""src/testdir/test_cmdline.vim"": {""insertions"": 19, ""deletions"": 0, ""lines"": 19}, ""src/version.c"": {""insertions"": 2, ""deletions"": 0, ""lines"": 2}}"
2022-02-24 17:59:09,4d56b971cbae01cc454eb09713326224993e38ed,=?UTF-8?q?Teubel=20Gy=C3=B6rgy?=,45,0,45,4,"{""runtime/autoload/dist/ft.vim"": {""insertions"": 4, ""deletions"": 0, ""lines"": 4}, ""runtime/filetype.vim"": {""insertions"": 1, ""deletions"": 0, ""lines"": 1}, ""src/testdir/test_filetype.vim"": {""insertions"": 38, ""deletions"": 0, ""lines"": 38}, ""src/version.c"": {""insertions"": 2, ""deletions"": 0, ""lines"": 2}}"
2022-02-24 13:28:41,38b85cb4d7216705058708bacbc25ab90cd61595,Yegappan Lakshmanan,850,117,967,14,"{""runtime/doc/options.txt"": {""insertions"": 8, ""deletions"": 0, ""lines"": 8}, ""src/buffer.c"": {""insertions"": 116, ""deletions"": 53, ""lines"": 169}, ""src/cmdexpand.c"": {""insertions"": 105, ""deletions"": 16, ""lines"": 121}, ""src/option.c"": {""insertions"": 148, ""deletions"": 42, ""lines"": 190}, ""src/option.h"": {""insertions"": 1, ""deletions"": 0, ""lines"": 1}, ""src/optionstr.c"": {""insertions"": 1, ""deletions"": 1, ""lines"": 2}, ""src/proto/cmdexpand.pro"": {""insertions"": 1, ""deletions"": 0, ""lines"": 1}, ""src/proto/option.pro"": {""insertions"": 1, ""deletions"": 1, ""lines"": 2}, ""src/proto/search.pro"": {""insertions"": 3, ""deletions"": 0, ""lines"": 3}, ""src/search.c"": {""insertions"": 131, ""deletions"": 3, ""lines"": 134}, ""src/structs.h"": {""insertions"": 8, ""deletions"": 0, ""lines"": 8}, ""src/testdir/gen_opt_test.vim"": {""insertions"": 2, ""deletions"": 1, ""lines"": 3}, ""src/testdir/test_cmdline.vim"": {""insertions"": 323, ""deletions"": 0, ""lines"": 323}, ""src/version.c"": {""insertions"": 2, ""deletions"": 0, ""lines"": 2}}"
2022-02-24 12:33:17,9c9be05b17ececb1515a2f41a4dedbf848d3d8b6,Yegappan Lakshmanan,183,14,197,5,"{""src/quickfix.c"": {""insertions"": 8, ""deletions"": 5, ""lines"": 13}, ""src/testdir/test_makeencoding.vim"": {""insertions"": 14, ""deletions"": 0, ""lines"": 14}, ""src/testdir/test_quickfix.vim"": {""insertions"": 158, ""deletions"": 8, ""lines"": 166}, ""src/version.c"": {""insertions"": 2, ""deletions"": 0, ""lines"": 2}, ""src/window.c"": {""insertions"": 1, ""deletions"": 1, ""lines"": 2}}"
2022-02-24 11:39:43,3c620b0c0394b754597f68fdd9da5de76156f3ce,Bram Moolenaar,4,0,4,2,"{""src/gui_w32.c"": {""insertions"": 2, ""deletions"": 0, ""lines"": 2}, ""src/version.c"": {""insertions"": 2, ""deletions"": 0, ""lines"": 2}}"
2022-02-23 22:12:02,dea5ab0fc5bb51105078d5349f987496b1aa8d6f,Bram Moolenaar,80,5,85,5,"{""src/errors.h"": {""insertions"": 2, ""deletions"": 1, ""lines"": 3}, ""src/testdir/test_vim9_func.vim"": {""insertions"": 57, ""deletions"": 0, ""lines"": 57}, ""src/userfunc.c"": {""insertions"": 14, ""deletions"": 3, ""lines"": 17}, ""src/version.c"": {""insertions"": 2, ""deletions"": 0, ""lines"": 2}, ""src/vim9compile.c"": {""insertions"": 5, ""deletions"": 1, ""lines"": 6}}"
2022-02-23 21:03:32,fa02616718103be3f9e13e26d57905d4eddf836d,Bram Moolenaar,15,0,15,3,"{""src/evalfunc.c"": {""insertions"": 2, ""deletions"": 0, ""lines"": 2}, ""src/testdir/test_vim9_builtin.vim"": {""insertions"": 11, ""deletions"": 0, ""lines"": 11}, ""src/version.c"": {""insertions"": 2, ""deletions"": 0, ""lines"": 2}}"
2022-02-23 19:11:49,6e1a38745f794715dc624399c318f513b54797c4,Bram Moolenaar,16,1,17,3,"{""src/evalfunc.c"": {""insertions"": 2, ""deletions"": 0, ""lines"": 2}, ""src/testdir/test_vim9_builtin.vim"": {""insertions"": 12, ""deletions"": 1, ""lines"": 13}, ""src/version.c"": {""insertions"": 2, ""deletions"": 0, ""lines"": 2}}"
2022-02-23 18:07:38,33fc4a63071c03ad46636b345a814e7e6d8f4ae0,Bram Moolenaar,101,8,109,9,"{""runtime/doc/various.txt"": {""insertions"": 1, ""deletions"": 0, ""lines"": 1}, ""src/Makefile"": {""insertions"": 2, ""deletions"": 0, ""lines"": 2}, ""src/config.h.in"": {""insertions"": 3, ""deletions"": 0, ""lines"": 3}, ""src/configure.ac"": {""insertions"": 10, ""deletions"": 6, ""lines"": 16}, ""src/evalfunc.c"": {""insertions"": 5, ""deletions"": 1, ""lines"": 6}, ""src/feature.h"": {""insertions"": 6, ""deletions"": 0, ""lines"": 6}, ""src/os_unix.c"": {""insertions"": 67, ""deletions"": 1, ""lines"": 68}, ""src/proto/os_unix.pro"": {""insertions"": 1, ""deletions"": 0, ""lines"": 1}, ""src/version.c"": {""insertions"": 6, ""deletions"": 0, ""lines"": 6}}"
2022-02-23 14:25:17,dd2dfb3cb00d47d2e8248c4e9d2cdf51e1574b79,Zdenek Dohnal,4,1,5,2,"{""src/testdir/test_terminal.vim"": {""insertions"": 2, ""deletions"": 1, ""lines"": 3}, ""src/version.c"": {""insertions"": 2, ""deletions"": 0, ""lines"": 2}}"
2022-02-23 13:17:47,2007dd49f5cb36f944cab1cfbceb0f864e625f74,Bram Moolenaar,29,16,45,6,"{""runtime/doc/builtin.txt"": {""insertions"": 12, ""deletions"": 11, ""lines"": 23}, ""runtime/menu.vim"": {""insertions"": 2, ""deletions"": 2, ""lines"": 4}, ""src/evalfunc.c"": {""insertions"": 0, ""deletions"": 1, ""lines"": 1}, ""src/list.c"": {""insertions"": 2, ""deletions"": 1, ""lines"": 3}, ""src/testdir/test_listdict.vim"": {""insertions"": 11, ""deletions"": 1, ""lines"": 12}, ""src/version.c"": {""insertions"": 2, ""deletions"": 0, ""lines"": 2}}"
2022-02-23 12:23:08,6a8b13614e5bcb233d20403ae9f008ccba152be3,zeertzjq,7,3,10,4,"{""src/testdir/test_exit.vim"": {""insertions"": 1, ""deletions"": 0, ""lines"": 1}, ""src/ui.c"": {""insertions"": 0, ""deletions"": 3, ""lines"": 3}, ""src/version.c"": {""insertions"": 2, ""deletions"": 0, ""lines"": 2}, ""src/window.c"": {""insertions"": 4, ""deletions"": 0, ""lines"": 4}}"
2022-02-23 12:06:00,4791fcd82565adcc60b86830e0bb6cd5b6eea0a6,Bram Moolenaar,42,1,43,5,"{""src/option.c"": {""insertions"": 8, ""deletions"": 0, ""lines"": 8}, ""src/proto/option.pro"": {""insertions"": 1, ""deletions"": 0, ""lines"": 1}, ""src/quickfix.c"": {""insertions"": 4, ""deletions"": 1, ""lines"": 5}, ""src/testdir/test_quickfix.vim"": {""insertions"": 27, ""deletions"": 0, ""lines"": 27}, ""src/version.c"": {""insertions"": 2, ""deletions"": 0, ""lines"": 2}}"
2022-02-23 10:52:41,2dada73a4ebffe2582af472ce362abd3116b58c9,Bram Moolenaar,4,1,5,2,"{""src/testdir/test_vartabs.vim"": {""insertions"": 2, ""deletions"": 1, ""lines"": 3}, ""src/version.c"": {""insertions"": 2, ""deletions"": 0, ""lines"": 2}}"
2022-02-22 22:53:10,9cd4c0fb98cb4fe6164e4e1751c21a5a5229b9cc,Bram Moolenaar,4,5,9,3,"{""src/evalfunc.c"": {""insertions"": 1, ""deletions"": 0, ""lines"": 1}, ""src/testdir/test_listdict.vim"": {""insertions"": 1, ""deletions"": 5, ""lines"": 6}, ""src/version.c"": {""insertions"": 2, ""deletions"": 0, ""lines"": 2}}"
2022-02-22 22:17:00,2afeb408310f4f0185ce5eec079b51a3fe415a33,Bram Moolenaar,7,1,8,2,"{""src/testdir/test_listdict.vim"": {""insertions"": 5, ""deletions"": 1, ""lines"": 6}, ""src/version.c"": {""insertions"": 2, ""deletions"": 0, ""lines"": 2}}"
2022-02-22 21:54:44,e843efcc3503b7af838dca3cb9dd2e17d4fc1672,Bram Moolenaar,65,4,69,3,"{""src/evalfunc.c"": {""insertions"": 38, ""deletions"": 1, ""lines"": 39}, ""src/testdir/test_vim9_builtin.vim"": {""insertions"": 25, ""deletions"": 3, ""lines"": 28}, ""src/version.c"": {""insertions"": 2, ""deletions"": 0, ""lines"": 2}}"
2022-02-22 21:17:40,b2c72359dce4c4027dc0c05844eb2e76ea947014,Bram Moolenaar,9,7,16,2,"{""runtime/autoload/dist/ft.vim"": {""insertions"": 7, ""deletions"": 7, ""lines"": 14}, ""src/version.c"": {""insertions"": 2, ""deletions"": 0, ""lines"": 2}}"
2022-02-22 20:43:36,afa048f0d4b5d63f2192c9ba340a9eb8b0822985,Bram Moolenaar,68,8,76,5,"{""runtime/doc/vim9.txt"": {""insertions"": 7, ""deletions"": 5, ""lines"": 12}, ""src/testdir/test_vim9_assign.vim"": {""insertions"": 44, ""deletions"": 1, ""lines"": 45}, ""src/version.c"": {""insertions"": 2, ""deletions"": 0, ""lines"": 2}, ""src/vim9compile.c"": {""insertions"": 6, ""deletions"": 0, ""lines"": 6}, ""src/vim9expr.c"": {""insertions"": 9, ""deletions"": 2, ""lines"": 11}}"
2022-02-22 19:39:13,fe73255c92b6cb54851f82fa32458340b736298d,Bram Moolenaar,39,5,44,3,"{""src/testdir/test_vim9_builtin.vim"": {""insertions"": 15, ""deletions"": 0, ""lines"": 15}, ""src/version.c"": {""insertions"": 2, ""deletions"": 0, ""lines"": 2}, ""src/vim9execute.c"": {""insertions"": 22, ""deletions"": 5, ""lines"": 27}}"
2022-02-22 18:48:11,29a9e6971849b4a9eabf14fee1130d51cecfbaa7,Bram Moolenaar,3,0,3,2,"{""src/testdir/test_exit.vim"": {""insertions"": 1, ""deletions"": 0, ""lines"": 1}, ""src/version.c"": {""insertions"": 2, ""deletions"": 0, ""lines"": 2}}"
2022-02-22 17:42:48,68eab67119734ea1efc7cef1287276d969f2713a,Bram Moolenaar,6,3,9,2,"{""src/testdir/test_exit.vim"": {""insertions"": 4, ""deletions"": 3, ""lines"": 7}, ""src/version.c"": {""insertions"": 2, ""deletions"": 0, ""lines"": 2}}"
2022-02-22 16:19:37,2457b2bbc28cce6e8c1106d427b8e867d4f58cfa,Bram Moolenaar,3,1,4,2,"{""src/testdir/test_regexp_utf8.vim"": {""insertions"": 1, ""deletions"": 1, ""lines"": 2}, ""src/version.c"": {""insertions"": 2, ""deletions"": 0, ""lines"": 2}}"
2022-02-22 15:24:51,70b9e4f4c3a62e325fd16ac108bd12feb026ede5,Bram Moolenaar,3,0,3,2,"{""src/testdir/test_exit.vim"": {""insertions"": 1, ""deletions"": 0, ""lines"": 1}, ""src/version.c"": {""insertions"": 2, ""deletions"": 0, ""lines"": 2}}"
2022-02-22 15:12:14,16f6c8ac94d8412075060945aa90ba90be08656f,Bram Moolenaar,135,95,230,3,"{""src/evalfunc.c"": {""insertions"": 80, ""deletions"": 86, ""lines"": 166}, ""src/testdir/test_vim9_builtin.vim"": {""insertions"": 53, ""deletions"": 9, ""lines"": 62}, ""src/version.c"": {""insertions"": 2, ""deletions"": 0, ""lines"": 2}}"
2022-02-22 13:37:31,6456fae9ba8e72c74b2c0c499eaf09974604ff30,Bram Moolenaar,17,2,19,3,"{""src/regexp_bt.c"": {""insertions"": 5, ""deletions"": 0, ""lines"": 5}, ""src/testdir/test_regexp_utf8.vim"": {""insertions"": 10, ""deletions"": 2, ""lines"": 12}, ""src/version.c"": {""insertions"": 2, ""deletions"": 0, ""lines"": 2}}"
2022-02-22 12:34:28,1349bd712cf7d24dc65408c523dd7deb30224f80,Bram Moolenaar,29,1,30,3,"{""src/mbyte.c"": {""insertions"": 2, ""deletions"": 1, ""lines"": 3}, ""src/testdir/test_options.vim"": {""insertions"": 25, ""deletions"": 0, ""lines"": 25}, ""src/version.c"": {""insertions"": 2, ""deletions"": 0, ""lines"": 2}}"
2022-02-22 12:08:07,ca0c1caa36823ea8e61184268d7337e79995352f,Bram Moolenaar,19,0,19,3,"{""src/testdir/test_exit.vim"": {""insertions"": 14, ""deletions"": 0, ""lines"": 14}, ""src/ui.c"": {""insertions"": 3, ""deletions"": 0, ""lines"": 3}, ""src/version.c"": {""insertions"": 2, ""deletions"": 0, ""lines"": 2}}"
2022-02-22 11:04:50,0f113e4f7b698fc94c1a8377afdb7249329beaee,K.Takata,5,3,8,2,"{""src/testdir/test_vartabs.vim"": {""insertions"": 3, ""deletions"": 3, ""lines"": 6}, ""src/version.c"": {""insertions"": 2, ""deletions"": 0, ""lines"": 2}}"
2022-02-21 19:36:12,4e889f98e95ac05d7c8bd3ee933ab4d47820fdfa,Bram Moolenaar,16,0,16,3,"{""src/indent.c"": {""insertions"": 2, ""deletions"": 0, ""lines"": 2}, ""src/testdir/test_vartabs.vim"": {""insertions"": 12, ""deletions"": 0, ""lines"": 12}, ""src/version.c"": {""insertions"": 2, ""deletions"": 0, ""lines"": 2}}"
2022-02-21 18:34:30,7842761bbaa7965fa52b5e3eadf162bc7fa6cdb1,Bram Moolenaar,2,1,3,2,"{""src/evalfunc.c"": {""insertions"": 0, ""deletions"": 1, ""lines"": 1}, ""src/version.c"": {""insertions"": 2, ""deletions"": 0, ""lines"": 2}}"
2022-02-21 17:56:33,16b51d26fe2cc3afb09afd439069220dea74581d,Sean Dewar,2,1,3,2,"{""src/version.c"": {""insertions"": 2, ""deletions"": 0, ""lines"": 2}, ""src/window.c"": {""insertions"": 0, ""deletions"": 1, ""lines"": 1}}"
2022-02-21 17:49:28,83e36c86062d052fa1db48ee27709549b706b6a2,K.Takata,7,1,8,2,"{"".github/workflows/ci.yml"": {""insertions"": 5, ""deletions"": 1, ""lines"": 6}, ""src/version.c"": {""insertions"": 2, ""deletions"": 0, ""lines"": 2}}"
2022-02-21 16:13:49,592f6250017c31c8996325403e511f4502077ba5,Bram Moolenaar,4,1,5,2,"{""src/version.c"": {""insertions"": 2, ""deletions"": 0, ""lines"": 2}, ""src/window.c"": {""insertions"": 2, ""deletions"": 1, ""lines"": 3}}"
2022-02-21 15:59:11,993faa34059c7fa304e2d4357c57463765cba6d3,Bram Moolenaar,144,146,290,2,"{""src/evalvars.c"": {""insertions"": 142, ""deletions"": 146, ""lines"": 288}, ""src/version.c"": {""insertions"": 2, ""deletions"": 0, ""lines"": 2}}"
2022-02-21 15:07:12,101979358f9addfac1414579c4191682e9e42468,Amon Sha,9,2,11,2,"{""src/fileio.c"": {""insertions"": 7, ""deletions"": 2, ""lines"": 9}, ""src/version.c"": {""insertions"": 2, ""deletions"": 0, ""lines"": 2}}"
2022-02-21 13:13:50,c2f17f7e64bb1bf872dbc6f3b8f0d8751e275287,Bram Moolenaar,81,7,88,6,"{""src/evalfunc.c"": {""insertions"": 3, ""deletions"": 1, ""lines"": 4}, ""src/proto/userfunc.pro"": {""insertions"": 1, ""deletions"": 0, ""lines"": 1}, ""src/testdir/test_vim9_import.vim"": {""insertions"": 40, ""deletions"": 0, ""lines"": 40}, ""src/userfunc.c"": {""insertions"": 34, ""deletions"": 5, ""lines"": 39}, ""src/version.c"": {""insertions"": 2, ""deletions"": 0, ""lines"": 2}, ""src/vim9type.c"": {""insertions"": 1, ""deletions"": 1, ""lines"": 2}}"
2022-02-20 20:49:35,0f6e28f686dbb59ab3b562408ab9b2234797b9b1,Bram Moolenaar,35,32,67,5,"{""src/evalvars.c"": {""insertions"": 2, ""deletions"": 12, ""lines"": 14}, ""src/proto/window.pro"": {""insertions"": 1, ""deletions"": 0, ""lines"": 1}, ""src/usercmd.c"": {""insertions"": 4, ""deletions"": 20, ""lines"": 24}, ""src/version.c"": {""insertions"": 2, ""deletions"": 0, ""lines"": 2}, ""src/window.c"": {""insertions"": 26, ""deletions"": 0, ""lines"": 26}}"
2022-02-20 19:48:20,944697ae19683441981539cd4d2469df89d6ec82,Bram Moolenaar,379,327,706,28,"{""runtime/doc/builtin.txt"": {""insertions"": 37, ""deletions"": 20, ""lines"": 57}, ""runtime/doc/editing.txt"": {""insertions"": 4, ""deletions"": 4, ""lines"": 8}, ""runtime/doc/eval.txt"": {""insertions"": 7, ""deletions"": 5, ""lines"": 12}, ""runtime/doc/options.txt"": {""insertions"": 5, ""deletions"": 5, ""lines"": 10}, ""runtime/doc/os_win32.txt"": {""insertions"": 5, ""deletions"": 5, ""lines"": 10}, ""runtime/doc/remote.txt"": {""insertions"": 5, ""deletions"": 1, ""lines"": 6}, ""runtime/doc/tags"": {""insertions"": 6, ""deletions"": 0, ""lines"": 6}, ""runtime/doc/todo.txt"": {""insertions"": 1, ""deletions"": 8, ""lines"": 9}, ""runtime/doc/usr_41.txt"": {""insertions"": 1, ""deletions"": 1, ""lines"": 2}, ""runtime/doc/vim-ja.UTF-8.1"": {""insertions"": 1, ""deletions"": 1, ""lines"": 2}, ""runtime/doc/vim9.txt"": {""insertions"": 49, ""deletions"": 18, ""lines"": 67}, ""runtime/filetype.vim"": {""insertions"": 1, ""deletions"": 1, ""lines"": 2}, ""runtime/lang/menu_ja_jp.euc-jp.vim"": {""insertions"": 6, ""deletions"": 6, ""lines"": 12}, ""runtime/lang/menu_ja_jp.utf-8.vim"": {""insertions"": 6, ""deletions"": 6, ""lines"": 12}, ""runtime/lang/menu_japanese_japan.932.vim"": {""insertions"": 6, ""deletions"": 6, ""lines"": 12}, ""runtime/syntax/structurizr.vim"": {""insertions"": 7, ""deletions"": 2, ""lines"": 9}, ""src/po/de.po"": {""insertions"": 0, ""deletions"": 2, ""lines"": 2}, ""src/po/en_GB.po"": {""insertions"": 0, ""deletions"": 3, ""lines"": 3}, ""src/po/es.po"": {""insertions"": 0, ""deletions"": 2, ""lines"": 2}, ""src/po/fi.po"": {""insertions"": 0, ""deletions"": 2, ""lines"": 2}, ""src/po/it.po"": {""insertions"": 0, ""deletions"": 1, ""lines"": 1}, ""src/po/ja.euc-jp.po"": {""insertions"": 74, ""deletions"": 56, ""lines"": 130}, ""src/po/ja.po"": {""insertions"": 74, ""deletions"": 56, ""lines"": 130}, ""src/po/ja.sjis.po"": {""insertions"": 74, ""deletions"": 56, ""lines"": 130}, ""src/po/sk.cp1250.po"": {""insertions"": 0, ""deletions"": 24, ""lines"": 24}, ""src/po/sk.po"": {""insertions"": 0, ""deletions"": 24, ""lines"": 24}, ""src/po/sr.po"": {""insertions"": 0, ""deletions"": 2, ""lines"": 2}, ""src/po/zh_CN.po"": {""insertions"": 10, ""deletions"": 10, ""lines"": 20}}"
2022-02-20 19:05:10,ad6c45f62558e03d3e3a927b3fe4dbaf30a36bef,zeertzjq,7,1,8,3,"{""src/getchar.c"": {""insertions"": 1, ""deletions"": 1, ""lines"": 2}, ""src/testdir/test_functions.vim"": {""insertions"": 4, ""deletions"": 0, ""lines"": 4}, ""src/version.c"": {""insertions"": 2, ""deletions"": 0, ""lines"": 2}}"
2022-02-20 18:26:46,c1e6c7bafec1115b690c745a28e1a6338750b137,Bram Moolenaar,47,7,54,5,"{""src/evalfunc.c"": {""insertions"": 4, ""deletions"": 2, ""lines"": 6}, ""src/ex_docmd.c"": {""insertions"": 4, ""deletions"": 1, ""lines"": 5}, ""src/testdir/test_vim9_builtin.vim"": {""insertions"": 32, ""deletions"": 2, ""lines"": 34}, ""src/version.c"": {""insertions"": 2, ""deletions"": 0, ""lines"": 2}, ""src/vim9compile.c"": {""insertions"": 5, ""deletions"": 2, ""lines"": 7}}"
2022-02-20 15:52:28,eddd4fc4f6d9d626374a73861c891f95ef999133,Bram Moolenaar,82,32,114,4,"{""src/evalfunc.c"": {""insertions"": 56, ""deletions"": 24, ""lines"": 80}, ""src/testdir/test_vim9_builtin.vim"": {""insertions"": 22, ""deletions"": 6, ""lines"": 28}, ""src/testdir/test_vim9_func.vim"": {""insertions"": 2, ""deletions"": 2, ""lines"": 4}, ""src/version.c"": {""insertions"": 2, ""deletions"": 0, ""lines"": 2}}"
2022-02-19 16:35:58,cdf717283ca70b18f20b8a2cefe7957083280c6f,NullVoxPopuli,8,0,8,3,"{""runtime/filetype.vim"": {""insertions"": 4, ""deletions"": 0, ""lines"": 4}, ""src/testdir/test_filetype.vim"": {""insertions"": 2, ""deletions"": 0, ""lines"": 2}, ""src/version.c"": {""insertions"": 2, ""deletions"": 0, ""lines"": 2}}"
2022-02-19 16:00:16,d56eb654f50434ea590142c0f080efba91bfe7f8,Bram Moolenaar,5,3,8,2,"{""src/Makefile"": {""insertions"": 3, ""deletions"": 3, ""lines"": 6}, ""src/version.c"": {""insertions"": 2, ""deletions"": 0, ""lines"": 2}}"
2022-02-19 14:49:51,adbb383e0f2bb59286ea8133f02c448fd334958f,Bram Moolenaar,3,1,4,2,"{""src/testdir/test_autochdir.vim"": {""insertions"": 1, ""deletions"": 1, ""lines"": 2}, ""src/version.c"": {""insertions"": 2, ""deletions"": 0, ""lines"": 2}}"
2022-02-19 13:25:18,20563e0f848d88b025ae5d2b0601f8bc51944974,Bram Moolenaar,9,6,15,3,"{""src/Makefile"": {""insertions"": 6, ""deletions"": 6, ""lines"": 12}, ""src/installman.sh"": {""insertions"": 1, ""deletions"": 0, ""lines"": 1}, ""src/version.c"": {""insertions"": 2, ""deletions"": 0, ""lines"": 2}}"
2022-02-19 12:06:09,a42535340a906d33173e8b3e82085c161a0524c8,Ada,1065,555,1620,55,"{""runtime/lang/Makefile"": {""insertions"": 196, ""deletions"": 0, ""lines"": 196}, ""runtime/lang/menu_af_af.latin1.vim"": {""insertions"": 1, ""deletions"": 0, ""lines"": 1}, ""runtime/lang/menu_ca_es.latin1.vim"": {""insertions"": 1, ""deletions"": 1, ""lines"": 2}, ""runtime/lang/menu_chinese_gb.936.vim"": {""insertions"": 3, ""deletions"": 2, ""lines"": 5}, ""runtime/lang/menu_chinese_taiwan.950.vim"": {""insertions"": 2, ""deletions"": 0, ""lines"": 2}, ""runtime/lang/menu_cs_cz.iso_8859-2.vim"": {""insertions"": 3, ""deletions"": 2, ""lines"": 5}, ""runtime/lang/menu_cs_cz.utf-8.vim"": {""insertions"": 1, ""deletions"": 0, ""lines"": 1}, ""runtime/lang/menu_czech_czech_republic.1250.vim"": {""insertions"": 1, ""deletions"": 0, ""lines"": 1}, ""runtime/lang/menu_czech_czech_republic.ascii.vim"": {""insertions"": 2, ""deletions"": 1, ""lines"": 3}, ""runtime/lang/menu_da.utf-8.vim"": {""insertions"": 1, ""deletions"": 0, ""lines"": 1}, ""runtime/lang/menu_de_de.latin1.vim"": {""insertions"": 1, ""deletions"": 0, ""lines"": 1}, ""runtime/lang/menu_eo.utf-8.vim"": {""insertions"": 1, ""deletions"": 0, ""lines"": 1}, ""runtime/lang/menu_es_es.latin1.vim"": {""insertions"": 1, ""deletions"": 1, ""lines"": 2}, ""runtime/lang/menu_fi_fi.latin1.vim"": {""insertions"": 1, ""deletions"": 0, ""lines"": 1}, ""runtime/lang/menu_fr_fr.latin1.vim"": {""insertions"": 1, ""deletions"": 0, ""lines"": 1}, ""runtime/lang/menu_hu_hu.iso_8859-2.vim"": {""insertions"": 1, ""deletions"": 0, ""lines"": 1}, ""runtime/lang/menu_hu_hu.utf-8.vim"": {""insertions"": 1, ""deletions"": 0, ""lines"": 1}, ""runtime/lang/menu_is_is.latin1.vim"": {""insertions"": 1, ""deletions"": 0, ""lines"": 1}, ""runtime/lang/menu_it_it.latin1.vim"": {""insertions"": 1, ""deletions"": 0, ""lines"": 1}, ""runtime/lang/menu_ja_jp.euc-jp.vim"": {""insertions"": 1, ""deletions"": 0, ""lines"": 1}, ""runtime/lang/menu_ja_jp.utf-8.vim"": {""insertions"": 1, ""deletions"": 0, ""lines"": 1}, ""runtime/lang/menu_japanese_japan.932.vim"": {""insertions"": 1, ""deletions"": 0, ""lines"": 1}, ""runtime/lang/menu_ko_kr.euckr.vim"": {""insertions"": 1, ""deletions"": 0, ""lines"": 1}, ""runtime/lang/menu_ko_kr.utf-8.vim"": {""insertions"": 1, ""deletions"": 0, ""lines"": 1}, ""runtime/lang/menu_nl_nl.latin1.vim"": {""insertions"": 1, ""deletions"": 0, ""lines"": 1}, ""runtime/lang/menu_no_no.latin1.vim"": {""insertions"": 1, ""deletions"": 0, ""lines"": 1}, ""runtime/lang/menu_pl_pl.iso_8859-2.vim"": {""insertions"": 1, ""deletions"": 0, ""lines"": 1}, ""runtime/lang/menu_pl_pl.utf-8.vim"": {""insertions"": 1, ""deletions"": 0, ""lines"": 1}, ""runtime/lang/menu_polish_poland.1250.vim"": {""insertions"": 1, ""deletions"": 0, ""lines"": 1}, ""runtime/lang/menu_pt_br.vim"": {""insertions"": 1, ""deletions"": 1, ""lines"": 2}, ""runtime/lang/menu_pt_pt.vim"": {""insertions"": 1, ""deletions"": 0, ""lines"": 1}, ""runtime/lang/menu_ru.utf-8.vim"": {""insertions"": 1, ""deletions"": 1, ""lines"": 2}, ""runtime/lang/menu_ru_ru.koi8-r.vim"": {""insertions"": 62, ""deletions"": 51, ""lines"": 113}, ""runtime/lang/menu_ru_ru.utf-8.vim"": {""insertions"": 335, ""deletions"": 1, ""lines"": 336}, ""runtime/lang/menu_ru_ru.vim"": {""insertions"": 1, ""deletions"": 334, ""lines"": 335}, ""runtime/lang/menu_sk_sk.iso_8859-2.vim"": {""insertions"": 1, ""deletions"": 0, ""lines"": 1}, ""runtime/lang/menu_sl_si.cp1250.vim"": {""insertions"": 25, ""deletions"": 24, ""lines"": 49}, ""runtime/lang/menu_sl_si.latin2.vim"": {""insertions"": 1, ""deletions"": 0, ""lines"": 1}, ""runtime/lang/menu_sl_si.utf-8.vim"": {""insertions"": 25, ""deletions"": 24, ""lines"": 49}, ""runtime/lang/menu_slovak_slovak_republic.1250.vim"": {""insertions"": 1, ""deletions"": 0, ""lines"": 1}, ""runtime/lang/menu_sr_rs.ascii.vim"": {""insertions"": 39, ""deletions"": 36, ""lines"": 75}, ""runtime/lang/menu_sr_rs.iso_8859-2.vim"": {""insertions"": 37, ""deletions"": 36, ""lines"": 73}, ""runtime/lang/menu_sr_rs.iso_8859-5.vim"": {""insertions"": 37, ""deletions"": 36, ""lines"": 73}, ""runtime/lang/menu_sr_rs.utf-8.vim"": {""insertions"": 1, ""deletions"": 0, ""lines"": 1}, ""runtime/lang/menu_sv_se.latin1.vim"": {""insertions"": 1, ""deletions"": 0, ""lines"": 1}, ""runtime/lang/menu_tr_tr.cp1254.vim"": {""insertions"": 1, ""deletions"": 0, ""lines"": 1}, ""runtime/lang/menu_tr_tr.iso_8859-9.vim"": {""insertions"": 2, ""deletions"": 1, ""lines"": 3}, ""runtime/lang/menu_tr_tr.utf-8.vim"": {""insertions"": 1, ""deletions"": 0, ""lines"": 1}, ""runtime/lang/menu_uk_ua.cp1251.vim"": {""insertions"": 1, ""deletions"": 0, ""lines"": 1}, ""runtime/lang/menu_uk_ua.koi8-u.vim"": {""insertions"": 1, ""deletions"": 0, ""lines"": 1}, ""runtime/lang/menu_uk_ua.utf-8.vim"": {""insertions"": 252, ""deletions"": 0, ""lines"": 252}, ""runtime/lang/menu_vi_vn.vim"": {""insertions"": 1, ""deletions"": 0, ""lines"": 1}, ""runtime/lang/menu_zh_cn.utf-8.vim"": {""insertions"": 4, ""deletions"": 3, ""lines"": 7}, ""runtime/lang/menu_zh_tw.utf-8.vim"": {""insertions"": 1, ""deletions"": 0, ""lines"": 1}, ""src/version.c"": {""insertions"": 2, ""deletions"": 0, ""lines"": 2}}"
2022-02-19 11:45:03,a493b6506b67887a1cc2d1c00a896598c3b2d445,Brandon Richardson,22,4,26,3,"{""src/buffer.c"": {""insertions"": 9, ""deletions"": 4, ""lines"": 13}, ""src/testdir/test_tabline.vim"": {""insertions"": 11, ""deletions"": 0, ""lines"": 11}, ""src/version.c"": {""insertions"": 2, ""deletions"": 0, ""lines"": 2}}"
2022-02-19 11:20:12,5921aeb5741fc6e84c870d68c7c35b93ad0c9f87,Bram Moolenaar,18,2,20,5,"{""src/charset.c"": {""insertions"": 6, ""deletions"": 0, ""lines"": 6}, ""src/filepath.c"": {""insertions"": 1, ""deletions"": 1, ""lines"": 2}, ""src/proto/charset.pro"": {""insertions"": 1, ""deletions"": 1, ""lines"": 2}, ""src/testdir/test_autochdir.vim"": {""insertions"": 8, ""deletions"": 0, ""lines"": 8}, ""src/version.c"": {""insertions"": 2, ""deletions"": 0, ""lines"": 2}}"
2022-02-18 18:34:45,e89bfd212b21c227f026e467f882c62cdd6e642d,Bram Moolenaar,5,1,6,2,"{""src/userfunc.c"": {""insertions"": 3, ""deletions"": 1, ""lines"": 4}, ""src/version.c"": {""insertions"": 2, ""deletions"": 0, ""lines"": 2}}"
2022-02-18 17:50:47,1fca5f3e86f08e696058fc7e86dfe41b415a78e6,Bram Moolenaar,50,9,59,4,"{""runtime/doc/options.txt"": {""insertions"": 13, ""deletions"": 3, ""lines"": 16}, ""src/testdir/test_ins_complete.vim"": {""insertions"": 17, ""deletions"": 0, ""lines"": 17}, ""src/userfunc.c"": {""insertions"": 18, ""deletions"": 6, ""lines"": 24}, ""src/version.c"": {""insertions"": 2, ""deletions"": 0, ""lines"": 2}}"
2022-02-18 13:56:38,b8fb5bb68d45f3e52bb9ea201dc9e7dc6b6d2c6d,Bram Moolenaar,10,8,18,3,"{""src/proto/usercmd.pro"": {""insertions"": 1, ""deletions"": 1, ""lines"": 2}, ""src/usercmd.c"": {""insertions"": 7, ""deletions"": 7, ""lines"": 14}, ""src/version.c"": {""insertions"": 2, ""deletions"": 0, ""lines"": 2}}"
2022-02-18 13:45:55,97b231541d4e82fbc85e51121448d95bd43c50ad,=?UTF-8?q?Dundar=20G=C3=B6c?=,6,0,6,3,"{""runtime/filetype.vim"": {""insertions"": 3, ""deletions"": 0, ""lines"": 3}, ""src/testdir/test_filetype.vim"": {""insertions"": 1, ""deletions"": 0, ""lines"": 1}, ""src/version.c"": {""insertions"": 2, ""deletions"": 0, ""lines"": 2}}"
2022-02-18 13:24:52,56acd1f8ed4d86e92684f90b3b8e0e9a355208d1,Bram Moolenaar,8,0,8,2,"{""src/version.c"": {""insertions"": 2, ""deletions"": 0, ""lines"": 2}, ""src/vim9execute.c"": {""insertions"": 6, ""deletions"": 0, ""lines"": 6}}"
2022-02-18 11:28:29,0257599036ceb3658b27a4de07834ca0d2fa418e,Bram Moolenaar,4,0,4,2,"{""src/po/cleanup.vim"": {""insertions"": 2, ""deletions"": 0, ""lines"": 2}, ""src/version.c"": {""insertions"": 2, ""deletions"": 0, ""lines"": 2}}"
2022-02-17 21:30:26,8e5ba693ad9377fbf4b047093624248b81eac854,=?UTF-8?q?Dundar=20G=C3=B6c?=,8,2,10,3,"{""runtime/filetype.vim"": {""insertions"": 5, ""deletions"": 2, ""lines"": 7}, ""src/testdir/test_filetype.vim"": {""insertions"": 1, ""deletions"": 0, ""lines"": 1}, ""src/version.c"": {""insertions"": 2, ""deletions"": 0, ""lines"": 2}}"
2022-02-17 19:44:07,0c7f2610de94b42ce111c4839ba37505720181d4,Bram Moolenaar,55,32,87,6,"{""src/testdir/test_vim9_assign.vim"": {""insertions"": 7, ""deletions"": 0, ""lines"": 7}, ""src/testdir/test_vim9_cmd.vim"": {""insertions"": 22, ""deletions"": 0, ""lines"": 22}, ""src/testdir/test_vim9_expr.vim"": {""insertions"": 8, ""deletions"": 0, ""lines"": 8}, ""src/testdir/test_vim9_script.vim"": {""insertions"": 12, ""deletions"": 0, ""lines"": 12}, ""src/version.c"": {""insertions"": 2, ""deletions"": 0, ""lines"": 2}, ""src/vim9execute.c"": {""insertions"": 4, ""deletions"": 32, ""lines"": 36}}"
2022-02-17 16:30:11,6296d1e60edf7ac150ee1707c14d4355f3220b88,Bram Moolenaar,17,4,21,3,"{""src/testdir/test_vim9_assign.vim"": {""insertions"": 7, ""deletions"": 0, ""lines"": 7}, ""src/version.c"": {""insertions"": 2, ""deletions"": 0, ""lines"": 2}, ""src/vim9execute.c"": {""insertions"": 8, ""deletions"": 4, ""lines"": 12}}"
2022-02-17 14:42:02,ea5c898b5fb60828b0223f258910f84f5c645e63,Bram Moolenaar,33,11,44,4,"{""src/errors.h"": {""insertions"": 1, ""deletions"": 2, ""lines"": 3}, ""src/testdir/test_vim9_assign.vim"": {""insertions"": 14, ""deletions"": 1, ""lines"": 15}, ""src/version.c"": {""insertions"": 2, ""deletions"": 0, ""lines"": 2}, ""src/vim9execute.c"": {""insertions"": 16, ""deletions"": 8, ""lines"": 24}}"
2022-02-17 13:08:26,e08be09a08485e8c919f46c05223c1ccfdaf175d,Bram Moolenaar,169,99,268,5,"{""src/testdir/test_vim9_assign.vim"": {""insertions"": 53, ""deletions"": 0, ""lines"": 53}, ""src/testdir/test_vim9_cmd.vim"": {""insertions"": 11, ""deletions"": 0, ""lines"": 11}, ""src/testdir/test_vim9_func.vim"": {""insertions"": 8, ""deletions"": 0, ""lines"": 8}, ""src/version.c"": {""insertions"": 2, ""deletions"": 0, ""lines"": 2}, ""src/vim9execute.c"": {""insertions"": 95, ""deletions"": 99, ""lines"": 194}}"
2022-02-17 11:26:42,24384308635f40b15d399fbd4e60c25d5e21ed8d,Yegappan Lakshmanan,307,188,495,3,"{""src/cmdexpand.c"": {""insertions"": 253, ""deletions"": 188, ""lines"": 441}, ""src/testdir/test_usercommands.vim"": {""insertions"": 52, ""deletions"": 0, ""lines"": 52}, ""src/version.c"": {""insertions"": 2, ""deletions"": 0, ""lines"": 2}}"
2022-02-16 21:51:00,8329ab79b26be4c6c5766d80abae4a22385ee9e1,Bram Moolenaar,4,1,5,2,"{""src/change.c"": {""insertions"": 2, ""deletions"": 1, ""lines"": 3}, ""src/version.c"": {""insertions"": 2, ""deletions"": 0, ""lines"": 2}}"
2022-02-16 21:48:25,cd1cda2f877aab5ec954e14bcba59076533529a4,Bram Moolenaar,151,0,151,4,"{""src/testdir/test_vim9_func.vim"": {""insertions"": 8, ""deletions"": 0, ""lines"": 8}, ""src/testdir/test_vim9_import.vim"": {""insertions"": 131, ""deletions"": 0, ""lines"": 131}, ""src/version.c"": {""insertions"": 2, ""deletions"": 0, ""lines"": 2}, ""src/vim9execute.c"": {""insertions"": 10, ""deletions"": 0, ""lines"": 10}}"
2022-02-16 20:30:52,943773783384a5ff63f57769d37ddabf8156fe1e,Bram Moolenaar,7,3,10,2,"{""src/change.c"": {""insertions"": 5, ""deletions"": 3, ""lines"": 8}, ""src/version.c"": {""insertions"": 2, ""deletions"": 0, ""lines"": 2}}"
2022-02-16 19:24:07,ae6f1d8b14c2f63811ee83ef14e32086fb3e9b83,kylo252,80,78,158,21,"{""src/autocmd.c"": {""insertions"": 3, ""deletions"": 3, ""lines"": 6}, ""src/charset.c"": {""insertions"": 3, ""deletions"": 3, ""lines"": 6}, ""src/drawline.c"": {""insertions"": 7, ""deletions"": 7, ""lines"": 14}, ""src/drawscreen.c"": {""insertions"": 2, ""deletions"": 2, ""lines"": 4}, ""src/evalfunc.c"": {""insertions"": 12, ""deletions"": 12, ""lines"": 24}, ""src/fileio.c"": {""insertions"": 1, ""deletions"": 1, ""lines"": 2}, ""src/fold.c"": {""insertions"": 1, ""deletions"": 1, ""lines"": 2}, ""src/getchar.c"": {""insertions"": 1, ""deletions"": 1, ""lines"": 2}, ""src/highlight.c"": {""insertions"": 2, ""deletions"": 2, ""lines"": 4}, ""src/memline.c"": {""insertions"": 1, ""deletions"": 1, ""lines"": 2}, ""src/normal.c"": {""insertions"": 1, ""deletions"": 1, ""lines"": 2}, ""src/quickfix.c"": {""insertions"": 10, ""deletions"": 10, ""lines"": 20}, ""src/regexp.c"": {""insertions"": 9, ""deletions"": 9, ""lines"": 18}, ""src/search.c"": {""insertions"": 5, ""deletions"": 5, ""lines"": 10}, ""src/sha256.c"": {""insertions"": 8, ""deletions"": 8, ""lines"": 16}, ""src/spell.c"": {""insertions"": 1, ""deletions"": 1, ""lines"": 2}, ""src/spellfile.c"": {""insertions"": 1, ""deletions"": 1, ""lines"": 2}, ""src/spellsuggest.c"": {""insertions"": 6, ""deletions"": 6, ""lines"": 12}, ""src/syntax.c"": {""insertions"": 3, ""deletions"": 3, ""lines"": 6}, ""src/version.c"": {""insertions"": 2, ""deletions"": 0, ""lines"": 2}, ""src/window.c"": {""insertions"": 1, ""deletions"": 1, ""lines"": 2}}"
2022-02-16 18:27:55,d288eaad846f0e07e0141226f97d858dcf96cb78,Bram Moolenaar,25,2,27,4,"{""src/map.c"": {""insertions"": 1, ""deletions"": 0, ""lines"": 1}, ""src/testdir/dumps/Test_map_list_1.dump"": {""insertions"": 6, ""deletions"": 0, ""lines"": 6}, ""src/testdir/test_mapping.vim"": {""insertions"": 16, ""deletions"": 2, ""lines"": 18}, ""src/version.c"": {""insertions"": 2, ""deletions"": 0, ""lines"": 2}}"
2022-02-16 17:51:47,646bb7247ad6051aca223a2b04b008f682cdb57f,zeertzjq,9,13,22,2,"{""src/getchar.c"": {""insertions"": 7, ""deletions"": 13, ""lines"": 20}, ""src/version.c"": {""insertions"": 2, ""deletions"": 0, ""lines"": 2}}"
2022-02-16 16:33:28,f9435e49ef8032e80d38e31e950e4a9b75387533,Bram Moolenaar,5,0,5,2,"{""src/memline.c"": {""insertions"": 3, ""deletions"": 0, ""lines"": 3}, ""src/version.c"": {""insertions"": 2, ""deletions"": 0, ""lines"": 2}}"
2022-02-16 12:44:29,b31aec3b9387ed12677dca09069c3ae98c6c7447,Yegappan Lakshmanan,486,341,827,6,"{""src/cmdexpand.c"": {""insertions"": 402, ""deletions"": 325, ""lines"": 727}, ""src/ex_getln.c"": {""insertions"": 4, ""deletions"": 2, ""lines"": 6}, ""src/proto/usercmd.pro"": {""insertions"": 1, ""deletions"": 0, ""lines"": 1}, ""src/testdir/test_cmdline.vim"": {""insertions"": 24, ""deletions"": 14, ""lines"": 38}, ""src/usercmd.c"": {""insertions"": 53, ""deletions"": 0, ""lines"": 53}, ""src/version.c"": {""insertions"": 2, ""deletions"": 0, ""lines"": 2}}"
2022-02-16 12:16:19,34f8117dec685ace52cd9e578e2729db278163fc,Bram Moolenaar,11,1,12,3,"{""src/testdir/test_assert.vim"": {""insertions"": 8, ""deletions"": 0, ""lines"": 8}, ""src/testing.c"": {""insertions"": 1, ""deletions"": 1, ""lines"": 2}, ""src/version.c"": {""insertions"": 2, ""deletions"": 0, ""lines"": 2}}"
2022-02-15 21:33:29,f5288c589500de0677444af4a428cfbccfccb8ce,Bram Moolenaar,3,1,4,2,"{""src/testdir/test_vim9_func.vim"": {""insertions"": 1, ""deletions"": 1, ""lines"": 2}, ""src/version.c"": {""insertions"": 2, ""deletions"": 0, ""lines"": 2}}"
2022-02-15 21:17:56,8b716f5f2204f938769de283d43bcb2f77d403e7,Bram Moolenaar,38,5,43,7,"{""src/errors.h"": {""insertions"": 2, ""deletions"": 1, ""lines"": 3}, ""src/evalvars.c"": {""insertions"": 2, ""deletions"": 1, ""lines"": 3}, ""src/testdir/test_vim9_assign.vim"": {""insertions"": 2, ""deletions"": 1, ""lines"": 3}, ""src/testdir/test_vim9_cmd.vim"": {""insertions"": 18, ""deletions"": 0, ""lines"": 18}, ""src/testdir/test_vim9_func.vim"": {""insertions"": 8, ""deletions"": 1, ""lines"": 9}, ""src/version.c"": {""insertions"": 2, ""deletions"": 0, ""lines"": 2}, ""src/vim9compile.c"": {""insertions"": 4, ""deletions"": 1, ""lines"": 5}}"
2022-02-15 19:52:56,9fdde7992ab4c21517f447ca3d651b9ff4a770e8,Bram Moolenaar,3,4,7,2,"{""src/getchar.c"": {""insertions"": 1, ""deletions"": 4, ""lines"": 5}, ""src/version.c"": {""insertions"": 2, ""deletions"": 0, ""lines"": 2}}"
2022-02-15 19:15:22,6b43471da4516e8f6c17e5dc2eccbb9d0ba2e0a4,Bram Moolenaar,4,2,6,2,"{""src/fold.c"": {""insertions"": 2, ""deletions"": 2, ""lines"": 4}, ""src/version.c"": {""insertions"": 2, ""deletions"": 0, ""lines"": 2}}"
2022-02-15 17:17:18,64d95cfc56406858a05032c6a134f1e08fe2ca78,Bram Moolenaar,6,1,7,2,"{""src/getchar.c"": {""insertions"": 4, ""deletions"": 1, ""lines"": 5}, ""src/version.c"": {""insertions"": 2, ""deletions"": 0, ""lines"": 2}}"
2022-02-15 16:17:44,0e1f36fc59b589e4755fd9102013971f45222084,Bram Moolenaar,6,4,10,3,"{""src/buffer.c"": {""insertions"": 4, ""deletions"": 0, ""lines"": 4}, ""src/screen.c"": {""insertions"": 0, ""deletions"": 4, ""lines"": 4}, ""src/version.c"": {""insertions"": 2, ""deletions"": 0, ""lines"": 2}}"
2022-02-15 15:37:11,e88c6b7a5d8b24f8aa9a3e976b78654bae293ae4,Bram Moolenaar,41,6,47,5,"{""src/testdir/test_vim9_assign.vim"": {""insertions"": 13, ""deletions"": 0, ""lines"": 13}, ""src/testdir/test_vim9_builtin.vim"": {""insertions"": 1, ""deletions"": 0, ""lines"": 1}, ""src/testdir/test_vim9_disassemble.vim"": {""insertions"": 10, ""deletions"": 5, ""lines"": 15}, ""src/version.c"": {""insertions"": 2, ""deletions"": 0, ""lines"": 2}, ""src/vim9compile.c"": {""insertions"": 15, ""deletions"": 1, ""lines"": 16}}"
2022-02-15 13:40:17,4556a2e8681c5c98fb4c7ca0a016924a69b4452a,Bram Moolenaar,64,30,94,3,"{""src/move.c"": {""insertions"": 43, ""deletions"": 28, ""lines"": 71}, ""src/testdir/test_cursor_func.vim"": {""insertions"": 19, ""deletions"": 2, ""lines"": 21}, ""src/version.c"": {""insertions"": 2, ""deletions"": 0, ""lines"": 2}}"
2022-02-15 11:48:22,7745f14ef324a7134b2f26a47451cf5032f44b89,zeertzjq,16,23,39,2,"{""src/ops.c"": {""insertions"": 14, ""deletions"": 23, ""lines"": 37}, ""src/version.c"": {""insertions"": 2, ""deletions"": 0, ""lines"": 2}}"
2022-02-15 11:35:54,e3846cf1ebdc4af0b39885153b4703f71a9b919e,Yegappan Lakshmanan,124,22,146,3,"{""src/cmdexpand.c"": {""insertions"": 17, ""deletions"": 9, ""lines"": 26}, ""src/testdir/test_cmdline.vim"": {""insertions"": 105, ""deletions"": 13, ""lines"": 118}, ""src/version.c"": {""insertions"": 2, ""deletions"": 0, ""lines"": 2}}"
2022-02-14 21:51:46,8991be2ab4a9f3418ab41594a0c5b789c5cb0935,Bram Moolenaar,3,1,4,2,"{""src/ex_docmd.c"": {""insertions"": 1, ""deletions"": 1, ""lines"": 2}, ""src/version.c"": {""insertions"": 2, ""deletions"": 0, ""lines"": 2}}"
2022-02-14 21:42:15,b5d2039e000e0787a04208928ad49e105529e36b,Bram Moolenaar,4,0,4,2,"{""src/errors.h"": {""insertions"": 2, ""deletions"": 0, ""lines"": 2}, ""src/version.c"": {""insertions"": 2, ""deletions"": 0, ""lines"": 2}}"
2022-02-14 21:19:04,bc510064027da8024d59460c9c816aea4ffac096,Bram Moolenaar,31,11,42,6,"{""src/errors.h"": {""insertions"": 2, ""deletions"": 1, ""lines"": 3}, ""src/ex_docmd.c"": {""insertions"": 10, ""deletions"": 3, ""lines"": 13}, ""src/testdir/test_vim9_assign.vim"": {""insertions"": 6, ""deletions"": 0, ""lines"": 6}, ""src/testdir/test_vim9_cmd.vim"": {""insertions"": 10, ""deletions"": 0, ""lines"": 10}, ""src/version.c"": {""insertions"": 2, ""deletions"": 0, ""lines"": 2}, ""src/vim9compile.c"": {""insertions"": 1, ""deletions"": 7, ""lines"": 8}}"
2022-02-14 19:53:03,7a3b802bab5add34baae37ec2c1ae7ad2f1693bd,Bram Moolenaar,13,16,29,2,"{""src/version.c"": {""insertions"": 2, ""deletions"": 0, ""lines"": 2}, ""src/vim9compile.c"": {""insertions"": 11, ""deletions"": 16, ""lines"": 27}}"
2022-02-14 19:17:53,e4835bf34001471a102528659af009bc46361141,Bram Moolenaar,31,4,35,5,"{""src/drawscreen.c"": {""insertions"": 0, ""deletions"": 4, ""lines"": 4}, ""src/screen.c"": {""insertions"": 4, ""deletions"": 0, ""lines"": 4}, ""src/testdir/dumps/Test_wildmenu_pum_40.dump"": {""insertions"": 10, ""deletions"": 0, ""lines"": 10}, ""src/testdir/test_cmdline.vim"": {""insertions"": 15, ""deletions"": 0, ""lines"": 15}, ""src/version.c"": {""insertions"": 2, ""deletions"": 0, ""lines"": 2}}"
2022-02-14 15:59:05,0e76714e901d179a2f020815f07fb375274b5404,Bram Moolenaar,2,1,3,2,"{""src/po/Make_all.mak"": {""insertions"": 0, ""deletions"": 1, ""lines"": 1}, ""src/version.c"": {""insertions"": 2, ""deletions"": 0, ""lines"": 2}}"
2022-02-14 15:04:55,774e55702f236b0f16ef4a255a290dc87cfca67b,Ada,9,0,9,3,"{""src/po/Make_all.mak"": {""insertions"": 1, ""deletions"": 0, ""lines"": 1}, ""src/po/Makefile"": {""insertions"": 6, ""deletions"": 0, ""lines"": 6}, ""src/version.c"": {""insertions"": 2, ""deletions"": 0, ""lines"": 2}}"
2022-02-14 14:51:22,55737c2a31ed450dd7bf2a9c587adfbb32b755bb,Bram Moolenaar,37,7,44,4,"{""src/change.c"": {""insertions"": 2, ""deletions"": 5, ""lines"": 7}, ""src/testdir/test_listener.vim"": {""insertions"": 31, ""deletions"": 0, ""lines"": 31}, ""src/undo.c"": {""insertions"": 2, ""deletions"": 2, ""lines"": 4}, ""src/version.c"": {""insertions"": 2, ""deletions"": 0, ""lines"": 2}}"
2022-02-14 12:44:32,6dd7424c7e6ab81998c29ca3526c41b75cfde5a1,Christian Brabandt,101,0,101,6,"{""src/search.c"": {""insertions"": 27, ""deletions"": 0, ""lines"": 27}, ""src/testdir/dumps/Test_searchstat_inc_1.dump"": {""insertions"": 10, ""deletions"": 0, ""lines"": 10}, ""src/testdir/dumps/Test_searchstat_inc_2.dump"": {""insertions"": 10, ""deletions"": 0, ""lines"": 10}, ""src/testdir/dumps/Test_searchstat_inc_3.dump"": {""insertions"": 10, ""deletions"": 0, ""lines"": 10}, ""src/testdir/test_search_stat.vim"": {""insertions"": 42, ""deletions"": 0, ""lines"": 42}, ""src/version.c"": {""insertions"": 2, ""deletions"": 0, ""lines"": 2}}"
2022-02-14 11:36:57,0cd3e94e2cf18550c10f85814c9c1b1d4929003c,ichizok,37,31,68,2,"{"".github/workflows/ci.yml"": {""insertions"": 35, ""deletions"": 31, ""lines"": 66}, ""src/version.c"": {""insertions"": 2, ""deletions"": 0, ""lines"": 2}}"
2022-02-14 11:10:59,9773db6f9bce7a6f063e23179976d7825ace4d72,Yegappan Lakshmanan,87,14,101,3,"{""src/testdir/test_cmdline.vim"": {""insertions"": 84, ""deletions"": 13, ""lines"": 97}, ""src/testdir/test_usercommands.vim"": {""insertions"": 1, ""deletions"": 1, ""lines"": 2}, ""src/version.c"": {""insertions"": 2, ""deletions"": 0, ""lines"": 2}}"
2022-02-13 21:51:08,4b1d9639726ebe1630991488a1314db628b6b854,Bram Moolenaar,24,63,87,11,"{""src/Makefile"": {""insertions"": 1, ""deletions"": 1, ""lines"": 2}, ""src/eval.c"": {""insertions"": 1, ""deletions"": 2, ""lines"": 3}, ""src/evalfunc.c"": {""insertions"": 1, ""deletions"": 1, ""lines"": 2}, ""src/evalvars.c"": {""insertions"": 4, ""deletions"": 4, ""lines"": 8}, ""src/proto/vim9compile.pro"": {""insertions"": 1, ""deletions"": 1, ""lines"": 2}, ""src/userfunc.c"": {""insertions"": 2, ""deletions"": 3, ""lines"": 5}, ""src/version.c"": {""insertions"": 2, ""deletions"": 0, ""lines"": 2}, ""src/vim9.h"": {""insertions"": 1, ""deletions"": 3, ""lines"": 4}, ""src/vim9compile.c"": {""insertions"": 7, ""deletions"": 44, ""lines"": 51}, ""src/vim9expr.c"": {""insertions"": 3, ""deletions"": 3, ""lines"": 6}, ""src/vim9script.c"": {""insertions"": 1, ""deletions"": 1, ""lines"": 2}}"
2022-02-13 21:20:21,0631bb4ed7674b88ba395daf59ed222f77bc4913,Bram Moolenaar,3,21,24,2,"{""src/version.c"": {""insertions"": 2, ""deletions"": 0, ""lines"": 2}, ""src/vim9compile.c"": {""insertions"": 1, ""deletions"": 21, ""lines"": 22}}"
2022-02-13 20:46:18,c87aa34dfd68e95e4b1aac96d2274fcd672753ac,Bram Moolenaar,29,10,39,2,"{""src/testdir/test_expr.vim"": {""insertions"": 27, ""deletions"": 10, ""lines"": 37}, ""src/version.c"": {""insertions"": 2, ""deletions"": 0, ""lines"": 2}}"
2022-02-13 20:32:02,299d8e5eec8f8ae91177f7feb67ad59402dfa8e2,Bram Moolenaar,432,421,853,3,"{""runtime/autoload/dist/script.vim"": {""insertions"": 426, ""deletions"": 0, ""lines"": 426}, ""runtime/scripts.vim"": {""insertions"": 4, ""deletions"": 421, ""lines"": 425}, ""src/version.c"": {""insertions"": 2, ""deletions"": 0, ""lines"": 2}}"
2022-02-13 13:56:29,75e27d78f5370e7d2e0898326d9b080937e7b090,Bram Moolenaar,19,1,20,4,"{""src/errors.h"": {""insertions"": 2, ""deletions"": 0, ""lines"": 2}, ""src/evalvars.c"": {""insertions"": 6, ""deletions"": 0, ""lines"": 6}, ""src/testdir/test_vim9_script.vim"": {""insertions"": 9, ""deletions"": 1, ""lines"": 10}, ""src/version.c"": {""insertions"": 2, ""deletions"": 0, ""lines"": 2}}"
2022-02-13 13:11:32,cf6ad8ea8cff318877758b48d3786ab08251ab89,Christian Brabandt,5,0,5,2,"{""nsis/gvim.nsi"": {""insertions"": 3, ""deletions"": 0, ""lines"": 3}, ""src/version.c"": {""insertions"": 2, ""deletions"": 0, ""lines"": 2}}"
2022-02-13 12:24:21,f7fbeed0ac8e694a6865cab26b82caeea0870966,ola.soder@axis.com,4,2,6,2,"{""src/feature.h"": {""insertions"": 2, ""deletions"": 2, ""lines"": 4}, ""src/version.c"": {""insertions"": 2, ""deletions"": 0, ""lines"": 2}}"
2022-02-13 12:13:38,e131496ebf714f5f12f9903d9aa910bcd8184460,ola.soder@axis.com,10,8,18,3,"{""src/os_amiga.c"": {""insertions"": 7, ""deletions"": 7, ""lines"": 14}, ""src/term.c"": {""insertions"": 1, ""deletions"": 1, ""lines"": 2}, ""src/version.c"": {""insertions"": 2, ""deletions"": 0, ""lines"": 2}}"
2022-02-13 11:57:33,4525a57afbea3e0885642bbebbc24d5a25c97da9,Bram Moolenaar,61,56,117,3,"{""src/eval.c"": {""insertions"": 33, ""deletions"": 32, ""lines"": 65}, ""src/userfunc.c"": {""insertions"": 26, ""deletions"": 24, ""lines"": 50}, ""src/version.c"": {""insertions"": 2, ""deletions"": 0, ""lines"": 2}}"
2022-02-13 11:45:09,4d03d870007c593bce2cfa8d0a6597ca3a20fa35,Yegappan Lakshmanan,61,0,61,4,"{""src/cmdexpand.c"": {""insertions"": 3, ""deletions"": 0, ""lines"": 3}, ""src/testdir/test_cmdline.vim"": {""insertions"": 45, ""deletions"": 0, ""lines"": 45}, ""src/testdir/test_usercommands.vim"": {""insertions"": 11, ""deletions"": 0, ""lines"": 11}, ""src/version.c"": {""insertions"": 2, ""deletions"": 0, ""lines"": 2}}"
2022-02-12 22:13:06,cdf04859699bdde891b5b52ea821d0bebd7e8ee0,Bram Moolenaar,23,0,23,3,"{""src/testdir/test_vim9_cmd.vim"": {""insertions"": 14, ""deletions"": 0, ""lines"": 14}, ""src/userfunc.c"": {""insertions"": 7, ""deletions"": 0, ""lines"": 7}, ""src/version.c"": {""insertions"": 2, ""deletions"": 0, ""lines"": 2}}"
2022-02-12 21:59:51,45491660787043ea412719544881db691338d730,Bram Moolenaar,3,1,4,2,"{""src/indent.c"": {""insertions"": 1, ""deletions"": 1, ""lines"": 2}, ""src/version.c"": {""insertions"": 2, ""deletions"": 0, ""lines"": 2}}"
2022-02-12 21:16:21,8e38555ece7d3fe1edc6681ec70fe5586a524862,Bram Moolenaar,5,1,6,2,"{""src/version.c"": {""insertions"": 2, ""deletions"": 0, ""lines"": 2}, ""src/vim.h"": {""insertions"": 3, ""deletions"": 1, ""lines"": 4}}"
2022-02-12 20:46:15,33f3c5985491032d5bdfc30e722e85d5a0285e64,Bram Moolenaar,10,1,11,2,"{""src/indent.c"": {""insertions"": 8, ""deletions"": 1, ""lines"": 9}, ""src/version.c"": {""insertions"": 2, ""deletions"": 0, ""lines"": 2}}"
2022-02-12 20:34:50,62b191c38758c835a577ef091a803b6dd4cd4f49,Bram Moolenaar,15,12,27,6,"{""src/testdir/test_expr.vim"": {""insertions"": 2, ""deletions"": 1, ""lines"": 3}, ""src/testdir/test_functions.vim"": {""insertions"": 1, ""deletions"": 1, ""lines"": 2}, ""src/testdir/test_ins_complete.vim"": {""insertions"": 6, ""deletions"": 6, ""lines"": 12}, ""src/testdir/test_normal.vim"": {""insertions"": 2, ""deletions"": 2, ""lines"": 4}, ""src/testdir/test_tagfunc.vim"": {""insertions"": 2, ""deletions"": 2, ""lines"": 4}, ""src/version.c"": {""insertions"": 2, ""deletions"": 0, ""lines"": 2}}"
2022-02-12 19:52:25,a749a42ed25534c88c636e5ab6603f1f97b857a4,Bram Moolenaar,151,61,212,15,"{""src/errors.h"": {""insertions"": 3, ""deletions"": 1, ""lines"": 4}, ""src/eval.c"": {""insertions"": 14, ""deletions"": 0, ""lines"": 14}, ""src/proto/userfunc.pro"": {""insertions"": 1, ""deletions"": 0, ""lines"": 1}, ""src/testdir/test_vim9_assign.vim"": {""insertions"": 30, ""deletions"": 29, ""lines"": 59}, ""src/testdir/test_vim9_builtin.vim"": {""insertions"": 2, ""deletions"": 2, ""lines"": 4}, ""src/testdir/test_vim9_cmd.vim"": {""insertions"": 6, ""deletions"": 1, ""lines"": 7}, ""src/testdir/test_vim9_disassemble.vim"": {""insertions"": 2, ""deletions"": 2, ""lines"": 4}, ""src/testdir/test_vim9_expr.vim"": {""insertions"": 4, ""deletions"": 4, ""lines"": 8}, ""src/testdir/test_vim9_func.vim"": {""insertions"": 6, ""deletions"": 6, ""lines"": 12}, ""src/testdir/test_vim9_import.vim"": {""insertions"": 6, ""deletions"": 6, ""lines"": 12}, ""src/testdir/test_vim9_script.vim"": {""insertions"": 50, ""deletions"": 3, ""lines"": 53}, ""src/testdir/vim9.vim"": {""insertions"": 6, ""deletions"": 6, ""lines"": 12}, ""src/userfunc.c"": {""insertions"": 18, ""deletions"": 0, ""lines"": 18}, ""src/version.c"": {""insertions"": 2, ""deletions"": 0, ""lines"": 2}, ""src/vim9compile.c"": {""insertions"": 1, ""deletions"": 1, ""lines"": 2}}"
2022-02-12 15:42:18,6e28703a8e41f775f64e442c5d11ce1ff599aa3f,Bram Moolenaar,26,0,26,3,"{""src/indent.c"": {""insertions"": 5, ""deletions"": 0, ""lines"": 5}, ""src/testdir/test_retab.vim"": {""insertions"": 19, ""deletions"": 0, ""lines"": 19}, ""src/version.c"": {""insertions"": 2, ""deletions"": 0, ""lines"": 2}}"
2022-02-12 14:23:17,90a57168a42048eb7e176a4f9acf607c31e8074f,Bram Moolenaar,15,0,15,3,"{""src/testdir/test_vim9_script.vim"": {""insertions"": 12, ""deletions"": 0, ""lines"": 12}, ""src/version.c"": {""insertions"": 2, ""deletions"": 0, ""lines"": 2}, ""src/vim9execute.c"": {""insertions"": 1, ""deletions"": 0, ""lines"": 1}}"
2022-02-12 13:30:17,2a9b62dfa2fb91a6ede9cb4d146ca47a1db31254,Bram Moolenaar,19,0,19,3,"{""src/scriptfile.c"": {""insertions"": 5, ""deletions"": 0, ""lines"": 5}, ""src/testdir/test_vim9_cmd.vim"": {""insertions"": 12, ""deletions"": 0, ""lines"": 12}, ""src/version.c"": {""insertions"": 2, ""deletions"": 0, ""lines"": 2}}"
2022-02-12 12:03:07,620d8edba01bb2779485718dd1a99ca670ca894b,Yegappan Lakshmanan,691,555,1246,2,"{""src/cmdexpand.c"": {""insertions"": 689, ""deletions"": 555, ""lines"": 1244}, ""src/version.c"": {""insertions"": 2, ""deletions"": 0, ""lines"": 2}}"
2022-02-12 11:51:25,0f7ff851cb721bb3c07261adbf82b591229f530d,Sean Dewar,3,5,8,3,"{""src/option.c"": {""insertions"": 1, ""deletions"": 1, ""lines"": 2}, ""src/version.c"": {""insertions"": 2, ""deletions"": 0, ""lines"": 2}, ""src/window.c"": {""insertions"": 0, ""deletions"": 4, ""lines"": 4}}"
2022-02-12 11:18:37,d68b2fc034fa3c824e0d4d53745cfe9eb8c5ecd6,K.Takata,79,31,110,8,"{""src/crypt.c"": {""insertions"": 57, ""deletions"": 22, ""lines"": 79}, ""src/evalfunc.c"": {""insertions"": 5, ""deletions"": 1, ""lines"": 6}, ""src/gui_dwrite.cpp"": {""insertions"": 3, ""deletions"": 3, ""lines"": 6}, ""src/if_cscope.c"": {""insertions"": 0, ""deletions"": 3, ""lines"": 3}, ""src/os_win32.c"": {""insertions"": 6, ""deletions"": 1, ""lines"": 7}, ""src/proto/crypt.pro"": {""insertions"": 1, ""deletions"": 0, ""lines"": 1}, ""src/proto/os_win32.pro"": {""insertions"": 1, ""deletions"": 1, ""lines"": 2}, ""src/version.c"": {""insertions"": 6, ""deletions"": 0, ""lines"": 6}}"
2022-02-12 10:53:07,18f7593e57730e6de7c2cf47c87e44252cfbb61e,Philip H,5,3,8,2,"{"".github/workflows/ci.yml"": {""insertions"": 3, ""deletions"": 3, ""lines"": 6}, ""src/version.c"": {""insertions"": 2, ""deletions"": 0, ""lines"": 2}}"
2022-02-12 10:33:56,0c3cc2fec31521b0697edc406f85b7a43e979860,Ananda Umamil,6,0,6,3,"{""runtime/filetype.vim"": {""insertions"": 3, ""deletions"": 0, ""lines"": 3}, ""src/testdir/test_filetype.vim"": {""insertions"": 1, ""deletions"": 0, ""lines"": 1}, ""src/version.c"": {""insertions"": 2, ""deletions"": 0, ""lines"": 2}}"
2022-02-12 10:13:13,41ee5b191376ee3c0394664de5a7e7d83974aaa4,ichizok,40,6,46,2,"{"".github/workflows/ci.yml"": {""insertions"": 38, ""deletions"": 6, ""lines"": 44}, ""src/version.c"": {""insertions"": 2, ""deletions"": 0, ""lines"": 2}}"
2022-02-11 21:13:35,29c70f612f62486cb2fc90a58ca9e1498dd28630,ola.soder@axis.com,2,1,3,2,"{""src/version.c"": {""insertions"": 2, ""deletions"": 0, ""lines"": 2}, ""src/vim.h"": {""insertions"": 0, ""deletions"": 1, ""lines"": 1}}"
2022-02-11 20:55:16,c9e3187d053dcef03d11915b06be0c78ab45bc75,Bram Moolenaar,4,0,4,2,"{""src/testdir/test_filechanged.vim"": {""insertions"": 2, ""deletions"": 0, ""lines"": 2}, ""src/version.c"": {""insertions"": 2, ""deletions"": 0, ""lines"": 2}}"
2022-02-11 20:33:48,5b1d6e98c6610553fe3946086cdba77718bd69d5,Bram Moolenaar,42,5,47,6,"{""runtime/doc/vim9.txt"": {""insertions"": 5, ""deletions"": 5, ""lines"": 10}, ""src/eval.c"": {""insertions"": 8, ""deletions"": 0, ""lines"": 8}, ""src/ex_docmd.c"": {""insertions"": 1, ""deletions"": 0, ""lines"": 1}, ""src/globals.h"": {""insertions"": 1, ""deletions"": 0, ""lines"": 1}, ""src/testdir/test_vim9_cmd.vim"": {""insertions"": 25, ""deletions"": 0, ""lines"": 25}, ""src/version.c"": {""insertions"": 2, ""deletions"": 0, ""lines"": 2}}"
2022-02-11 19:27:55,bd89d4406327d3a30517443a4a518f49ebc99368,ola.soder@axis.com,13,4,17,2,"{""src/version.c"": {""insertions"": 2, ""deletions"": 0, ""lines"": 2}, ""src/vim.h"": {""insertions"": 11, ""deletions"": 4, ""lines"": 15}}"
2022-02-11 18:51:45,481acb11413a436653e235d2098990b2ad47d195,Bram Moolenaar,31,0,31,4,"{""src/drawscreen.c"": {""insertions"": 4, ""deletions"": 0, ""lines"": 4}, ""src/testdir/dumps/Test_wildmenu_pum_39.dump"": {""insertions"": 10, ""deletions"": 0, ""lines"": 10}, ""src/testdir/test_cmdline.vim"": {""insertions"": 15, ""deletions"": 0, ""lines"": 15}, ""src/version.c"": {""insertions"": 2, ""deletions"": 0, ""lines"": 2}}"
2022-02-11 16:30:12,f6246f51e3d85a982a899b4a8fd9045a5e23016f,Bram Moolenaar,15,3,18,3,"{""src/autocmd.c"": {""insertions"": 3, ""deletions"": 1, ""lines"": 4}, ""src/testdir/test_autocmd.vim"": {""insertions"": 10, ""deletions"": 2, ""lines"": 12}, ""src/version.c"": {""insertions"": 2, ""deletions"": 0, ""lines"": 2}}"
2022-02-11 16:11:14,14f23122bf94d0d835bed6f0bd0d17b3e47441ab,ola.soder@axis.com,2,1,3,2,"{""src/memfile.c"": {""insertions"": 0, ""deletions"": 1, ""lines"": 1}, ""src/version.c"": {""insertions"": 2, ""deletions"": 0, ""lines"": 2}}"
2022-02-11 15:12:10,8196e94a8b72ed8618605cb66615571313097d78,Rob Pilling,145,17,162,8,"{""runtime/doc/editing.txt"": {""insertions"": 5, ""deletions"": 0, ""lines"": 5}, ""runtime/doc/eval.txt"": {""insertions"": 5, ""deletions"": 0, ""lines"": 5}, ""src/fileio.c"": {""insertions"": 35, ""deletions"": 15, ""lines"": 50}, ""src/message.c"": {""insertions"": 2, ""deletions"": 0, ""lines"": 2}, ""src/proto/fileio.pro"": {""insertions"": 1, ""deletions"": 1, ""lines"": 2}, ""src/spellfile.c"": {""insertions"": 1, ""deletions"": 1, ""lines"": 2}, ""src/testdir/test_filechanged.vim"": {""insertions"": 94, ""deletions"": 0, ""lines"": 94}, ""src/version.c"": {""insertions"": 2, ""deletions"": 0, ""lines"": 2}}"
2022-02-11 13:29:40,92f645bef7bb817822d115291fe584b15647d577,Bram Moolenaar,83,62,145,7,"{""runtime/doc/testing.txt"": {""insertions"": 1, ""deletions"": 1, ""lines"": 2}, ""runtime/doc/todo.txt"": {""insertions"": 4, ""deletions"": 1, ""lines"": 5}, ""runtime/doc/usr_41.txt"": {""insertions"": 3, ""deletions"": 1, ""lines"": 4}, ""runtime/doc/vim9.txt"": {""insertions"": 14, ""deletions"": 9, ""lines"": 23}, ""runtime/ftplugin.vim"": {""insertions"": 3, ""deletions"": 2, ""lines"": 5}, ""runtime/indent.vim"": {""insertions"": 2, ""deletions"": 2, ""lines"": 4}, ""runtime/pack/dist/opt/shellmenu/plugin/shellmenu.vim"": {""insertions"": 56, ""deletions"": 46, ""lines"": 102}}"
2022-02-11 11:09:40,bece72785dcbeba00e6424d78a941450fda78929,ichizok,3,1,4,2,"{"".github/workflows/ci.yml"": {""insertions"": 1, ""deletions"": 1, ""lines"": 2}, ""src/version.c"": {""insertions"": 2, ""deletions"": 0, ""lines"": 2}}"
2022-02-10 21:09:45,414acd342f4a66d930da34d419929985b48bd301,Bram Moolenaar,20,0,20,4,"{""src/cmdexpand.c"": {""insertions"": 1, ""deletions"": 0, ""lines"": 1}, ""src/testdir/dumps/Test_wildmenu_pum_38.dump"": {""insertions"": 10, ""deletions"": 0, ""lines"": 10}, ""src/testdir/test_cmdline.vim"": {""insertions"": 7, ""deletions"": 0, ""lines"": 7}, ""src/version.c"": {""insertions"": 2, ""deletions"": 0, ""lines"": 2}}"
2022-02-10 20:21:04,949b35d83b69a7eab7b280b5af6940da9aedad43,ola.soder@axis.com,44,2,46,2,"{""src/os_amiga.c"": {""insertions"": 42, ""deletions"": 2, ""lines"": 44}, ""src/version.c"": {""insertions"": 2, ""deletions"": 0, ""lines"": 2}}"
2022-02-10 19:52:10,560dff49c0095111fc96b4b8dd7f4d269aba9473,Yegappan Lakshmanan,216,139,355,22,"{""src/cmdexpand.c"": {""insertions"": 79, ""deletions"": 42, ""lines"": 121}, ""src/ex_getln.c"": {""insertions"": 20, ""deletions"": 15, ""lines"": 35}, ""src/popupmenu.c"": {""insertions"": 2, ""deletions"": 0, ""lines"": 2}, ""src/testdir/dumps/Test_wildmenu_pum_33.dump"": {""insertions"": 10, ""deletions"": 0, ""lines"": 10}, ""src/testdir/dumps/Test_wildmenu_pum_34.dump"": {""insertions"": 10, ""deletions"": 0, ""lines"": 10}, ""src/testdir/dumps/Test_wildmenu_pum_35.dump"": {""insertions"": 10, ""deletions"": 0, ""lines"": 10}, ""src/testdir/dumps/Test_wildmenu_pum_36.dump"": {""insertions"": 10, ""deletions"": 0, ""lines"": 10}, ""src/testdir/dumps/Test_wildmenu_pum_37.dump"": {""insertions"": 10, ""deletions"": 0, ""lines"": 10}, ""src/testdir/screendump.vim"": {""insertions"": 3, ""deletions"": 0, ""lines"": 3}, ""src/testdir/test_bufline.vim"": {""insertions"": 0, ""deletions"": 1, ""lines"": 1}, ""src/testdir/test_cmdline.vim"": {""insertions"": 60, ""deletions"": 35, ""lines"": 95}, ""src/testdir/test_conceal.vim"": {""insertions"": 0, ""deletions"": 1, ""lines"": 1}, ""src/testdir/test_cursorline.vim"": {""insertions"": 0, ""deletions"": 21, ""lines"": 21}, ""src/testdir/test_diffmode.vim"": {""insertions"": 0, ""deletions"": 1, ""lines"": 1}, ""src/testdir/test_display.vim"": {""insertions"": 0, ""deletions"": 1, ""lines"": 1}, ""src/testdir/test_highlight.vim"": {""insertions"": 0, ""deletions"": 3, ""lines"": 3}, ""src/testdir/test_match.vim"": {""insertions"": 0, ""deletions"": 3, ""lines"": 3}, ""src/testdir/test_popup.vim"": {""insertions"": 0, ""deletions"": 3, ""lines"": 3}, ""src/testdir/test_search_stat.vim"": {""insertions"": 0, ""deletions"": 7, ""lines"": 7}, ""src/testdir/test_terminal.vim"": {""insertions"": 0, ""deletions"": 3, ""lines"": 3}, ""src/testdir/test_textprop.vim"": {""insertions"": 0, ""deletions"": 3, ""lines"": 3}, ""src/version.c"": {""insertions"": 2, ""deletions"": 0, ""lines"": 2}}"
2022-02-10 14:07:41,74a0a5b26d0180f3ea89e9495dff6a26f0df23cb,Bram Moolenaar,88,0,88,6,"{""src/getchar.c"": {""insertions"": 24, ""deletions"": 0, ""lines"": 24}, ""src/testdir/dumps/Test_map_expr_2.dump"": {""insertions"": 10, ""deletions"": 0, ""lines"": 10}, ""src/testdir/dumps/Test_map_expr_3.dump"": {""insertions"": 10, ""deletions"": 0, ""lines"": 10}, ""src/testdir/dumps/Test_map_expr_4.dump"": {""insertions"": 10, ""deletions"": 0, ""lines"": 10}, ""src/testdir/test_mapping.vim"": {""insertions"": 32, ""deletions"": 0, ""lines"": 32}, ""src/version.c"": {""insertions"": 2, ""deletions"": 0, ""lines"": 2}}"
2022-02-09 21:50:44,9da17d7c57071c306565da6a35c3704db1916b78,Bram Moolenaar,167,122,289,77,"{""runtime/doc/autocmd.txt"": {""insertions"": 2, ""deletions"": 2, ""lines"": 4}, ""runtime/doc/builtin.txt"": {""insertions"": 6, ""deletions"": 4, ""lines"": 10}, ""runtime/doc/if_pyth.txt"": {""insertions"": 15, ""deletions"": 2, ""lines"": 17}, ""runtime/doc/index.txt"": {""insertions"": 2, ""deletions"": 2, ""lines"": 4}, ""runtime/doc/options.txt"": {""insertions"": 1, ""deletions"": 1, ""lines"": 2}, ""runtime/doc/quickfix.txt"": {""insertions"": 1, ""deletions"": 1, ""lines"": 2}, ""runtime/doc/syntax.txt"": {""insertions"": 12, ""deletions"": 8, ""lines"": 20}, ""runtime/doc/tags"": {""insertions"": 2, ""deletions"": 0, ""lines"": 2}, ""runtime/doc/todo.txt"": {""insertions"": 8, ""deletions"": 5, ""lines"": 13}, ""runtime/doc/uganda.txt"": {""insertions"": 3, ""deletions"": 3, ""lines"": 6}, ""runtime/doc/vim9.txt"": {""insertions"": 19, ""deletions"": 7, ""lines"": 26}, ""runtime/ftplugin.vim"": {""insertions"": 15, ""deletions"": 8, ""lines"": 23}, ""runtime/ftplugof.vim"": {""insertions"": 9, ""deletions"": 7, ""lines"": 16}, ""runtime/menu.vim"": {""insertions"": 2, ""deletions"": 2, ""lines"": 4}, ""runtime/syntax/vim.vim"": {""insertions"": 4, ""deletions"": 4, ""lines"": 8}, ""runtime/tutor/tutor"": {""insertions"": 1, ""deletions"": 1, ""lines"": 2}, ""runtime/tutor/tutor.bar"": {""insertions"": 2, ""deletions"": 2, ""lines"": 4}, ""runtime/tutor/tutor.bar.utf-8"": {""insertions"": 2, ""deletions"": 2, ""lines"": 4}, ""runtime/tutor/tutor.bg.utf-8"": {""insertions"": 1, ""deletions"": 1, ""lines"": 2}, ""runtime/tutor/tutor.ca"": {""insertions"": 1, ""deletions"": 1, ""lines"": 2}, ""runtime/tutor/tutor.ca.utf-8"": {""insertions"": 1, ""deletions"": 1, ""lines"": 2}, ""runtime/tutor/tutor.cs"": {""insertions"": 1, ""deletions"": 1, ""lines"": 2}, ""runtime/tutor/tutor.cs.cp1250"": {""insertions"": 1, ""deletions"": 1, ""lines"": 2}, ""runtime/tutor/tutor.cs.utf-8"": {""insertions"": 1, ""deletions"": 1, ""lines"": 2}, ""runtime/tutor/tutor.da"": {""insertions"": 1, ""deletions"": 1, ""lines"": 2}, ""runtime/tutor/tutor.da.utf-8"": {""insertions"": 1, ""deletions"": 1, ""lines"": 2}, ""runtime/tutor/tutor.de"": {""insertions"": 2, ""deletions"": 2, ""lines"": 4}, ""runtime/tutor/tutor.de.utf-8"": {""insertions"": 2, ""deletions"": 2, ""lines"": 4}, ""runtime/tutor/tutor.el"": {""insertions"": 1, ""deletions"": 1, ""lines"": 2}, ""runtime/tutor/tutor.el.cp737"": {""insertions"": 1, ""deletions"": 1, ""lines"": 2}, ""runtime/tutor/tutor.el.utf-8"": {""insertions"": 1, ""deletions"": 1, ""lines"": 2}, ""runtime/tutor/tutor.hr"": {""insertions"": 1, ""deletions"": 1, ""lines"": 2}, ""runtime/tutor/tutor.hr.cp1250"": {""insertions"": 1, ""deletions"": 1, ""lines"": 2}, ""runtime/tutor/tutor.hr.utf-8"": {""insertions"": 1, ""deletions"": 1, ""lines"": 2}, ""runtime/tutor/tutor.hu"": {""insertions"": 1, ""deletions"": 1, ""lines"": 2}, ""runtime/tutor/tutor.hu.cp1250"": {""insertions"": 1, ""deletions"": 1, ""lines"": 2}, ""runtime/tutor/tutor.hu.utf-8"": {""insertions"": 1, ""deletions"": 1, ""lines"": 2}, ""runtime/tutor/tutor.it"": {""insertions"": 1, ""deletions"": 1, ""lines"": 2}, ""runtime/tutor/tutor.it.utf-8"": {""insertions"": 1, ""deletions"": 1, ""lines"": 2}, ""runtime/tutor/tutor.ja.euc"": {""insertions"": 1, ""deletions"": 1, ""lines"": 2}, ""runtime/tutor/tutor.ja.sjis"": {""insertions"": 1, ""deletions"": 1, ""lines"": 2}, ""runtime/tutor/tutor.ja.utf-8"": {""insertions"": 1, ""deletions"": 1, ""lines"": 2}, ""runtime/tutor/tutor.ko"": {""insertions"": 1, ""deletions"": 1, ""lines"": 2}, ""runtime/tutor/tutor.ko.euc"": {""insertions"": 1, ""deletions"": 1, ""lines"": 2}, ""runtime/tutor/tutor.ko.utf-8"": {""insertions"": 1, ""deletions"": 1, ""lines"": 2}, ""runtime/tutor/tutor.lv.utf-8"": {""insertions"": 1, ""deletions"": 1, ""lines"": 2}, ""runtime/tutor/tutor.nb"": {""insertions"": 1, ""deletions"": 1, ""lines"": 2}, ""runtime/tutor/tutor.nb.utf-8"": {""insertions"": 1, ""deletions"": 1, ""lines"": 2}, ""runtime/tutor/tutor.nl"": {""insertions"": 1, ""deletions"": 1, ""lines"": 2}, ""runtime/tutor/tutor.nl.utf-8"": {""insertions"": 1, ""deletions"": 1, ""lines"": 2}, ""runtime/tutor/tutor.no"": {""insertions"": 1, ""deletions"": 1, ""lines"": 2}, ""runtime/tutor/tutor.no.utf-8"": {""insertions"": 1, ""deletions"": 1, ""lines"": 2}, ""runtime/tutor/tutor.pl"": {""insertions"": 1, ""deletions"": 1, ""lines"": 2}, ""runtime/tutor/tutor.pl.cp1250"": {""insertions"": 1, ""deletions"": 1, ""lines"": 2}, ""runtime/tutor/tutor.pl.utf-8"": {""insertions"": 1, ""deletions"": 1, ""lines"": 2}, ""runtime/tutor/tutor.pt"": {""insertions"": 1, ""deletions"": 1, ""lines"": 2}, ""runtime/tutor/tutor.pt.utf-8"": {""insertions"": 1, ""deletions"": 1, ""lines"": 2}, ""runtime/tutor/tutor.ru"": {""insertions"": 1, ""deletions"": 1, ""lines"": 2}, ""runtime/tutor/tutor.ru.cp1251"": {""insertions"": 1, ""deletions"": 1, ""lines"": 2}, ""runtime/tutor/tutor.ru.utf-8"": {""insertions"": 1, ""deletions"": 1, ""lines"": 2}, ""runtime/tutor/tutor.sk"": {""insertions"": 1, ""deletions"": 1, ""lines"": 2}, ""runtime/tutor/tutor.sk.cp1250"": {""insertions"": 1, ""deletions"": 1, ""lines"": 2}, ""runtime/tutor/tutor.sk.utf-8"": {""insertions"": 1, ""deletions"": 1, ""lines"": 2}, ""runtime/tutor/tutor.sr.cp1250"": {""insertions"": 1, ""deletions"": 1, ""lines"": 2}, ""runtime/tutor/tutor.sr.utf-8"": {""insertions"": 1, ""deletions"": 1, ""lines"": 2}, ""runtime/tutor/tutor.sv"": {""insertions"": 1, ""deletions"": 1, ""lines"": 2}, ""runtime/tutor/tutor.sv.utf-8"": {""insertions"": 1, ""deletions"": 1, ""lines"": 2}, ""runtime/tutor/tutor.tr.iso9"": {""insertions"": 1, ""deletions"": 1, ""lines"": 2}, ""runtime/tutor/tutor.tr.utf-8"": {""insertions"": 1, ""deletions"": 1, ""lines"": 2}, ""runtime/tutor/tutor.uk.utf-8"": {""insertions"": 1, ""deletions"": 1, ""lines"": 2}, ""runtime/tutor/tutor.utf-8"": {""insertions"": 1, ""deletions"": 1, ""lines"": 2}, ""runtime/tutor/tutor.vi.utf-8"": {""insertions"": 1, ""deletions"": 1, ""lines"": 2}, ""runtime/tutor/tutor.zh.big5"": {""insertions"": 1, ""deletions"": 1, ""lines"": 2}, ""runtime/tutor/tutor.zh.euc"": {""insertions"": 1, ""deletions"": 1, ""lines"": 2}, ""runtime/tutor/tutor.zh.utf-8"": {""insertions"": 1, ""deletions"": 1, ""lines"": 2}, ""runtime/tutor/tutor.zh_cn.utf-8"": {""insertions"": 1, ""deletions"": 1, ""lines"": 2}, ""runtime/tutor/tutor.zh_tw.utf-8"": {""insertions"": 1, ""deletions"": 1, ""lines"": 2}}"
2022-02-09 15:20:39,78a8404f8b6ad0152614d5fdc3ec277444c1eee5,=?UTF-8?q?Dundar=20G=C3=B6c?=,3,1,4,2,"{""src/filepath.c"": {""insertions"": 1, ""deletions"": 1, ""lines"": 2}, ""src/version.c"": {""insertions"": 2, ""deletions"": 0, ""lines"": 2}}"
2022-02-09 14:31:05,769f5895ebfd10535a0ad978f071da8f20178fc6,Bram Moolenaar,15,4,19,3,"{""src/scriptfile.c"": {""insertions"": 7, ""deletions"": 4, ""lines"": 11}, ""src/testdir/test_filter_cmd.vim"": {""insertions"": 6, ""deletions"": 0, ""lines"": 6}, ""src/version.c"": {""insertions"": 2, ""deletions"": 0, ""lines"": 2}}"
2022-02-09 12:58:20,28e8f73ae2d90009fd62cd60f97c2643ba44de68,Bram Moolenaar,60,20,80,8,"{""runtime/doc/autocmd.txt"": {""insertions"": 6, ""deletions"": 0, ""lines"": 6}, ""src/autocmd.c"": {""insertions"": 1, ""deletions"": 0, ""lines"": 1}, ""src/ex_docmd.c"": {""insertions"": 38, ""deletions"": 16, ""lines"": 54}, ""src/misc2.c"": {""insertions"": 3, ""deletions"": 0, ""lines"": 3}, ""src/proto/ex_docmd.pro"": {""insertions"": 1, ""deletions"": 0, ""lines"": 1}, ""src/testdir/test_autocmd.vim"": {""insertions"": 8, ""deletions"": 4, ""lines"": 12}, ""src/version.c"": {""insertions"": 2, ""deletions"": 0, ""lines"": 2}, ""src/vim.h"": {""insertions"": 1, ""deletions"": 0, ""lines"": 1}}"
2022-02-09 11:55:47,68cc2b8a37197872e737fb61244069e13b7227a2,rbtnn,24,1,25,4,"{""src/cmdexpand.c"": {""insertions"": 1, ""deletions"": 1, ""lines"": 2}, ""src/testdir/dumps/Test_wildmenu_pum_32.dump"": {""insertions"": 10, ""deletions"": 0, ""lines"": 10}, ""src/testdir/test_cmdline.vim"": {""insertions"": 11, ""deletions"": 0, ""lines"": 11}, ""src/version.c"": {""insertions"": 2, ""deletions"": 0, ""lines"": 2}}"
2022-02-08 21:17:22,b6a138eb334621f60c5891d035f80f398d59dbd3,Bram Moolenaar,19,10,29,7,"{""src/eval.c"": {""insertions"": 2, ""deletions"": 2, ""lines"": 4}, ""src/proto/vim9compile.pro"": {""insertions"": 1, ""deletions"": 1, ""lines"": 2}, ""src/proto/vim9script.pro"": {""insertions"": 1, ""deletions"": 1, ""lines"": 2}, ""src/version.c"": {""insertions"": 2, ""deletions"": 0, ""lines"": 2}, ""src/vim9compile.c"": {""insertions"": 8, ""deletions"": 3, ""lines"": 11}, ""src/vim9expr.c"": {""insertions"": 2, ""deletions"": 2, ""lines"": 4}, ""src/vim9script.c"": {""insertions"": 3, ""deletions"": 1, ""lines"": 4}}"
2022-02-08 20:35:30,dce2441a603f2c9343a4a46091283a32420d80a2,Bram Moolenaar,86,24,110,7,"{""src/proto/vim9compile.pro"": {""insertions"": 2, ""deletions"": 2, ""lines"": 4}, ""src/testdir/test_vim9_func.vim"": {""insertions"": 37, ""deletions"": 0, ""lines"": 37}, ""src/userfunc.c"": {""insertions"": 7, ""deletions"": 4, ""lines"": 11}, ""src/version.c"": {""insertions"": 2, ""deletions"": 0, ""lines"": 2}, ""src/vim9compile.c"": {""insertions"": 35, ""deletions"": 16, ""lines"": 51}, ""src/vim9expr.c"": {""insertions"": 1, ""deletions"": 1, ""lines"": 2}, ""src/vim9script.c"": {""insertions"": 2, ""deletions"": 1, ""lines"": 3}}"
2022-02-08 19:23:35,3a5988c025f8517ba382730dc54bb13df937edb4,Bram Moolenaar,27,1,28,2,"{""src/testdir/test_vim9_func.vim"": {""insertions"": 25, ""deletions"": 1, ""lines"": 26}, ""src/version.c"": {""insertions"": 2, ""deletions"": 0, ""lines"": 2}}"
2022-02-08 19:12:19,779aeff5c32c26161f42cdccbaa2376e78ee77d6,Bram Moolenaar,20,2,22,4,"{""src/errors.h"": {""insertions"": 2, ""deletions"": 1, ""lines"": 3}, ""src/testdir/test_vim9_import.vim"": {""insertions"": 10, ""deletions"": 1, ""lines"": 11}, ""src/version.c"": {""insertions"": 2, ""deletions"": 0, ""lines"": 2}, ""src/vim9script.c"": {""insertions"": 6, ""deletions"": 0, ""lines"": 6}}"
2022-02-08 18:09:29,e023d499378942a6c3a3855cbe461ec2cb570f63,haya14busa,88,18,106,4,"{""runtime/doc/quickfix.txt"": {""insertions"": 5, ""deletions"": 0, ""lines"": 5}, ""src/quickfix.c"": {""insertions"": 58, ""deletions"": 18, ""lines"": 76}, ""src/testdir/test_quickfix.vim"": {""insertions"": 23, ""deletions"": 0, ""lines"": 23}, ""src/version.c"": {""insertions"": 2, ""deletions"": 0, ""lines"": 2}}"
2022-02-08 17:40:36,73a16c22a4703cb9a7becdf459ce62bd894980d7,Bram Moolenaar,33,1,34,5,"{""src/ex_getln.c"": {""insertions"": 2, ""deletions"": 1, ""lines"": 3}, ""src/testdir/dumps/Test_wildmenu_pum_30.dump"": {""insertions"": 10, ""deletions"": 0, ""lines"": 10}, ""src/testdir/dumps/Test_wildmenu_pum_31.dump"": {""insertions"": 10, ""deletions"": 0, ""lines"": 10}, ""src/testdir/test_cmdline.vim"": {""insertions"": 9, ""deletions"": 0, ""lines"": 9}, ""src/version.c"": {""insertions"": 2, ""deletions"": 0, ""lines"": 2}}"
2022-02-08 15:05:20,e3537aec2f8d6470010547af28dcbd83d41461b8,Bram Moolenaar,49,4,53,3,"{""src/buffer.c"": {""insertions"": 22, ""deletions"": 4, ""lines"": 26}, ""src/testdir/test_quickfix.vim"": {""insertions"": 25, ""deletions"": 0, ""lines"": 25}, ""src/version.c"": {""insertions"": 2, ""deletions"": 0, ""lines"": 2}}"
2022-02-08 12:58:37,51ab7c7d0da08aac796acff22a6c075dac579e76,zeertzjq,29,1,30,2,"{""src/testdir/test_textformat.vim"": {""insertions"": 27, ""deletions"": 1, ""lines"": 28}, ""src/version.c"": {""insertions"": 2, ""deletions"": 0, ""lines"": 2}}"
2022-02-08 12:08:07,3908ef5017a6b4425727013588f72cc7343199b9,Yegappan Lakshmanan,673,17,690,41,"{""runtime/doc/options.txt"": {""insertions"": 25, ""deletions"": 6, ""lines"": 31}, ""src/cmdexpand.c"": {""insertions"": 106, ""deletions"": 3, ""lines"": 109}, ""src/drawscreen.c"": {""insertions"": 4, ""deletions"": 0, ""lines"": 4}, ""src/evalfunc.c"": {""insertions"": 1, ""deletions"": 1, ""lines"": 2}, ""src/ex_getln.c"": {""insertions"": 50, ""deletions"": 5, ""lines"": 55}, ""src/option.h"": {""insertions"": 5, ""deletions"": 0, ""lines"": 5}, ""src/optionstr.c"": {""insertions"": 1, ""deletions"": 1, ""lines"": 2}, ""src/popupmenu.c"": {""insertions"": 9, ""deletions"": 1, ""lines"": 10}, ""src/proto/cmdexpand.pro"": {""insertions"": 5, ""deletions"": 0, ""lines"": 5}, ""src/testdir/dumps/Test_wildmenu_pum_01.dump"": {""insertions"": 10, ""deletions"": 0, ""lines"": 10}, ""src/testdir/dumps/Test_wildmenu_pum_02.dump"": {""insertions"": 10, ""deletions"": 0, ""lines"": 10}, ""src/testdir/dumps/Test_wildmenu_pum_03.dump"": {""insertions"": 10, ""deletions"": 0, ""lines"": 10}, ""src/testdir/dumps/Test_wildmenu_pum_04.dump"": {""insertions"": 10, ""deletions"": 0, ""lines"": 10}, ""src/testdir/dumps/Test_wildmenu_pum_05.dump"": {""insertions"": 10, ""deletions"": 0, ""lines"": 10}, ""src/testdir/dumps/Test_wildmenu_pum_06.dump"": {""insertions"": 10, ""deletions"": 0, ""lines"": 10}, ""src/testdir/dumps/Test_wildmenu_pum_07.dump"": {""insertions"": 10, ""deletions"": 0, ""lines"": 10}, ""src/testdir/dumps/Test_wildmenu_pum_08.dump"": {""insertions"": 10, ""deletions"": 0, ""lines"": 10}, ""src/testdir/dumps/Test_wildmenu_pum_09.dump"": {""insertions"": 10, ""deletions"": 0, ""lines"": 10}, ""src/testdir/dumps/Test_wildmenu_pum_10.dump"": {""insertions"": 10, ""deletions"": 0, ""lines"": 10}, ""src/testdir/dumps/Test_wildmenu_pum_11.dump"": {""insertions"": 10, ""deletions"": 0, ""lines"": 10}, ""src/testdir/dumps/Test_wildmenu_pum_12.dump"": {""insertions"": 10, ""deletions"": 0, ""lines"": 10}, ""src/testdir/dumps/Test_wildmenu_pum_13.dump"": {""insertions"": 10, ""deletions"": 0, ""lines"": 10}, ""src/testdir/dumps/Test_wildmenu_pum_14.dump"": {""insertions"": 10, ""deletions"": 0, ""lines"": 10}, ""src/testdir/dumps/Test_wildmenu_pum_15.dump"": {""insertions"": 10, ""deletions"": 0, ""lines"": 10}, ""src/testdir/dumps/Test_wildmenu_pum_16.dump"": {""insertions"": 10, ""deletions"": 0, ""lines"": 10}, ""src/testdir/dumps/Test_wildmenu_pum_17.dump"": {""insertions"": 10, ""deletions"": 0, ""lines"": 10}, ""src/testdir/dumps/Test_wildmenu_pum_18.dump"": {""insertions"": 10, ""deletions"": 0, ""lines"": 10}, ""src/testdir/dumps/Test_wildmenu_pum_19.dump"": {""insertions"": 10, ""deletions"": 0, ""lines"": 10}, ""src/testdir/dumps/Test_wildmenu_pum_20.dump"": {""insertions"": 10, ""deletions"": 0, ""lines"": 10}, ""src/testdir/dumps/Test_wildmenu_pum_21.dump"": {""insertions"": 10, ""deletions"": 0, ""lines"": 10}, ""src/testdir/dumps/Test_wildmenu_pum_22.dump"": {""insertions"": 10, ""deletions"": 0, ""lines"": 10}, ""src/testdir/dumps/Test_wildmenu_pum_23.dump"": {""insertions"": 10, ""deletions"": 0, ""lines"": 10}, ""src/testdir/dumps/Test_wildmenu_pum_24.dump"": {""insertions"": 10, ""deletions"": 0, ""lines"": 10}, ""src/testdir/dumps/Test_wildmenu_pum_25.dump"": {""insertions"": 10, ""deletions"": 0, ""lines"": 10}, ""src/testdir/dumps/Test_wildmenu_pum_26.dump"": {""insertions"": 10, ""deletions"": 0, ""lines"": 10}, ""src/testdir/dumps/Test_wildmenu_pum_27.dump"": {""insertions"": 10, ""deletions"": 0, ""lines"": 10}, ""src/testdir/dumps/Test_wildmenu_pum_28.dump"": {""insertions"": 10, ""deletions"": 0, ""lines"": 10}, ""src/testdir/dumps/Test_wildmenu_pum_29.dump"": {""insertions"": 10, ""deletions"": 0, ""lines"": 10}, ""src/testdir/test_cmdline.vim"": {""insertions"": 173, ""deletions"": 0, ""lines"": 173}, ""src/version.c"": {""insertions"": 2, ""deletions"": 0, ""lines"": 2}, ""src/vim.h"": {""insertions"": 2, ""deletions"": 0, ""lines"": 2}}"
2022-02-07 21:54:01,3787f26c2ed33732a36f26ebe46faeebfe0151af,Bram Moolenaar,44,18,62,5,"{""src/errors.h"": {""insertions"": 4, ""deletions"": 0, ""lines"": 4}, ""src/testdir/test_vim9_func.vim"": {""insertions"": 23, ""deletions"": 7, ""lines"": 30}, ""src/userfunc.c"": {""insertions"": 14, ""deletions"": 10, ""lines"": 24}, ""src/version.c"": {""insertions"": 2, ""deletions"": 0, ""lines"": 2}, ""src/vim9compile.c"": {""insertions"": 1, ""deletions"": 1, ""lines"": 2}}"
2022-02-07 20:30:57,f681cfb90b972cb347b3d707c87e48f8accd0e2a,Bram Moolenaar,33,2,35,3,"{""src/testdir/test_vim9_func.vim"": {""insertions"": 26, ""deletions"": 2, ""lines"": 28}, ""src/version.c"": {""insertions"": 2, ""deletions"": 0, ""lines"": 2}, ""src/vim9compile.c"": {""insertions"": 5, ""deletions"": 0, ""lines"": 5}}"
2022-02-07 19:56:43,7aca5ca6763e50d2c23953b20e30fca7457c9abf,Bram Moolenaar,54,5,59,6,"{""src/eval.c"": {""insertions"": 3, ""deletions"": 0, ""lines"": 3}, ""src/evalfunc.c"": {""insertions"": 4, ""deletions"": 1, ""lines"": 5}, ""src/structs.h"": {""insertions"": 3, ""deletions"": 0, ""lines"": 3}, ""src/testdir/test_vim9_func.vim"": {""insertions"": 19, ""deletions"": 0, ""lines"": 19}, ""src/version.c"": {""insertions"": 2, ""deletions"": 0, ""lines"": 2}, ""src/vim9execute.c"": {""insertions"": 23, ""deletions"": 4, ""lines"": 27}}"
2022-02-07 17:50:39,92368aad613bca700877ccb1725e1cb5a80dd34a,Bram Moolenaar,27,0,27,3,"{""src/evalfunc.c"": {""insertions"": 3, ""deletions"": 0, ""lines"": 3}, ""src/testdir/test_vim9_func.vim"": {""insertions"": 22, ""deletions"": 0, ""lines"": 22}, ""src/version.c"": {""insertions"": 2, ""deletions"": 0, ""lines"": 2}}"
2022-02-07 15:57:50,28f1a51bde36e2770dd54c9e2ae69a26cafa5a64,qsmodo,34,12,46,3,"{""src/gui_athena.c"": {""insertions"": 16, ""deletions"": 6, ""lines"": 22}, ""src/gui_motif.c"": {""insertions"": 16, ""deletions"": 6, ""lines"": 22}, ""src/version.c"": {""insertions"": 2, ""deletions"": 0, ""lines"": 2}}"
2022-02-07 15:31:37,4e713bafc0ae191b1830e3cd3c323ebd695bc3a1,Bram Moolenaar,14,1,15,3,"{""src/testdir/test_vim9_cmd.vim"": {""insertions"": 6, ""deletions"": 0, ""lines"": 6}, ""src/version.c"": {""insertions"": 2, ""deletions"": 0, ""lines"": 2}, ""src/vim9execute.c"": {""insertions"": 6, ""deletions"": 1, ""lines"": 7}}"
2022-02-07 13:56:44,54969f4ef5825205ecde09ea80f4087fc3b68e5d,Bram Moolenaar,14,11,25,6,"{""src/clientserver.c"": {""insertions"": 1, ""deletions"": 1, ""lines"": 2}, ""src/eval.c"": {""insertions"": 5, ""deletions"": 5, ""lines"": 10}, ""src/evalvars.c"": {""insertions"": 2, ""deletions"": 1, ""lines"": 3}, ""src/version.c"": {""insertions"": 2, ""deletions"": 0, ""lines"": 2}, ""src/vim9cmds.c"": {""insertions"": 3, ""deletions"": 3, ""lines"": 6}, ""src/window.c"": {""insertions"": 1, ""deletions"": 1, ""lines"": 2}}"
2022-02-07 13:54:01,63ff72aab91679725077eab5c5405267792268bd,Bram Moolenaar,119,14,133,5,"{""src/errors.h"": {""insertions"": 4, ""deletions"": 0, ""lines"": 4}, ""src/if_python3.c"": {""insertions"": 83, ""deletions"": 10, ""lines"": 93}, ""src/os_win32.c"": {""insertions"": 29, ""deletions"": 4, ""lines"": 33}, ""src/proto/os_win32.pro"": {""insertions"": 1, ""deletions"": 0, ""lines"": 1}, ""src/version.c"": {""insertions"": 2, ""deletions"": 0, ""lines"": 2}}"
2022-02-07 10:45:23,b247e0622ef16b7819f5dadefd3e3f0a803b4021,K.Takata,6,8,14,5,"{""src/main.c"": {""insertions"": 1, ""deletions"": 1, ""lines"": 2}, ""src/os_unix.c"": {""insertions"": 1, ""deletions"": 1, ""lines"": 2}, ""src/pty.c"": {""insertions"": 0, ""deletions"": 4, ""lines"": 4}, ""src/version.c"": {""insertions"": 2, ""deletions"": 0, ""lines"": 2}, ""src/vim.h"": {""insertions"": 2, ""deletions"": 2, ""lines"": 4}}"
2022-02-07 10:33:20,6bf821e8abe1da24e5d0624f032d7eda745756e8,zeertzjq,42,6,48,2,"{""src/testdir/test_visual.vim"": {""insertions"": 40, ""deletions"": 6, ""lines"": 46}, ""src/version.c"": {""insertions"": 2, ""deletions"": 0, ""lines"": 2}}"
2022-02-06 20:28:13,8cbf2499179db39a46e700ab04d0b36e22bcc1bb,Bram Moolenaar,14,2,16,3,"{""src/testdir/test_vim9_script.vim"": {""insertions"": 5, ""deletions"": 0, ""lines"": 5}, ""src/version.c"": {""insertions"": 2, ""deletions"": 0, ""lines"": 2}, ""src/vim9compile.c"": {""insertions"": 7, ""deletions"": 2, ""lines"": 9}}"
2022-02-06 18:36:53,5f4ef5f5e5529c147c2274cd0f6416e2546d6fc7,Bram Moolenaar,6,0,6,3,"{""src/testdir/test_vim9_builtin.vim"": {""insertions"": 1, ""deletions"": 0, ""lines"": 1}, ""src/version.c"": {""insertions"": 2, ""deletions"": 0, ""lines"": 2}, ""src/vim9expr.c"": {""insertions"": 3, ""deletions"": 0, ""lines"": 3}}"
2022-02-06 17:30:41,107f7325f615a1ffa5b49521e316b44e117b0a04,Bram Moolenaar,7,0,7,3,"{""src/testdir/test_vim9_script.vim"": {""insertions"": 1, ""deletions"": 0, ""lines"": 1}, ""src/version.c"": {""insertions"": 2, ""deletions"": 0, ""lines"": 2}, ""src/vim9compile.c"": {""insertions"": 4, ""deletions"": 0, ""lines"": 4}}"
2022-02-06 17:17:02,160afdb1850b8cf56dc8e94acee7a04bc2113992,Bram Moolenaar,13,1,14,3,"{""src/testdir/test_vim9_assign.vim"": {""insertions"": 10, ""deletions"": 0, ""lines"": 10}, ""src/version.c"": {""insertions"": 2, ""deletions"": 0, ""lines"": 2}, ""src/vim9instr.c"": {""insertions"": 1, ""deletions"": 1, ""lines"": 2}}"
2022-02-06 15:49:35,2626d6a71ca616bd91d4ee2c27bd76a78a00d412,Bram Moolenaar,12,18,30,5,"{""src/proto/vim9type.pro"": {""insertions"": 1, ""deletions"": 1, ""lines"": 2}, ""src/testdir/test_vim9_builtin.vim"": {""insertions"": 5, ""deletions"": 0, ""lines"": 5}, ""src/version.c"": {""insertions"": 2, ""deletions"": 0, ""lines"": 2}, ""src/vim9instr.c"": {""insertions"": 4, ""deletions"": 8, ""lines"": 12}, ""src/vim9type.c"": {""insertions"": 0, ""deletions"": 9, ""lines"": 9}}"
2022-02-06 13:55:03,fe1bfc9b267fffedac6b5224d7aa6cc5d9d15f64,Bram Moolenaar,40,5,45,3,"{""src/testdir/test_vim9_func.vim"": {""insertions"": 29, ""deletions"": 0, ""lines"": 29}, ""src/version.c"": {""insertions"": 2, ""deletions"": 0, ""lines"": 2}, ""src/vim9execute.c"": {""insertions"": 9, ""deletions"": 5, ""lines"": 14}}"
2022-02-06 13:08:41,8164f6ea3cd675d0c22b058d71df2454fa108a35,Bram Moolenaar,7,1,8,3,"{""src/testdir/test_vim9_import.vim"": {""insertions"": 4, ""deletions"": 0, ""lines"": 4}, ""src/userfunc.c"": {""insertions"": 1, ""deletions"": 1, ""lines"": 2}, ""src/version.c"": {""insertions"": 2, ""deletions"": 0, ""lines"": 2}}"
2022-02-06 11:41:57,0c1550d9e94046d3fc9a8ad70b895eaa1e53fca5,Bram Moolenaar,7,5,12,2,"{""src/syntax.c"": {""insertions"": 5, ""deletions"": 5, ""lines"": 10}, ""src/version.c"": {""insertions"": 2, ""deletions"": 0, ""lines"": 2}}"
2022-02-05 20:23:59,500761b1cf666f030009d2dcdacfdce28f68f43d,Bram Moolenaar,336,313,649,2,"{""src/testdir/test_filetype.vim"": {""insertions"": 334, ""deletions"": 313, ""lines"": 647}, ""src/version.c"": {""insertions"": 2, ""deletions"": 0, ""lines"": 2}}"
2022-02-05 19:50:34,e5b7897585eccec84431d8b23df5cde2e283828c,Bram Moolenaar,25,3,28,3,"{""runtime/autoload/dist/ft.vim"": {""insertions"": 4, ""deletions"": 3, ""lines"": 7}, ""src/testdir/test_filetype.vim"": {""insertions"": 19, ""deletions"": 0, ""lines"": 19}, ""src/version.c"": {""insertions"": 2, ""deletions"": 0, ""lines"": 2}}"
2022-02-05 19:23:18,00eb99528edc9ee1d14241d6914168fc33331ded,Bram Moolenaar,27,1,28,3,"{""src/evalfunc.c"": {""insertions"": 22, ""deletions"": 1, ""lines"": 23}, ""src/testdir/test_vim9_builtin.vim"": {""insertions"": 3, ""deletions"": 0, ""lines"": 3}, ""src/version.c"": {""insertions"": 2, ""deletions"": 0, ""lines"": 2}}"
2022-02-05 18:53:06,cd53eed2c55f2256008962965b1de1d1df76d535,Dominique Pelle,7,5,12,2,"{""src/syntax.c"": {""insertions"": 5, ""deletions"": 5, ""lines"": 10}, ""src/version.c"": {""insertions"": 2, ""deletions"": 0, ""lines"": 2}}"
2022-02-05 18:12:34,82e46e5d31ba1ca8d4e322acdacdd90ab80705d9,Bram Moolenaar,67,20,87,3,"{""src/evalfunc.c"": {""insertions"": 30, ""deletions"": 20, ""lines"": 50}, ""src/testdir/test_vim9_builtin.vim"": {""insertions"": 35, ""deletions"": 0, ""lines"": 35}, ""src/version.c"": {""insertions"": 2, ""deletions"": 0, ""lines"": 2}}"
2022-02-05 14:05:51,e0c2b2ceaa8ca2d0f412f17f4cf14fb4f7a3296f,Bram Moolenaar,9,1,10,3,"{""src/dict.c"": {""insertions"": 4, ""deletions"": 1, ""lines"": 5}, ""src/testdir/test_vim9_builtin.vim"": {""insertions"": 3, ""deletions"": 0, ""lines"": 3}, ""src/version.c"": {""insertions"": 2, ""deletions"": 0, ""lines"": 2}}"
2022-02-05 12:39:24,4fa1346bf4210747f34b64d05b39309918ca538d,Bram Moolenaar,6,2,8,2,"{""src/main.c"": {""insertions"": 4, ""deletions"": 2, ""lines"": 6}, ""src/version.c"": {""insertions"": 2, ""deletions"": 0, ""lines"": 2}}"
2022-02-05 12:10:52,46f3080e5cd4cd1bae23e72a429a8195eb1ded7a,Bram Moolenaar,4,1,5,2,"{""src/main.c"": {""insertions"": 2, ""deletions"": 1, ""lines"": 3}, ""src/version.c"": {""insertions"": 2, ""deletions"": 0, ""lines"": 2}}"
2022-02-05 11:13:05,fc88df42f1ae64bcc4d6cbc0fbd3445f8c59afdf,Bram Moolenaar,13,1,14,3,"{""src/indent.c"": {""insertions"": 1, ""deletions"": 1, ""lines"": 2}, ""src/testdir/test_vartabs.vim"": {""insertions"": 10, ""deletions"": 0, ""lines"": 10}, ""src/version.c"": {""insertions"": 2, ""deletions"": 0, ""lines"": 2}}"
2022-02-04 21:58:58,21ebb0899ecf9049c3e1c9cbc2e06fd8e2a99e06,Bram Moolenaar,48,0,48,3,"{""src/testdir/test_vim9_disassemble.vim"": {""insertions"": 38, ""deletions"": 0, ""lines"": 38}, ""src/testdir/test_vim9_script.vim"": {""insertions"": 8, ""deletions"": 0, ""lines"": 8}, ""src/version.c"": {""insertions"": 2, ""deletions"": 0, ""lines"": 2}}"
2022-02-04 21:17:58,83d0cec95697c244c8096c78aa806469302a8e19,Bram Moolenaar,13,2,15,5,"{""src/testdir/test_vim9_assign.vim"": {""insertions"": 6, ""deletions"": 0, ""lines"": 6}, ""src/testdir/test_vim9_cmd.vim"": {""insertions"": 1, ""deletions"": 1, ""lines"": 2}, ""src/testdir/test_vim9_expr.vim"": {""insertions"": 1, ""deletions"": 0, ""lines"": 1}, ""src/version.c"": {""insertions"": 2, ""deletions"": 0, ""lines"": 2}, ""src/vim9expr.c"": {""insertions"": 3, ""deletions"": 1, ""lines"": 4}}"
2022-02-04 19:48:06,3e79c97c18c50f97797ab13ed81c4011eba9aba0,Bram Moolenaar,476,513,989,7,"{""runtime/autoload/dist/ft.vim"": {""insertions"": 1, ""deletions"": 1, ""lines"": 2}, ""runtime/doc/uganda.txt"": {""insertions"": 32, ""deletions"": 62, ""lines"": 94}, ""runtime/ftplugin.vim"": {""insertions"": 21, ""deletions"": 21, ""lines"": 42}, ""runtime/indent.vim"": {""insertions"": 19, ""deletions"": 18, ""lines"": 37}, ""runtime/makemenu.vim"": {""insertions"": 41, ""deletions"": 39, ""lines"": 80}, ""runtime/menu.vim"": {""insertions"": 335, ""deletions"": 340, ""lines"": 675}, ""runtime/synmenu.vim"": {""insertions"": 27, ""deletions"": 32, ""lines"": 59}}"
2022-02-04 16:09:54,a2baa73d1d33014adea0fd9567949089ca21a782,Bram Moolenaar,8348,5615,13963,26,"{""runtime/autoload/dist/ft.vim"": {""insertions"": 367, ""deletions"": 371, ""lines"": 738}, ""runtime/doc/builtin.txt"": {""insertions"": 13, ""deletions"": 10, ""lines"": 23}, ""runtime/doc/change.txt"": {""insertions"": 3, ""deletions"": 3, ""lines"": 6}, ""runtime/doc/cmdline.txt"": {""insertions"": 2, ""deletions"": 2, ""lines"": 4}, ""runtime/doc/editing.txt"": {""insertions"": 4, ""deletions"": 6, ""lines"": 10}, ""runtime/doc/eval.txt"": {""insertions"": 19, ""deletions"": 12, ""lines"": 31}, ""runtime/doc/filetype.txt"": {""insertions"": 2, ""deletions"": 1, ""lines"": 3}, ""runtime/doc/options.txt"": {""insertions"": 6, ""deletions"": 2, ""lines"": 8}, ""runtime/doc/pattern.txt"": {""insertions"": 2, ""deletions"": 2, ""lines"": 4}, ""runtime/doc/starting.txt"": {""insertions"": 1, ""deletions"": 1, ""lines"": 2}, ""runtime/doc/syntax.txt"": {""insertions"": 11, ""deletions"": 2, ""lines"": 13}, ""runtime/doc/tabpage.txt"": {""insertions"": 4, ""deletions"": 2, ""lines"": 6}, ""runtime/doc/tags"": {""insertions"": 98, ""deletions"": 3, ""lines"": 101}, ""runtime/doc/testing.txt"": {""insertions"": 22, ""deletions"": 24, ""lines"": 46}, ""runtime/doc/todo.txt"": {""insertions"": 1, ""deletions"": 13, ""lines"": 14}, ""runtime/doc/various.txt"": {""insertions"": 5, ""deletions"": 5, ""lines"": 10}, ""runtime/doc/version8.txt"": {""insertions"": 2, ""deletions"": 2, ""lines"": 4}, ""runtime/doc/vim9.txt"": {""insertions"": 110, ""deletions"": 34, ""lines"": 144}, ""runtime/doc/windows.txt"": {""insertions"": 2, ""deletions"": 2, ""lines"": 4}, ""runtime/gvim.desktop"": {""insertions"": 4, ""deletions"": 1, ""lines"": 5}, ""runtime/syntax/vim.vim"": {""insertions"": 8, ""deletions"": 8, ""lines"": 16}, ""runtime/vim.desktop"": {""insertions"": 4, ""deletions"": 1, ""lines"": 5}, ""src/po/ga.po"": {""insertions"": 7592, ""deletions"": 5058, ""lines"": 12650}, ""src/po/gvim.desktop.in"": {""insertions"": 0, ""deletions"": 1, ""lines"": 1}, ""src/po/it.po"": {""insertions"": 66, ""deletions"": 48, ""lines"": 114}, ""src/po/vim.desktop.in"": {""insertions"": 0, ""deletions"": 1, ""lines"": 1}}"
2022-02-04 11:36:51,46950b225fab2e10245a04952b2c238e0362e1b7,Bram Moolenaar,10,3,13,3,"{""src/list.c"": {""insertions"": 2, ""deletions"": 3, ""lines"": 5}, ""src/testdir/test_vim9_expr.vim"": {""insertions"": 6, ""deletions"": 0, ""lines"": 6}, ""src/version.c"": {""insertions"": 2, ""deletions"": 0, ""lines"": 2}}"
2022-02-04 10:45:38,972db232795874c58b9fdf23e43f53885a378eae,K.Takata,24,32,56,6,"{""src/evalfunc.c"": {""insertions"": 1, ""deletions"": 1, ""lines"": 2}, ""src/main.c"": {""insertions"": 3, ""deletions"": 5, ""lines"": 8}, ""src/os_unix.c"": {""insertions"": 6, ""deletions"": 8, ""lines"": 14}, ""src/os_win32.c"": {""insertions"": 10, ""deletions"": 14, ""lines"": 24}, ""src/os_win32.h"": {""insertions"": 2, ""deletions"": 4, ""lines"": 6}, ""src/version.c"": {""insertions"": 2, ""deletions"": 0, ""lines"": 2}}"
2022-02-03 21:47:34,7676c158798a7c90f500cab2c12af0d47bad6026,Bram Moolenaar,10,1,11,3,"{""src/list.c"": {""insertions"": 5, ""deletions"": 1, ""lines"": 6}, ""src/testdir/test_vim9_expr.vim"": {""insertions"": 3, ""deletions"": 0, ""lines"": 3}, ""src/version.c"": {""insertions"": 2, ""deletions"": 0, ""lines"": 2}}"
2022-02-03 21:29:39,02a977ea5ee733412011a7f259a4efa0ffc95f1a,Bram Moolenaar,3,1,4,2,"{""src/testdir/test_vim9_cmd.vim"": {""insertions"": 1, ""deletions"": 1, ""lines"": 2}, ""src/version.c"": {""insertions"": 2, ""deletions"": 0, ""lines"": 2}}"
2022-02-03 20:09:19,5658ca343f49a770ec068a858f52547ce822afa1,Bram Moolenaar,4,3,7,2,"{""src/errors.h"": {""insertions"": 2, ""deletions"": 3, ""lines"": 5}, ""src/version.c"": {""insertions"": 2, ""deletions"": 0, ""lines"": 2}}"
2022-02-03 14:32:33,a8ec4916caadd0a5113b7d41fa81d6d2c807260f,K.Takata,24,37,61,2,"{""src/gui_w32.c"": {""insertions"": 22, ""deletions"": 37, ""lines"": 59}, ""src/version.c"": {""insertions"": 2, ""deletions"": 0, ""lines"": 2}}"
2022-02-03 13:33:03,5411910c77cba85212963a2fb71d8c71f8a5d203,K.Takata,25,23,48,7,"{""src/cmdexpand.c"": {""insertions"": 3, ""deletions"": 3, ""lines"": 6}, ""src/drawscreen.c"": {""insertions"": 7, ""deletions"": 7, ""lines"": 14}, ""src/filepath.c"": {""insertions"": 3, ""deletions"": 3, ""lines"": 6}, ""src/getchar.c"": {""insertions"": 6, ""deletions"": 6, ""lines"": 12}, ""src/menu.c"": {""insertions"": 1, ""deletions"": 1, ""lines"": 2}, ""src/os_win32.c"": {""insertions"": 2, ""deletions"": 2, ""lines"": 4}, ""src/version.c"": {""insertions"": 3, ""deletions"": 1, ""lines"": 4}}"
2022-02-03 13:05:32,6e1d31e9e3ca42cb883abca198f011dc6f4ceb14,K.Takata,34,32,66,9,"{""src/arglist.c"": {""insertions"": 2, ""deletions"": 2, ""lines"": 4}, ""src/change.c"": {""insertions"": 2, ""deletions"": 2, ""lines"": 4}, ""src/ex_cmds.c"": {""insertions"": 2, ""deletions"": 2, ""lines"": 4}, ""src/gui.c"": {""insertions"": 9, ""deletions"": 9, ""lines"": 18}, ""src/hashtab.c"": {""insertions"": 2, ""deletions"": 2, ""lines"": 4}, ""src/indent.c"": {""insertions"": 2, ""deletions"": 2, ""lines"": 4}, ""src/ops.c"": {""insertions"": 2, ""deletions"": 2, ""lines"": 4}, ""src/os_win32.c"": {""insertions"": 11, ""deletions"": 11, ""lines"": 22}, ""src/version.c"": {""insertions"": 2, ""deletions"": 0, ""lines"": 2}}"
2022-02-03 12:34:05,2d3ac2e03093c4b0ae5d18c5f2f51ae0c2a9ec72,Bram Moolenaar,19,4,23,4,"{""src/testdir/test_vim9_assign.vim"": {""insertions"": 9, ""deletions"": 0, ""lines"": 9}, ""src/testdir/test_vim9_func.vim"": {""insertions"": 3, ""deletions"": 3, ""lines"": 6}, ""src/version.c"": {""insertions"": 2, ""deletions"": 0, ""lines"": 2}, ""src/vim9type.c"": {""insertions"": 5, ""deletions"": 1, ""lines"": 6}}"
2022-02-02 20:01:27,381692b6f1c2ec9b73a139500286ddc9347a1c01,Bram Moolenaar,154,57,211,14,"{""src/dict.c"": {""insertions"": 7, ""deletions"": 5, ""lines"": 12}, ""src/eval.c"": {""insertions"": 6, ""deletions"": 2, ""lines"": 8}, ""src/evalfunc.c"": {""insertions"": 31, ""deletions"": 4, ""lines"": 35}, ""src/evalvars.c"": {""insertions"": 1, ""deletions"": 18, ""lines"": 19}, ""src/list.c"": {""insertions"": 9, ""deletions"": 8, ""lines"": 17}, ""src/proto/dict.pro"": {""insertions"": 1, ""deletions"": 1, ""lines"": 2}, ""src/proto/eval.pro"": {""insertions"": 1, ""deletions"": 1, ""lines"": 2}, ""src/proto/list.pro"": {""insertions"": 1, ""deletions"": 1, ""lines"": 2}, ""src/proto/vim9type.pro"": {""insertions"": 1, ""deletions"": 0, ""lines"": 1}, ""src/testdir/test_vim9_assign.vim"": {""insertions"": 1, ""deletions"": 1, ""lines"": 2}, ""src/testdir/test_vim9_builtin.vim"": {""insertions"": 25, ""deletions"": 0, ""lines"": 25}, ""src/version.c"": {""insertions"": 2, ""deletions"": 0, ""lines"": 2}, ""src/vim9execute.c"": {""insertions"": 3, ""deletions"": 16, ""lines"": 19}, ""src/vim9type.c"": {""insertions"": 65, ""deletions"": 0, ""lines"": 65}}"
2022-02-02 16:20:26,a1c519518050383e7d319514a3ff6c42a9154c48,Bram Moolenaar,23,9,32,5,"{""src/proto/vim9compile.pro"": {""insertions"": 1, ""deletions"": 0, ""lines"": 1}, ""src/testdir/test_vim9_script.vim"": {""insertions"": 17, ""deletions"": 1, ""lines"": 18}, ""src/version.c"": {""insertions"": 2, ""deletions"": 0, ""lines"": 2}, ""src/vim9cmds.c"": {""insertions"": 2, ""deletions"": 7, ""lines"": 9}, ""src/vim9compile.c"": {""insertions"": 1, ""deletions"": 1, ""lines"": 2}}"
2022-02-02 15:19:38,ab8f7c50cf7d5c0c72dfa5067e5b1f57585db4d8,ichizok,2,790,792,9,"{""Filelist"": {""insertions"": 0, ""deletions"": 4, ""lines"": 4}, ""src/Makefile"": {""insertions"": 0, ""deletions"": 8, ""lines"": 8}, ""src/dehqx.py"": {""insertions"": 0, ""deletions"": 45, ""lines"": 45}, ""src/infplist.xml"": {""insertions"": 0, ""deletions"": 74, ""lines"": 74}, ""src/os_mac.rsr.hqx"": {""insertions"": 0, ""deletions"": 659, ""lines"": 659}, ""src/os_mac_rsrc/app.icns"": {""insertions"": 0, ""deletions"": 0, ""lines"": 0}, ""src/os_mac_rsrc/doc-txt.icns"": {""insertions"": 0, ""deletions"": 0, ""lines"": 0}, ""src/os_mac_rsrc/doc.icns"": {""insertions"": 0, ""deletions"": 0, ""lines"": 0}, ""src/version.c"": {""insertions"": 2, ""deletions"": 0, ""lines"": 2}}"
2022-02-02 13:16:37,73257149d759a8e6ddbe555d2b5aa37b6cb8db8b,zeertzjq,30,35,65,3,"{""src/ex_docmd.c"": {""insertions"": 21, ""deletions"": 26, ""lines"": 47}, ""src/misc2.c"": {""insertions"": 7, ""deletions"": 9, ""lines"": 16}, ""src/version.c"": {""insertions"": 2, ""deletions"": 0, ""lines"": 2}}"
2022-02-01 17:26:12,adbb1bf21dad5697cd82d46d9dd9e8e8d0f647e6,matveyt,23,0,23,4,"{""runtime/doc/starting.txt"": {""insertions"": 2, ""deletions"": 0, ""lines"": 2}, ""src/option.c"": {""insertions"": 11, ""deletions"": 0, ""lines"": 11}, ""src/testdir/test_restricted.vim"": {""insertions"": 8, ""deletions"": 0, ""lines"": 8}, ""src/version.c"": {""insertions"": 2, ""deletions"": 0, ""lines"": 2}}"
2022-02-01 13:54:17,9b4a80a66544f2782040b641498754bcb5b8d461,Bram Moolenaar,29,4,33,3,"{""src/buffer.c"": {""insertions"": 10, ""deletions"": 4, ""lines"": 14}, ""src/testdir/test_quickfix.vim"": {""insertions"": 17, ""deletions"": 0, ""lines"": 17}, ""src/version.c"": {""insertions"": 2, ""deletions"": 0, ""lines"": 2}}"
2022-02-01 12:47:07,eb4a9ba293be51039e57e0e18337785e2ce526e7,Bram Moolenaar,3,1,4,2,"{""src/version.c"": {""insertions"": 2, ""deletions"": 0, ""lines"": 2}, ""src/vim9expr.c"": {""insertions"": 1, ""deletions"": 1, ""lines"": 2}}"
2022-02-01 12:11:58,8133018f50bc447570825801e93d5ed67e8dac90,Bram Moolenaar,202,46,248,7,"{""src/evalfunc.c"": {""insertions"": 155, ""deletions"": 38, ""lines"": 193}, ""src/proto/evalfunc.pro"": {""insertions"": 1, ""deletions"": 1, ""lines"": 2}, ""src/proto/vim9type.pro"": {""insertions"": 1, ""deletions"": 0, ""lines"": 1}, ""src/testdir/test_vim9_builtin.vim"": {""insertions"": 13, ""deletions"": 1, ""lines"": 14}, ""src/version.c"": {""insertions"": 2, ""deletions"": 0, ""lines"": 2}, ""src/vim9instr.c"": {""insertions"": 8, ""deletions"": 4, ""lines"": 12}, ""src/vim9type.c"": {""insertions"": 22, ""deletions"": 2, ""lines"": 24}}"
2022-02-01 10:16:00,4e3b3182307444f205a5f35e257c651f0f3717ad,Bram Moolenaar,6,0,6,2,"{""src/testing.c"": {""insertions"": 4, ""deletions"": 0, ""lines"": 4}, ""src/version.c"": {""insertions"": 2, ""deletions"": 0, ""lines"": 2}}"
2022-01-31 18:59:13,68854a82fdedebf6ee0675d1abeae6fc627ff6bb,Bram Moolenaar,14,5,19,3,"{""src/ex_docmd.c"": {""insertions"": 4, ""deletions"": 4, ""lines"": 8}, ""src/testdir/test_vim9_import.vim"": {""insertions"": 8, ""deletions"": 1, ""lines"": 9}, ""src/version.c"": {""insertions"": 2, ""deletions"": 0, ""lines"": 2}}"
2022-01-31 17:40:55,9e0208f51cf1354ce0a7d3988133041a78681605,Yegappan Lakshmanan,68,67,135,8,"{""runtime/doc/builtin.txt"": {""insertions"": 0, ""deletions"": 2, ""lines"": 2}, ""runtime/doc/usr_41.txt"": {""insertions"": 0, ""deletions"": 1, ""lines"": 1}, ""src/evalfunc.c"": {""insertions"": 0, ""deletions"": 9, ""lines"": 9}, ""src/proto/testing.pro"": {""insertions"": 0, ""deletions"": 1, ""lines"": 1}, ""src/testdir/test_gui.vim"": {""insertions"": 27, ""deletions"": 3, ""lines"": 30}, ""src/testdir/test_vim9_builtin.vim"": {""insertions"": 0, ""deletions"": 7, ""lines"": 7}, ""src/testing.c"": {""insertions"": 39, ""deletions"": 44, ""lines"": 83}, ""src/version.c"": {""insertions"": 2, ""deletions"": 0, ""lines"": 2}}"
2022-01-31 17:26:05,223a950a85448253780da4e821a5b23dcdfad28f,=?UTF-8?q?Bj=C3=B6rn=20Linse?=,16,1,17,3,"{""src/scriptfile.c"": {""insertions"": 1, ""deletions"": 1, ""lines"": 2}, ""src/testdir/test_packadd.vim"": {""insertions"": 13, ""deletions"": 0, ""lines"": 13}, ""src/version.c"": {""insertions"": 2, ""deletions"": 0, ""lines"": 2}}"
2022-01-31 17:09:14,c570e9cf68c0fe30366e82c96be460047dd659b9,Doug Kearns,51,5,56,4,"{""runtime/autoload/dist/ft.vim"": {""insertions"": 20, ""deletions"": 4, ""lines"": 24}, ""runtime/filetype.vim"": {""insertions"": 1, ""deletions"": 1, ""lines"": 2}, ""src/testdir/test_filetype.vim"": {""insertions"": 28, ""deletions"": 0, ""lines"": 28}, ""src/version.c"": {""insertions"": 2, ""deletions"": 0, ""lines"": 2}}"
2022-01-31 15:40:56,c4573eb12dba6a062af28ee0b8938d1521934ce4,Bram Moolenaar,98,69,167,11,"{""runtime/autoload/ccomplete.vim"": {""insertions"": 29, ""deletions"": 34, ""lines"": 63}, ""runtime/autoload/dist/ft.vim"": {""insertions"": 4, ""deletions"": 2, ""lines"": 6}, ""runtime/doc/indent.txt"": {""insertions"": 10, ""deletions"": 1, ""lines"": 11}, ""runtime/doc/tags"": {""insertions"": 1, ""deletions"": 5, ""lines"": 6}, ""runtime/doc/todo.txt"": {""insertions"": 4, ""deletions"": 7, ""lines"": 11}, ""runtime/doc/vim9.txt"": {""insertions"": 5, ""deletions"": 6, ""lines"": 11}, ""runtime/filetype.vim"": {""insertions"": 2, ""deletions"": 2, ""lines"": 4}, ""runtime/indent/html.vim"": {""insertions"": 12, ""deletions"": 3, ""lines"": 15}, ""runtime/indent/testdir/html.in"": {""insertions"": 12, ""deletions"": 1, ""lines"": 13}, ""runtime/indent/testdir/html.ok"": {""insertions"": 12, ""deletions"": 1, ""lines"": 13}, ""runtime/syntax/vim.vim"": {""insertions"": 7, ""deletions"": 7, ""lines"": 14}}"
2022-01-31 14:59:41,424bcae1fb0f69e0aef5e0cf84fd771cf34a0fb7,Bram Moolenaar,431,1304,1735,43,"{""src/ascii.h"": {""insertions"": 0, ""deletions"": 94, ""lines"": 94}, ""src/charset.c"": {""insertions"": 3, ""deletions"": 104, ""lines"": 107}, ""src/cindent.c"": {""insertions"": 1, ""deletions"": 7, ""lines"": 8}, ""src/digraph.c"": {""insertions"": 3, ""deletions"": 116, ""lines"": 119}, ""src/edit.c"": {""insertions"": 4, ""deletions"": 18, ""lines"": 22}, ""src/eval.c"": {""insertions"": 0, ""deletions"": 7, ""lines"": 7}, ""src/evalfunc.c"": {""insertions"": 1, ""deletions"": 34, ""lines"": 35}, ""src/ex_cmds.c"": {""insertions"": 2, ""deletions"": 8, ""lines"": 10}, ""src/feature.h"": {""insertions"": 4, ""deletions"": 18, ""lines"": 22}, ""src/filepath.c"": {""insertions"": 1, ""deletions"": 10, ""lines"": 11}, ""src/findfile.c"": {""insertions"": 0, ""deletions"": 1, ""lines"": 1}, ""src/getchar.c"": {""insertions"": 3, ""deletions"": 15, ""lines"": 18}, ""src/gui.c"": {""insertions"": 2, ""deletions"": 11, ""lines"": 13}, ""src/gui_motif.c"": {""insertions"": 0, ""deletions"": 4, ""lines"": 4}, ""src/hardcopy.c"": {""insertions"": 11, ""deletions"": 21, ""lines"": 32}, ""src/help.c"": {""insertions"": 1, ""deletions"": 10, ""lines"": 11}, ""src/macros.h"": {""insertions"": 6, ""deletions"": 18, ""lines"": 24}, ""src/map.c"": {""insertions"": 1, ""deletions"": 1, ""lines"": 2}, ""src/mark.c"": {""insertions"": 1, ""deletions"": 4, ""lines"": 5}, ""src/misc2.c"": {""insertions"": 1, ""deletions"": 14, ""lines"": 15}, ""src/normal.c"": {""insertions"": 1, ""deletions"": 13, ""lines"": 14}, ""src/ops.c"": {""insertions"": 0, ""deletions"": 8, ""lines"": 8}, ""src/option.c"": {""insertions"": 3, ""deletions"": 11, ""lines"": 14}, ""src/option.h"": {""insertions"": 0, ""deletions"": 4, ""lines"": 4}, ""src/optiondefs.h"": {""insertions"": 2, ""deletions"": 28, ""lines"": 30}, ""src/os_unix.c"": {""insertions"": 21, ""deletions"": 153, ""lines"": 174}, ""src/proto/evalfunc.pro"": {""insertions"": 0, ""deletions"": 1, ""lines"": 1}, ""src/regexp.c"": {""insertions"": 1, ""deletions"": 45, ""lines"": 46}, ""src/regexp_bt.c"": {""insertions"": 1, ""deletions"": 29, ""lines"": 30}, ""src/regexp_nfa.c"": {""insertions"": 59, ""deletions"": 128, ""lines"": 187}, ""src/register.c"": {""insertions"": 0, ""deletions"": 14, ""lines"": 14}, ""src/screen.c"": {""insertions"": 2, ""deletions"": 2, ""lines"": 4}, ""src/spell.c"": {""insertions"": 0, ""deletions"": 1, ""lines"": 1}, ""src/strings.c"": {""insertions"": 0, ""deletions"": 4, ""lines"": 4}, ""src/structs.h"": {""insertions"": 0, ""deletions"": 3, ""lines"": 3}, ""src/term.c"": {""insertions"": 283, ""deletions"": 293, ""lines"": 576}, ""src/testdir/test_edit.vim"": {""insertions"": 1, ""deletions"": 7, ""lines"": 8}, ""src/testdir/test_exec_while_if.vim"": {""insertions"": 3, ""deletions"": 15, ""lines"": 18}, ""src/testdir/test_expr.vim"": {""insertions"": 1, ""deletions"": 5, ""lines"": 6}, ""src/testdir/test_gf.vim"": {""insertions"": 2, ""deletions"": 10, ""lines"": 12}, ""src/testdir/test_regexp_utf8.vim"": {""insertions"": 0, ""deletions"": 5, ""lines"": 5}, ""src/version.c"": {""insertions"": 2, ""deletions"": 4, ""lines"": 6}, ""src/viminfo.c"": {""insertions"": 4, ""deletions"": 6, ""lines"": 10}}"
2022-01-31 13:36:36,eb6c2765959c91ddbb527f96f91ba5be199b8d41,Bram Moolenaar,5,2,7,2,"{""src/testdir/test_vim9_expr.vim"": {""insertions"": 3, ""deletions"": 2, ""lines"": 5}, ""src/version.c"": {""insertions"": 2, ""deletions"": 0, ""lines"": 2}}"
2022-01-31 13:25:36,1f47a287ee4f8b1d007dff878b23dd0cd6104f38,K.Takata,11,1,12,3,"{""src/Make_cyg_ming.mak"": {""insertions"": 5, ""deletions"": 1, ""lines"": 6}, ""src/Make_mvc.mak"": {""insertions"": 4, ""deletions"": 0, ""lines"": 4}, ""src/version.c"": {""insertions"": 2, ""deletions"": 0, ""lines"": 2}}"
2022-01-31 12:27:18,672776dbe8427876ef4bfce84520712df87b6eb1,ichizok,443,418,861,14,"{""Filelist"": {""insertions"": 2, ""deletions"": 0, ""lines"": 2}, ""runtime/doc/builtin.txt"": {""insertions"": 0, ""deletions"": 6, ""lines"": 6}, ""runtime/doc/usr_41.txt"": {""insertions"": 0, ""deletions"": 1, ""lines"": 1}, ""src/Make_cyg_ming.mak"": {""insertions"": 8, ""deletions"": 8, ""lines"": 16}, ""src/Make_mvc.mak"": {""insertions"": 8, ""deletions"": 8, ""lines"": 16}, ""src/Make_vms.mms"": {""insertions"": 1, ""deletions"": 1, ""lines"": 2}, ""src/Makefile"": {""insertions"": 12, ""deletions"": 10, ""lines"": 22}, ""src/create_nvcmdidxs.c"": {""insertions"": 38, ""deletions"": 0, ""lines"": 38}, ""src/create_nvcmdidxs.vim"": {""insertions"": 58, ""deletions"": 70, ""lines"": 128}, ""src/evalfunc.c"": {""insertions"": 0, ""deletions"": 2, ""lines"": 2}, ""src/normal.c"": {""insertions"": 4, ""deletions"": 311, ""lines"": 315}, ""src/nv_cmds.h"": {""insertions"": 310, ""deletions"": 0, ""lines"": 310}, ""src/proto/normal.pro"": {""insertions"": 0, ""deletions"": 1, ""lines"": 1}, ""src/version.c"": {""insertions"": 2, ""deletions"": 0, ""lines"": 2}}"
2022-01-31 11:44:48,48a604845e33399893d6bf293e71bcd2a412800d,Bram Moolenaar,4,1,5,2,"{""src/userfunc.c"": {""insertions"": 2, ""deletions"": 1, ""lines"": 3}, ""src/version.c"": {""insertions"": 2, ""deletions"": 0, ""lines"": 2}}"
2022-01-31 11:38:53,44d1f89c241c611a0904dbbca784facfa13b7916,ichizok,8,3,11,2,"{"".github/workflows/ci.yml"": {""insertions"": 6, ""deletions"": 3, ""lines"": 9}, ""src/version.c"": {""insertions"": 2, ""deletions"": 0, ""lines"": 2}}"
2022-01-31 11:29:51,4c93aff20f228d0dfca11f4793eb2c8895d4984c,Bram Moolenaar,5,4,9,2,"{""src/keymap.h"": {""insertions"": 3, ""deletions"": 4, ""lines"": 7}, ""src/version.c"": {""insertions"": 2, ""deletions"": 0, ""lines"": 2}}"
2022-01-30 19:37:52,5703310e640c4b142a16a3ea4f45317565ae8c32,Bram Moolenaar,3,1,4,2,"{""src/userfunc.c"": {""insertions"": 1, ""deletions"": 1, ""lines"": 2}, ""src/version.c"": {""insertions"": 2, ""deletions"": 0, ""lines"": 2}}"
2022-01-30 18:56:35,6a058070924928f1b2bdb11f345229074904d8bd,Bram Moolenaar,8,6,14,4,"{""src/testdir/sautest/autoload/auto9.vim"": {""insertions"": 2, ""deletions"": 2, ""lines"": 4}, ""src/testdir/test_autoload.vim"": {""insertions"": 2, ""deletions"": 2, ""lines"": 4}, ""src/testdir/test_ins_complete.vim"": {""insertions"": 2, ""deletions"": 2, ""lines"": 4}, ""src/version.c"": {""insertions"": 2, ""deletions"": 0, ""lines"": 2}}"
2022-01-30 18:40:44,d8fe6d34bb582438142d7c1f73d0bd8537bb3a7a,Bram Moolenaar,42,32,74,6,"{""src/errors.h"": {""insertions"": 2, ""deletions"": 2, ""lines"": 4}, ""src/testdir/test_vim9_func.vim"": {""insertions"": 3, ""deletions"": 3, ""lines"": 6}, ""src/testdir/test_vim9_import.vim"": {""insertions"": 26, ""deletions"": 17, ""lines"": 43}, ""src/testdir/test_vim9_script.vim"": {""insertions"": 4, ""deletions"": 4, ""lines"": 8}, ""src/userfunc.c"": {""insertions"": 5, ""deletions"": 6, ""lines"": 11}, ""src/version.c"": {""insertions"": 2, ""deletions"": 0, ""lines"": 2}}"
2022-01-30 18:01:24,ec3637cbaf23730b6efe5e5c0047e23adc82160b,Yegappan Lakshmanan,133,22,155,4,"{""runtime/doc/testing.txt"": {""insertions"": 22, ""deletions"": 5, ""lines"": 27}, ""src/testdir/test_gui.vim"": {""insertions"": 67, ""deletions"": 4, ""lines"": 71}, ""src/testing.c"": {""insertions"": 42, ""deletions"": 13, ""lines"": 55}, ""src/version.c"": {""insertions"": 2, ""deletions"": 0, ""lines"": 2}}"
2022-01-30 17:17:41,44a4d947bbc2c5ddb2908346a7c61ef93b59a3ca,Bram Moolenaar,3,1,4,2,"{""src/regexp.c"": {""insertions"": 1, ""deletions"": 1, ""lines"": 2}, ""src/version.c"": {""insertions"": 2, ""deletions"": 0, ""lines"": 2}}"
2022-01-30 16:42:56,679d66c2d21dfe03d0f89b9a818b0aaebb4c3b87,Bram Moolenaar,15,2,17,3,"{""src/regexp.c"": {""insertions"": 2, ""deletions"": 2, ""lines"": 4}, ""src/testdir/test_help.vim"": {""insertions"": 11, ""deletions"": 0, ""lines"": 11}, ""src/version.c"": {""insertions"": 2, ""deletions"": 0, ""lines"": 2}}"
2022-01-30 15:28:30,848faddb870f3ba4d84fcacd1cccb5cdbbfd9c41,Bram Moolenaar,102,54,156,16,"{""src/evalvars.c"": {""insertions"": 6, ""deletions"": 3, ""lines"": 9}, ""src/proto/userfunc.pro"": {""insertions"": 1, ""deletions"": 0, ""lines"": 1}, ""src/testdir/dumps/Test_popupwin_scroll_11.dump"": {""insertions"": 1, ""deletions"": 1, ""lines"": 2}, ""src/testdir/dumps/Test_popupwin_scroll_12.dump"": {""insertions"": 1, ""deletions"": 1, ""lines"": 2}, ""src/testdir/test_ins_complete.vim"": {""insertions"": 3, ""deletions"": 3, ""lines"": 6}, ""src/testdir/test_popupwin.vim"": {""insertions"": 2, ""deletions"": 2, ""lines"": 4}, ""src/testdir/test_vim9_assign.vim"": {""insertions"": 3, ""deletions"": 3, ""lines"": 6}, ""src/testdir/test_vim9_builtin.vim"": {""insertions"": 1, ""deletions"": 1, ""lines"": 2}, ""src/testdir/test_vim9_cmd.vim"": {""insertions"": 1, ""deletions"": 1, ""lines"": 2}, ""src/testdir/test_vim9_disassemble.vim"": {""insertions"": 6, ""deletions"": 6, ""lines"": 12}, ""src/testdir/test_vim9_expr.vim"": {""insertions"": 14, ""deletions"": 9, ""lines"": 23}, ""src/testdir/test_vim9_func.vim"": {""insertions"": 14, ""deletions"": 14, ""lines"": 28}, ""src/testdir/test_vim9_import.vim"": {""insertions"": 1, ""deletions"": 1, ""lines"": 2}, ""src/userfunc.c"": {""insertions"": 39, ""deletions"": 3, ""lines"": 42}, ""src/version.c"": {""insertions"": 2, ""deletions"": 0, ""lines"": 2}, ""src/vim9expr.c"": {""insertions"": 7, ""deletions"": 6, ""lines"": 13}}"
2022-01-30 12:37:29,06011e1a55f32e47fe0af4bd449be6f0e3ff0814,Yegappan Lakshmanan,367,261,628,9,"{""runtime/doc/builtin.txt"": {""insertions"": 1, ""deletions"": 7, ""lines"": 8}, ""runtime/doc/testing.txt"": {""insertions"": 68, ""deletions"": 54, ""lines"": 122}, ""runtime/doc/usr_41.txt"": {""insertions"": 1, ""deletions"": 4, ""lines"": 5}, ""src/evalfunc.c"": {""insertions"": 2, ""deletions"": 10, ""lines"": 12}, ""src/proto/testing.pro"": {""insertions"": 1, ""deletions"": 4, ""lines"": 5}, ""src/testdir/test_gui.vim"": {""insertions"": 166, ""deletions"": 85, ""lines"": 251}, ""src/testdir/test_vim9_builtin.vim"": {""insertions"": 3, ""deletions"": 14, ""lines"": 17}, ""src/testing.c"": {""insertions"": 123, ""deletions"": 83, ""lines"": 206}, ""src/version.c"": {""insertions"": 2, ""deletions"": 0, ""lines"": 2}}"
2022-01-30 12:10:39,6970e1e36a1ecdb4d330d6ac9ca76f97fa515e36,Bram Moolenaar,4,2,6,2,"{""src/spellsuggest.c"": {""insertions"": 2, ""deletions"": 2, ""lines"": 4}, ""src/version.c"": {""insertions"": 2, ""deletions"": 0, ""lines"": 2}}"
2022-01-29 22:20:48,f10911e5db16f1fe6ab519c5d091ad0c1df0d063,Bram Moolenaar,1156,251,1407,28,"{"".github/CODEOWNERS"": {""insertions"": 6, ""deletions"": 0, ""lines"": 6}, ""runtime/autoload/dist/ft.vim"": {""insertions"": 1, ""deletions"": 1, ""lines"": 2}, ""runtime/autoload/freebasic.vim"": {""insertions"": 41, ""deletions"": 0, ""lines"": 41}, ""runtime/doc/builtin.txt"": {""insertions"": 20, ""deletions"": 19, ""lines"": 39}, ""runtime/doc/change.txt"": {""insertions"": 7, ""deletions"": 4, ""lines"": 11}, ""runtime/doc/eval.txt"": {""insertions"": 23, ""deletions"": 16, ""lines"": 39}, ""runtime/doc/if_perl.txt"": {""insertions"": 2, ""deletions"": 2, ""lines"": 4}, ""runtime/doc/index.txt"": {""insertions"": 6, ""deletions"": 2, ""lines"": 8}, ""runtime/doc/message.txt"": {""insertions"": 6, ""deletions"": 6, ""lines"": 12}, ""runtime/doc/options.txt"": {""insertions"": 15, ""deletions"": 5, ""lines"": 20}, ""runtime/doc/print.txt"": {""insertions"": 4, ""deletions"": 2, ""lines"": 6}, ""runtime/doc/tags"": {""insertions"": 56, ""deletions"": 0, ""lines"": 56}, ""runtime/doc/testing.txt"": {""insertions"": 3, ""deletions"": 3, ""lines"": 6}, ""runtime/doc/todo.txt"": {""insertions"": 19, ""deletions"": 5, ""lines"": 24}, ""runtime/doc/usr_41.txt"": {""insertions"": 2, ""deletions"": 2, ""lines"": 4}, ""runtime/doc/vim9.txt"": {""insertions"": 37, ""deletions"": 28, ""lines"": 65}, ""runtime/filetype.vim"": {""insertions"": 1, ""deletions"": 1, ""lines"": 2}, ""runtime/ftplugin/basic.vim"": {""insertions"": 36, ""deletions"": 7, ""lines"": 43}, ""runtime/ftplugin/freebasic.vim"": {""insertions"": 56, ""deletions"": 4, ""lines"": 60}, ""runtime/ftplugin/qb64.vim"": {""insertions"": 26, ""deletions"": 0, ""lines"": 26}, ""runtime/indent/basic.vim"": {""insertions"": 11, ""deletions"": 0, ""lines"": 11}, ""runtime/indent/freebasic.vim"": {""insertions"": 11, ""deletions"": 0, ""lines"": 11}, ""runtime/indent/qb64.vim"": {""insertions"": 11, ""deletions"": 0, ""lines"": 11}, ""runtime/pack/dist/opt/matchit/autoload/matchit.vim"": {""insertions"": 2, ""deletions"": 2, ""lines"": 4}, ""runtime/syntax/basic.vim"": {""insertions"": 343, ""deletions"": 139, ""lines"": 482}, ""runtime/syntax/qb64.vim"": {""insertions"": 409, ""deletions"": 0, ""lines"": 409}, ""runtime/syntax/strace.vim"": {""insertions"": 1, ""deletions"": 2, ""lines"": 3}, ""src/testdir/README.txt"": {""insertions"": 1, ""deletions"": 1, ""lines"": 2}}"
2022-01-29 21:45:34,62aec93bfdb9e1b40d03a6d2e8e9511f8b1bdb2d,Bram Moolenaar,3235,3199,6434,34,"{""src/eval.c"": {""insertions"": 1, ""deletions"": 1, ""lines"": 2}, ""src/evalfunc.c"": {""insertions"": 0, ""deletions"": 7, ""lines"": 7}, ""src/testdir/test_blob.vim"": {""insertions"": 65, ""deletions"": 65, ""lines"": 130}, ""src/testdir/test_debugger.vim"": {""insertions"": 9, ""deletions"": 9, ""lines"": 18}, ""src/testdir/test_execute_func.vim"": {""insertions"": 2, ""deletions"": 2, ""lines"": 4}, ""src/testdir/test_expr.vim"": {""insertions"": 58, ""deletions"": 58, ""lines"": 116}, ""src/testdir/test_filter_map.vim"": {""insertions"": 5, ""deletions"": 5, ""lines"": 10}, ""src/testdir/test_float_func.vim"": {""insertions"": 2, ""deletions"": 2, ""lines"": 4}, ""src/testdir/test_functions.vim"": {""insertions"": 6, ""deletions"": 6, ""lines"": 12}, ""src/testdir/test_glob2regpat.vim"": {""insertions"": 2, ""deletions"": 2, ""lines"": 4}, ""src/testdir/test_highlight.vim"": {""insertions"": 11, ""deletions"": 11, ""lines"": 22}, ""src/testdir/test_iminsert.vim"": {""insertions"": 11, ""deletions"": 11, ""lines"": 22}, ""src/testdir/test_ins_complete.vim"": {""insertions"": 23, ""deletions"": 23, ""lines"": 46}, ""src/testdir/test_listdict.vim"": {""insertions"": 79, ""deletions"": 79, ""lines"": 158}, ""src/testdir/test_mapping.vim"": {""insertions"": 4, ""deletions"": 4, ""lines"": 8}, ""src/testdir/test_normal.vim"": {""insertions"": 3, ""deletions"": 3, ""lines"": 6}, ""src/testdir/test_popupwin.vim"": {""insertions"": 1, ""deletions"": 1, ""lines"": 2}, ""src/testdir/test_profile.vim"": {""insertions"": 0, ""deletions"": 1, ""lines"": 1}, ""src/testdir/test_quickfix.vim"": {""insertions"": 7, ""deletions"": 7, ""lines"": 14}, ""src/testdir/test_tagfunc.vim"": {""insertions"": 8, ""deletions"": 8, ""lines"": 16}, ""src/testdir/test_textprop.vim"": {""insertions"": 7, ""deletions"": 7, ""lines"": 14}, ""src/testdir/test_usercommands.vim"": {""insertions"": 6, ""deletions"": 6, ""lines"": 12}, ""src/testdir/test_vim9_assign.vim"": {""insertions"": 265, ""deletions"": 265, ""lines"": 530}, ""src/testdir/test_vim9_builtin.vim"": {""insertions"": 1039, ""deletions"": 1033, ""lines"": 2072}, ""src/testdir/test_vim9_cmd.vim"": {""insertions"": 122, ""deletions"": 122, ""lines"": 244}, ""src/testdir/test_vim9_disassemble.vim"": {""insertions"": 36, ""deletions"": 36, ""lines"": 72}, ""src/testdir/test_vim9_expr.vim"": {""insertions"": 606, ""deletions"": 586, ""lines"": 1192}, ""src/testdir/test_vim9_func.vim"": {""insertions"": 319, ""deletions"": 319, ""lines"": 638}, ""src/testdir/test_vim9_import.vim"": {""insertions"": 72, ""deletions"": 72, ""lines"": 144}, ""src/testdir/test_vim9_script.vim"": {""insertions"": 378, ""deletions"": 376, ""lines"": 754}, ""src/testdir/vim9.vim"": {""insertions"": 62, ""deletions"": 60, ""lines"": 122}, ""src/userfunc.c"": {""insertions"": 1, ""deletions"": 1, ""lines"": 2}, ""src/version.c"": {""insertions"": 2, ""deletions"": 0, ""lines"": 2}, ""src/vim9expr.c"": {""insertions"": 23, ""deletions"": 11, ""lines"": 34}}"
2022-01-29 15:27:58,135e15251efd96c960e51e8ab31333c2d6887983,K.Takata,10,7,17,3,"{""src/gui_w32.c"": {""insertions"": 4, ""deletions"": 3, ""lines"": 7}, ""src/os_win32.c"": {""insertions"": 4, ""deletions"": 4, ""lines"": 8}, ""src/version.c"": {""insertions"": 2, ""deletions"": 0, ""lines"": 2}}"
2022-01-29 15:19:23,d5cec1f1f055316c353cfa15ad8d5eb0952d50a0,=?UTF-8?q?Dundar=20G=C3=B6c?=,28,23,51,11,"{""src/alloc.c"": {""insertions"": 2, ""deletions"": 2, ""lines"": 4}, ""src/drawline.c"": {""insertions"": 1, ""deletions"": 1, ""lines"": 2}, ""src/eval.c"": {""insertions"": 1, ""deletions"": 1, ""lines"": 2}, ""src/evalfunc.c"": {""insertions"": 1, ""deletions"": 1, ""lines"": 2}, ""src/ex_docmd.c"": {""insertions"": 1, ""deletions"": 1, ""lines"": 2}, ""src/hardcopy.c"": {""insertions"": 6, ""deletions"": 6, ""lines"": 12}, ""src/list.c"": {""insertions"": 1, ""deletions"": 1, ""lines"": 2}, ""src/memfile.c"": {""insertions"": 8, ""deletions"": 6, ""lines"": 14}, ""src/memline.c"": {""insertions"": 1, ""deletions"": 1, ""lines"": 2}, ""src/popupwin.c"": {""insertions"": 4, ""deletions"": 3, ""lines"": 7}, ""src/version.c"": {""insertions"": 2, ""deletions"": 0, ""lines"": 2}}"
2022-01-29 15:12:39,f12b7815f6b55c3e2f37366aa45e723b1fcb2e9a,=?UTF-8?q?Dundar=20G=C3=B6c?=,9,7,16,2,"{""src/if_cscope.c"": {""insertions"": 7, ""deletions"": 7, ""lines"": 14}, ""src/version.c"": {""insertions"": 2, ""deletions"": 0, ""lines"": 2}}"
2022-01-29 14:21:51,37f47958b8a2a44abc60614271d9537e7f14e51a,Bram Moolenaar,34,4,38,3,"{""src/ex_cmds.c"": {""insertions"": 15, ""deletions"": 4, ""lines"": 19}, ""src/testdir/test_substitute.vim"": {""insertions"": 17, ""deletions"": 0, ""lines"": 17}, ""src/version.c"": {""insertions"": 2, ""deletions"": 0, ""lines"": 2}}"
2022-01-29 13:06:40,4dc0dd869972ddafc7d9ee5ea765645b818a6dc9,Yegappan Lakshmanan,399,64,463,14,"{""Filelist"": {""insertions"": 2, ""deletions"": 0, ""lines"": 2}, ""runtime/doc/builtin.txt"": {""insertions"": 6, ""deletions"": 0, ""lines"": 6}, ""runtime/doc/usr_41.txt"": {""insertions"": 1, ""deletions"": 0, ""lines"": 1}, ""src/Make_cyg_ming.mak"": {""insertions"": 12, ""deletions"": 0, ""lines"": 12}, ""src/Make_mvc.mak"": {""insertions"": 11, ""deletions"": 1, ""lines"": 12}, ""src/Make_vms.mms"": {""insertions"": 1, ""deletions"": 1, ""lines"": 2}, ""src/Makefile"": {""insertions"": 11, ""deletions"": 1, ""lines"": 12}, ""src/create_nvcmdidxs.vim"": {""insertions"": 72, ""deletions"": 0, ""lines"": 72}, ""src/evalfunc.c"": {""insertions"": 2, ""deletions"": 0, ""lines"": 2}, ""src/main.c"": {""insertions"": 0, ""deletions"": 3, ""lines"": 3}, ""src/normal.c"": {""insertions"": 69, ""deletions"": 57, ""lines"": 126}, ""src/nv_cmdidxs.h"": {""insertions"": 209, ""deletions"": 0, ""lines"": 209}, ""src/proto/normal.pro"": {""insertions"": 1, ""deletions"": 1, ""lines"": 2}, ""src/version.c"": {""insertions"": 2, ""deletions"": 0, ""lines"": 2}}"
2022-01-29 12:45:47,97c554d5149c2aa4a43d689c59563e77277265d4,Bram Moolenaar,6,0,6,3,"{""runtime/filetype.vim"": {""insertions"": 3, ""deletions"": 0, ""lines"": 3}, ""src/testdir/test_filetype.vim"": {""insertions"": 1, ""deletions"": 0, ""lines"": 1}, ""src/version.c"": {""insertions"": 2, ""deletions"": 0, ""lines"": 2}}"
2022-01-29 12:10:43,24714a191659b89c26bd7acd5934590d1c5c51d2,ichizok,100,0,100,3,"{""src/testdir/test_channel_pipe.py"": {""insertions"": 8, ""deletions"": 0, ""lines"": 8}, ""src/testdir/thread_util.py"": {""insertions"": 90, ""deletions"": 0, ""lines"": 90}, ""src/version.c"": {""insertions"": 2, ""deletions"": 0, ""lines"": 2}}"
2022-01-29 11:22:17,585ee07cfef307b2fc828537e0d31fdc22d7e79f,Bram Moolenaar,34,5,39,4,"{""runtime/doc/options.txt"": {""insertions"": 6, ""deletions"": 0, ""lines"": 6}, ""src/spellsuggest.c"": {""insertions"": 16, ""deletions"": 5, ""lines"": 21}, ""src/testdir/test_spell.vim"": {""insertions"": 10, ""deletions"": 0, ""lines"": 10}, ""src/version.c"": {""insertions"": 2, ""deletions"": 0, ""lines"": 2}}"
2022-01-29 10:59:53,a0c4e2f2d7aa164d9d7692702c752ea063bd3a8c,zeertzjq,24,1,25,3,"{""src/testdir/test_window_cmd.vim"": {""insertions"": 19, ""deletions"": 0, ""lines"": 19}, ""src/version.c"": {""insertions"": 2, ""deletions"": 0, ""lines"": 2}, ""src/window.c"": {""insertions"": 3, ""deletions"": 1, ""lines"": 4}}"
2022-01-29 10:51:59,06f15416bb8d5636200a10776f1752c4d6e49f31,Bram Moolenaar,25,2,27,3,"{""src/spellsuggest.c"": {""insertions"": 15, ""deletions"": 2, ""lines"": 17}, ""src/testdir/test_spell.vim"": {""insertions"": 8, ""deletions"": 0, ""lines"": 8}, ""src/version.c"": {""insertions"": 2, ""deletions"": 0, ""lines"": 2}}"
2022-01-28 21:00:51,e96eea7b6a56bc7c12e062e90b2e816ff61e705c,Bram Moolenaar,8,4,12,3,"{""src/errors.h"": {""insertions"": 4, ""deletions"": 1, ""lines"": 5}, ""src/if_perl.xs"": {""insertions"": 2, ""deletions"": 3, ""lines"": 5}, ""src/version.c"": {""insertions"": 2, ""deletions"": 0, ""lines"": 2}}"
2022-01-28 20:47:49,652dee448618589de5528a9e9a36995803f5557a,Bram Moolenaar,17,9,26,5,"{""src/indent.c"": {""insertions"": 2, ""deletions"": 2, ""lines"": 4}, ""src/option.c"": {""insertions"": 9, ""deletions"": 7, ""lines"": 16}, ""src/testdir/test_options.vim"": {""insertions"": 2, ""deletions"": 0, ""lines"": 2}, ""src/version.c"": {""insertions"": 2, ""deletions"": 0, ""lines"": 2}, ""src/vim.h"": {""insertions"": 2, ""deletions"": 0, ""lines"": 2}}"
2022-01-28 18:54:13,14cbf77845624e4bfc28a65a5debb81864cba2cf,K.Takata,27,20,47,2,"{""src/Make_mvc.mak"": {""insertions"": 25, ""deletions"": 20, ""lines"": 45}, ""src/version.c"": {""insertions"": 2, ""deletions"": 0, ""lines"": 2}}"
2022-01-28 17:20:03,57ff2b7068c03c89fbfc8930e1325274e72d22a3,=?UTF-8?q?Jakub=20Kul=C3=ADk?=,10,10,20,2,"{""src/testdir/test_lua.vim"": {""insertions"": 8, ""deletions"": 10, ""lines"": 18}, ""src/version.c"": {""insertions"": 2, ""deletions"": 0, ""lines"": 2}}"
2022-01-28 16:01:13,fb55207ed17918c8a2a6cadf5ad9d5fcf686a7ab,Shougo Matsushita,43,10,53,5,"{""runtime/doc/visual.txt"": {""insertions"": 1, ""deletions"": 0, ""lines"": 1}, ""src/normal.c"": {""insertions"": 16, ""deletions"": 2, ""lines"": 18}, ""src/register.c"": {""insertions"": 0, ""deletions"": 8, ""lines"": 8}, ""src/testdir/test_visual.vim"": {""insertions"": 24, ""deletions"": 0, ""lines"": 24}, ""src/version.c"": {""insertions"": 2, ""deletions"": 0, ""lines"": 2}}"
2022-01-28 15:28:04,420fabcd4ffeaf79082a6e43db91e1d363f88f27,=?UTF-8?q?Dundar=20G=C3=B6c?=,92,93,185,32,"{""src/blob.c"": {""insertions"": 1, ""deletions"": 1, ""lines"": 2}, ""src/buffer.c"": {""insertions"": 2, ""deletions"": 2, ""lines"": 4}, ""src/channel.c"": {""insertions"": 1, ""deletions"": 1, ""lines"": 2}, ""src/clientserver.c"": {""insertions"": 2, ""deletions"": 2, ""lines"": 4}, ""src/clipboard.c"": {""insertions"": 1, ""deletions"": 1, ""lines"": 2}, ""src/drawline.c"": {""insertions"": 4, ""deletions"": 4, ""lines"": 8}, ""src/drawscreen.c"": {""insertions"": 4, ""deletions"": 6, ""lines"": 10}, ""src/edit.c"": {""insertions"": 3, ""deletions"": 3, ""lines"": 6}, ""src/evalfunc.c"": {""insertions"": 4, ""deletions"": 4, ""lines"": 8}, ""src/ex_cmds.c"": {""insertions"": 1, ""deletions"": 1, ""lines"": 2}, ""src/ex_docmd.c"": {""insertions"": 3, ""deletions"": 3, ""lines"": 6}, ""src/ex_eval.c"": {""insertions"": 1, ""deletions"": 1, ""lines"": 2}, ""src/fold.c"": {""insertions"": 1, ""deletions"": 1, ""lines"": 2}, ""src/if_cscope.c"": {""insertions"": 1, ""deletions"": 1, ""lines"": 2}, ""src/json.c"": {""insertions"": 1, ""deletions"": 1, ""lines"": 2}, ""src/match.c"": {""insertions"": 2, ""deletions"": 2, ""lines"": 4}, ""src/memline.c"": {""insertions"": 3, ""deletions"": 3, ""lines"": 6}, ""src/message.c"": {""insertions"": 3, ""deletions"": 3, ""lines"": 6}, ""src/misc1.c"": {""insertions"": 1, ""deletions"": 1, ""lines"": 2}, ""src/normal.c"": {""insertions"": 1, ""deletions"": 1, ""lines"": 2}, ""src/ops.c"": {""insertions"": 25, ""deletions"": 26, ""lines"": 51}, ""src/option.c"": {""insertions"": 2, ""deletions"": 2, ""lines"": 4}, ""src/optionstr.c"": {""insertions"": 1, ""deletions"": 1, ""lines"": 2}, ""src/os_unix.c"": {""insertions"": 4, ""deletions"": 4, ""lines"": 8}, ""src/register.c"": {""insertions"": 1, ""deletions"": 1, ""lines"": 2}, ""src/sign.c"": {""insertions"": 7, ""deletions"": 7, ""lines"": 14}, ""src/spellfile.c"": {""insertions"": 1, ""deletions"": 1, ""lines"": 2}, ""src/tag.c"": {""insertions"": 1, ""deletions"": 1, ""lines"": 2}, ""src/ui.c"": {""insertions"": 4, ""deletions"": 4, ""lines"": 8}, ""src/undo.c"": {""insertions"": 3, ""deletions"": 3, ""lines"": 6}, ""src/version.c"": {""insertions"": 2, ""deletions"": 0, ""lines"": 2}, ""src/window.c"": {""insertions"": 1, ""deletions"": 1, ""lines"": 2}}"
2022-01-28 15:01:47,fb80862e49fcbcf47907fc8cdaaf5c41cb9eb06e,Bram Moolenaar,3,1,4,2,"{""src/errors.h"": {""insertions"": 1, ""deletions"": 1, ""lines"": 2}, ""src/version.c"": {""insertions"": 2, ""deletions"": 0, ""lines"": 2}}"
2022-01-28 14:39:58,ddd815ba2a4191992d0f7d7b2902ba76a0db36ef,Bram Moolenaar,4,2,6,2,"{""src/testing.c"": {""insertions"": 2, ""deletions"": 2, ""lines"": 4}, ""src/version.c"": {""insertions"": 2, ""deletions"": 0, ""lines"": 2}}"
2022-01-28 14:15:09,bd8168c7705e315827642f2976ec59e26b7fe009,=?UTF-8?q?Dundar=20G=C3=B6c?=,41,3,44,4,"{""runtime/autoload/dist/ft.vim"": {""insertions"": 15, ""deletions"": 0, ""lines"": 15}, ""runtime/filetype.vim"": {""insertions"": 6, ""deletions"": 3, ""lines"": 9}, ""src/testdir/test_filetype.vim"": {""insertions"": 18, ""deletions"": 0, ""lines"": 18}, ""src/version.c"": {""insertions"": 2, ""deletions"": 0, ""lines"": 2}}"
2022-01-28 12:50:43,fbf4f1ca159028382eaeb3bfc31bb6bb96dbb67a,zeertzjq,17,3,20,3,"{""src/normal.c"": {""insertions"": 4, ""deletions"": 3, ""lines"": 7}, ""src/testdir/test_registers.vim"": {""insertions"": 11, ""deletions"": 0, ""lines"": 11}, ""src/version.c"": {""insertions"": 2, ""deletions"": 0, ""lines"": 2}}"
2022-01-27 21:56:40,166788c657f4b1090a31ea37a023b1f2c78790c8,Bram Moolenaar,3,0,3,2,"{""src/getchar.c"": {""insertions"": 1, ""deletions"": 0, ""lines"": 1}, ""src/version.c"": {""insertions"": 2, ""deletions"": 0, ""lines"": 2}}"
2022-01-27 20:47:03,37cf413e3e768b76c975e4a7081472d75d649c72,Bram Moolenaar,3,1,4,2,"{""src/getchar.c"": {""insertions"": 1, ""deletions"": 1, ""lines"": 2}, ""src/version.c"": {""insertions"": 2, ""deletions"": 0, ""lines"": 2}}"
2022-01-27 19:59:47,b3d83980d2ac0f7a25314270416f17af874ca269,Bram Moolenaar,14,2,16,4,"{""src/errors.h"": {""insertions"": 2, ""deletions"": 1, ""lines"": 3}, ""src/testdir/test_functions.vim"": {""insertions"": 6, ""deletions"": 0, ""lines"": 6}, ""src/testing.c"": {""insertions"": 4, ""deletions"": 1, ""lines"": 5}, ""src/version.c"": {""insertions"": 2, ""deletions"": 0, ""lines"": 2}}"
2022-01-27 19:27:16,a4bc2dd7cccf5a4a9f78b58b6f35a45d17164323,Bram Moolenaar,15,1,16,3,"{""src/getchar.c"": {""insertions"": 4, ""deletions"": 1, ""lines"": 5}, ""src/testdir/test_registers.vim"": {""insertions"": 9, ""deletions"": 0, ""lines"": 9}, ""src/version.c"": {""insertions"": 2, ""deletions"": 0, ""lines"": 2}}"
2022-01-27 17:37:41,98cd30383a378eb5f2dbf1b4e887fa17b5494a64,Bram Moolenaar,3,3,6,2,"{""src/list.c"": {""insertions"": 1, ""deletions"": 3, ""lines"": 4}, ""src/version.c"": {""insertions"": 2, ""deletions"": 0, ""lines"": 2}}"
2022-01-27 16:36:29,35c807df1f5774f09612d756ddc3cd5c44eacaca,Bram Moolenaar,35,20,55,6,"{""src/evalfunc.c"": {""insertions"": 13, ""deletions"": 4, ""lines"": 17}, ""src/list.c"": {""insertions"": 10, ""deletions"": 11, ""lines"": 21}, ""src/testdir/test_vim9_assign.vim"": {""insertions"": 1, ""deletions"": 1, ""lines"": 2}, ""src/testdir/test_vim9_builtin.vim"": {""insertions"": 6, ""deletions"": 1, ""lines"": 7}, ""src/version.c"": {""insertions"": 2, ""deletions"": 0, ""lines"": 2}, ""src/vim9instr.c"": {""insertions"": 3, ""deletions"": 3, ""lines"": 6}}"
2022-01-27 15:04:22,94373c48e7e438e5b924b34ce820e9b2eb9f810c,K.Takata,7,4,11,2,"{""src/gui.c"": {""insertions"": 5, ""deletions"": 4, ""lines"": 9}, ""src/version.c"": {""insertions"": 2, ""deletions"": 0, ""lines"": 2}}"
2022-01-27 13:55:35,745b938a48104778dcb7b0245e6589b54cb93593,Bram Moolenaar,12,0,12,3,"{""src/testdir/test_vim9_builtin.vim"": {""insertions"": 2, ""deletions"": 0, ""lines"": 2}, ""src/time.c"": {""insertions"": 8, ""deletions"": 0, ""lines"": 8}, ""src/version.c"": {""insertions"": 2, ""deletions"": 0, ""lines"": 2}}"
2022-01-27 13:16:59,b0ad2d92fd19e673ddbbc66742bae3f71778efde,Yegappan Lakshmanan,169,3,172,11,"{""runtime/doc/builtin.txt"": {""insertions"": 3, ""deletions"": 0, ""lines"": 3}, ""runtime/doc/testing.txt"": {""insertions"": 18, ""deletions"": 0, ""lines"": 18}, ""runtime/doc/usr_41.txt"": {""insertions"": 2, ""deletions"": 0, ""lines"": 2}, ""src/evalfunc.c"": {""insertions"": 4, ""deletions"": 0, ""lines"": 4}, ""src/normal.c"": {""insertions"": 3, ""deletions"": 2, ""lines"": 5}, ""src/proto/testing.pro"": {""insertions"": 2, ""deletions"": 0, ""lines"": 2}, ""src/testdir/test_diffmode.vim"": {""insertions"": 46, ""deletions"": 0, ""lines"": 46}, ""src/testdir/test_gui.vim"": {""insertions"": 53, ""deletions"": 0, ""lines"": 53}, ""src/testdir/test_normal.vim"": {""insertions"": 2, ""deletions"": 1, ""lines"": 3}, ""src/testing.c"": {""insertions"": 34, ""deletions"": 0, ""lines"": 34}, ""src/version.c"": {""insertions"": 2, ""deletions"": 0, ""lines"": 2}}"
2022-01-26 21:32:59,e939f5ebbae8dd7825d62d84e0c9910fa1756a9c,Bram Moolenaar,19,4,23,3,"{""src/testdir/test_vim9_cmd.vim"": {""insertions"": 11, ""deletions"": 0, ""lines"": 11}, ""src/version.c"": {""insertions"": 2, ""deletions"": 0, ""lines"": 2}, ""src/vim9cmds.c"": {""insertions"": 6, ""deletions"": 4, ""lines"": 10}}"
2022-01-26 21:17:04,fc4c44836acf7cd83af6d9b5b4737a305c5b3fb2,Bram Moolenaar,3,1,4,2,"{""src/eval.c"": {""insertions"": 1, ""deletions"": 1, ""lines"": 2}, ""src/version.c"": {""insertions"": 2, ""deletions"": 0, ""lines"": 2}}"
2022-01-26 21:01:15,70c43d84be98ab54d3723155dcc4232dc5a5f081,Bram Moolenaar,82,18,100,9,"{""src/errors.h"": {""insertions"": 4, ""deletions"": 4, ""lines"": 8}, ""src/evalfunc.c"": {""insertions"": 6, ""deletions"": 1, ""lines"": 7}, ""src/evalvars.c"": {""insertions"": 12, ""deletions"": 4, ""lines"": 16}, ""src/structs.h"": {""insertions"": 5, ""deletions"": 3, ""lines"": 8}, ""src/testdir/test_vim9_cmd.vim"": {""insertions"": 29, ""deletions"": 0, ""lines"": 29}, ""src/testdir/test_vim9_disassemble.vim"": {""insertions"": 1, ""deletions"": 1, ""lines"": 2}, ""src/version.c"": {""insertions"": 2, ""deletions"": 0, ""lines"": 2}, ""src/vim9cmds.c"": {""insertions"": 20, ""deletions"": 3, ""lines"": 23}, ""src/vim9execute.c"": {""insertions"": 3, ""deletions"": 2, ""lines"": 5}}"
2022-01-26 18:26:21,1080c48ec8d672d7e9fbefb5a1255c9df09a2884,Bram Moolenaar,50,20,70,4,"{""src/eval.c"": {""insertions"": 1, ""deletions"": 1, ""lines"": 2}, ""src/evalfunc.c"": {""insertions"": 45, ""deletions"": 19, ""lines"": 64}, ""src/testdir/test_vim9_builtin.vim"": {""insertions"": 2, ""deletions"": 0, ""lines"": 2}, ""src/version.c"": {""insertions"": 2, ""deletions"": 0, ""lines"": 2}}"
2022-01-26 16:45:20,1a804528ab39f5c810cf42397702057100a94ade,K.Takata,5,3,8,4,"{""src/alloc.c"": {""insertions"": 1, ""deletions"": 1, ""lines"": 2}, ""src/eval.c"": {""insertions"": 1, ""deletions"": 1, ""lines"": 2}, ""src/version.c"": {""insertions"": 2, ""deletions"": 0, ""lines"": 2}, ""src/vim9script.c"": {""insertions"": 1, ""deletions"": 1, ""lines"": 2}}"
2022-01-26 16:20:21,47d1666d605998a97d3827eca4d467ad0930b284,K.Takata,14,10,24,4,"{"".github/workflows/ci.yml"": {""insertions"": 2, ""deletions"": 4, ""lines"": 6}, ""ci/appveyor.bat"": {""insertions"": 3, ""deletions"": 5, ""lines"": 8}, ""src/Make_mvc.mak"": {""insertions"": 7, ""deletions"": 1, ""lines"": 8}, ""src/version.c"": {""insertions"": 2, ""deletions"": 0, ""lines"": 2}}"
2022-01-26 12:14:15,a827bf3ea8fe465aa456ef7a7a37d6afe6a47628,Yegappan Lakshmanan,484,602,1086,2,"{""src/normal.c"": {""insertions"": 482, ""deletions"": 602, ""lines"": 1084}, ""src/version.c"": {""insertions"": 2, ""deletions"": 0, ""lines"": 2}}"
2022-01-26 11:16:52,250155ae319802418c1576e9ff88d0e16b108282,K.Takata,44,93,137,3,"{""src/Make_mvc.mak"": {""insertions"": 40, ""deletions"": 84, ""lines"": 124}, ""src/version.c"": {""insertions"": 2, ""deletions"": 0, ""lines"": 2}, ""src/vim.h"": {""insertions"": 2, ""deletions"": 9, ""lines"": 11}}"
2022-01-25 21:26:17,44db8213d38c39877d2148eff6a72f4beccfb94e,Bram Moolenaar,10,1,11,3,"{""src/register.c"": {""insertions"": 1, ""deletions"": 1, ""lines"": 2}, ""src/testdir/test_visual.vim"": {""insertions"": 7, ""deletions"": 0, ""lines"": 7}, ""src/version.c"": {""insertions"": 2, ""deletions"": 0, ""lines"": 2}}"
2022-01-25 20:45:16,806d037671e133bd28a7864248763f643967973a,Bram Moolenaar,7,1,8,3,"{""src/edit.c"": {""insertions"": 2, ""deletions"": 1, ""lines"": 3}, ""src/testdir/test_paste.vim"": {""insertions"": 3, ""deletions"": 0, ""lines"": 3}, ""src/version.c"": {""insertions"": 2, ""deletions"": 0, ""lines"": 2}}"
2022-01-25 18:24:00,8d02ce1ed75d008c34a5c9aaa51b67cbb9d33baa,Bram Moolenaar,19,0,19,3,"{""src/testdir/test_visual.vim"": {""insertions"": 15, ""deletions"": 0, ""lines"": 15}, ""src/undo.c"": {""insertions"": 2, ""deletions"": 0, ""lines"": 2}, ""src/version.c"": {""insertions"": 2, ""deletions"": 0, ""lines"": 2}}"
2022-01-25 15:51:56,06b77229ca704d00c4f138ed0377556e54d5851f,Bram Moolenaar,196,75,271,8,"{""src/proto/vim9instr.pro"": {""insertions"": 1, ""deletions"": 0, ""lines"": 1}, ""src/testdir/test_vim9_disassemble.vim"": {""insertions"": 30, ""deletions"": 15, ""lines"": 45}, ""src/testdir/test_vim9_import.vim"": {""insertions"": 35, ""deletions"": 0, ""lines"": 35}, ""src/version.c"": {""insertions"": 2, ""deletions"": 0, ""lines"": 2}, ""src/vim9.h"": {""insertions"": 2, ""deletions"": 0, ""lines"": 2}, ""src/vim9execute.c"": {""insertions"": 105, ""deletions"": 58, ""lines"": 163}, ""src/vim9expr.c"": {""insertions"": 3, ""deletions"": 2, ""lines"": 5}, ""src/vim9instr.c"": {""insertions"": 18, ""deletions"": 0, ""lines"": 18}}"
2022-01-25 13:52:53,dc5490e2cbc8c16022a23b449b48c1bd0083f366,Bram Moolenaar,15,0,15,3,"{""src/ex_cmds.c"": {""insertions"": 2, ""deletions"": 0, ""lines"": 2}, ""src/testdir/test_visual.vim"": {""insertions"": 11, ""deletions"": 0, ""lines"": 11}, ""src/version.c"": {""insertions"": 2, ""deletions"": 0, ""lines"": 2}}"
2022-01-25 11:55:02,85b6747abc15a7a81086db31289cf1b8b17e6cb1,Bram Moolenaar,13,1,14,3,"{""src/ex_getln.c"": {""insertions"": 1, ""deletions"": 1, ""lines"": 2}, ""src/testdir/test_ex_mode.vim"": {""insertions"": 10, ""deletions"": 0, ""lines"": 10}, ""src/version.c"": {""insertions"": 2, ""deletions"": 0, ""lines"": 2}}"
2022-01-25 10:31:37,76687d27173e64d739ea371751697c03ad0821ef,K.Takata,14,357,371,7,"{""Filelist"": {""insertions"": 0, ""deletions"": 1, ""lines"": 1}, ""src/INSTALLpc.txt"": {""insertions"": 2, ""deletions"": 77, ""lines"": 79}, ""src/Make_mvc.mak"": {""insertions"": 4, ""deletions"": 12, ""lines"": 16}, ""src/gui_w32.c"": {""insertions"": 6, ""deletions"": 248, ""lines"": 254}, ""src/msvcsetup.bat"": {""insertions"": 0, ""deletions"": 12, ""lines"": 12}, ""src/os_win32.c"": {""insertions"": 0, ""deletions"": 7, ""lines"": 7}, ""src/version.c"": {""insertions"": 2, ""deletions"": 0, ""lines"": 2}}"
2022-01-24 22:32:28,1450112eef2eda211d398d6d7ac03f7a29fa4f55,Bram Moolenaar,3,0,3,2,"{""src/testdir/test_functions.vim"": {""insertions"": 1, ""deletions"": 0, ""lines"": 1}, ""src/version.c"": {""insertions"": 2, ""deletions"": 0, ""lines"": 2}}"
2022-01-24 22:18:24,3a8ad5918b5c1b4c36b39c420ce933b452929dd8,Bram Moolenaar,3,1,4,2,"{""src/testdir/test_functions.vim"": {""insertions"": 1, ""deletions"": 1, ""lines"": 2}, ""src/version.c"": {""insertions"": 2, ""deletions"": 0, ""lines"": 2}}"
2022-01-24 22:02:15,a6c09a7c20dd8dae43a99c6dc634151940c2fc6c,Bram Moolenaar,5,0,5,2,"{""src/testdir/test_functions.vim"": {""insertions"": 3, ""deletions"": 0, ""lines"": 3}, ""src/version.c"": {""insertions"": 2, ""deletions"": 0, ""lines"": 2}}"
2022-01-24 21:28:01,3e93a2b075e99a2b3ced85227a6373be233712ff,Bram Moolenaar,59,7,66,3,"{""src/evalvars.c"": {""insertions"": 24, ""deletions"": 7, ""lines"": 31}, ""src/testdir/test_vim9_import.vim"": {""insertions"": 33, ""deletions"": 0, ""lines"": 33}, ""src/version.c"": {""insertions"": 2, ""deletions"": 0, ""lines"": 2}}"
2022-01-24 20:00:55,dff97e65eb1bb24c44c2b7430a480888d8afb3f4,Bram Moolenaar,27,1,28,3,"{""src/autocmd.c"": {""insertions"": 3, ""deletions"": 0, ""lines"": 3}, ""src/testdir/test_functions.vim"": {""insertions"": 22, ""deletions"": 1, ""lines"": 23}, ""src/version.c"": {""insertions"": 2, ""deletions"": 0, ""lines"": 2}}"
2022-01-24 18:36:39,50e05254450954f04183efc7bc871527a67868b8,Bram Moolenaar,10,2,12,2,"{""src/eval.c"": {""insertions"": 8, ""deletions"": 2, ""lines"": 10}, ""src/version.c"": {""insertions"": 2, ""deletions"": 0, ""lines"": 2}}"
2022-01-24 18:16:12,fe6fb267e6ee5c5da2f41889e4e0e0ac5bf4b89d,Bram Moolenaar,25,1,26,4,"{""src/errors.h"": {""insertions"": 6, ""deletions"": 1, ""lines"": 7}, ""src/eval.c"": {""insertions"": 12, ""deletions"": 0, ""lines"": 12}, ""src/testdir/test_eval_stuff.vim"": {""insertions"": 5, ""deletions"": 0, ""lines"": 5}, ""src/version.c"": {""insertions"": 2, ""deletions"": 0, ""lines"": 2}}"
2022-01-24 16:30:30,46634350740d062fc7e555fd6c5d4d43798d4df7,Yegappan Lakshmanan,476,351,827,2,"{""src/normal.c"": {""insertions"": 474, ""deletions"": 351, ""lines"": 825}, ""src/version.c"": {""insertions"": 2, ""deletions"": 0, ""lines"": 2}}"
2022-01-24 16:15:15,7924a17791217d50be5a91989a9641bf68e7a735,Bram Moolenaar,7,2,9,3,"{""src/move.c"": {""insertions"": 4, ""deletions"": 1, ""lines"": 5}, ""src/testdir/test_cursor_func.vim"": {""insertions"": 1, ""deletions"": 1, ""lines"": 2}, ""src/version.c"": {""insertions"": 2, ""deletions"": 0, ""lines"": 2}}"
2022-01-24 15:27:50,502d8ae3e8ed8b6f8dd2ff175f154f9aa87228ef,zeertzjq,28,4,32,3,"{""src/edit.c"": {""insertions"": 9, ""deletions"": 0, ""lines"": 9}, ""src/testdir/test_edit.vim"": {""insertions"": 17, ""deletions"": 4, ""lines"": 21}, ""src/version.c"": {""insertions"": 2, ""deletions"": 0, ""lines"": 2}}"
2022-01-24 13:54:45,acc4b5648b49ec13c4f35ee0bf552eda71b0c372,Bram Moolenaar,58,12,70,7,"{""src/proto/userfunc.pro"": {""insertions"": 1, ""deletions"": 1, ""lines"": 2}, ""src/testdir/test_vim9_import.vim"": {""insertions"": 31, ""deletions"": 0, ""lines"": 31}, ""src/userfunc.c"": {""insertions"": 18, ""deletions"": 9, ""lines"": 27}, ""src/version.c"": {""insertions"": 2, ""deletions"": 0, ""lines"": 2}, ""src/vim.h"": {""insertions"": 4, ""deletions"": 0, ""lines"": 4}, ""src/vim9compile.c"": {""insertions"": 1, ""deletions"": 1, ""lines"": 2}, ""src/vim9instr.c"": {""insertions"": 1, ""deletions"": 1, ""lines"": 2}}"
2022-01-24 12:20:45,8e4af851fd3eff4b22fca962e5be783742e8f1bb,Bram Moolenaar,10,1,11,2,"{""src/os_unix.c"": {""insertions"": 8, ""deletions"": 1, ""lines"": 9}, ""src/version.c"": {""insertions"": 2, ""deletions"": 0, ""lines"": 2}}"
2022-01-24 11:40:37,7e765a39b795d5331bf2d4927b41df7b78915af9,Yegappan Lakshmanan,10,2,12,4,"{""src/testdir/test_filetype.vim"": {""insertions"": 4, ""deletions"": 0, ""lines"": 4}, ""src/testdir/test_messages.vim"": {""insertions"": 1, ""deletions"": 0, ""lines"": 1}, ""src/testdir/test_vim9_import.vim"": {""insertions"": 3, ""deletions"": 2, ""lines"": 5}, ""src/version.c"": {""insertions"": 2, ""deletions"": 0, ""lines"": 2}}"
2022-01-24 11:24:08,c351dc1e0ca959084ba36bb350291334bf74b9f8,K.Takata,31,199,230,15,"{""src/GvimExt/gvimext.h"": {""insertions"": 0, ""deletions"": 6, ""lines"": 6}, ""src/ex_docmd.c"": {""insertions"": 0, ""deletions"": 9, ""lines"": 9}, ""src/feature.h"": {""insertions"": 1, ""deletions"": 2, ""lines"": 3}, ""src/gui_w32.c"": {""insertions"": 0, ""deletions"": 7, ""lines"": 7}, ""src/if_cscope.c"": {""insertions"": 2, ""deletions"": 7, ""lines"": 9}, ""src/if_ole.cpp"": {""insertions"": 0, ""deletions"": 7, ""lines"": 7}, ""src/if_ruby.c"": {""insertions"": 0, ""deletions"": 5, ""lines"": 5}, ""src/macros.h"": {""insertions"": 2, ""deletions"": 2, ""lines"": 4}, ""src/os_mswin.c"": {""insertions"": 12, ""deletions"": 27, ""lines"": 39}, ""src/os_win32.c"": {""insertions"": 0, ""deletions"": 82, ""lines"": 82}, ""src/os_win32.h"": {""insertions"": 5, ""deletions"": 22, ""lines"": 27}, ""src/proto/os_win32.pro"": {""insertions"": 0, ""deletions"": 1, ""lines"": 1}, ""src/time.c"": {""insertions"": 3, ""deletions"": 17, ""lines"": 20}, ""src/version.c"": {""insertions"": 2, ""deletions"": 0, ""lines"": 2}, ""src/vim.h"": {""insertions"": 4, ""deletions"": 5, ""lines"": 9}}"
2022-01-23 20:00:42,058ee7c5699ef551be5aa04c66b3cffc436e9b08,Bram Moolenaar,586,532,1118,2,"{""src/version.c"": {""insertions"": 2, ""deletions"": 0, ""lines"": 2}, ""src/vim9execute.c"": {""insertions"": 584, ""deletions"": 532, ""lines"": 1116}}"
2022-01-23 17:59:06,2a7aa834583dea157eccf3e69827d2ff1d9fe9c7,Bram Moolenaar,36,0,36,3,"{""src/evalvars.c"": {""insertions"": 6, ""deletions"": 0, ""lines"": 6}, ""src/testdir/test_vim9_import.vim"": {""insertions"": 28, ""deletions"": 0, ""lines"": 28}, ""src/version.c"": {""insertions"": 2, ""deletions"": 0, ""lines"": 2}}"
2022-01-23 17:09:05,428058ab3213e81531cbd7989f4267870f35d52e,=?UTF-8?q?Dundar=20G=C3=B6c?=,84,0,84,3,"{""runtime/filetype.vim"": {""insertions"": 61, ""deletions"": 0, ""lines"": 61}, ""src/testdir/test_filetype.vim"": {""insertions"": 21, ""deletions"": 0, ""lines"": 21}, ""src/version.c"": {""insertions"": 2, ""deletions"": 0, ""lines"": 2}}"
2022-01-23 16:41:14,79a6e25b79cdb35e00d8b364516103eb358d8cc7,dbivolaru,5,1,6,2,"{""src/os_unix.c"": {""insertions"": 3, ""deletions"": 1, ""lines"": 4}, ""src/version.c"": {""insertions"": 2, ""deletions"": 0, ""lines"": 2}}"
2022-01-23 16:25:17,abe628e1bd92ecb85a526348f376891d56bf3ea8,K.Takata,20,15,35,2,"{""src/gui_w32.c"": {""insertions"": 18, ""deletions"": 15, ""lines"": 33}, ""src/version.c"": {""insertions"": 2, ""deletions"": 0, ""lines"": 2}}"
2022-01-23 14:17:28,f4e88f2152c5975a6f4cfa7ccd745575fe4d1c78,Bram Moolenaar,44,2,46,4,"{""src/evalvars.c"": {""insertions"": 8, ""deletions"": 0, ""lines"": 8}, ""src/optionstr.c"": {""insertions"": 3, ""deletions"": 2, ""lines"": 5}, ""src/testdir/test_vim9_import.vim"": {""insertions"": 31, ""deletions"": 0, ""lines"": 31}, ""src/version.c"": {""insertions"": 2, ""deletions"": 0, ""lines"": 2}}"
2022-01-23 13:44:35,7ef4a2fe3736bbeb5bad182782a74576aa06b0db,Bram Moolenaar,41,0,41,3,"{""src/evalvars.c"": {""insertions"": 8, ""deletions"": 0, ""lines"": 8}, ""src/testdir/test_vim9_import.vim"": {""insertions"": 31, ""deletions"": 0, ""lines"": 31}, ""src/version.c"": {""insertions"": 2, ""deletions"": 0, ""lines"": 2}}"
2022-01-23 13:05:39,e15ebeffb35da4bb7d9054358671735ce6988c28,=?UTF-8?q?Dundar=20G=C3=B6c?=,6,0,6,3,"{""runtime/filetype.vim"": {""insertions"": 3, ""deletions"": 0, ""lines"": 3}, ""src/testdir/test_filetype.vim"": {""insertions"": 1, ""deletions"": 0, ""lines"": 1}, ""src/version.c"": {""insertions"": 2, ""deletions"": 0, ""lines"": 2}}"
2022-01-23 12:42:55,206919191fe1881dea00d60d392cc68a07c0106f,zeertzjq,8,1,9,2,"{""src/testdir/test_conceal.vim"": {""insertions"": 6, ""deletions"": 1, ""lines"": 7}, ""src/version.c"": {""insertions"": 2, ""deletions"": 0, ""lines"": 2}}"
2022-01-23 12:31:57,d1c58999c82afbdcbbe01548c1dea06d4d086f3e,K.Takata,60,96,156,2,"{""src/gui_w32.c"": {""insertions"": 58, ""deletions"": 96, ""lines"": 154}, ""src/version.c"": {""insertions"": 2, ""deletions"": 0, ""lines"": 2}}"
2022-01-23 12:07:04,6f4754b9f7253d7e4ba527064a24aff1acdb1e8f,Bram Moolenaar,15612,12230,27842,33,"{""runtime/doc/autocmd.txt"": {""insertions"": 2, ""deletions"": 2, ""lines"": 4}, ""runtime/doc/builtin.txt"": {""insertions"": 4, ""deletions"": 5, ""lines"": 9}, ""runtime/doc/diff.txt"": {""insertions"": 12, ""deletions"": 6, ""lines"": 18}, ""runtime/doc/editing.txt"": {""insertions"": 3, ""deletions"": 3, ""lines"": 6}, ""runtime/doc/eval.txt"": {""insertions"": 40, ""deletions"": 20, ""lines"": 60}, ""runtime/doc/filetype.txt"": {""insertions"": 5, ""deletions"": 4, ""lines"": 9}, ""runtime/doc/fold.txt"": {""insertions"": 5, ""deletions"": 2, ""lines"": 7}, ""runtime/doc/map.txt"": {""insertions"": 4, ""deletions"": 2, ""lines"": 6}, ""runtime/doc/mbyte.txt"": {""insertions"": 1, ""deletions"": 1, ""lines"": 2}, ""runtime/doc/message.txt"": {""insertions"": 231, ""deletions"": 230, ""lines"": 461}, ""runtime/doc/options.txt"": {""insertions"": 22, ""deletions"": 9, ""lines"": 31}, ""runtime/doc/repeat.txt"": {""insertions"": 4, ""deletions"": 4, ""lines"": 8}, ""runtime/doc/starting.txt"": {""insertions"": 3, ""deletions"": 3, ""lines"": 6}, ""runtime/doc/syntax.txt"": {""insertions"": 5, ""deletions"": 1, ""lines"": 6}, ""runtime/doc/tags"": {""insertions"": 79, ""deletions"": 2, ""lines"": 81}, ""runtime/doc/terminal.txt"": {""insertions"": 2, ""deletions"": 2, ""lines"": 4}, ""runtime/doc/testing.txt"": {""insertions"": 2, ""deletions"": 2, ""lines"": 4}, ""runtime/doc/todo.txt"": {""insertions"": 13, ""deletions"": 13, ""lines"": 26}, ""runtime/doc/vim.1"": {""insertions"": 1, ""deletions"": 1, ""lines"": 2}, ""runtime/doc/vim.man"": {""insertions"": 1, ""deletions"": 1, ""lines"": 2}, ""runtime/doc/vim9.txt"": {""insertions"": 53, ""deletions"": 30, ""lines"": 83}, ""runtime/doc/visual.txt"": {""insertions"": 1, ""deletions"": 1, ""lines"": 2}, ""runtime/filetype.vim"": {""insertions"": 1, ""deletions"": 1, ""lines"": 2}, ""runtime/gvim.desktop"": {""insertions"": 4, ""deletions"": 1, ""lines"": 5}, ""runtime/pack/dist/opt/termdebug/plugin/termdebug.vim"": {""insertions"": 2, ""deletions"": 1, ""lines"": 3}, ""runtime/syntax/rc.vim"": {""insertions"": 11, ""deletions"": 10, ""lines"": 21}, ""runtime/syntax/scala.vim"": {""insertions"": 55, ""deletions"": 55, ""lines"": 110}, ""runtime/vim.desktop"": {""insertions"": 4, ""deletions"": 1, ""lines"": 5}, ""src/po/de.po"": {""insertions"": 3598, ""deletions"": 3571, ""lines"": 7169}, ""src/po/fi.po"": {""insertions"": 7658, ""deletions"": 4752, ""lines"": 12410}, ""src/po/gvim.desktop.in"": {""insertions"": 0, ""deletions"": 1, ""lines"": 1}, ""src/po/sr.po"": {""insertions"": 3786, ""deletions"": 3492, ""lines"": 7278}, ""src/po/vim.desktop.in"": {""insertions"": 0, ""deletions"": 1, ""lines"": 1}}"
2022-01-23 11:28:16,bcfa11b7dfdfbb4d412dd843a6da3fce68ba2e39,Tim Pope,6,2,8,3,"{""runtime/filetype.vim"": {""insertions"": 3, ""deletions"": 1, ""lines"": 4}, ""src/testdir/test_filetype.vim"": {""insertions"": 1, ""deletions"": 1, ""lines"": 2}, ""src/version.c"": {""insertions"": 2, ""deletions"": 0, ""lines"": 2}}"
2022-01-23 11:19:37,ff5cbe8133c6eb5dd86b9e042f32f589627e9bf9,nobodyatandnothing,4,2,6,3,"{""runtime/filetype.vim"": {""insertions"": 1, ""deletions"": 1, ""lines"": 2}, ""src/testdir/test_filetype.vim"": {""insertions"": 1, ""deletions"": 1, ""lines"": 2}, ""src/version.c"": {""insertions"": 2, ""deletions"": 0, ""lines"": 2}}"
2022-01-22 20:55:30,36c2add7f82bc5dbbfc45db31953ef9633c635b3,Bram Moolenaar,45,2,47,3,"{""src/evalvars.c"": {""insertions"": 13, ""deletions"": 2, ""lines"": 15}, ""src/testdir/test_vim9_import.vim"": {""insertions"": 30, ""deletions"": 0, ""lines"": 30}, ""src/version.c"": {""insertions"": 2, ""deletions"": 0, ""lines"": 2}}"
2022-01-22 20:32:00,28e60cc088cadd25afb69ee636f0e2e34233ba4e,Bram Moolenaar,32,0,32,3,"{""src/indent.c"": {""insertions"": 3, ""deletions"": 0, ""lines"": 3}, ""src/testdir/test_vim9_import.vim"": {""insertions"": 27, ""deletions"": 0, ""lines"": 27}, ""src/version.c"": {""insertions"": 2, ""deletions"": 0, ""lines"": 2}}"
2022-01-22 20:19:22,47bcc5f4c83c158f43ac2ea7abfe99dbf5c2e098,Bram Moolenaar,38,1,39,3,"{""src/findfile.c"": {""insertions"": 6, ""deletions"": 1, ""lines"": 7}, ""src/testdir/test_vim9_import.vim"": {""insertions"": 30, ""deletions"": 0, ""lines"": 30}, ""src/version.c"": {""insertions"": 2, ""deletions"": 0, ""lines"": 2}}"
2022-01-22 19:17:31,3ba685eeefcfbbf895d70664357ef05f252d7b21,Bram Moolenaar,33,0,33,3,"{""src/testdir/test_vim9_import.vim"": {""insertions"": 28, ""deletions"": 0, ""lines"": 28}, ""src/textformat.c"": {""insertions"": 3, ""deletions"": 0, ""lines"": 3}, ""src/version.c"": {""insertions"": 2, ""deletions"": 0, ""lines"": 2}}"
2022-01-22 18:21:36,39b8944539a9cde553fe709e535fdfd37d0f9307,Bram Moolenaar,3,1,4,2,"{""src/evalvars.c"": {""insertions"": 1, ""deletions"": 1, ""lines"": 2}, ""src/version.c"": {""insertions"": 2, ""deletions"": 0, ""lines"": 2}}"
2022-01-22 17:58:13,7b29f6a3949743914f08410b6f6bd6237c2f2038,Bram Moolenaar,58,2,60,3,"{""src/evalvars.c"": {""insertions"": 13, ""deletions"": 2, ""lines"": 15}, ""src/testdir/test_vim9_import.vim"": {""insertions"": 43, ""deletions"": 0, ""lines"": 43}, ""src/version.c"": {""insertions"": 2, ""deletions"": 0, ""lines"": 2}}"
2022-01-22 15:09:36,5600a709f453045c80f92087acc0f855b4af377a,Bram Moolenaar,36,4,40,8,"{""src/beval.c"": {""insertions"": 13, ""deletions"": 0, ""lines"": 13}, ""src/option.c"": {""insertions"": 15, ""deletions"": 0, ""lines"": 15}, ""src/proto/option.pro"": {""insertions"": 1, ""deletions"": 0, ""lines"": 1}, ""src/testdir/dumps/Test_balloon_eval_term_01.dump"": {""insertions"": 1, ""deletions"": 1, ""lines"": 2}, ""src/testdir/dumps/Test_balloon_eval_term_01a.dump"": {""insertions"": 1, ""deletions"": 1, ""lines"": 2}, ""src/testdir/dumps/Test_balloon_eval_term_02.dump"": {""insertions"": 1, ""deletions"": 1, ""lines"": 2}, ""src/testdir/test_balloon.vim"": {""insertions"": 2, ""deletions"": 1, ""lines"": 3}, ""src/version.c"": {""insertions"": 2, ""deletions"": 0, ""lines"": 2}}"
2022-01-22 13:39:08,9530b580a7b71960dbbdb2b12a3aafeb540bd135,Bram Moolenaar,24,13,37,7,"{""src/buffer.c"": {""insertions"": 2, ""deletions"": 2, ""lines"": 4}, ""src/eval.c"": {""insertions"": 4, ""deletions"": 2, ""lines"": 6}, ""src/findfile.c"": {""insertions"": 1, ""deletions"": 1, ""lines"": 2}, ""src/fold.c"": {""insertions"": 9, ""deletions"": 6, ""lines"": 15}, ""src/proto/eval.pro"": {""insertions"": 1, ""deletions"": 1, ""lines"": 2}, ""src/testdir/test_vim9_import.vim"": {""insertions"": 5, ""deletions"": 1, ""lines"": 6}, ""src/version.c"": {""insertions"": 2, ""deletions"": 0, ""lines"": 2}}"
2022-01-22 12:27:04,0bfa84916d110d4f4d863e91e144ff05ba431316,Bram Moolenaar,6,1,7,2,"{""src/version.c"": {""insertions"": 2, ""deletions"": 0, ""lines"": 2}, ""src/vim9cmds.c"": {""insertions"": 4, ""deletions"": 1, ""lines"": 5}}"
2022-01-22 11:27:29,b697dc295d0625bf2445649f03019f9b8fccc1a8,Bram Moolenaar,46,2,48,3,"{""src/testdir/test_vim9_import.vim"": {""insertions"": 42, ""deletions"": 0, ""lines"": 42}, ""src/version.c"": {""insertions"": 2, ""deletions"": 0, ""lines"": 2}, ""src/vim9compile.c"": {""insertions"": 2, ""deletions"": 2, ""lines"": 4}}"
2022-01-22 11:00:02,3d8e25a6d2660432df033cdad29f981ffe6ae0fc,Bram Moolenaar,29,1,30,3,"{""src/evalfunc.c"": {""insertions"": 24, ""deletions"": 0, ""lines"": 24}, ""src/testdir/test_vim9_import.vim"": {""insertions"": 3, ""deletions"": 1, ""lines"": 4}, ""src/version.c"": {""insertions"": 2, ""deletions"": 0, ""lines"": 2}}"
2022-01-22 10:24:47,0bd663a3804fceb3efb26a179e9c1d830ddcdb6e,Bram Moolenaar,15,146,161,4,"{""src/evalfunc.c"": {""insertions"": 2, ""deletions"": 10, ""lines"": 12}, ""src/gui_w32.c"": {""insertions"": 11, ""deletions"": 135, ""lines"": 146}, ""src/proto/gui_w32.pro"": {""insertions"": 0, ""deletions"": 1, ""lines"": 1}, ""src/version.c"": {""insertions"": 2, ""deletions"": 0, ""lines"": 2}}"
2022-01-21 20:37:05,19e69a63302f7f8972cee723bf0f3fc176825583,Bram Moolenaar,22,1,23,4,"{""src/errors.h"": {""insertions"": 2, ""deletions"": 1, ""lines"": 3}, ""src/testdir/test_vim9_import.vim"": {""insertions"": 12, ""deletions"": 0, ""lines"": 12}, ""src/userfunc.c"": {""insertions"": 6, ""deletions"": 0, ""lines"": 6}, ""src/version.c"": {""insertions"": 2, ""deletions"": 0, ""lines"": 2}}"
2022-01-21 16:31:11,e70dd11ef41f69bd5e94f630194e6b3c4f3f2102,Bram Moolenaar,59,9,68,7,"{""src/eval.c"": {""insertions"": 8, ""deletions"": 2, ""lines"": 10}, ""src/fold.c"": {""insertions"": 1, ""deletions"": 1, ""lines"": 2}, ""src/option.c"": {""insertions"": 6, ""deletions"": 0, ""lines"": 6}, ""src/proto/eval.pro"": {""insertions"": 1, ""deletions"": 3, ""lines"": 4}, ""src/structs.h"": {""insertions"": 2, ""deletions"": 3, ""lines"": 5}, ""src/testdir/test_vim9_import.vim"": {""insertions"": 39, ""deletions"": 0, ""lines"": 39}, ""src/version.c"": {""insertions"": 2, ""deletions"": 0, ""lines"": 2}}"
2022-01-21 14:55:13,6517f14165cdebf83a07ab9d4aeeb102b4e16e92,Bram Moolenaar,89,8,97,4,"{""runtime/autoload/dist/ft.vim"": {""insertions"": 21, ""deletions"": 5, ""lines"": 26}, ""runtime/filetype.vim"": {""insertions"": 3, ""deletions"": 2, ""lines"": 5}, ""src/testdir/test_filetype.vim"": {""insertions"": 63, ""deletions"": 1, ""lines"": 64}, ""src/version.c"": {""insertions"": 2, ""deletions"": 0, ""lines"": 2}}"
2022-01-21 13:29:56,f0e7e6365e86ca42c177fe165d3097d1bfb35f72,Bram Moolenaar,92,11,103,6,"{""src/evalvars.c"": {""insertions"": 41, ""deletions"": 9, ""lines"": 50}, ""src/option.c"": {""insertions"": 5, ""deletions"": 0, ""lines"": 5}, ""src/proto/evalvars.pro"": {""insertions"": 1, ""deletions"": 0, ""lines"": 1}, ""src/testdir/test_vim9_import.vim"": {""insertions"": 42, ""deletions"": 1, ""lines"": 43}, ""src/userfunc.c"": {""insertions"": 1, ""deletions"": 1, ""lines"": 2}, ""src/version.c"": {""insertions"": 2, ""deletions"": 0, ""lines"": 2}}"
2022-01-21 11:37:07,b7057bdd090ddcce96dc058e4e65340c8ec961d7,K.Takata,21,25,46,5,"{""src/gui_w32.c"": {""insertions"": 10, ""deletions"": 10, ""lines"": 20}, ""src/os_mswin.c"": {""insertions"": 5, ""deletions"": 5, ""lines"": 10}, ""src/os_win32.c"": {""insertions"": 4, ""deletions"": 4, ""lines"": 8}, ""src/os_win32.h"": {""insertions"": 0, ""deletions"": 6, ""lines"": 6}, ""src/version.c"": {""insertions"": 2, ""deletions"": 0, ""lines"": 2}}"
2022-01-21 11:11:00,45f9cfbdc75e10d420039fbe98d9f554bd415213,K.Takata,13,12,25,2,"{""src/gui_w32.c"": {""insertions"": 11, ""deletions"": 12, ""lines"": 23}, ""src/version.c"": {""insertions"": 2, ""deletions"": 0, ""lines"": 2}}"
2022-01-21 10:32:58,e6a4200ff47708febcd7cb2b8c3dd3801a975d43,Bram Moolenaar,12,2,14,4,"{""src/testdir/sautest/autoload/foo.vim"": {""insertions"": 4, ""deletions"": 0, ""lines"": 4}, ""src/testdir/test_autoload.vim"": {""insertions"": 4, ""deletions"": 0, ""lines"": 4}, ""src/userfunc.c"": {""insertions"": 2, ""deletions"": 2, ""lines"": 4}, ""src/version.c"": {""insertions"": 2, ""deletions"": 0, ""lines"": 2}}"
2022-01-20 21:32:54,dd5893be34649482ed62525430fb8baa1ec273ce,Bram Moolenaar,17,3,20,4,"{""src/errors.h"": {""insertions"": 1, ""deletions"": 2, ""lines"": 3}, ""src/evalvars.c"": {""insertions"": 1, ""deletions"": 1, ""lines"": 2}, ""src/testdir/test_vim9_import.vim"": {""insertions"": 13, ""deletions"": 0, ""lines"": 13}, ""src/version.c"": {""insertions"": 2, ""deletions"": 0, ""lines"": 2}}"
2022-01-20 21:00:54,e615db06046312e74886fa1ef98feb5a9db2a7c3,Bram Moolenaar,30,1,31,3,"{""src/buffer.c"": {""insertions"": 5, ""deletions"": 1, ""lines"": 6}, ""src/testdir/test_timers.vim"": {""insertions"": 23, ""deletions"": 0, ""lines"": 23}, ""src/version.c"": {""insertions"": 2, ""deletions"": 0, ""lines"": 2}}"
2022-01-20 20:18:27,05386ca1d4823e5c98c24b8cd038af49aee62577,Yegappan Lakshmanan,305,292,597,2,"{""src/normal.c"": {""insertions"": 303, ""deletions"": 292, ""lines"": 595}, ""src/version.c"": {""insertions"": 2, ""deletions"": 0, ""lines"": 2}}"
2022-01-20 19:56:49,6f0ddbf00dfc4c6eb70aa4abc415cad7aba46b6a,Bram Moolenaar,3,1,4,2,"{""src/userfunc.c"": {""insertions"": 1, ""deletions"": 1, ""lines"": 2}, ""src/version.c"": {""insertions"": 2, ""deletions"": 0, ""lines"": 2}}"
2022-01-20 19:38:46,2017d6f3b1d523204e5471e941cfa687b4da0058,Bram Moolenaar,19,1,20,3,"{""src/testdir/test_vim9_import.vim"": {""insertions"": 15, ""deletions"": 0, ""lines"": 15}, ""src/userfunc.c"": {""insertions"": 2, ""deletions"": 1, ""lines"": 3}, ""src/version.c"": {""insertions"": 2, ""deletions"": 0, ""lines"": 2}}"
2022-01-20 19:10:25,9c7cae66bc21a3dc5c6e60cd64216ce7c9073003,Bram Moolenaar,129,7,136,4,"{""src/scriptfile.c"": {""insertions"": 1, ""deletions"": 2, ""lines"": 3}, ""src/testdir/test_vim9_import.vim"": {""insertions"": 74, ""deletions"": 0, ""lines"": 74}, ""src/userfunc.c"": {""insertions"": 52, ""deletions"": 5, ""lines"": 57}, ""src/version.c"": {""insertions"": 2, ""deletions"": 0, ""lines"": 2}}"
2022-01-20 17:35:49,21f0d6cbca9c93e2319d45a33ba26b10a85ff4dc,Bram Moolenaar,9,2,11,3,"{""src/testdir/test_vim9_import.vim"": {""insertions"": 7, ""deletions"": 1, ""lines"": 8}, ""src/version.c"": {""insertions"": 2, ""deletions"": 0, ""lines"": 2}, ""src/vim9expr.c"": {""insertions"": 0, ""deletions"": 1, ""lines"": 1}}"
2022-01-20 15:26:03,4ede01f18884961f2e008880b4964e5d61ea5c36,Shougo Matsushita,95,4,99,6,"{""runtime/doc/visual.txt"": {""insertions"": 5, ""deletions"": 0, ""lines"": 5}, ""src/globals.h"": {""insertions"": 2, ""deletions"": 0, ""lines"": 2}, ""src/normal.c"": {""insertions"": 30, ""deletions"": 4, ""lines"": 34}, ""src/ops.c"": {""insertions"": 4, ""deletions"": 0, ""lines"": 4}, ""src/testdir/test_selectmode.vim"": {""insertions"": 52, ""deletions"": 0, ""lines"": 52}, ""src/version.c"": {""insertions"": 2, ""deletions"": 0, ""lines"": 2}}"
2022-01-20 15:10:57,92000e2e713a68f80a25472cfa74058366c58c9c,K.Takata,240,229,469,2,"{""src/gui_w32.c"": {""insertions"": 238, ""deletions"": 229, ""lines"": 467}, ""src/version.c"": {""insertions"": 2, ""deletions"": 0, ""lines"": 2}}"
2022-01-20 15:05:22,14b8d6ac6b50f2f4f3e7463e4c335f51a512ad30,K.Takata,9,9,18,2,"{""src/gui_w32.c"": {""insertions"": 7, ""deletions"": 9, ""lines"": 16}, ""src/version.c"": {""insertions"": 2, ""deletions"": 0, ""lines"": 2}}"
2022-01-20 14:57:29,ae1bd87fe84bfb31379bc5da351bca56a3d3b571,ichizok,11,0,11,6,"{""runtime/doc/testing.txt"": {""insertions"": 2, ""deletions"": 0, ""lines"": 2}, ""src/globals.h"": {""insertions"": 1, ""deletions"": 0, ""lines"": 1}, ""src/terminal.c"": {""insertions"": 2, ""deletions"": 0, ""lines"": 2}, ""src/testdir/test_terminal.vim"": {""insertions"": 2, ""deletions"": 0, ""lines"": 2}, ""src/testing.c"": {""insertions"": 2, ""deletions"": 0, ""lines"": 2}, ""src/version.c"": {""insertions"": 2, ""deletions"": 0, ""lines"": 2}}"
2022-01-20 14:44:38,726f7f91fd17e3e7eb39614a20d10ea83c134df0,Rob Pilling,46,0,46,4,"{""src/message.c"": {""insertions"": 7, ""deletions"": 0, ""lines"": 7}, ""src/testdir/dumps/Test_fileinfo_after_echo.dump"": {""insertions"": 6, ""deletions"": 0, ""lines"": 6}, ""src/testdir/test_messages.vim"": {""insertions"": 31, ""deletions"": 0, ""lines"": 31}, ""src/version.c"": {""insertions"": 2, ""deletions"": 0, ""lines"": 2}}"
2022-01-20 14:25:57,7e93577a957e4f402bb690c4c8629fd831e24a9d,Bram Moolenaar,3,0,3,2,"{""src/time.c"": {""insertions"": 1, ""deletions"": 0, ""lines"": 1}, ""src/version.c"": {""insertions"": 2, ""deletions"": 0, ""lines"": 2}}"
2022-01-20 13:32:50,05b27615481e72e3b338bb12990fb3e0c2ecc2a9,Bram Moolenaar,18,1,19,3,"{""src/testdir/test_visual.vim"": {""insertions"": 10, ""deletions"": 0, ""lines"": 10}, ""src/version.c"": {""insertions"": 2, ""deletions"": 0, ""lines"": 2}, ""src/window.c"": {""insertions"": 6, ""deletions"": 1, ""lines"": 7}}"
2022-01-20 12:44:28,4ac893f32109f29349661322676e5b81eb169b74,K.Takata,32,997,1029,9,"{""Filelist"": {""insertions"": 0, ""deletions"": 3, ""lines"": 3}, ""runtime/doc/mbyte.txt"": {""insertions"": 3, ""deletions"": 24, ""lines"": 27}, ""src/Make_mvc.mak"": {""insertions"": 0, ""deletions"": 16, ""lines"": 16}, ""src/dimm.idl"": {""insertions"": 0, ""deletions"": 544, ""lines"": 544}, ""src/glbl_ime.cpp"": {""insertions"": 0, ""deletions"": 256, ""lines"": 256}, ""src/glbl_ime.h"": {""insertions"": 0, ""deletions"": 33, ""lines"": 33}, ""src/gui_w32.c"": {""insertions"": 24, ""deletions"": 116, ""lines"": 140}, ""src/version.c"": {""insertions"": 2, ""deletions"": 0, ""lines"": 2}, ""src/vim.h"": {""insertions"": 3, ""deletions"": 5, ""lines"": 8}}"
2022-01-20 12:22:35,fc6ccebea668c49e9e617e0657421b6a8ed9df1e,Bram Moolenaar,3,1,4,2,"{""src/testdir/test_utf8.vim"": {""insertions"": 1, ""deletions"": 1, ""lines"": 2}, ""src/version.c"": {""insertions"": 2, ""deletions"": 0, ""lines"": 2}}"
2022-01-20 12:10:48,57df9e8a9f9ae1aafdde9b86b10ad907627a87dc,Bram Moolenaar,13,17,30,3,"{""src/ops.c"": {""insertions"": 2, ""deletions"": 17, ""lines"": 19}, ""src/testdir/test_visual.vim"": {""insertions"": 9, ""deletions"": 0, ""lines"": 9}, ""src/version.c"": {""insertions"": 2, ""deletions"": 0, ""lines"": 2}}"
2022-01-20 11:27:58,8aa0e6c60da5f7a4b04eaead40d183fd8e5640a4,Bram Moolenaar,3,1,4,2,"{""src/map.c"": {""insertions"": 1, ""deletions"": 1, ""lines"": 2}, ""src/version.c"": {""insertions"": 2, ""deletions"": 0, ""lines"": 2}}"
2022-01-20 11:17:18,ca34db3bdef7238b203386dc82b975ffdf26f839,Bram Moolenaar,4,1,5,3,"{""src/testdir/test_autocmd.vim"": {""insertions"": 1, ""deletions"": 1, ""lines"": 2}, ""src/testdir/test_mapping.vim"": {""insertions"": 1, ""deletions"": 0, ""lines"": 1}, ""src/version.c"": {""insertions"": 2, ""deletions"": 0, ""lines"": 2}}"
2022-01-19 22:51:48,f61c89d2e698e287a9d04c0a29f4ecc0130c2ea2,Bram Moolenaar,23,4,27,5,"{""src/getchar.c"": {""insertions"": 3, ""deletions"": 2, ""lines"": 5}, ""src/map.c"": {""insertions"": 1, ""deletions"": 1, ""lines"": 2}, ""src/proto/getchar.pro"": {""insertions"": 1, ""deletions"": 1, ""lines"": 2}, ""src/testdir/test_mapping.vim"": {""insertions"": 16, ""deletions"": 0, ""lines"": 16}, ""src/version.c"": {""insertions"": 2, ""deletions"": 0, ""lines"": 2}}"
2022-01-19 20:48:37,bed34f0a8a4e38a72a080184881bc68254a8cdc6,Bram Moolenaar,36,2,38,5,"{""src/errors.h"": {""insertions"": 2, ""deletions"": 0, ""lines"": 2}, ""src/ex_docmd.c"": {""insertions"": 1, ""deletions"": 1, ""lines"": 2}, ""src/testdir/test_vim9_script.vim"": {""insertions"": 30, ""deletions"": 0, ""lines"": 30}, ""src/version.c"": {""insertions"": 2, ""deletions"": 0, ""lines"": 2}, ""src/vim9compile.c"": {""insertions"": 1, ""deletions"": 1, ""lines"": 2}}"
2022-01-19 17:23:05,f67c717e34e5553ab1c3b02b1861274cbcb78935,Bram Moolenaar,17,6,23,2,"{""src/version.c"": {""insertions"": 2, ""deletions"": 0, ""lines"": 2}, ""src/vim9expr.c"": {""insertions"": 15, ""deletions"": 6, ""lines"": 21}}"
2022-01-19 17:21:29,937610bc9f9c827e3e25fed32661fcbf3f994e10,Bram Moolenaar,27,8,35,6,"{""src/eval.c"": {""insertions"": 1, ""deletions"": 1, ""lines"": 2}, ""src/proto/userfunc.pro"": {""insertions"": 1, ""deletions"": 1, ""lines"": 2}, ""src/testdir/test_vim9_import.vim"": {""insertions"": 11, ""deletions"": 1, ""lines"": 12}, ""src/userfunc.c"": {""insertions"": 11, ""deletions"": 5, ""lines"": 16}, ""src/version.c"": {""insertions"": 2, ""deletions"": 0, ""lines"": 2}, ""src/vim.h"": {""insertions"": 1, ""deletions"": 0, ""lines"": 1}}"
2022-01-19 13:32:57,1a8825d7a3484d76ca16ea2aa9769cadca7758a4,K.Takata,144,7,151,7,"{""src/Make_cyg_ming.mak"": {""insertions"": 7, ""deletions"": 0, ""lines"": 7}, ""src/Make_mvc.mak"": {""insertions"": 12, ""deletions"": 4, ""lines"": 16}, ""src/buffer.c"": {""insertions"": 3, ""deletions"": 2, ""lines"": 5}, ""src/crypt.c"": {""insertions"": 116, ""deletions"": 0, ""lines"": 116}, ""src/memline.c"": {""insertions"": 2, ""deletions"": 1, ""lines"": 3}, ""src/proto/crypt.pro"": {""insertions"": 2, ""deletions"": 0, ""lines"": 2}, ""src/version.c"": {""insertions"": 2, ""deletions"": 0, ""lines"": 2}}"
2022-01-19 12:59:21,b0b2b73dca40c26ff1f4befe5c3aad3fd4bccfad,K.Takata,21,64,85,2,"{""src/gui_w32.c"": {""insertions"": 19, ""deletions"": 64, ""lines"": 83}, ""src/version.c"": {""insertions"": 2, ""deletions"": 0, ""lines"": 2}}"
2022-01-19 11:24:40,b4868eddd9cdc7086c88a7a3699dd435d34ae904,Bram Moolenaar,3,1,4,2,"{""src/fileio.c"": {""insertions"": 1, ""deletions"": 1, ""lines"": 2}, ""src/version.c"": {""insertions"": 2, ""deletions"": 0, ""lines"": 2}}"
2022-01-18 21:42:37,17dd51963367495f75b0f0a73139081dd7b25500,Bram Moolenaar,3,0,3,2,"{""src/testdir/test_vim9_builtin.vim"": {""insertions"": 1, ""deletions"": 0, ""lines"": 1}, ""src/version.c"": {""insertions"": 2, ""deletions"": 0, ""lines"": 2}}"
2022-01-18 20:51:35,a9528b39a666dbaa026320f73bae4b1628a7fe51,Bram Moolenaar,23,9,32,4,"{""runtime/doc/builtin.txt"": {""insertions"": 2, ""deletions"": 0, ""lines"": 2}, ""src/map.c"": {""insertions"": 11, ""deletions"": 5, ""lines"": 16}, ""src/testdir/test_maparg.vim"": {""insertions"": 8, ""deletions"": 4, ""lines"": 12}, ""src/version.c"": {""insertions"": 2, ""deletions"": 0, ""lines"": 2}}"
2022-01-18 20:30:39,94075b2b0e8e3b75334799d2c082497fbf85ffa1,Bram Moolenaar,33,6,39,3,"{""src/map.c"": {""insertions"": 18, ""deletions"": 5, ""lines"": 23}, ""src/testdir/test_mapping.vim"": {""insertions"": 13, ""deletions"": 1, ""lines"": 14}, ""src/version.c"": {""insertions"": 2, ""deletions"": 0, ""lines"": 2}}"
2022-01-18 18:46:07,ef7aadbe36ad43a1b909f5f6c7e9b170ad62ef91,Bram Moolenaar,21,7,28,3,"{""src/testdir/test_vim9_func.vim"": {""insertions"": 14, ""deletions"": 0, ""lines"": 14}, ""src/version.c"": {""insertions"": 2, ""deletions"": 0, ""lines"": 2}, ""src/vim9cmds.c"": {""insertions"": 5, ""deletions"": 7, ""lines"": 12}}"
2022-01-18 17:43:04,d02dce2bb572f0e6b4570442e9cdbed14ef41820,Bram Moolenaar,170,29,199,5,"{""src/testdir/test_vim9_import.vim"": {""insertions"": 130, ""deletions"": 0, ""lines"": 130}, ""src/version.c"": {""insertions"": 2, ""deletions"": 0, ""lines"": 2}, ""src/vim9execute.c"": {""insertions"": 8, ""deletions"": 22, ""lines"": 30}, ""src/vim9expr.c"": {""insertions"": 11, ""deletions"": 2, ""lines"": 13}, ""src/vim9script.c"": {""insertions"": 19, ""deletions"": 5, ""lines"": 24}}"
2022-01-18 16:26:24,fd218c8a36e7ed33f7a205163690c5b7d2f31f8a,Bram Moolenaar,28,36,64,6,"{""runtime/doc/repeat.txt"": {""insertions"": 3, ""deletions"": 4, ""lines"": 7}, ""runtime/doc/vim9.txt"": {""insertions"": 8, ""deletions"": 7, ""lines"": 15}, ""src/errors.h"": {""insertions"": 1, ""deletions"": 2, ""lines"": 3}, ""src/testdir/test_vim9_import.vim"": {""insertions"": 14, ""deletions"": 8, ""lines"": 22}, ""src/version.c"": {""insertions"": 2, ""deletions"": 0, ""lines"": 2}, ""src/vim9script.c"": {""insertions"": 0, ""deletions"": 15, ""lines"": 15}}"
2022-01-18 14:16:59,6079da7cfb10c798535224c92db7fedd3914cb71,Bram Moolenaar,17,4,21,4,"{""runtime/doc/repeat.txt"": {""insertions"": 3, ""deletions"": 0, ""lines"": 3}, ""src/scriptfile.c"": {""insertions"": 10, ""deletions"": 4, ""lines"": 14}, ""src/testdir/test_vim9_import.vim"": {""insertions"": 2, ""deletions"": 0, ""lines"": 2}, ""src/version.c"": {""insertions"": 2, ""deletions"": 0, ""lines"": 2}}"
2022-01-18 13:43:58,113b8dc111febf605cd1492788353be6c3931fce,Bram Moolenaar,9,1,10,2,"{""src/version.c"": {""insertions"": 2, ""deletions"": 0, ""lines"": 2}, ""src/vim9script.c"": {""insertions"": 7, ""deletions"": 1, ""lines"": 8}}"
2022-01-18 13:34:05,840f16202e1ae2d574507ef52a7e8a98775f243c,Bram Moolenaar,11,1,12,3,"{""src/scriptfile.c"": {""insertions"": 5, ""deletions"": 1, ""lines"": 6}, ""src/testdir/test_scriptnames.vim"": {""insertions"": 4, ""deletions"": 0, ""lines"": 4}, ""src/version.c"": {""insertions"": 2, ""deletions"": 0, ""lines"": 2}}"
2022-01-18 13:14:47,1836d6157828baddd94e1f2c82488031570e444d,Bram Moolenaar,17,3,20,3,"{""src/testdir/test_vim9_import.vim"": {""insertions"": 13, ""deletions"": 1, ""lines"": 14}, ""src/version.c"": {""insertions"": 2, ""deletions"": 0, ""lines"": 2}, ""src/vim9script.c"": {""insertions"": 2, ""deletions"": 2, ""lines"": 4}}"
2022-01-18 12:58:28,cbbc48f64b9cfd88720dc94b0578a3726f725178,Bram Moolenaar,44,7,51,3,"{""src/testdir/test_vim9_import.vim"": {""insertions"": 11, ""deletions"": 0, ""lines"": 11}, ""src/version.c"": {""insertions"": 2, ""deletions"": 0, ""lines"": 2}, ""src/vim9execute.c"": {""insertions"": 31, ""deletions"": 7, ""lines"": 38}}"
2022-01-18 11:34:57,31dcc8de463843e3378bb15a16247940d6a147e4,K.Takata,11,6,17,2,"{""src/Make_mvc.mak"": {""insertions"": 9, ""deletions"": 6, ""lines"": 15}, ""src/version.c"": {""insertions"": 2, ""deletions"": 0, ""lines"": 2}}"
2022-01-18 11:11:25,1247126956c2ba666048b2bf99630eef7495e98e,Bram Moolenaar,45,20,65,3,"{""src/auto/configure"": {""insertions"": 22, ""deletions"": 10, ""lines"": 32}, ""src/configure.ac"": {""insertions"": 21, ""deletions"": 10, ""lines"": 31}, ""src/version.c"": {""insertions"": 2, ""deletions"": 0, ""lines"": 2}}"
2022-01-18 10:37:29,64283d5e1f5487e2dbaa17d478e6eae040daa064,Bram Moolenaar,17,2,19,3,"{""src/eval.c"": {""insertions"": 7, ""deletions"": 2, ""lines"": 9}, ""src/testdir/test_vim9_expr.vim"": {""insertions"": 8, ""deletions"": 0, ""lines"": 8}, ""src/version.c"": {""insertions"": 2, ""deletions"": 0, ""lines"": 2}}"
2022-01-17 22:16:33,78f60322f70ab91a32e572fbf3d97c792acbc83a,Bram Moolenaar,4,0,4,2,"{""src/usercmd.c"": {""insertions"": 2, ""deletions"": 0, ""lines"": 2}, ""src/version.c"": {""insertions"": 2, ""deletions"": 0, ""lines"": 2}}"
2022-01-17 21:34:38,afa76e1cf2e7e1f9e1097e345a4272e9ddbf14ad,Bram Moolenaar,13,8,21,2,"{""src/if_tcl.c"": {""insertions"": 11, ""deletions"": 8, ""lines"": 19}, ""src/version.c"": {""insertions"": 2, ""deletions"": 0, ""lines"": 2}}"
2022-01-17 21:13:28,b3d9ceed2bc96acb7a2388e138559df6282118af,Bram Moolenaar,4,0,4,2,"{""src/eval.c"": {""insertions"": 2, ""deletions"": 0, ""lines"": 2}, ""src/version.c"": {""insertions"": 2, ""deletions"": 0, ""lines"": 2}}"
2022-01-17 20:50:40,6389baa6691fde4ca56ec6243ed83322543df300,Bram Moolenaar,85,50,135,3,"{""src/testdir/test_vim9_expr.vim"": {""insertions"": 68, ""deletions"": 42, ""lines"": 110}, ""src/version.c"": {""insertions"": 2, ""deletions"": 0, ""lines"": 2}, ""src/vim9expr.c"": {""insertions"": 15, ""deletions"": 8, ""lines"": 23}}"
2022-01-17 20:09:08,15d1635e50896002fbd4ebbc896b78a155b2487d,Bram Moolenaar,114,49,163,4,"{""src/eval.c"": {""insertions"": 73, ""deletions"": 45, ""lines"": 118}, ""src/testdir/test_vim9_import.vim"": {""insertions"": 23, ""deletions"": 0, ""lines"": 23}, ""src/userfunc.c"": {""insertions"": 16, ""deletions"": 4, ""lines"": 20}, ""src/version.c"": {""insertions"": 2, ""deletions"": 0, ""lines"": 2}}"
2022-01-17 19:06:56,3f3597be3ffa9ae226b2e9831e4ed64c8ae43c42,Bram Moolenaar,11,2,13,3,"{""src/testdir/test_usercommands.vim"": {""insertions"": 2, ""deletions"": 2, ""lines"": 4}, ""src/usercmd.c"": {""insertions"": 7, ""deletions"": 0, ""lines"": 7}, ""src/version.c"": {""insertions"": 2, ""deletions"": 0, ""lines"": 2}}"
2022-01-17 17:52:22,262898ae43fa223916cfa27b0de81e5d9f3fc4b0,Bram Moolenaar,4,0,4,2,"{""src/testdir/test_visual.vim"": {""insertions"": 2, ""deletions"": 0, ""lines"": 2}, ""src/version.c"": {""insertions"": 2, ""deletions"": 0, ""lines"": 2}}"
2022-01-17 17:30:21,9f8c304c8a390ade133bac29963dc8e56ab14cbc,Bram Moolenaar,37,14,51,3,"{""src/ops.c"": {""insertions"": 26, ""deletions"": 14, ""lines"": 40}, ""src/testdir/test_visual.vim"": {""insertions"": 9, ""deletions"": 0, ""lines"": 9}, ""src/version.c"": {""insertions"": 2, ""deletions"": 0, ""lines"": 2}}"
2022-01-17 11:23:45,e8741a73e20cd6043dd1610fb4c22ae9d132eb56,Dominique Pelle,3,1,4,2,"{""src/misc2.c"": {""insertions"": 1, ""deletions"": 1, ""lines"": 2}, ""src/version.c"": {""insertions"": 2, ""deletions"": 0, ""lines"": 2}}"
2022-01-16 21:54:19,0023f82a76cf43a12b41e71f97a2e860d0444e1b,Bram Moolenaar,6,4,10,2,"{""src/usercmd.c"": {""insertions"": 4, ""deletions"": 4, ""lines"": 8}, ""src/version.c"": {""insertions"": 2, ""deletions"": 0, ""lines"": 2}}"
2022-01-16 21:18:53,47036b6bd7e5a0b38f093d9f0630f054b04fa68e,Bram Moolenaar,4,2,6,3,"{""src/eval.c"": {""insertions"": 0, ""deletions"": 1, ""lines"": 1}, ""src/testdir/test_vim9_import.vim"": {""insertions"": 2, ""deletions"": 1, ""lines"": 3}, ""src/version.c"": {""insertions"": 2, ""deletions"": 0, ""lines"": 2}}"
2022-01-16 20:59:39,c73499351aef8b611b13c70ef8706a7e98df67a8,Bram Moolenaar,72,31,103,3,"{""src/testdir/test_vim9_expr.vim"": {""insertions"": 1, ""deletions"": 2, ""lines"": 3}, ""src/version.c"": {""insertions"": 2, ""deletions"": 0, ""lines"": 2}, ""src/vim9expr.c"": {""insertions"": 69, ""deletions"": 29, ""lines"": 98}}"
2022-01-16 19:38:07,c665dabdf4c49a0fbf1dc566253c75c2abe2effa,Bram Moolenaar,78,50,128,4,"{""src/errors.h"": {""insertions"": 2, ""deletions"": 0, ""lines"": 2}, ""src/eval.c"": {""insertions"": 52, ""deletions"": 49, ""lines"": 101}, ""src/testdir/test_vim9_expr.vim"": {""insertions"": 22, ""deletions"": 1, ""lines"": 23}, ""src/version.c"": {""insertions"": 2, ""deletions"": 0, ""lines"": 2}}"
2022-01-16 18:06:21,c84287d6d8dd055bb6e30605465a23a8addb6fde,Bram Moolenaar,31,8,39,5,"{""src/proto/vim9type.pro"": {""insertions"": 1, ""deletions"": 2, ""lines"": 3}, ""src/testdir/test_vim9_expr.vim"": {""insertions"": 8, ""deletions"": 0, ""lines"": 8}, ""src/userfunc.c"": {""insertions"": 2, ""deletions"": 1, ""lines"": 3}, ""src/version.c"": {""insertions"": 2, ""deletions"": 0, ""lines"": 2}, ""src/vim9type.c"": {""insertions"": 18, ""deletions"": 5, ""lines"": 23}}"
2022-01-16 15:52:35,dc98776f89689846466462767be75c6b63b6630f,Bram Moolenaar,19,1,20,3,"{""src/testdir/test_mapping.vim"": {""insertions"": 16, ""deletions"": 0, ""lines"": 16}, ""src/version.c"": {""insertions"": 2, ""deletions"": 0, ""lines"": 2}, ""src/vim.h"": {""insertions"": 1, ""deletions"": 1, ""lines"": 2}}"
2022-01-16 15:00:08,d9b74a2a41e43ca17a9885ec0a58404adff4273f,Bram Moolenaar,4,0,4,2,"{""src/testdir/test_diffmode.vim"": {""insertions"": 2, ""deletions"": 0, ""lines"": 2}, ""src/version.c"": {""insertions"": 2, ""deletions"": 0, ""lines"": 2}}"
2022-01-16 14:58:34,d648c01f2f3798a5c75422aa83211928ad783128,Bram Moolenaar,5,0,5,2,"{""src/map.c"": {""insertions"": 3, ""deletions"": 0, ""lines"": 3}, ""src/version.c"": {""insertions"": 2, ""deletions"": 0, ""lines"": 2}}"
2022-01-16 14:51:30,8f9956994d5c75ed88d6b2881b6ac0bb62a0d6af,Bram Moolenaar,9,5,14,2,"{""src/eval.c"": {""insertions"": 7, ""deletions"": 5, ""lines"": 12}, ""src/version.c"": {""insertions"": 2, ""deletions"": 0, ""lines"": 2}}"
2022-01-16 14:46:06,fd31be29b8220ee1cb0b3460c82f2634ae3cc370,Bram Moolenaar,26139,18590,44729,25,"{""runtime/autoload/dist/ft.vim"": {""insertions"": 1, ""deletions"": 1, ""lines"": 2}, ""runtime/doc/autocmd.txt"": {""insertions"": 18, ""deletions"": 18, ""lines"": 36}, ""runtime/doc/builtin.txt"": {""insertions"": 1, ""deletions"": 1, ""lines"": 2}, ""runtime/doc/editing.txt"": {""insertions"": 3, ""deletions"": 2, ""lines"": 5}, ""runtime/doc/map.txt"": {""insertions"": 3, ""deletions"": 3, ""lines"": 6}, ""runtime/doc/repeat.txt"": {""insertions"": 1, ""deletions"": 1, ""lines"": 2}, ""runtime/doc/tags"": {""insertions"": 5, ""deletions"": 1, ""lines"": 6}, ""runtime/doc/testing.txt"": {""insertions"": 1, ""deletions"": 1, ""lines"": 2}, ""runtime/doc/todo.txt"": {""insertions"": 12, ""deletions"": 13, ""lines"": 25}, ""runtime/doc/various.txt"": {""insertions"": 9, ""deletions"": 9, ""lines"": 18}, ""runtime/doc/vim-ja.UTF-8.1"": {""insertions"": 9, ""deletions"": 3, ""lines"": 12}, ""runtime/doc/vim9.txt"": {""insertions"": 26, ""deletions"": 8, ""lines"": 34}, ""runtime/doc/vimdiff-ja.UTF-8.1"": {""insertions"": 3, ""deletions"": 3, ""lines"": 6}, ""runtime/doc/xxd-ja.UTF-8.1"": {""insertions"": 1, ""deletions"": 0, ""lines"": 1}, ""runtime/filetype.vim"": {""insertions"": 1, ""deletions"": 1, ""lines"": 2}, ""runtime/pack/dist/opt/termdebug/plugin/termdebug.vim"": {""insertions"": 14, ""deletions"": 2, ""lines"": 16}, ""runtime/syntax/i3config.vim"": {""insertions"": 2, ""deletions"": 2, ""lines"": 4}, ""runtime/syntax/vim.vim"": {""insertions"": 8, ""deletions"": 8, ""lines"": 16}, ""runtime/tutor/tutor.ja.euc"": {""insertions"": 115, ""deletions"": 115, ""lines"": 230}, ""runtime/tutor/tutor.ja.sjis"": {""insertions"": 115, ""deletions"": 115, ""lines"": 230}, ""runtime/tutor/tutor.ja.utf-8"": {""insertions"": 115, ""deletions"": 115, ""lines"": 230}, ""src/po/it.po"": {""insertions"": 3539, ""deletions"": 3489, ""lines"": 7028}, ""src/po/ja.euc-jp.po"": {""insertions"": 7382, ""deletions"": 4896, ""lines"": 12278}, ""src/po/ja.po"": {""insertions"": 7382, ""deletions"": 4896, ""lines"": 12278}, ""src/po/ja.sjis.po"": {""insertions"": 7373, ""deletions"": 4887, ""lines"": 12260}}"
2022-01-16 14:15:49,c81e9bf4f07d350b860b934aa6bf0c2a7c91d07e,K.Takata,300,115,415,5,"{""src/gui.c"": {""insertions"": 1, ""deletions"": 15, ""lines"": 16}, ""src/gui.h"": {""insertions"": 1, ""deletions"": 1, ""lines"": 2}, ""src/gui_w32.c"": {""insertions"": 291, ""deletions"": 95, ""lines"": 386}, ""src/version.c"": {""insertions"": 2, ""deletions"": 0, ""lines"": 2}, ""src/vim.manifest"": {""insertions"": 5, ""deletions"": 4, ""lines"": 9}}"
2022-01-16 13:58:33,f6ebc820041b3f77794297026b46c1ebbc279a3a,Bram Moolenaar,7,2,9,2,"{""src/drawscreen.c"": {""insertions"": 5, ""deletions"": 2, ""lines"": 7}, ""src/version.c"": {""insertions"": 2, ""deletions"": 0, ""lines"": 2}}"
2022-01-16 13:30:33,a9725221ac4650b7e9219bf6e3682826fe2e0096,Bram Moolenaar,36,4,40,5,"{""runtime/doc/builtin.txt"": {""insertions"": 3, ""deletions"": 0, ""lines"": 3}, ""src/evalfunc.c"": {""insertions"": 14, ""deletions"": 1, ""lines"": 15}, ""src/getchar.c"": {""insertions"": 3, ""deletions"": 3, ""lines"": 6}, ""src/testdir/test_mapping.vim"": {""insertions"": 14, ""deletions"": 0, ""lines"": 14}, ""src/version.c"": {""insertions"": 2, ""deletions"": 0, ""lines"": 2}}"
2022-01-16 11:42:20,fa1a45705995f16ee7e69434c772107a3ddeeebd,Bram Moolenaar,7,0,7,2,"{""src/drawscreen.c"": {""insertions"": 5, ""deletions"": 0, ""lines"": 5}, ""src/version.c"": {""insertions"": 2, ""deletions"": 0, ""lines"": 2}}"
2022-01-16 11:25:26,b5988e365646746029e13473251e5844440d819c,K.Takata,7,1,8,3,"{""src/errors.h"": {""insertions"": 5, ""deletions"": 0, ""lines"": 5}, ""src/ex_docmd.c"": {""insertions"": 0, ""deletions"": 1, ""lines"": 1}, ""src/version.c"": {""insertions"": 2, ""deletions"": 0, ""lines"": 2}}"
2022-01-16 11:12:12,bfac409d0b24d212a6d846edb651c49dac03745f,Bram Moolenaar,11,4,15,3,"{""src/scriptfile.c"": {""insertions"": 0, ""deletions"": 4, ""lines"": 4}, ""src/testdir/test_vim9_import.vim"": {""insertions"": 9, ""deletions"": 0, ""lines"": 9}, ""src/version.c"": {""insertions"": 2, ""deletions"": 0, ""lines"": 2}}"
2022-01-15 21:44:44,38ecd9722664049d636f4fba759b3ebbfd34e97d,Bram Moolenaar,67,4,71,5,"{""src/proto/vim9instr.pro"": {""insertions"": 1, ""deletions"": 0, ""lines"": 1}, ""src/testdir/test_vim9_assign.vim"": {""insertions"": 35, ""deletions"": 0, ""lines"": 35}, ""src/version.c"": {""insertions"": 2, ""deletions"": 0, ""lines"": 2}, ""src/vim9compile.c"": {""insertions"": 8, ""deletions"": 3, ""lines"": 11}, ""src/vim9instr.c"": {""insertions"": 21, ""deletions"": 1, ""lines"": 22}}"
2022-01-15 21:08:19,857c8bb1bbe754cf2c5b709703d2eb848c800285,Bram Moolenaar,87,13,100,3,"{""src/eval.c"": {""insertions"": 78, ""deletions"": 13, ""lines"": 91}, ""src/testdir/test_vim9_import.vim"": {""insertions"": 7, ""deletions"": 0, ""lines"": 7}, ""src/version.c"": {""insertions"": 2, ""deletions"": 0, ""lines"": 2}}"
2022-01-15 18:48:32,d4e2f5090124d7753057de82727a99892f0231fe,Bram Moolenaar,3,1,4,2,"{""src/getchar.c"": {""insertions"": 1, ""deletions"": 1, ""lines"": 2}, ""src/version.c"": {""insertions"": 2, ""deletions"": 0, ""lines"": 2}}"
2022-01-15 18:31:43,04b871da800768287a8a432de568b11297db8686,Bram Moolenaar,18,2,20,3,"{""src/option.c"": {""insertions"": 0, ""deletions"": 1, ""lines"": 1}, ""src/testdir/test_breakindent.vim"": {""insertions"": 16, ""deletions"": 1, ""lines"": 17}, ""src/version.c"": {""insertions"": 2, ""deletions"": 0, ""lines"": 2}}"
2022-01-15 18:26:04,e32c3c462ce9b3163a4a4bffd985897910885d29,Bram Moolenaar,113,22,135,13,"{""runtime/doc/map.txt"": {""insertions"": 26, ""deletions"": 6, ""lines"": 32}, ""src/edit.c"": {""insertions"": 3, ""deletions"": 2, ""lines"": 5}, ""src/ex_getln.c"": {""insertions"": 2, ""deletions"": 2, ""lines"": 4}, ""src/getchar.c"": {""insertions"": 39, ""deletions"": 2, ""lines"": 41}, ""src/insexpand.c"": {""insertions"": 2, ""deletions"": 1, ""lines"": 3}, ""src/keymap.h"": {""insertions"": 2, ""deletions"": 0, ""lines"": 2}, ""src/misc2.c"": {""insertions"": 1, ""deletions"": 0, ""lines"": 1}, ""src/normal.c"": {""insertions"": 9, ""deletions"": 3, ""lines"": 12}, ""src/ops.c"": {""insertions"": 11, ""deletions"": 4, ""lines"": 15}, ""src/proto/getchar.pro"": {""insertions"": 2, ""deletions"": 1, ""lines"": 3}, ""src/terminal.c"": {""insertions"": 2, ""deletions"": 1, ""lines"": 3}, ""src/testdir/test_vim9_import.vim"": {""insertions"": 12, ""deletions"": 0, ""lines"": 12}, ""src/version.c"": {""insertions"": 2, ""deletions"": 0, ""lines"": 2}}"
2022-01-15 15:23:44,069613c9e8645acea3a128c15ebdbf56e2219d44,Bram Moolenaar,9,0,9,2,"{""src/main.c"": {""insertions"": 7, ""deletions"": 0, ""lines"": 7}, ""src/version.c"": {""insertions"": 2, ""deletions"": 0, ""lines"": 2}}"
2022-01-15 14:16:37,f60a63485ea26d9bda1618d1b72662eca65b5f1f,Bram Moolenaar,3,1,4,2,"{""src/version.c"": {""insertions"": 2, ""deletions"": 0, ""lines"": 2}, ""src/vim9compile.c"": {""insertions"": 1, ""deletions"": 1, ""lines"": 2}}"
2022-01-15 13:37:14,1050476ead81a49be0289f40b2041c47a70c95ab,ichizok,22,14,36,2,"{"".github/workflows/ci.yml"": {""insertions"": 20, ""deletions"": 14, ""lines"": 34}, ""src/version.c"": {""insertions"": 2, ""deletions"": 0, ""lines"": 2}}"
2022-01-15 12:27:09,e3ce17a3ca838954728df21ccb6c2a724490203d,Bram Moolenaar,9,1,10,3,"{""runtime/scripts.vim"": {""insertions"": 6, ""deletions"": 0, ""lines"": 6}, ""src/testdir/test_filetype.vim"": {""insertions"": 1, ""deletions"": 1, ""lines"": 2}, ""src/version.c"": {""insertions"": 2, ""deletions"": 0, ""lines"": 2}}"
2022-01-15 10:52:16,e1833bfd01c100896d2a01f281762c285192d84b,zeertzjq,4,2,6,3,"{""src/option.h"": {""insertions"": 1, ""deletions"": 1, ""lines"": 2}, ""src/optiondefs.h"": {""insertions"": 1, ""deletions"": 1, ""lines"": 2}, ""src/version.c"": {""insertions"": 2, ""deletions"": 0, ""lines"": 2}}"
2022-01-15 10:01:05,c53b467473160b5cfce77277fbae414bf43e66ce,Christian Brabandt,87,3,90,6,"{""runtime/doc/options.txt"": {""insertions"": 1, ""deletions"": 0, ""lines"": 1}, ""src/indent.c"": {""insertions"": 14, ""deletions"": 3, ""lines"": 17}, ""src/option.c"": {""insertions"": 12, ""deletions"": 0, ""lines"": 12}, ""src/proto/option.pro"": {""insertions"": 1, ""deletions"": 0, ""lines"": 1}, ""src/testdir/test_breakindent.vim"": {""insertions"": 57, ""deletions"": 0, ""lines"": 57}, ""src/version.c"": {""insertions"": 2, ""deletions"": 0, ""lines"": 2}}"
2022-01-14 21:28:59,ece07639f4989a300276d66b13553c21a7435030,ichizok,3,0,3,2,"{"".github/workflows/ci.yml"": {""insertions"": 1, ""deletions"": 0, ""lines"": 1}, ""src/version.c"": {""insertions"": 2, ""deletions"": 0, ""lines"": 2}}"
2022-01-14 20:11:38,0f112052acaeffd75b7eb001eeb8a246ad12a276,zeertzjq,12,9,21,3,"{""src/buffer.c"": {""insertions"": 1, ""deletions"": 9, ""lines"": 10}, ""src/testdir/test_statusline.vim"": {""insertions"": 9, ""deletions"": 0, ""lines"": 9}, ""src/version.c"": {""insertions"": 2, ""deletions"": 0, ""lines"": 2}}"
2022-01-14 13:19:43,26ebf1f036517ebeacf571c333a83cca7e13bbe2,Evgeni Chasnovski,54,24,78,3,"{""src/session.c"": {""insertions"": 27, ""deletions"": 24, ""lines"": 51}, ""src/testdir/test_mksession.vim"": {""insertions"": 25, ""deletions"": 0, ""lines"": 25}, ""src/version.c"": {""insertions"": 2, ""deletions"": 0, ""lines"": 2}}"
2022-01-14 12:06:47,7bfa6d698e7a9f586251d53cd092ad6e8110e045,Bram Moolenaar,4,0,4,2,"{""src/testdir/test_terminal3.vim"": {""insertions"": 2, ""deletions"": 0, ""lines"": 2}, ""src/version.c"": {""insertions"": 2, ""deletions"": 0, ""lines"": 2}}"
2022-01-14 11:58:48,c0a1d370fa655cea9eaa74f5e605b95825dc9de1,Erik Auerswald,44,9,53,5,"{""runtime/doc/xxd.1"": {""insertions"": 1, ""deletions"": 0, ""lines"": 1}, ""runtime/doc/xxd.man"": {""insertions"": 2, ""deletions"": 1, ""lines"": 3}, ""src/testdir/test_xxd.vim"": {""insertions"": 25, ""deletions"": 1, ""lines"": 26}, ""src/version.c"": {""insertions"": 2, ""deletions"": 0, ""lines"": 2}, ""src/xxd/xxd.c"": {""insertions"": 14, ""deletions"": 7, ""lines"": 21}}"
2022-01-13 22:05:09,3e4fa3d7d37162cd08fc0c6e83f52fd323f63eba,Bram Moolenaar,53,7,60,6,"{""runtime/doc/testing.txt"": {""insertions"": 9, ""deletions"": 7, ""lines"": 16}, ""src/globals.h"": {""insertions"": 1, ""deletions"": 0, ""lines"": 1}, ""src/testdir/test_vim9_import.vim"": {""insertions"": 36, ""deletions"": 0, ""lines"": 36}, ""src/testing.c"": {""insertions"": 2, ""deletions"": 0, ""lines"": 2}, ""src/version.c"": {""insertions"": 2, ""deletions"": 0, ""lines"": 2}, ""src/vim9script.c"": {""insertions"": 3, ""deletions"": 0, ""lines"": 3}}"
2022-01-13 21:15:21,d9d2fd0aa33dd9f7460d6f1e403505a60f7ce2fc,Bram Moolenaar,43,41,84,12,"{""src/evalfunc.c"": {""insertions"": 2, ""deletions"": 2, ""lines"": 4}, ""src/evalvars.c"": {""insertions"": 2, ""deletions"": 2, ""lines"": 4}, ""src/proto/userfunc.pro"": {""insertions"": 2, ""deletions"": 2, ""lines"": 4}, ""src/testing.c"": {""insertions"": 1, ""deletions"": 1, ""lines"": 2}, ""src/userfunc.c"": {""insertions"": 19, ""deletions"": 19, ""lines"": 38}, ""src/version.c"": {""insertions"": 2, ""deletions"": 0, ""lines"": 2}, ""src/vim9compile.c"": {""insertions"": 2, ""deletions"": 2, ""lines"": 4}, ""src/vim9execute.c"": {""insertions"": 5, ""deletions"": 5, ""lines"": 10}, ""src/vim9expr.c"": {""insertions"": 4, ""deletions"": 4, ""lines"": 8}, ""src/vim9instr.c"": {""insertions"": 1, ""deletions"": 1, ""lines"": 2}, ""src/vim9script.c"": {""insertions"": 2, ""deletions"": 2, ""lines"": 4}, ""src/vim9type.c"": {""insertions"": 1, ""deletions"": 1, ""lines"": 2}}"
2022-01-13 20:51:56,c43e6235c7b3e64f81c6a4e294e4e47abf7a869a,Bram Moolenaar,39,9,48,2,"{""src/testdir/test_vim9_import.vim"": {""insertions"": 37, ""deletions"": 9, ""lines"": 46}, ""src/version.c"": {""insertions"": 2, ""deletions"": 0, ""lines"": 2}}"
2022-01-13 20:39:41,130f65d46bca94535d30cef518a6184613fb7ebf,Bram Moolenaar,3,1,4,2,"{""src/evalvars.c"": {""insertions"": 1, ""deletions"": 1, ""lines"": 2}, ""src/version.c"": {""insertions"": 2, ""deletions"": 0, ""lines"": 2}}"
2022-01-13 20:18:56,0e3e7ba05fa9cebe17d38def97ecd38a987d02ec,Bram Moolenaar,41,7,48,3,"{""src/evalvars.c"": {""insertions"": 27, ""deletions"": 1, ""lines"": 28}, ""src/testdir/test_vim9_import.vim"": {""insertions"": 12, ""deletions"": 6, ""lines"": 18}, ""src/version.c"": {""insertions"": 2, ""deletions"": 0, ""lines"": 2}}"
2022-01-13 19:25:50,3049fcf0a189b0fea8468fa308887b8252d93dce,Bram Moolenaar,31,0,31,3,"{""src/scriptfile.c"": {""insertions"": 4, ""deletions"": 0, ""lines"": 4}, ""src/testdir/test_vim9_import.vim"": {""insertions"": 25, ""deletions"": 0, ""lines"": 25}, ""src/version.c"": {""insertions"": 2, ""deletions"": 0, ""lines"": 2}}"
2022-01-13 18:09:11,4050305bfd24e7d0e241f617519bd0fa86263b9a,ichizok,82,95,177,9,"{""Filelist"": {""insertions"": 0, ""deletions"": 1, ""lines"": 1}, ""src/Make_cyg_ming.mak"": {""insertions"": 1, ""deletions"": 1, ""lines"": 2}, ""src/Make_mvc.mak"": {""insertions"": 1, ""deletions"": 1, ""lines"": 2}, ""src/Make_vms.mms"": {""insertions"": 1, ""deletions"": 1, ""lines"": 2}, ""src/Makefile"": {""insertions"": 1, ""deletions"": 1, ""lines"": 2}, ""src/if_cscope.c"": {""insertions"": 75, ""deletions"": 18, ""lines"": 93}, ""src/if_cscope.h"": {""insertions"": 0, ""deletions"": 71, ""lines"": 71}, ""src/testdir/test_cscope.vim"": {""insertions"": 1, ""deletions"": 1, ""lines"": 2}, ""src/version.c"": {""insertions"": 2, ""deletions"": 0, ""lines"": 2}}"
2022-01-13 17:42:28,a00e622a294b10671ee78216dcd21169a2b884cf,Erik Auerswald,55,3,58,2,"{""src/testdir/test_xxd.vim"": {""insertions"": 53, ""deletions"": 3, ""lines"": 56}, ""src/version.c"": {""insertions"": 2, ""deletions"": 0, ""lines"": 2}}"
2022-01-13 16:06:45,33b25d1317e4c06ec6b1cafb46ea9cde475a61ae,K.Takata,3,1,4,2,"{""src/main.c"": {""insertions"": 1, ""deletions"": 1, ""lines"": 2}, ""src/version.c"": {""insertions"": 2, ""deletions"": 0, ""lines"": 2}}"
2022-01-13 15:25:32,ced2b38a560cc4f4ec983ed2cf4372ab62e1dbc1,Bram Moolenaar,12,27,39,6,"{""src/testdir/term_util.vim"": {""insertions"": 5, ""deletions"": 0, ""lines"": 5}, ""src/testdir/test_mapping.vim"": {""insertions"": 0, ""deletions"": 1, ""lines"": 1}, ""src/testdir/test_terminal.vim"": {""insertions"": 0, ""deletions"": 12, ""lines"": 12}, ""src/testdir/test_terminal2.vim"": {""insertions"": 0, ""deletions"": 7, ""lines"": 7}, ""src/testdir/test_terminal3.vim"": {""insertions"": 5, ""deletions"": 7, ""lines"": 12}, ""src/version.c"": {""insertions"": 2, ""deletions"": 0, ""lines"": 2}}"
2022-01-13 14:49:10,8d9e470aa91a93da7d6bda62521aef69a79e956d,Bram Moolenaar,6,1,7,3,"{""runtime/filetype.vim"": {""insertions"": 3, ""deletions"": 0, ""lines"": 3}, ""src/testdir/test_filetype.vim"": {""insertions"": 1, ""deletions"": 1, ""lines"": 2}, ""src/version.c"": {""insertions"": 2, ""deletions"": 0, ""lines"": 2}}"
2022-01-13 13:47:43,71930f174d47ef7765e9180df58f597cec71dec7,Bram Moolenaar,4,1,5,2,"{""src/version.c"": {""insertions"": 2, ""deletions"": 0, ""lines"": 2}, ""src/vim9script.c"": {""insertions"": 2, ""deletions"": 1, ""lines"": 3}}"
2022-01-13 13:24:34,78a70533c3707aa50cbf998c7807221945aa9787,Bram Moolenaar,3,3,6,2,"{""src/userfunc.c"": {""insertions"": 1, ""deletions"": 3, ""lines"": 4}, ""src/version.c"": {""insertions"": 2, ""deletions"": 0, ""lines"": 2}}"
2022-01-13 13:08:14,de05bb25733c3319e18dca44e9b59c6ee389eb26,Bram Moolenaar,22,4,26,3,"{""src/drawscreen.c"": {""insertions"": 5, ""deletions"": 4, ""lines"": 9}, ""src/testdir/test_edit.vim"": {""insertions"": 15, ""deletions"": 0, ""lines"": 15}, ""src/version.c"": {""insertions"": 2, ""deletions"": 0, ""lines"": 2}}"
2022-01-13 12:05:09,54598066ca4cfaf0761aedf47e4ba9844674791e,Bram Moolenaar,6,4,10,2,"{""src/userfunc.c"": {""insertions"": 4, ""deletions"": 4, ""lines"": 8}, ""src/version.c"": {""insertions"": 2, ""deletions"": 0, ""lines"": 2}}"
2022-01-12 19:54:00,d041f4208b0a2149e9d41f6443aa1c14c076a411,Bram Moolenaar,83,4,87,6,"{""src/testdir/test_vim9_import.vim"": {""insertions"": 36, ""deletions"": 0, ""lines"": 36}, ""src/version.c"": {""insertions"": 2, ""deletions"": 0, ""lines"": 2}, ""src/vim9execute.c"": {""insertions"": 10, ""deletions"": 0, ""lines"": 10}, ""src/vim9expr.c"": {""insertions"": 23, ""deletions"": 1, ""lines"": 24}, ""src/vim9instr.c"": {""insertions"": 2, ""deletions"": 2, ""lines"": 4}, ""src/vim9script.c"": {""insertions"": 10, ""deletions"": 1, ""lines"": 11}}"
2022-01-12 16:18:18,53c296112edd8471eb63afbca03f96bad164c813,Bram Moolenaar,73,2,75,5,"{""src/testdir/test_vim9_script.vim"": {""insertions"": 58, ""deletions"": 1, ""lines"": 59}, ""src/version.c"": {""insertions"": 2, ""deletions"": 0, ""lines"": 2}, ""src/vim9.h"": {""insertions"": 2, ""deletions"": 0, ""lines"": 2}, ""src/vim9cmds.c"": {""insertions"": 11, ""deletions"": 0, ""lines"": 11}, ""src/vim9compile.c"": {""insertions"": 0, ""deletions"": 1, ""lines"": 1}}"
2022-01-12 15:24:40,f5d639a8af719eb8ecb141b5c0890627e4d83134,Dominique Pelle,10,1,11,3,"{""src/filepath.c"": {""insertions"": 1, ""deletions"": 1, ""lines"": 2}, ""src/testdir/test_eval_stuff.vim"": {""insertions"": 7, ""deletions"": 0, ""lines"": 7}, ""src/version.c"": {""insertions"": 2, ""deletions"": 0, ""lines"": 2}}"
2022-01-12 15:15:27,5d9826973d9f4c6ffbb5648676bb628660c62906,Bram Moolenaar,8,6,14,4,"{""src/eval.c"": {""insertions"": 2, ""deletions"": 2, ""lines"": 4}, ""src/scriptfile.c"": {""insertions"": 1, ""deletions"": 1, ""lines"": 2}, ""src/testdir/test_vim9_import.vim"": {""insertions"": 3, ""deletions"": 3, ""lines"": 6}, ""src/version.c"": {""insertions"": 2, ""deletions"": 0, ""lines"": 2}}"
2022-01-12 12:54:55,f479cac084c7ddd9f20944c8978d39f3ef092868,Bram Moolenaar,4,1,5,2,"{""src/scriptfile.c"": {""insertions"": 2, ""deletions"": 1, ""lines"": 3}, ""src/version.c"": {""insertions"": 2, ""deletions"": 0, ""lines"": 2}}"
2022-01-12 12:48:17,f111cdfae6edf697390e0d9a85082a6526b03da6,Bram Moolenaar,55,0,55,3,"{""src/testdir/test_vim9_import.vim"": {""insertions"": 29, ""deletions"": 0, ""lines"": 29}, ""src/userfunc.c"": {""insertions"": 24, ""deletions"": 0, ""lines"": 24}, ""src/version.c"": {""insertions"": 2, ""deletions"": 0, ""lines"": 2}}"
2022-01-12 11:46:40,17d36cbcd36d944c744ef68afa971718959b2111,Bram Moolenaar,29,13,42,4,"{""src/testdir/test_vim9_import.vim"": {""insertions"": 8, ""deletions"": 3, ""lines"": 11}, ""src/version.c"": {""insertions"": 2, ""deletions"": 0, ""lines"": 2}, ""src/vim9compile.c"": {""insertions"": 3, ""deletions"": 1, ""lines"": 4}, ""src/vim9script.c"": {""insertions"": 16, ""deletions"": 9, ""lines"": 25}}"
2022-01-11 19:34:16,3cf21b305104e91a28e4ce3a473672b2e88a9469,Bram Moolenaar,12,2,14,3,"{""src/ex_docmd.c"": {""insertions"": 4, ""deletions"": 1, ""lines"": 5}, ""src/testdir/test_excmd.vim"": {""insertions"": 6, ""deletions"": 1, ""lines"": 7}, ""src/version.c"": {""insertions"": 2, ""deletions"": 0, ""lines"": 2}}"
2022-01-11 18:14:23,2284f6cca384e0ccc352bfec7277dc26386cac3d,Elwardi,72,0,72,4,"{""runtime/autoload/dist/ft.vim"": {""insertions"": 17, ""deletions"": 0, ""lines"": 17}, ""runtime/filetype.vim"": {""insertions"": 3, ""deletions"": 0, ""lines"": 3}, ""src/testdir/test_filetype.vim"": {""insertions"": 50, ""deletions"": 0, ""lines"": 50}, ""src/version.c"": {""insertions"": 2, ""deletions"": 0, ""lines"": 2}}"
2022-01-11 15:24:05,b8822442d716df0230c79531132e530e95cc17e3,Bram Moolenaar,55,7,62,3,"{""src/testdir/test_vim9_import.vim"": {""insertions"": 4, ""deletions"": 4, ""lines"": 8}, ""src/userfunc.c"": {""insertions"": 49, ""deletions"": 3, ""lines"": 52}, ""src/version.c"": {""insertions"": 2, ""deletions"": 0, ""lines"": 2}}"
2022-01-11 13:14:54,0bbca540f7377889e2154aa5731f6eeffcb5c0cc,Bram Moolenaar,33,2,35,4,"{""src/drawline.c"": {""insertions"": 3, ""deletions"": 2, ""lines"": 5}, ""src/testdir/dumps/Test_match_tab_linebreak.dump"": {""insertions"": 10, ""deletions"": 0, ""lines"": 10}, ""src/testdir/test_match.vim"": {""insertions"": 18, ""deletions"": 0, ""lines"": 18}, ""src/version.c"": {""insertions"": 2, ""deletions"": 0, ""lines"": 2}}"
2022-01-11 13:05:26,0d47ad40274ed9c7ace636b2a4063182c905a2b4,ichizok,35,27,62,2,"{"".github/workflows/ci.yml"": {""insertions"": 33, ""deletions"": 27, ""lines"": 60}, ""src/version.c"": {""insertions"": 2, ""deletions"": 0, ""lines"": 2}}"
2022-01-11 12:37:20,d6f27c66cca32b93fcf8024b1bad1618946bbbea,Bram Moolenaar,17,2,19,2,"{""src/evalwindow.c"": {""insertions"": 15, ""deletions"": 2, ""lines"": 17}, ""src/version.c"": {""insertions"": 2, ""deletions"": 0, ""lines"": 2}}"
2022-01-11 11:58:19,19db9e6ba710ca32f0f5e0c2ca2ba69f8228b833,Bram Moolenaar,58,9,67,5,"{""src/getchar.c"": {""insertions"": 1, ""deletions"": 5, ""lines"": 6}, ""src/map.c"": {""insertions"": 16, ""deletions"": 3, ""lines"": 19}, ""src/proto/map.pro"": {""insertions"": 1, ""deletions"": 1, ""lines"": 2}, ""src/testdir/test_vim9_import.vim"": {""insertions"": 38, ""deletions"": 0, ""lines"": 38}, ""src/version.c"": {""insertions"": 2, ""deletions"": 0, ""lines"": 2}}"
2022-01-10 21:39:03,762838218feb223f53ab87d80928dadd991a1746,Bram Moolenaar,3,1,4,2,"{""src/testdir/test_vim9_import.vim"": {""insertions"": 1, ""deletions"": 1, ""lines"": 2}, ""src/version.c"": {""insertions"": 2, ""deletions"": 0, ""lines"": 2}}"
2022-01-10 21:29:57,160aa86a9d5f4b99437bf48ef16400de33bf2f50,Bram Moolenaar,248,177,425,4,"{""src/testdir/test_vim9_import.vim"": {""insertions"": 245, ""deletions"": 0, ""lines"": 245}, ""src/testdir/test_vim9_script.vim"": {""insertions"": 0, ""deletions"": 176, ""lines"": 176}, ""src/version.c"": {""insertions"": 2, ""deletions"": 0, ""lines"": 2}, ""src/vim9script.c"": {""insertions"": 1, ""deletions"": 1, ""lines"": 2}}"
2022-01-10 19:21:06,6990b78f253eb7f3ebd296fd5c8353e3da1cc8f2,Bram Moolenaar,3,0,3,2,"{""src/scriptfile.c"": {""insertions"": 1, ""deletions"": 0, ""lines"": 1}, ""src/version.c"": {""insertions"": 2, ""deletions"": 0, ""lines"": 2}}"
2022-01-10 18:50:52,5e6b9882fe0218ae4878f6ad0561c8654a2277d8,Bram Moolenaar,26,3,29,3,"{""src/testdir/test_vim9_expr.vim"": {""insertions"": 16, ""deletions"": 0, ""lines"": 16}, ""src/userfunc.c"": {""insertions"": 8, ""deletions"": 3, ""lines"": 11}, ""src/version.c"": {""insertions"": 2, ""deletions"": 0, ""lines"": 2}}"
2022-01-10 18:42:52,577bd85d55f30019c890ec80fd44d91108ec35c9,Bram Moolenaar,14,0,14,2,"{""src/version.c"": {""insertions"": 2, ""deletions"": 0, ""lines"": 2}, ""src/vim9compile.c"": {""insertions"": 12, ""deletions"": 0, ""lines"": 12}}"
2022-01-10 18:08:00,fe2ef0b2cda0b25c45bd9e320f8b77931ee8ef2e,Bram Moolenaar,139,52,191,9,"{""src/evalvars.c"": {""insertions"": 38, ""deletions"": 11, ""lines"": 49}, ""src/proto/scriptfile.pro"": {""insertions"": 1, ""deletions"": 0, ""lines"": 1}, ""src/proto/vim9script.pro"": {""insertions"": 1, ""deletions"": 1, ""lines"": 2}, ""src/scriptfile.c"": {""insertions"": 53, ""deletions"": 26, ""lines"": 79}, ""src/structs.h"": {""insertions"": 3, ""deletions"": 1, ""lines"": 4}, ""src/testdir/test_vim9_script.vim"": {""insertions"": 8, ""deletions"": 0, ""lines"": 8}, ""src/userfunc.c"": {""insertions"": 5, ""deletions"": 2, ""lines"": 7}, ""src/version.c"": {""insertions"": 2, ""deletions"": 0, ""lines"": 2}, ""src/vim9script.c"": {""insertions"": 28, ""deletions"": 11, ""lines"": 39}}"
2022-01-10 13:36:34,ee63031b572eb7aea27be4c7e3dafba0daaf681b,Daniel Steinberg,189,0,189,7,"{""runtime/doc/builtin.txt"": {""insertions"": 31, ""deletions"": 0, ""lines"": 31}, ""runtime/doc/usr_41.txt"": {""insertions"": 2, ""deletions"": 0, ""lines"": 2}, ""src/evalfunc.c"": {""insertions"": 4, ""deletions"": 0, ""lines"": 4}, ""src/evalwindow.c"": {""insertions"": 50, ""deletions"": 0, ""lines"": 50}, ""src/proto/evalwindow.pro"": {""insertions"": 2, ""deletions"": 0, ""lines"": 2}, ""src/testdir/test_window_cmd.vim"": {""insertions"": 98, ""deletions"": 0, ""lines"": 98}, ""src/version.c"": {""insertions"": 2, ""deletions"": 0, ""lines"": 2}}"
2022-01-10 11:26:33,b06cfcf5a3b0248527fd70f9323272aa96db2f56,Bram Moolenaar,7,3,10,2,"{""src/scriptfile.c"": {""insertions"": 5, ""deletions"": 3, ""lines"": 8}, ""src/version.c"": {""insertions"": 2, ""deletions"": 0, ""lines"": 2}}"
2022-01-09 21:36:37,dc4451df61a6aa12a0661817b7094fb32f09e11d,Bram Moolenaar,403,118,521,15,"{""runtime/doc/repeat.txt"": {""insertions"": 2, ""deletions"": 1, ""lines"": 3}, ""runtime/doc/vim9.txt"": {""insertions"": 26, ""deletions"": 20, ""lines"": 46}, ""src/errors.h"": {""insertions"": 4, ""deletions"": 0, ""lines"": 4}, ""src/eval.c"": {""insertions"": 3, ""deletions"": 1, ""lines"": 4}, ""src/evalvars.c"": {""insertions"": 3, ""deletions"": 3, ""lines"": 6}, ""src/proto/scriptfile.pro"": {""insertions"": 3, ""deletions"": 0, ""lines"": 3}, ""src/proto/vim9compile.pro"": {""insertions"": 1, ""deletions"": 1, ""lines"": 2}, ""src/scriptfile.c"": {""insertions"": 218, ""deletions"": 60, ""lines"": 278}, ""src/structs.h"": {""insertions"": 4, ""deletions"": 1, ""lines"": 5}, ""src/testdir/test_vim9_script.vim"": {""insertions"": 20, ""deletions"": 0, ""lines"": 20}, ""src/userfunc.c"": {""insertions"": 5, ""deletions"": 2, ""lines"": 7}, ""src/version.c"": {""insertions"": 2, ""deletions"": 0, ""lines"": 2}, ""src/vim9compile.c"": {""insertions"": 21, ""deletions"": 6, ""lines"": 27}, ""src/vim9expr.c"": {""insertions"": 3, ""deletions"": 2, ""lines"": 5}, ""src/vim9script.c"": {""insertions"": 88, ""deletions"": 21, ""lines"": 109}}"
2022-01-09 13:36:28,5f25c3855071bd7e26255c68bf458b1b5cf92f39,Bram Moolenaar,4,1,5,3,"{""src/testdir/test_vim9_expr.vim"": {""insertions"": 1, ""deletions"": 0, ""lines"": 1}, ""src/version.c"": {""insertions"": 2, ""deletions"": 0, ""lines"": 2}, ""src/vim9expr.c"": {""insertions"": 1, ""deletions"": 1, ""lines"": 2}}"
2022-01-09 12:57:48,c14f667626ba677a767d474324306e39096dc43e,Dominique Pelle,8,6,14,2,"{""src/if_py_both.h"": {""insertions"": 6, ""deletions"": 6, ""lines"": 12}, ""src/version.c"": {""insertions"": 2, ""deletions"": 0, ""lines"": 2}}"
2022-01-09 12:49:31,f85a424c832777892c4efaff163c2fa710ce8d91,Dominique Pelle,341,35,376,2,"{""src/errors.h"": {""insertions"": 339, ""deletions"": 35, ""lines"": 374}, ""src/version.c"": {""insertions"": 2, ""deletions"": 0, ""lines"": 2}}"
2022-01-08 21:51:59,2f0936cb9a2eb026acac03e6a8fd0b2a5d97508b,Bram Moolenaar,341,280,621,38,"{""runtime/doc/builtin.txt"": {""insertions"": 13, ""deletions"": 8, ""lines"": 21}, ""runtime/doc/cmdline.txt"": {""insertions"": 5, ""deletions"": 3, ""lines"": 8}, ""runtime/doc/editing.txt"": {""insertions"": 1, ""deletions"": 1, ""lines"": 2}, ""runtime/doc/eval.txt"": {""insertions"": 17, ""deletions"": 16, ""lines"": 33}, ""runtime/doc/helphelp.txt"": {""insertions"": 2, ""deletions"": 2, ""lines"": 4}, ""runtime/doc/if_cscop.txt"": {""insertions"": 2, ""deletions"": 2, ""lines"": 4}, ""runtime/doc/if_perl.txt"": {""insertions"": 1, ""deletions"": 2, ""lines"": 3}, ""runtime/doc/if_tcl.txt"": {""insertions"": 2, ""deletions"": 2, ""lines"": 4}, ""runtime/doc/indent.txt"": {""insertions"": 2, ""deletions"": 2, ""lines"": 4}, ""runtime/doc/insert.txt"": {""insertions"": 2, ""deletions"": 2, ""lines"": 4}, ""runtime/doc/map.txt"": {""insertions"": 3, ""deletions"": 4, ""lines"": 7}, ""runtime/doc/mbyte.txt"": {""insertions"": 3, ""deletions"": 3, ""lines"": 6}, ""runtime/doc/message.txt"": {""insertions"": 8, ""deletions"": 6, ""lines"": 14}, ""runtime/doc/options.txt"": {""insertions"": 8, ""deletions"": 6, ""lines"": 14}, ""runtime/doc/os_dos.txt"": {""insertions"": 6, ""deletions"": 6, ""lines"": 12}, ""runtime/doc/pattern.txt"": {""insertions"": 14, ""deletions"": 13, ""lines"": 27}, ""runtime/doc/popup.txt"": {""insertions"": 3, ""deletions"": 3, ""lines"": 6}, ""runtime/doc/quickfix.txt"": {""insertions"": 2, ""deletions"": 2, ""lines"": 4}, ""runtime/doc/starting.txt"": {""insertions"": 3, ""deletions"": 1, ""lines"": 4}, ""runtime/doc/syntax.txt"": {""insertions"": 2, ""deletions"": 2, ""lines"": 4}, ""runtime/doc/tags"": {""insertions"": 17, ""deletions"": 3, ""lines"": 20}, ""runtime/doc/terminal.txt"": {""insertions"": 1, ""deletions"": 0, ""lines"": 1}, ""runtime/doc/todo.txt"": {""insertions"": 16, ""deletions"": 4, ""lines"": 20}, ""runtime/doc/usr_06.txt"": {""insertions"": 2, ""deletions"": 2, ""lines"": 4}, ""runtime/doc/usr_40.txt"": {""insertions"": 2, ""deletions"": 2, ""lines"": 4}, ""runtime/doc/usr_41.txt"": {""insertions"": 6, ""deletions"": 6, ""lines"": 12}, ""runtime/doc/various.txt"": {""insertions"": 3, ""deletions"": 3, ""lines"": 6}, ""runtime/doc/vim9.txt"": {""insertions"": 32, ""deletions"": 15, ""lines"": 47}, ""runtime/doc/windows.txt"": {""insertions"": 6, ""deletions"": 2, ""lines"": 8}, ""runtime/filetype.vim"": {""insertions"": 1, ""deletions"": 1, ""lines"": 2}, ""runtime/ftplugin/git.vim"": {""insertions"": 0, ""deletions"": 41, ""lines"": 41}, ""runtime/ftplugin/gitcommit.vim"": {""insertions"": 19, ""deletions"": 28, ""lines"": 47}, ""runtime/ftplugin/gitrebase.vim"": {""insertions"": 6, ""deletions"": 9, ""lines"": 15}, ""runtime/pack/dist/opt/termdebug/plugin/termdebug.vim"": {""insertions"": 5, ""deletions"": 5, ""lines"": 10}, ""runtime/syntax/git.vim"": {""insertions"": 62, ""deletions"": 31, ""lines"": 93}, ""runtime/syntax/gitcommit.vim"": {""insertions"": 51, ""deletions"": 35, ""lines"": 86}, ""runtime/syntax/gitrebase.vim"": {""insertions"": 10, ""deletions"": 5, ""lines"": 15}, ""runtime/syntax/i3config.vim"": {""insertions"": 3, ""deletions"": 2, ""lines"": 5}}"
2022-01-08 21:38:52,b2810f123cbf4b585f8bc5f0e594a6690d95729a,Bram Moolenaar,13,4,17,4,"{""src/errors.h"": {""insertions"": 9, ""deletions"": 2, ""lines"": 11}, ""src/regexp_bt.c"": {""insertions"": 1, ""deletions"": 1, ""lines"": 2}, ""src/typval.c"": {""insertions"": 1, ""deletions"": 1, ""lines"": 2}, ""src/version.c"": {""insertions"": 2, ""deletions"": 0, ""lines"": 2}}"
2022-01-08 18:43:40,782b43d89473dac00e3a8e02224a8330b88dbfef,Yegappan Lakshmanan,111,113,224,11,"{""src/ex_getln.c"": {""insertions"": 20, ""deletions"": 18, ""lines"": 38}, ""src/highlight.c"": {""insertions"": 17, ""deletions"": 14, ""lines"": 31}, ""src/proto/ex_getln.pro"": {""insertions"": 0, ""deletions"": 1, ""lines"": 1}, ""src/proto/highlight.pro"": {""insertions"": 0, ""deletions"": 3, ""lines"": 3}, ""src/proto/vim9compile.pro"": {""insertions"": 0, ""deletions"": 1, ""lines"": 1}, ""src/proto/vim9instr.pro"": {""insertions"": 0, ""deletions"": 3, ""lines"": 3}, ""src/proto/window.pro"": {""insertions"": 0, ""deletions"": 1, ""lines"": 1}, ""src/version.c"": {""insertions"": 2, ""deletions"": 0, ""lines"": 2}, ""src/vim9compile.c"": {""insertions"": 21, ""deletions"": 21, ""lines"": 42}, ""src/vim9instr.c"": {""insertions"": 3, ""deletions"": 3, ""lines"": 6}, ""src/window.c"": {""insertions"": 48, ""deletions"": 48, ""lines"": 96}}"
2022-01-08 17:03:55,7c24dfddc28776eeff7464982ae5b94e187b6135,Bram Moolenaar,51,31,82,4,"{""src/errors.h"": {""insertions"": 2, ""deletions"": 0, ""lines"": 2}, ""src/testdir/test_vim9_import.vim"": {""insertions"": 21, ""deletions"": 19, ""lines"": 40}, ""src/version.c"": {""insertions"": 2, ""deletions"": 0, ""lines"": 2}, ""src/vim9script.c"": {""insertions"": 26, ""deletions"": 12, ""lines"": 38}}"
2022-01-08 16:19:22,04935fb17e5f0f66b82cf4546b9752d3d1fa650e,Bram Moolenaar,69,67,136,36,"{""src/arglist.c"": {""insertions"": 2, ""deletions"": 2, ""lines"": 4}, ""src/channel.c"": {""insertions"": 1, ""deletions"": 1, ""lines"": 2}, ""src/cmdexpand.c"": {""insertions"": 3, ""deletions"": 3, ""lines"": 6}, ""src/dict.c"": {""insertions"": 1, ""deletions"": 1, ""lines"": 2}, ""src/digraph.c"": {""insertions"": 1, ""deletions"": 1, ""lines"": 2}, ""src/eval.c"": {""insertions"": 1, ""deletions"": 1, ""lines"": 2}, ""src/evalfunc.c"": {""insertions"": 1, ""deletions"": 1, ""lines"": 2}, ""src/evalvars.c"": {""insertions"": 1, ""deletions"": 1, ""lines"": 2}, ""src/evalwindow.c"": {""insertions"": 1, ""deletions"": 1, ""lines"": 2}, ""src/ex_docmd.c"": {""insertions"": 1, ""deletions"": 1, ""lines"": 2}, ""src/fileio.c"": {""insertions"": 1, ""deletions"": 1, ""lines"": 2}, ""src/filepath.c"": {""insertions"": 2, ""deletions"": 2, ""lines"": 4}, ""src/findfile.c"": {""insertions"": 2, ""deletions"": 2, ""lines"": 4}, ""src/fold.c"": {""insertions"": 3, ""deletions"": 3, ""lines"": 6}, ""src/hardcopy.c"": {""insertions"": 2, ""deletions"": 2, ""lines"": 4}, ""src/help.c"": {""insertions"": 1, ""deletions"": 1, ""lines"": 2}, ""src/if_py_both.h"": {""insertions"": 1, ""deletions"": 1, ""lines"": 2}, ""src/job.c"": {""insertions"": 2, ""deletions"": 2, ""lines"": 4}, ""src/list.c"": {""insertions"": 3, ""deletions"": 3, ""lines"": 6}, ""src/menu.c"": {""insertions"": 1, ""deletions"": 1, ""lines"": 2}, ""src/os_win32.c"": {""insertions"": 1, ""deletions"": 1, ""lines"": 2}, ""src/register.c"": {""insertions"": 1, ""deletions"": 1, ""lines"": 2}, ""src/scriptfile.c"": {""insertions"": 3, ""deletions"": 3, ""lines"": 6}, ""src/spellfile.c"": {""insertions"": 6, ""deletions"": 6, ""lines"": 12}, ""src/spellsuggest.c"": {""insertions"": 3, ""deletions"": 3, ""lines"": 6}, ""src/strings.c"": {""insertions"": 2, ""deletions"": 2, ""lines"": 4}, ""src/syntax.c"": {""insertions"": 2, ""deletions"": 2, ""lines"": 4}, ""src/tag.c"": {""insertions"": 2, ""deletions"": 2, ""lines"": 4}, ""src/terminal.c"": {""insertions"": 4, ""deletions"": 4, ""lines"": 8}, ""src/undo.c"": {""insertions"": 1, ""deletions"": 1, ""lines"": 2}, ""src/usercmd.c"": {""insertions"": 1, ""deletions"": 1, ""lines"": 2}, ""src/userfunc.c"": {""insertions"": 7, ""deletions"": 7, ""lines"": 14}, ""src/version.c"": {""insertions"": 2, ""deletions"": 0, ""lines"": 2}, ""src/vim9execute.c"": {""insertions"": 1, ""deletions"": 1, ""lines"": 2}, ""src/viminfo.c"": {""insertions"": 1, ""deletions"": 1, ""lines"": 2}, ""src/window.c"": {""insertions"": 1, ""deletions"": 1, ""lines"": 2}}"
2022-01-08 16:02:59,143367256836b0f69881dc0c65ff165ae091dbc5,Bram Moolenaar,7,4,11,2,"{""src/version.c"": {""insertions"": 2, ""deletions"": 0, ""lines"": 2}, ""src/vim9execute.c"": {""insertions"": 5, ""deletions"": 4, ""lines"": 9}}"
2022-01-08 15:44:22,aa9b3cacd52a6c34591bbd89fb6b06d4c097fe03,Bram Moolenaar,6,0,6,2,"{""src/evalvars.c"": {""insertions"": 4, ""deletions"": 0, ""lines"": 4}, ""src/version.c"": {""insertions"": 2, ""deletions"": 0, ""lines"": 2}}"
2022-01-08 15:39:39,9f1a39a5d1cd7989ada2d1cb32f97d84360e050f,Bram Moolenaar,82,47,129,10,"{""src/alloc.c"": {""insertions"": 15, ""deletions"": 2, ""lines"": 17}, ""src/message.c"": {""insertions"": 1, ""deletions"": 1, ""lines"": 2}, ""src/proto/alloc.pro"": {""insertions"": 2, ""deletions"": 1, ""lines"": 3}, ""src/proto/userfunc.pro"": {""insertions"": 1, ""deletions"": 1, ""lines"": 2}, ""src/testdir/test_vim9_func.vim"": {""insertions"": 15, ""deletions"": 1, ""lines"": 16}, ""src/usercmd.c"": {""insertions"": 2, ""deletions"": 2, ""lines"": 4}, ""src/userfunc.c"": {""insertions"": 32, ""deletions"": 30, ""lines"": 62}, ""src/version.c"": {""insertions"": 2, ""deletions"": 0, ""lines"": 2}, ""src/vim9compile.c"": {""insertions"": 10, ""deletions"": 7, ""lines"": 17}, ""src/viminfo.c"": {""insertions"": 2, ""deletions"": 2, ""lines"": 4}}"
2022-01-08 13:36:57,67ffb417861a90fd2c1b215a42fd230272ed94cb,Bram Moolenaar,32,2,34,6,"{""src/Makefile"": {""insertions"": 1, ""deletions"": 1, ""lines"": 2}, ""src/auto/configure"": {""insertions"": 15, ""deletions"": 0, ""lines"": 15}, ""src/config.mk.in"": {""insertions"": 2, ""deletions"": 0, ""lines"": 2}, ""src/configure.ac"": {""insertions"": 10, ""deletions"": 0, ""lines"": 10}, ""src/feature.h"": {""insertions"": 2, ""deletions"": 1, ""lines"": 3}, ""src/version.c"": {""insertions"": 2, ""deletions"": 0, ""lines"": 2}}"
2022-01-08 12:41:16,748b308eebe8d8860888eb27da08333f175d547d,Dominique Pelle,126,74,200,35,"{""src/alloc.c"": {""insertions"": 6, ""deletions"": 0, ""lines"": 6}, ""src/buffer.c"": {""insertions"": 6, ""deletions"": 0, ""lines"": 6}, ""src/charset.c"": {""insertions"": 2, ""deletions"": 0, ""lines"": 2}, ""src/clipboard.c"": {""insertions"": 2, ""deletions"": 0, ""lines"": 2}, ""src/cmdhist.c"": {""insertions"": 4, ""deletions"": 0, ""lines"": 4}, ""src/crypt.c"": {""insertions"": 2, ""deletions"": 0, ""lines"": 2}, ""src/edit.c"": {""insertions"": 2, ""deletions"": 0, ""lines"": 2}, ""src/eval.c"": {""insertions"": 6, ""deletions"": 43, ""lines"": 49}, ""src/evalbuffer.c"": {""insertions"": 1, ""deletions"": 3, ""lines"": 4}, ""src/evalfunc.c"": {""insertions"": 2, ""deletions"": 0, ""lines"": 2}, ""src/ex_docmd.c"": {""insertions"": 4, ""deletions"": 0, ""lines"": 4}, ""src/globals.h"": {""insertions"": 10, ""deletions"": 0, ""lines"": 10}, ""src/gui_xim.c"": {""insertions"": 4, ""deletions"": 3, ""lines"": 7}, ""src/hashtab.c"": {""insertions"": 2, ""deletions"": 0, ""lines"": 2}, ""src/highlight.c"": {""insertions"": 2, ""deletions"": 0, ""lines"": 2}, ""src/insexpand.c"": {""insertions"": 2, ""deletions"": 0, ""lines"": 2}, ""src/main.c"": {""insertions"": 4, ""deletions"": 0, ""lines"": 4}, ""src/mark.c"": {""insertions"": 2, ""deletions"": 0, ""lines"": 2}, ""src/message.c"": {""insertions"": 4, ""deletions"": 0, ""lines"": 4}, ""src/misc1.c"": {""insertions"": 3, ""deletions"": 1, ""lines"": 4}, ""src/misc2.c"": {""insertions"": 2, ""deletions"": 0, ""lines"": 2}, ""src/ops.c"": {""insertions"": 2, ""deletions"": 2, ""lines"": 4}, ""src/option.c"": {""insertions"": 4, ""deletions"": 0, ""lines"": 4}, ""src/option.h"": {""insertions"": 7, ""deletions"": 8, ""lines"": 15}, ""src/optionstr.c"": {""insertions"": 2, ""deletions"": 0, ""lines"": 2}, ""src/register.c"": {""insertions"": 16, ""deletions"": 0, ""lines"": 16}, ""src/scriptfile.c"": {""insertions"": 1, ""deletions"": 2, ""lines"": 3}, ""src/tag.c"": {""insertions"": 6, ""deletions"": 6, ""lines"": 12}, ""src/term.c"": {""insertions"": 2, ""deletions"": 0, ""lines"": 2}, ""src/typval.c"": {""insertions"": 4, ""deletions"": 0, ""lines"": 4}, ""src/usercmd.c"": {""insertions"": 4, ""deletions"": 0, ""lines"": 4}, ""src/userfunc.c"": {""insertions"": 2, ""deletions"": 0, ""lines"": 2}, ""src/version.c"": {""insertions"": 2, ""deletions"": 0, ""lines"": 2}, ""src/vim9script.c"": {""insertions"": 2, ""deletions"": 0, ""lines"": 2}, ""src/vim9type.c"": {""insertions"": 0, ""deletions"": 6, ""lines"": 6}}"
2022-01-08 10:38:48,370791465e745354d66696de8cbd15504cf958c0,Yegappan Lakshmanan,264,6,270,3,"{""src/insexpand.c"": {""insertions"": 27, ""deletions"": 6, ""lines"": 33}, ""src/testdir/test_ins_complete.vim"": {""insertions"": 235, ""deletions"": 0, ""lines"": 235}, ""src/version.c"": {""insertions"": 2, ""deletions"": 0, ""lines"": 2}}"
2022-01-07 21:39:52,d844862bcec5db210116847a67de93578ba781d7,Bram Moolenaar,1074,1059,2133,4,"{""src/testdir/Make_all.mak"": {""insertions"": 2, ""deletions"": 0, ""lines"": 2}, ""src/testdir/test_vim9_import.vim"": {""insertions"": 1069, ""deletions"": 0, ""lines"": 1069}, ""src/testdir/test_vim9_script.vim"": {""insertions"": 1, ""deletions"": 1059, ""lines"": 1060}, ""src/version.c"": {""insertions"": 2, ""deletions"": 0, ""lines"": 2}}"
2022-01-07 20:40:08,48d0ac775cb2da3b5aa9d46711ff17c50ce0f707,Bram Moolenaar,5,2,7,2,"{""src/time.c"": {""insertions"": 3, ""deletions"": 2, ""lines"": 5}, ""src/version.c"": {""insertions"": 2, ""deletions"": 0, ""lines"": 2}}"
2022-01-07 20:18:16,62a099cc6dbfc31c0ced3f6d895711208bf10518,Bram Moolenaar,3,1,4,2,"{""src/version.c"": {""insertions"": 2, ""deletions"": 0, ""lines"": 2}, ""src/vim9type.c"": {""insertions"": 1, ""deletions"": 1, ""lines"": 2}}"
2022-01-07 20:07:46,a4c96252b12c9ebc0ba563694c064e500d707b06,zeertzjq,3,1,4,2,"{""src/testdir/test_filetype.vim"": {""insertions"": 1, ""deletions"": 1, ""lines"": 2}, ""src/version.c"": {""insertions"": 2, ""deletions"": 0, ""lines"": 2}}"
2022-01-07 20:01:07,e12406526a24768e6121450112eb2f9f92445ac5,ichizok,10,6,16,3,"{""src/if_ruby.c"": {""insertions"": 5, ""deletions"": 1, ""lines"": 6}, ""src/version.c"": {""insertions"": 2, ""deletions"": 0, ""lines"": 2}, ""src/vim.h"": {""insertions"": 3, ""deletions"": 5, ""lines"": 8}}"
2022-01-07 19:24:20,d1f34e64f0e1a9ddaed76623bc40e669f2d09260,Bram Moolenaar,14,1,15,3,"{""src/term.c"": {""insertions"": 1, ""deletions"": 1, ""lines"": 2}, ""src/testdir/test_startup.vim"": {""insertions"": 11, ""deletions"": 0, ""lines"": 11}, ""src/version.c"": {""insertions"": 2, ""deletions"": 0, ""lines"": 2}}"
2022-01-07 18:20:55,71f21938bc9f4f6c0e52c178f51cb19be9804690,Bram Moolenaar,59,28,87,5,"{""src/evalvars.c"": {""insertions"": 30, ""deletions"": 1, ""lines"": 31}, ""src/proto/evalvars.pro"": {""insertions"": 1, ""deletions"": 0, ""lines"": 1}, ""src/testdir/test_vim9_script.vim"": {""insertions"": 25, ""deletions"": 26, ""lines"": 51}, ""src/userfunc.c"": {""insertions"": 1, ""deletions"": 1, ""lines"": 2}, ""src/version.c"": {""insertions"": 2, ""deletions"": 0, ""lines"": 2}}"
2022-01-07 16:55:32,b2d85e3784ac89f5209489844c1ee0f54d117abb,Bram Moolenaar,76,45,121,4,"{""src/indent.c"": {""insertions"": 34, ""deletions"": 21, ""lines"": 55}, ""src/optionstr.c"": {""insertions"": 11, ""deletions"": 0, ""lines"": 11}, ""src/regexp_nfa.c"": {""insertions"": 29, ""deletions"": 24, ""lines"": 53}, ""src/version.c"": {""insertions"": 2, ""deletions"": 0, ""lines"": 2}}"
2022-01-07 15:45:18,cb1956d6f2aece8ad93e19e5d4c7e0b5e405f056,Bram Moolenaar,22,2,24,4,"{""src/autocmd.c"": {""insertions"": 9, ""deletions"": 2, ""lines"": 11}, ""src/structs.h"": {""insertions"": 1, ""deletions"": 0, ""lines"": 1}, ""src/testdir/test_autocmd.vim"": {""insertions"": 10, ""deletions"": 0, ""lines"": 10}, ""src/version.c"": {""insertions"": 2, ""deletions"": 0, ""lines"": 2}}"
2022-01-07 14:39:56,2b04d5f1ef0dfaac1706e413947a7297285fa7b9,Bram Moolenaar,10,8,18,2,"{""src/testdir/test_vim9_script.vim"": {""insertions"": 8, ""deletions"": 8, ""lines"": 16}, ""src/version.c"": {""insertions"": 2, ""deletions"": 0, ""lines"": 2}}"
2022-01-07 14:08:03,e664a327014f4aa8baf8549a34a4caab2f3116a3,Bram Moolenaar,23,0,23,3,"{""src/evalwindow.c"": {""insertions"": 6, ""deletions"": 0, ""lines"": 6}, ""src/testdir/test_execute_func.vim"": {""insertions"": 15, ""deletions"": 0, ""lines"": 15}, ""src/version.c"": {""insertions"": 2, ""deletions"": 0, ""lines"": 2}}"
2022-01-07 13:38:24,834d41853e12b9022f60b08c32480928c2a9e48f,Bram Moolenaar,42,7,49,4,"{""src/errors.h"": {""insertions"": 4, ""deletions"": 2, ""lines"": 6}, ""src/testdir/test_vim9_script.vim"": {""insertions"": 29, ""deletions"": 2, ""lines"": 31}, ""src/version.c"": {""insertions"": 2, ""deletions"": 0, ""lines"": 2}, ""src/vim9script.c"": {""insertions"": 7, ""deletions"": 3, ""lines"": 10}}"
2022-01-07 12:45:29,32884ad753ffb462d27998beb50678888209075f,Bram Moolenaar,39,9,48,6,"{""src/eval.c"": {""insertions"": 9, ""deletions"": 2, ""lines"": 11}, ""src/evalvars.c"": {""insertions"": 4, ""deletions"": 3, ""lines"": 7}, ""src/proto/eval.pro"": {""insertions"": 1, ""deletions"": 1, ""lines"": 2}, ""src/testdir/test_vim9_script.vim"": {""insertions"": 22, ""deletions"": 2, ""lines"": 24}, ""src/userfunc.c"": {""insertions"": 1, ""deletions"": 1, ""lines"": 2}, ""src/version.c"": {""insertions"": 2, ""deletions"": 0, ""lines"": 2}}"
2022-01-06 22:07:57,a909c48bec1f7ae13a9143b5d627c40cac5b240e,Bram Moolenaar,3,1,4,2,"{""src/version.c"": {""insertions"": 2, ""deletions"": 0, ""lines"": 2}, ""src/vim9script.c"": {""insertions"": 1, ""deletions"": 1, ""lines"": 2}}"
2022-01-06 21:41:11,11de43d2d476c449587f1f0712924890ab677708,Bram Moolenaar,6,4,10,3,"{""src/popupwin.c"": {""insertions"": 3, ""deletions"": 3, ""lines"": 6}, ""src/usercmd.c"": {""insertions"": 1, ""deletions"": 1, ""lines"": 2}, ""src/version.c"": {""insertions"": 2, ""deletions"": 0, ""lines"": 2}}"
2022-01-06 21:38:11,2ef01d929d094c9063a259a74e23cf61be74b9b6,Bram Moolenaar,12,10,22,2,"{""src/version.c"": {""insertions"": 2, ""deletions"": 0, ""lines"": 2}, ""src/vim9cmds.c"": {""insertions"": 10, ""deletions"": 10, ""lines"": 20}}"
2022-01-06 21:31:19,84c62d59a3604d15c447f28e89679944a4926cc3,Bram Moolenaar,4,2,6,2,"{""src/testdir/test_debugger.vim"": {""insertions"": 2, ""deletions"": 2, ""lines"": 4}, ""src/version.c"": {""insertions"": 2, ""deletions"": 0, ""lines"": 2}}"
2022-01-06 21:10:28,d5f400c607182db6d4fbe2964471d796277f67e8,Bram Moolenaar,472,667,1139,16,"{""runtime/doc/vim9.txt"": {""insertions"": 22, ""deletions"": 16, ""lines"": 38}, ""src/errors.h"": {""insertions"": 12, ""deletions"": 4, ""lines"": 16}, ""src/eval.c"": {""insertions"": 60, ""deletions"": 15, ""lines"": 75}, ""src/evalvars.c"": {""insertions"": 49, ""deletions"": 56, ""lines"": 105}, ""src/proto/eval.pro"": {""insertions"": 3, ""deletions"": 0, ""lines"": 3}, ""src/proto/evalvars.pro"": {""insertions"": 2, ""deletions"": 2, ""lines"": 4}, ""src/proto/vim9script.pro"": {""insertions"": 1, ""deletions"": 1, ""lines"": 2}, ""src/structs.h"": {""insertions"": 5, ""deletions"": 10, ""lines"": 15}, ""src/testdir/test_vim9_assign.vim"": {""insertions"": 3, ""deletions"": 3, ""lines"": 6}, ""src/testdir/test_vim9_script.vim"": {""insertions"": 164, ""deletions"": 252, ""lines"": 416}, ""src/userfunc.c"": {""insertions"": 10, ""deletions"": 62, ""lines"": 72}, ""src/version.c"": {""insertions"": 2, ""deletions"": 0, ""lines"": 2}, ""src/vim9compile.c"": {""insertions"": 32, ""deletions"": 0, ""lines"": 32}, ""src/vim9execute.c"": {""insertions"": 2, ""deletions"": 2, ""lines"": 4}, ""src/vim9expr.c"": {""insertions"": 40, ""deletions"": 49, ""lines"": 89}, ""src/vim9script.c"": {""insertions"": 65, ""deletions"": 195, ""lines"": 260}}"
2022-01-06 13:24:51,18f4740f043b353abe47b7a00131317052457686,Bram Moolenaar,109,88,197,10,"{""src/evalbuffer.c"": {""insertions"": 8, ""deletions"": 10, ""lines"": 18}, ""src/evalfunc.c"": {""insertions"": 3, ""deletions"": 5, ""lines"": 8}, ""src/evalvars.c"": {""insertions"": 10, ""deletions"": 12, ""lines"": 22}, ""src/evalwindow.c"": {""insertions"": 38, ""deletions"": 29, ""lines"": 67}, ""src/if_py_both.h"": {""insertions"": 25, ""deletions"": 26, ""lines"": 51}, ""src/proto/evalbuffer.pro"": {""insertions"": 2, ""deletions"": 2, ""lines"": 4}, ""src/proto/evalwindow.pro"": {""insertions"": 4, ""deletions"": 4, ""lines"": 8}, ""src/structs.h"": {""insertions"": 7, ""deletions"": 0, ""lines"": 7}, ""src/testdir/test_execute_func.vim"": {""insertions"": 10, ""deletions"": 0, ""lines"": 10}, ""src/version.c"": {""insertions"": 2, ""deletions"": 0, ""lines"": 2}}"
2022-01-06 12:35:31,a33737b6d80f5461c1c6c4c96b5bc4964a737927,Dominique Pelle,4,0,4,2,"{""src/gui_athena.c"": {""insertions"": 2, ""deletions"": 0, ""lines"": 2}, ""src/version.c"": {""insertions"": 2, ""deletions"": 0, ""lines"": 2}}"
2022-01-06 12:23:30,58493cfae255adec2d5b407593b82d07abcc0975,Bram Moolenaar,19,4,23,3,"{""src/testdir/test_vim9_func.vim"": {""insertions"": 15, ""deletions"": 0, ""lines"": 15}, ""src/version.c"": {""insertions"": 2, ""deletions"": 0, ""lines"": 2}, ""src/vim9compile.c"": {""insertions"": 2, ""deletions"": 4, ""lines"": 6}}"
2022-01-06 11:43:21,269dc6361888ca23ef8d87f2795753f0bacd95e6,Bram Moolenaar,4,0,4,2,"{""src/errors.h"": {""insertions"": 2, ""deletions"": 0, ""lines"": 2}, ""src/version.c"": {""insertions"": 2, ""deletions"": 0, ""lines"": 2}}"
2022-01-05 20:56:38,c689f8c3d98fffe7e13730e198ce120934528f9c,Bram Moolenaar,58,8,66,4,"{""runtime/filetype.vim"": {""insertions"": 3, ""deletions"": 6, ""lines"": 9}, ""runtime/scripts.vim"": {""insertions"": 1, ""deletions"": 1, ""lines"": 2}, ""src/testdir/test_filetype.vim"": {""insertions"": 52, ""deletions"": 1, ""lines"": 53}, ""src/version.c"": {""insertions"": 2, ""deletions"": 0, ""lines"": 2}}"
2022-01-05 20:40:34,e60b3c47d701e73ecbadb1b9a12bf82010cadae8,Bram Moolenaar,4,0,4,2,"{""src/errors.h"": {""insertions"": 2, ""deletions"": 0, ""lines"": 2}, ""src/version.c"": {""insertions"": 2, ""deletions"": 0, ""lines"": 2}}"
2022-01-05 20:24:39,d82a47dd0493ee976aa3f15ecdc9aea7da6ad5bf,Bram Moolenaar,357,156,513,34,"{""src/channel.c"": {""insertions"": 13, ""deletions"": 16, ""lines"": 29}, ""src/clientserver.c"": {""insertions"": 2, ""deletions"": 2, ""lines"": 4}, ""src/diff.c"": {""insertions"": 2, ""deletions"": 2, ""lines"": 4}, ""src/errors.h"": {""insertions"": 239, ""deletions"": 15, ""lines"": 254}, ""src/evalfunc.c"": {""insertions"": 6, ""deletions"": 7, ""lines"": 13}, ""src/evalvars.c"": {""insertions"": 8, ""deletions"": 8, ""lines"": 16}, ""src/ex_cmds2.c"": {""insertions"": 1, ""deletions"": 2, ""lines"": 3}, ""src/ex_docmd.c"": {""insertions"": 4, ""deletions"": 4, ""lines"": 8}, ""src/gui_w32.c"": {""insertions"": 1, ""deletions"": 1, ""lines"": 2}, ""src/help.c"": {""insertions"": 1, ""deletions"": 1, ""lines"": 2}, ""src/if_mzsch.c"": {""insertions"": 1, ""deletions"": 1, ""lines"": 2}, ""src/if_py_both.h"": {""insertions"": 3, ""deletions"": 5, ""lines"": 8}, ""src/if_python.c"": {""insertions"": 1, ""deletions"": 1, ""lines"": 2}, ""src/job.c"": {""insertions"": 4, ""deletions"": 4, ""lines"": 8}, ""src/json.c"": {""insertions"": 1, ""deletions"": 2, ""lines"": 3}, ""src/list.c"": {""insertions"": 4, ""deletions"": 6, ""lines"": 10}, ""src/option.c"": {""insertions"": 3, ""deletions"": 3, ""lines"": 6}, ""src/optionstr.c"": {""insertions"": 2, ""deletions"": 2, ""lines"": 4}, ""src/quickfix.c"": {""insertions"": 2, ""deletions"": 8, ""lines"": 10}, ""src/regexp.c"": {""insertions"": 1, ""deletions"": 1, ""lines"": 2}, ""src/regexp_nfa.c"": {""insertions"": 12, ""deletions"": 12, ""lines"": 24}, ""src/register.c"": {""insertions"": 1, ""deletions"": 2, ""lines"": 3}, ""src/scriptfile.c"": {""insertions"": 2, ""deletions"": 2, ""lines"": 4}, ""src/sign.c"": {""insertions"": 2, ""deletions"": 2, ""lines"": 4}, ""src/syntax.c"": {""insertions"": 2, ""deletions"": 2, ""lines"": 4}, ""src/tag.c"": {""insertions"": 5, ""deletions"": 10, ""lines"": 15}, ""src/terminal.c"": {""insertions"": 5, ""deletions"": 5, ""lines"": 10}, ""src/textprop.c"": {""insertions"": 7, ""deletions"": 9, ""lines"": 16}, ""src/typval.c"": {""insertions"": 14, ""deletions"": 14, ""lines"": 28}, ""src/undo.c"": {""insertions"": 1, ""deletions"": 1, ""lines"": 2}, ""src/userfunc.c"": {""insertions"": 2, ""deletions"": 2, ""lines"": 4}, ""src/version.c"": {""insertions"": 2, ""deletions"": 0, ""lines"": 2}, ""src/vim9compile.c"": {""insertions"": 1, ""deletions"": 1, ""lines"": 2}, ""src/viminfo.c"": {""insertions"": 2, ""deletions"": 3, ""lines"": 5}}"
2022-01-05 18:16:53,bb8cac56d9c398a2b546d9c81c15e8c3d8fd811e,Bram Moolenaar,7,4,11,3,"{""src/errors.h"": {""insertions"": 3, ""deletions"": 2, ""lines"": 5}, ""src/match.c"": {""insertions"": 2, ""deletions"": 2, ""lines"": 4}, ""src/version.c"": {""insertions"": 2, ""deletions"": 0, ""lines"": 2}}"
2022-01-05 17:49:15,9d00e4a8146862c17ed429dc6b1b43349acb2b5f,Bram Moolenaar,200,87,287,31,"{""src/crypt.c"": {""insertions"": 1, ""deletions"": 1, ""lines"": 2}, ""src/diff.c"": {""insertions"": 2, ""deletions"": 2, ""lines"": 4}, ""src/errors.h"": {""insertions"": 132, ""deletions"": 4, ""lines"": 136}, ""src/ex_docmd.c"": {""insertions"": 2, ""deletions"": 2, ""lines"": 4}, ""src/ex_getln.c"": {""insertions"": 1, ""deletions"": 1, ""lines"": 2}, ""src/fileio.c"": {""insertions"": 3, ""deletions"": 4, ""lines"": 7}, ""src/findfile.c"": {""insertions"": 2, ""deletions"": 4, ""lines"": 6}, ""src/float.c"": {""insertions"": 1, ""deletions"": 1, ""lines"": 2}, ""src/gui.c"": {""insertions"": 2, ""deletions"": 2, ""lines"": 4}, ""src/highlight.c"": {""insertions"": 1, ""deletions"": 1, ""lines"": 2}, ""src/if_mzsch.c"": {""insertions"": 1, ""deletions"": 1, ""lines"": 2}, ""src/if_py_both.h"": {""insertions"": 2, ""deletions"": 2, ""lines"": 4}, ""src/if_python.c"": {""insertions"": 1, ""deletions"": 1, ""lines"": 2}, ""src/if_python3.c"": {""insertions"": 1, ""deletions"": 1, ""lines"": 2}, ""src/insexpand.c"": {""insertions"": 2, ""deletions"": 5, ""lines"": 7}, ""src/match.c"": {""insertions"": 3, ""deletions"": 4, ""lines"": 7}, ""src/memline.c"": {""insertions"": 2, ""deletions"": 2, ""lines"": 4}, ""src/option.c"": {""insertions"": 1, ""deletions"": 1, ""lines"": 2}, ""src/popupwin.c"": {""insertions"": 2, ""deletions"": 2, ""lines"": 4}, ""src/regexp.c"": {""insertions"": 1, ""deletions"": 1, ""lines"": 2}, ""src/regexp_nfa.c"": {""insertions"": 12, ""deletions"": 19, ""lines"": 31}, ""src/spellfile.c"": {""insertions"": 1, ""deletions"": 1, ""lines"": 2}, ""src/strings.c"": {""insertions"": 1, ""deletions"": 1, ""lines"": 2}, ""src/syntax.c"": {""insertions"": 3, ""deletions"": 3, ""lines"": 6}, ""src/textprop.c"": {""insertions"": 2, ""deletions"": 2, ""lines"": 4}, ""src/typval.c"": {""insertions"": 1, ""deletions"": 1, ""lines"": 2}, ""src/undo.c"": {""insertions"": 11, ""deletions"": 14, ""lines"": 25}, ""src/usercmd.c"": {""insertions"": 1, ""deletions"": 1, ""lines"": 2}, ""src/userfunc.c"": {""insertions"": 2, ""deletions"": 2, ""lines"": 4}, ""src/version.c"": {""insertions"": 2, ""deletions"": 0, ""lines"": 2}, ""src/window.c"": {""insertions"": 1, ""deletions"": 1, ""lines"": 2}}"
2022-01-05 16:50:40,d3a117814d6acbf0dca3eff1a7626843b9b3734a,Bram Moolenaar,17,2,19,4,"{""src/ex_docmd.c"": {""insertions"": 2, ""deletions"": 1, ""lines"": 3}, ""src/testdir/test_vim9_func.vim"": {""insertions"": 11, ""deletions"": 0, ""lines"": 11}, ""src/version.c"": {""insertions"": 2, ""deletions"": 0, ""lines"": 2}, ""src/vim9compile.c"": {""insertions"": 2, ""deletions"": 1, ""lines"": 3}}"
2022-01-05 16:09:06,677658ae49de31fe2e5b1fa6d93fdfab85a4362e,Bram Moolenaar,187,76,263,28,"{""src/diff.c"": {""insertions"": 2, ""deletions"": 2, ""lines"": 4}, ""src/digraph.c"": {""insertions"": 1, ""deletions"": 1, ""lines"": 2}, ""src/errors.h"": {""insertions"": 124, ""deletions"": 4, ""lines"": 128}, ""src/evalfunc.c"": {""insertions"": 1, ""deletions"": 1, ""lines"": 2}, ""src/evalvars.c"": {""insertions"": 1, ""deletions"": 1, ""lines"": 2}, ""src/ex_cmds.c"": {""insertions"": 1, ""deletions"": 2, ""lines"": 3}, ""src/ex_docmd.c"": {""insertions"": 2, ""deletions"": 2, ""lines"": 4}, ""src/ex_getln.c"": {""insertions"": 1, ""deletions"": 1, ""lines"": 2}, ""src/insexpand.c"": {""insertions"": 1, ""deletions"": 1, ""lines"": 2}, ""src/match.c"": {""insertions"": 3, ""deletions"": 4, ""lines"": 7}, ""src/memline.c"": {""insertions"": 1, ""deletions"": 1, ""lines"": 2}, ""src/menu.c"": {""insertions"": 1, ""deletions"": 1, ""lines"": 2}, ""src/ops.c"": {""insertions"": 2, ""deletions"": 2, ""lines"": 4}, ""src/profiler.c"": {""insertions"": 1, ""deletions"": 1, ""lines"": 2}, ""src/quickfix.c"": {""insertions"": 1, ""deletions"": 1, ""lines"": 2}, ""src/regexp.c"": {""insertions"": 2, ""deletions"": 7, ""lines"": 9}, ""src/regexp_bt.c"": {""insertions"": 4, ""deletions"": 3, ""lines"": 7}, ""src/regexp_nfa.c"": {""insertions"": 2, ""deletions"": 2, ""lines"": 4}, ""src/register.c"": {""insertions"": 1, ""deletions"": 1, ""lines"": 2}, ""src/spell.c"": {""insertions"": 4, ""deletions"": 4, ""lines"": 8}, ""src/spell.h"": {""insertions"": 0, ""deletions"": 3, ""lines"": 3}, ""src/spellfile.c"": {""insertions"": 22, ""deletions"": 25, ""lines"": 47}, ""src/strings.c"": {""insertions"": 2, ""deletions"": 2, ""lines"": 4}, ""src/syntax.c"": {""insertions"": 1, ""deletions"": 1, ""lines"": 2}, ""src/typval.c"": {""insertions"": 1, ""deletions"": 1, ""lines"": 2}, ""src/undo.c"": {""insertions"": 1, ""deletions"": 1, ""lines"": 2}, ""src/userfunc.c"": {""insertions"": 2, ""deletions"": 1, ""lines"": 3}, ""src/version.c"": {""insertions"": 2, ""deletions"": 0, ""lines"": 2}}"
2022-01-05 14:01:30,8e7d9db32b53ca2b1cb7570d2042860bcd1e943f,matveyt,51,3,54,3,"{""src/session.c"": {""insertions"": 19, ""deletions"": 3, ""lines"": 22}, ""src/testdir/test_mksession.vim"": {""insertions"": 30, ""deletions"": 0, ""lines"": 30}, ""src/version.c"": {""insertions"": 2, ""deletions"": 0, ""lines"": 2}}"
2022-01-05 10:16:30,c653e4a2bd4099e2fac8e1c448a0f34581d5a658,Bram Moolenaar,39,3,42,3,"{""src/eval.c"": {""insertions"": 19, ""deletions"": 3, ""lines"": 22}, ""src/testdir/test_vim9_assign.vim"": {""insertions"": 18, ""deletions"": 0, ""lines"": 18}, ""src/version.c"": {""insertions"": 2, ""deletions"": 0, ""lines"": 2}}"
2022-01-04 21:30:47,a6f7929e62c19a6a2418a016b4c59b83eb1887ac,Bram Moolenaar,196,78,274,25,"{""src/dict.c"": {""insertions"": 1, ""deletions"": 1, ""lines"": 2}, ""src/errors.h"": {""insertions"": 127, ""deletions"": 2, ""lines"": 129}, ""src/eval.c"": {""insertions"": 5, ""deletions"": 5, ""lines"": 10}, ""src/evalfunc.c"": {""insertions"": 4, ""deletions"": 4, ""lines"": 8}, ""src/evalvars.c"": {""insertions"": 5, ""deletions"": 6, ""lines"": 11}, ""src/ex_cmds2.c"": {""insertions"": 1, ""deletions"": 1, ""lines"": 2}, ""src/ex_docmd.c"": {""insertions"": 1, ""deletions"": 1, ""lines"": 2}, ""src/ex_eval.c"": {""insertions"": 2, ""deletions"": 2, ""lines"": 4}, ""src/filepath.c"": {""insertions"": 1, ""deletions"": 1, ""lines"": 2}, ""src/gui.c"": {""insertions"": 1, ""deletions"": 1, ""lines"": 2}, ""src/gui_w32.c"": {""insertions"": 2, ""deletions"": 2, ""lines"": 4}, ""src/hardcopy.c"": {""insertions"": 3, ""deletions"": 3, ""lines"": 6}, ""src/help.c"": {""insertions"": 2, ""deletions"": 2, ""lines"": 4}, ""src/highlight.c"": {""insertions"": 2, ""deletions"": 2, ""lines"": 4}, ""src/if_python.c"": {""insertions"": 1, ""deletions"": 1, ""lines"": 2}, ""src/list.c"": {""insertions"": 2, ""deletions"": 2, ""lines"": 4}, ""src/misc1.c"": {""insertions"": 1, ""deletions"": 1, ""lines"": 2}, ""src/normal.c"": {""insertions"": 3, ""deletions"": 3, ""lines"": 6}, ""src/quickfix.c"": {""insertions"": 2, ""deletions"": 2, ""lines"": 4}, ""src/regexp.c"": {""insertions"": 1, ""deletions"": 1, ""lines"": 2}, ""src/regexp_bt.c"": {""insertions"": 2, ""deletions"": 2, ""lines"": 4}, ""src/regexp_nfa.c"": {""insertions"": 2, ""deletions"": 3, ""lines"": 5}, ""src/typval.c"": {""insertions"": 10, ""deletions"": 10, ""lines"": 20}, ""src/userfunc.c"": {""insertions"": 13, ""deletions"": 20, ""lines"": 33}, ""src/version.c"": {""insertions"": 2, ""deletions"": 0, ""lines"": 2}}"
2022-01-04 20:05:04,548911ee145cdd166f20e46aa720d1631e66f64e,Bram Moolenaar,4,2,6,2,"{""src/evalfunc.c"": {""insertions"": 2, ""deletions"": 2, ""lines"": 4}, ""src/version.c"": {""insertions"": 2, ""deletions"": 0, ""lines"": 2}}"
2022-01-04 19:57:55,d88be5be80f47826397d12ffc90150a443821f2b,Bram Moolenaar,197,65,262,14,"{""src/channel.c"": {""insertions"": 2, ""deletions"": 2, ""lines"": 4}, ""src/errors.h"": {""insertions"": 132, ""deletions"": 3, ""lines"": 135}, ""src/ex_docmd.c"": {""insertions"": 1, ""deletions"": 1, ""lines"": 2}, ""src/ex_eval.c"": {""insertions"": 3, ""deletions"": 3, ""lines"": 6}, ""src/gui_at_fs.c"": {""insertions"": 3, ""deletions"": 3, ""lines"": 6}, ""src/hardcopy.c"": {""insertions"": 13, ""deletions"": 13, ""lines"": 26}, ""src/if_cscope.c"": {""insertions"": 5, ""deletions"": 5, ""lines"": 10}, ""src/menu.c"": {""insertions"": 1, ""deletions"": 1, ""lines"": 2}, ""src/netbeans.c"": {""insertions"": 30, ""deletions"": 29, ""lines"": 59}, ""src/optionstr.c"": {""insertions"": 2, ""deletions"": 2, ""lines"": 4}, ""src/os_mswin.c"": {""insertions"": 1, ""deletions"": 1, ""lines"": 2}, ""src/sign.c"": {""insertions"": 1, ""deletions"": 1, ""lines"": 2}, ""src/typval.c"": {""insertions"": 1, ""deletions"": 1, ""lines"": 2}, ""src/version.c"": {""insertions"": 2, ""deletions"": 0, ""lines"": 2}}"
2022-01-04 18:01:21,6cac77016b1636e04073e8348b7cee02259ef928,zeertzjq,67,5,72,3,"{""src/getchar.c"": {""insertions"": 13, ""deletions"": 5, ""lines"": 18}, ""src/testdir/test_utf8.vim"": {""insertions"": 52, ""deletions"": 0, ""lines"": 52}, ""src/version.c"": {""insertions"": 2, ""deletions"": 0, ""lines"": 2}}"
2022-01-04 17:01:44,d94fbfc74a8b8073e7a256c95fa6f39fc527c726,Yegappan Lakshmanan,246,163,409,7,"{""src/edit.c"": {""insertions"": 2, ""deletions"": 2, ""lines"": 4}, ""src/getchar.c"": {""insertions"": 1, ""deletions"": 1, ""lines"": 2}, ""src/globals.h"": {""insertions"": 0, ""deletions"": 17, ""lines"": 17}, ""src/insexpand.c"": {""insertions"": 223, ""deletions"": 128, ""lines"": 351}, ""src/proto/insexpand.pro"": {""insertions"": 5, ""deletions"": 1, ""lines"": 6}, ""src/search.c"": {""insertions"": 13, ""deletions"": 14, ""lines"": 27}, ""src/version.c"": {""insertions"": 2, ""deletions"": 0, ""lines"": 2}}"
2022-01-04 16:44:56,fcd1635a4680d53090baa433996954bfe0642366,Bram Moolenaar,2,2,4,2,"{""src/help.c"": {""insertions"": 0, ""deletions"": 2, ""lines"": 2}, ""src/version.c"": {""insertions"": 2, ""deletions"": 0, ""lines"": 2}}"
2022-01-04 16:22:52,c024ed9233feac4c8da7394a62bb50474803514f,zeertzjq,3,1,4,2,"{""src/ex_docmd.c"": {""insertions"": 1, ""deletions"": 1, ""lines"": 2}, ""src/version.c"": {""insertions"": 2, ""deletions"": 0, ""lines"": 2}}"
2022-01-04 16:05:48,48824e952f7db8ca657fe20e66456fc19fca6815,Bram Moolenaar,4,1,5,2,"{""src/version.c"": {""insertions"": 2, ""deletions"": 0, ""lines"": 2}, ""src/vim9type.c"": {""insertions"": 2, ""deletions"": 1, ""lines"": 3}}"
2022-01-04 15:54:38,10d6f18b2f9090d19dd884827c4be59a20b446bf,Bram Moolenaar,39,15,54,7,"{""src/dict.c"": {""insertions"": 0, ""deletions"": 2, ""lines"": 2}, ""src/list.c"": {""insertions"": 0, ""deletions"": 4, ""lines"": 4}, ""src/structs.h"": {""insertions"": 0, ""deletions"": 2, ""lines"": 2}, ""src/testdir/test_vim9_builtin.vim"": {""insertions"": 34, ""deletions"": 3, ""lines"": 37}, ""src/testdir/test_vim9_disassemble.vim"": {""insertions"": 1, ""deletions"": 0, ""lines"": 1}, ""src/version.c"": {""insertions"": 2, ""deletions"": 0, ""lines"": 2}, ""src/vim9compile.c"": {""insertions"": 2, ""deletions"": 4, ""lines"": 6}}"
2022-01-04 15:17:03,078a46161e8b1b30bf306d6c1f4f0af7c616a989,Bram Moolenaar,464,365,829,17,"{""src/dict.c"": {""insertions"": 3, ""deletions"": 2, ""lines"": 5}, ""src/evalbuffer.c"": {""insertions"": 0, ""deletions"": 6, ""lines"": 6}, ""src/evalfunc.c"": {""insertions"": 112, ""deletions"": 105, ""lines"": 217}, ""src/list.c"": {""insertions"": 4, ""deletions"": 0, ""lines"": 4}, ""src/proto/evalbuffer.pro"": {""insertions"": 0, ""deletions"": 1, ""lines"": 1}, ""src/proto/evalfunc.pro"": {""insertions"": 2, ""deletions"": 2, ""lines"": 4}, ""src/proto/vim9instr.pro"": {""insertions"": 1, ""deletions"": 0, ""lines"": 1}, ""src/proto/vim9type.pro"": {""insertions"": 6, ""deletions"": 2, ""lines"": 8}, ""src/structs.h"": {""insertions"": 9, ""deletions"": 2, ""lines"": 11}, ""src/testdir/test_vim9_assign.vim"": {""insertions"": 34, ""deletions"": 0, ""lines"": 34}, ""src/testdir/test_vim9_builtin.vim"": {""insertions"": 5, ""deletions"": 9, ""lines"": 14}, ""src/version.c"": {""insertions"": 2, ""deletions"": 0, ""lines"": 2}, ""src/vim9cmds.c"": {""insertions"": 14, ""deletions"": 16, ""lines"": 30}, ""src/vim9compile.c"": {""insertions"": 12, ""deletions"": 15, ""lines"": 27}, ""src/vim9expr.c"": {""insertions"": 67, ""deletions"": 44, ""lines"": 111}, ""src/vim9instr.c"": {""insertions"": 111, ""deletions"": 151, ""lines"": 262}, ""src/vim9type.c"": {""insertions"": 82, ""deletions"": 10, ""lines"": 92}}"
2022-01-03 17:32:46,9acf2d8be93f3b50607279e7f3484b019675d0a7,David Auer,5,3,8,3,"{""runtime/filetype.vim"": {""insertions"": 2, ""deletions"": 2, ""lines"": 4}, ""src/testdir/test_filetype.vim"": {""insertions"": 1, ""deletions"": 1, ""lines"": 2}, ""src/version.c"": {""insertions"": 2, ""deletions"": 0, ""lines"": 2}}"
2022-01-03 16:52:28,ad8f2485856eadb931ebd1f633ca366a40e415b8,Bram Moolenaar,26,13,39,3,"{""src/list.c"": {""insertions"": 12, ""deletions"": 11, ""lines"": 23}, ""src/testdir/test_vim9_builtin.vim"": {""insertions"": 12, ""deletions"": 2, ""lines"": 14}, ""src/version.c"": {""insertions"": 2, ""deletions"": 0, ""lines"": 2}}"
2022-01-03 13:47:50,c88e977862ba6477a3b5b28706c45f96069a3073,Bram Moolenaar,69,11,80,5,"{""src/getchar.c"": {""insertions"": 46, ""deletions"": 9, ""lines"": 55}, ""src/normal.c"": {""insertions"": 8, ""deletions"": 1, ""lines"": 9}, ""src/proto/getchar.pro"": {""insertions"": 2, ""deletions"": 1, ""lines"": 3}, ""src/testdir/test_registers.vim"": {""insertions"": 11, ""deletions"": 0, ""lines"": 11}, ""src/version.c"": {""insertions"": 2, ""deletions"": 0, ""lines"": 2}}"
2022-01-03 12:53:24,0e2508d9e63e63414de2c06b3c8a446fdfe4470b,h-east,50,23,73,3,"{""src/help.c"": {""insertions"": 15, ""deletions"": 16, ""lines"": 31}, ""src/testdir/test_help.vim"": {""insertions"": 33, ""deletions"": 7, ""lines"": 40}, ""src/version.c"": {""insertions"": 2, ""deletions"": 0, ""lines"": 2}}"
2022-01-03 12:28:03,114dbda7858df956161c0adba5d4d8279645ff67,Bram Moolenaar,66,28,94,10,"{""src/eval.c"": {""insertions"": 2, ""deletions"": 1, ""lines"": 3}, ""src/list.c"": {""insertions"": 3, ""deletions"": 3, ""lines"": 6}, ""src/testdir/test_vim9_assign.vim"": {""insertions"": 8, ""deletions"": 0, ""lines"": 8}, ""src/testdir/test_vim9_builtin.vim"": {""insertions"": 5, ""deletions"": 0, ""lines"": 5}, ""src/testdir/test_vim9_func.vim"": {""insertions"": 5, ""deletions"": 2, ""lines"": 7}, ""src/version.c"": {""insertions"": 2, ""deletions"": 0, ""lines"": 2}, ""src/vim9.h"": {""insertions"": 4, ""deletions"": 0, ""lines"": 4}, ""src/vim9compile.c"": {""insertions"": 0, ""deletions"": 5, ""lines"": 5}, ""src/vim9script.c"": {""insertions"": 2, ""deletions"": 1, ""lines"": 3}, ""src/vim9type.c"": {""insertions"": 35, ""deletions"": 16, ""lines"": 51}}"
2022-01-03 11:15:47,5c75eed758fbeb39825834d51f3ee4e08f137af3,naohiro ono,3,1,4,2,"{""src/testdir/test_normal.vim"": {""insertions"": 1, ""deletions"": 1, ""lines"": 2}, ""src/version.c"": {""insertions"": 2, ""deletions"": 0, ""lines"": 2}}"
2022-01-03 11:03:48,e982586f8eebf2b055987218f6d3f7a084c4bf69,Yegappan Lakshmanan,210,47,257,4,"{""src/insexpand.c"": {""insertions"": 84, ""deletions"": 45, ""lines"": 129}, ""src/testdir/test_edit.vim"": {""insertions"": 24, ""deletions"": 2, ""lines"": 26}, ""src/testdir/test_ins_complete.vim"": {""insertions"": 100, ""deletions"": 0, ""lines"": 100}, ""src/version.c"": {""insertions"": 2, ""deletions"": 0, ""lines"": 2}}"
2022-01-02 21:46:29,475d9521baaeb060ebb915d678094ff28e67b5be,Bram Moolenaar,3,1,4,2,"{""src/errors.h"": {""insertions"": 1, ""deletions"": 1, ""lines"": 2}, ""src/version.c"": {""insertions"": 2, ""deletions"": 0, ""lines"": 2}}"
2022-01-02 21:26:16,1d423ef75fc8bce2edfd2aab61cc9beaa63e31aa,Bram Moolenaar,237,85,322,19,"{""src/digraph.c"": {""insertions"": 1, ""deletions"": 1, ""lines"": 2}, ""src/errors.h"": {""insertions"": 157, ""deletions"": 2, ""lines"": 159}, ""src/ex_eval.c"": {""insertions"": 5, ""deletions"": 5, ""lines"": 10}, ""src/gui.c"": {""insertions"": 1, ""deletions"": 1, ""lines"": 2}, ""src/hardcopy.c"": {""insertions"": 3, ""deletions"": 3, ""lines"": 6}, ""src/if_cscope.c"": {""insertions"": 11, ""deletions"": 12, ""lines"": 23}, ""src/if_tcl.c"": {""insertions"": 2, ""deletions"": 2, ""lines"": 4}, ""src/if_xcmdsrv.c"": {""insertions"": 1, ""deletions"": 1, ""lines"": 2}, ""src/mbyte.c"": {""insertions"": 1, ""deletions"": 1, ""lines"": 2}, ""src/misc2.c"": {""insertions"": 6, ""deletions"": 6, ""lines"": 12}, ""src/netbeans.c"": {""insertions"": 1, ""deletions"": 1, ""lines"": 2}, ""src/option.c"": {""insertions"": 10, ""deletions"": 10, ""lines"": 20}, ""src/optionstr.c"": {""insertions"": 23, ""deletions"": 24, ""lines"": 47}, ""src/quickfix.c"": {""insertions"": 1, ""deletions"": 2, ""lines"": 3}, ""src/regexp.c"": {""insertions"": 1, ""deletions"": 1, ""lines"": 2}, ""src/tag.c"": {""insertions"": 4, ""deletions"": 6, ""lines"": 10}, ""src/term.c"": {""insertions"": 3, ""deletions"": 3, ""lines"": 6}, ""src/version.c"": {""insertions"": 2, ""deletions"": 0, ""lines"": 2}, ""src/viminfo.c"": {""insertions"": 4, ""deletions"": 4, ""lines"": 8}}"
2022-01-02 20:20:45,b09feaa86ecc53b9b953710082496951776dc5c6,Bram Moolenaar,141,69,210,18,"{""src/errors.h"": {""insertions"": 87, ""deletions"": 11, ""lines"": 98}, ""src/evalvars.c"": {""insertions"": 1, ""deletions"": 1, ""lines"": 2}, ""src/ex_cmds.c"": {""insertions"": 2, ""deletions"": 3, ""lines"": 5}, ""src/ex_docmd.c"": {""insertions"": 13, ""deletions"": 13, ""lines"": 26}, ""src/fileio.c"": {""insertions"": 1, ""deletions"": 2, ""lines"": 3}, ""src/fold.c"": {""insertions"": 4, ""deletions"": 6, ""lines"": 10}, ""src/gui_x11.c"": {""insertions"": 1, ""deletions"": 1, ""lines"": 2}, ""src/hardcopy.c"": {""insertions"": 9, ""deletions"": 10, ""lines"": 19}, ""src/help.c"": {""insertions"": 1, ""deletions"": 1, ""lines"": 2}, ""src/highlight.c"": {""insertions"": 1, ""deletions"": 1, ""lines"": 2}, ""src/if_cscope.c"": {""insertions"": 2, ""deletions"": 1, ""lines"": 3}, ""src/json.c"": {""insertions"": 9, ""deletions"": 11, ""lines"": 20}, ""src/map.c"": {""insertions"": 1, ""deletions"": 1, ""lines"": 2}, ""src/netbeans.c"": {""insertions"": 2, ""deletions"": 2, ""lines"": 4}, ""src/popupwin.c"": {""insertions"": 1, ""deletions"": 1, ""lines"": 2}, ""src/usercmd.c"": {""insertions"": 2, ""deletions"": 2, ""lines"": 4}, ""src/userfunc.c"": {""insertions"": 2, ""deletions"": 2, ""lines"": 4}, ""src/version.c"": {""insertions"": 2, ""deletions"": 0, ""lines"": 2}}"
2022-01-02 19:25:26,ac78dd4a352196ca4e6640f8e4caaf126afd49e3,Bram Moolenaar,285,104,389,23,"{""src/errors.h"": {""insertions"": 189, ""deletions"": 2, ""lines"": 191}, ""src/findfile.c"": {""insertions"": 2, ""deletions"": 2, ""lines"": 4}, ""src/fold.c"": {""insertions"": 2, ""deletions"": 2, ""lines"": 4}, ""src/hardcopy.c"": {""insertions"": 1, ""deletions"": 1, ""lines"": 2}, ""src/highlight.c"": {""insertions"": 14, ""deletions"": 17, ""lines"": 31}, ""src/map.c"": {""insertions"": 2, ""deletions"": 2, ""lines"": 4}, ""src/message.c"": {""insertions"": 1, ""deletions"": 1, ""lines"": 2}, ""src/normal.c"": {""insertions"": 1, ""deletions"": 1, ""lines"": 2}, ""src/option.c"": {""insertions"": 2, ""deletions"": 2, ""lines"": 4}, ""src/os_amiga.c"": {""insertions"": 1, ""deletions"": 1, ""lines"": 2}, ""src/os_unix.c"": {""insertions"": 1, ""deletions"": 1, ""lines"": 2}, ""src/os_win32.c"": {""insertions"": 1, ""deletions"": 1, ""lines"": 2}, ""src/quickfix.c"": {""insertions"": 10, ""deletions"": 10, ""lines"": 20}, ""src/regexp.c"": {""insertions"": 1, ""deletions"": 1, ""lines"": 2}, ""src/register.c"": {""insertions"": 1, ""deletions"": 1, ""lines"": 2}, ""src/search.c"": {""insertions"": 7, ""deletions"": 9, ""lines"": 16}, ""src/syntax.c"": {""insertions"": 24, ""deletions"": 27, ""lines"": 51}, ""src/tag.c"": {""insertions"": 11, ""deletions"": 11, ""lines"": 22}, ""src/term.c"": {""insertions"": 2, ""deletions"": 2, ""lines"": 4}, ""src/typval.c"": {""insertions"": 1, ""deletions"": 1, ""lines"": 2}, ""src/undo.c"": {""insertions"": 3, ""deletions"": 3, ""lines"": 6}, ""src/version.c"": {""insertions"": 2, ""deletions"": 0, ""lines"": 2}, ""src/window.c"": {""insertions"": 6, ""deletions"": 6, ""lines"": 12}}"
2022-01-02 17:28:57,3d0da09bb2d31afc611bf1c4b35796739d87ed63,Bram Moolenaar,13,6,19,2,"{""src/testdir/test_debugger.vim"": {""insertions"": 11, ""deletions"": 6, ""lines"": 17}, ""src/version.c"": {""insertions"": 2, ""deletions"": 0, ""lines"": 2}}"
2022-01-02 17:00:40,eaaac014a01ce37c1f86dbda054c01a5c6f034e7,Bram Moolenaar,163,64,227,12,"{""src/errors.h"": {""insertions"": 102, ""deletions"": 1, ""lines"": 103}, ""src/ex_docmd.c"": {""insertions"": 1, ""deletions"": 1, ""lines"": 2}, ""src/fileio.c"": {""insertions"": 1, ""deletions"": 1, ""lines"": 2}, ""src/filepath.c"": {""insertions"": 1, ""deletions"": 1, ""lines"": 2}, ""src/findfile.c"": {""insertions"": 5, ""deletions"": 5, ""lines"": 10}, ""src/hardcopy.c"": {""insertions"": 1, ""deletions"": 1, ""lines"": 2}, ""src/memfile.c"": {""insertions"": 1, ""deletions"": 1, ""lines"": 2}, ""src/memline.c"": {""insertions"": 26, ""deletions"": 26, ""lines"": 52}, ""src/menu.c"": {""insertions"": 17, ""deletions"": 20, ""lines"": 37}, ""src/normal.c"": {""insertions"": 5, ""deletions"": 6, ""lines"": 11}, ""src/regexp_bt.c"": {""insertions"": 1, ""deletions"": 1, ""lines"": 2}, ""src/version.c"": {""insertions"": 2, ""deletions"": 0, ""lines"": 2}}"
2022-01-02 16:16:33,8bfa0eb863357c1013024233ebb2e95a0a848002,Dominique Pelle,16,4,20,6,"{""src/testdir/test_filter_map.vim"": {""insertions"": 3, ""deletions"": 3, ""lines"": 6}, ""src/testdir/test_highlight.vim"": {""insertions"": 3, ""deletions"": 0, ""lines"": 3}, ""src/testdir/test_regexp_latin.vim"": {""insertions"": 4, ""deletions"": 1, ""lines"": 5}, ""src/testdir/test_search.vim"": {""insertions"": 2, ""deletions"": 0, ""lines"": 2}, ""src/testdir/test_vim9_builtin.vim"": {""insertions"": 2, ""deletions"": 0, ""lines"": 2}, ""src/version.c"": {""insertions"": 2, ""deletions"": 0, ""lines"": 2}}"
2022-01-02 14:08:18,2b4ecc2c31c00df6e1c8ad46a3e4eabb1f1f84e3,Bram Moolenaar,61,16,77,3,"{""src/testdir/test_vim9_disassemble.vim"": {""insertions"": 37, ""deletions"": 0, ""lines"": 37}, ""src/version.c"": {""insertions"": 2, ""deletions"": 0, ""lines"": 2}, ""src/vim9cmds.c"": {""insertions"": 22, ""deletions"": 16, ""lines"": 38}}"
2022-01-02 13:05:45,b3bd1d39e68e2d697c014b9f85482c2c12a3f909,Bram Moolenaar,58,27,85,3,"{""src/ops.c"": {""insertions"": 42, ""deletions"": 27, ""lines"": 69}, ""src/testdir/test_normal.vim"": {""insertions"": 14, ""deletions"": 0, ""lines"": 14}, ""src/version.c"": {""insertions"": 2, ""deletions"": 0, ""lines"": 2}}"
2022-01-02 12:06:33,a6feb163f0295dfefb829d93ba3fa659b9c262b6,Bram Moolenaar,9,4,13,3,"{""runtime/doc/builtin.txt"": {""insertions"": 1, ""deletions"": 0, ""lines"": 1}, ""runtime/doc/various.txt"": {""insertions"": 2, ""deletions"": 1, ""lines"": 3}, ""src/version.c"": {""insertions"": 6, ""deletions"": 3, ""lines"": 9}}"
2022-01-02 01:04:09,6b1a99dfe33cf5a1d7f82febd81face85ac1b8a6,Bram Moolenaar,3,1,4,2,"{""src/errors.h"": {""insertions"": 1, ""deletions"": 1, ""lines"": 2}, ""src/version.c"": {""insertions"": 2, ""deletions"": 0, ""lines"": 2}}"
2022-01-01 21:59:18,9a846fbaa569b3690d70606f2a86e97f77a05496,Bram Moolenaar,147,43,190,20,"{""src/change.c"": {""insertions"": 1, ""deletions"": 1, ""lines"": 2}, ""src/clientserver.c"": {""insertions"": 1, ""deletions"": 1, ""lines"": 2}, ""src/errors.h"": {""insertions"": 107, ""deletions"": 1, ""lines"": 108}, ""src/eval.c"": {""insertions"": 1, ""deletions"": 1, ""lines"": 2}, ""src/gui_xim.c"": {""insertions"": 6, ""deletions"": 10, ""lines"": 16}, ""src/if_cscope.c"": {""insertions"": 2, ""deletions"": 2, ""lines"": 4}, ""src/if_py_both.h"": {""insertions"": 1, ""deletions"": 1, ""lines"": 2}, ""src/if_python.c"": {""insertions"": 1, ""deletions"": 1, ""lines"": 2}, ""src/if_python3.c"": {""insertions"": 1, ""deletions"": 1, ""lines"": 2}, ""src/if_ruby.c"": {""insertions"": 9, ""deletions"": 9, ""lines"": 18}, ""src/if_tcl.c"": {""insertions"": 1, ""deletions"": 1, ""lines"": 2}, ""src/main.c"": {""insertions"": 1, ""deletions"": 1, ""lines"": 2}, ""src/mark.c"": {""insertions"": 1, ""deletions"": 1, ""lines"": 2}, ""src/match.c"": {""insertions"": 1, ""deletions"": 1, ""lines"": 2}, ""src/memfile.c"": {""insertions"": 5, ""deletions"": 5, ""lines"": 10}, ""src/memline.c"": {""insertions"": 3, ""deletions"": 3, ""lines"": 6}, ""src/terminal.c"": {""insertions"": 1, ""deletions"": 1, ""lines"": 2}, ""src/textprop.c"": {""insertions"": 1, ""deletions"": 1, ""lines"": 2}, ""src/userfunc.c"": {""insertions"": 1, ""deletions"": 1, ""lines"": 2}, ""src/version.c"": {""insertions"": 2, ""deletions"": 0, ""lines"": 2}}"
2022-01-01 19:42:16,b34689010a587e85ff724051f276513a15c634d0,Bram Moolenaar,3,9,12,2,"{""src/evalfunc.c"": {""insertions"": 1, ""deletions"": 9, ""lines"": 10}, ""src/version.c"": {""insertions"": 2, ""deletions"": 0, ""lines"": 2}}"
2022-01-01 19:33:50,cbadefe25a27ded93548eaa7a325d2a04bf55d7c,Bram Moolenaar,104,34,138,14,"{""src/clientserver.c"": {""insertions"": 3, ""deletions"": 3, ""lines"": 6}, ""src/errors.h"": {""insertions"": 73, ""deletions"": 8, ""lines"": 81}, ""src/fileio.c"": {""insertions"": 1, ""deletions"": 1, ""lines"": 2}, ""src/gui.c"": {""insertions"": 2, ""deletions"": 2, ""lines"": 4}, ""src/gui_beval.c"": {""insertions"": 1, ""deletions"": 1, ""lines"": 2}, ""src/gui_w32.c"": {""insertions"": 2, ""deletions"": 3, ""lines"": 5}, ""src/gui_x11.c"": {""insertions"": 4, ""deletions"": 4, ""lines"": 8}, ""src/if_cscope.c"": {""insertions"": 3, ""deletions"": 2, ""lines"": 5}, ""src/if_xcmdsrv.c"": {""insertions"": 2, ""deletions"": 2, ""lines"": 4}, ""src/os_mswin.c"": {""insertions"": 8, ""deletions"": 5, ""lines"": 13}, ""src/sign.c"": {""insertions"": 1, ""deletions"": 1, ""lines"": 2}, ""src/version.c"": {""insertions"": 2, ""deletions"": 0, ""lines"": 2}, ""src/viminfo.c"": {""insertions"": 1, ""deletions"": 1, ""lines"": 2}, ""src/window.c"": {""insertions"": 1, ""deletions"": 1, ""lines"": 2}}"
2022-01-01 18:29:21,1f4a3457a3e55cdacd70ab0d5be587c248fb1ce8,Bram Moolenaar,16,1,17,3,"{""src/testdir/test_vim9_builtin.vim"": {""insertions"": 11, ""deletions"": 0, ""lines"": 11}, ""src/version.c"": {""insertions"": 2, ""deletions"": 0, ""lines"": 2}, ""src/vim9execute.c"": {""insertions"": 3, ""deletions"": 1, ""lines"": 4}}"
2022-01-01 16:31:48,0f7a5e758c5d8be2d8f1ab4a145d1636a36d18b2,Bram Moolenaar,4,0,4,2,"{""src/errors.h"": {""insertions"": 2, ""deletions"": 0, ""lines"": 2}, ""src/version.c"": {""insertions"": 2, ""deletions"": 0, ""lines"": 2}}"
2022-01-01 16:21:00,3a846e6bca25bd3d0addcd9ed3bdd9a6774adbe5,Bram Moolenaar,61,49,110,15,"{""src/errors.h"": {""insertions"": 30, ""deletions"": 0, ""lines"": 30}, ""src/eval.c"": {""insertions"": 4, ""deletions"": 4, ""lines"": 8}, ""src/evalfunc.c"": {""insertions"": 2, ""deletions"": 2, ""lines"": 4}, ""src/evalvars.c"": {""insertions"": 2, ""deletions"": 2, ""lines"": 4}, ""src/evalwindow.c"": {""insertions"": 1, ""deletions"": 1, ""lines"": 2}, ""src/ex_eval.c"": {""insertions"": 2, ""deletions"": 2, ""lines"": 4}, ""src/globals.h"": {""insertions"": 5, ""deletions"": 26, ""lines"": 31}, ""src/list.c"": {""insertions"": 2, ""deletions"": 2, ""lines"": 4}, ""src/match.c"": {""insertions"": 2, ""deletions"": 2, ""lines"": 4}, ""src/menu.c"": {""insertions"": 2, ""deletions"": 2, ""lines"": 4}, ""src/popupmenu.c"": {""insertions"": 1, ""deletions"": 1, ""lines"": 2}, ""src/search.c"": {""insertions"": 2, ""deletions"": 1, ""lines"": 3}, ""src/version.c"": {""insertions"": 2, ""deletions"": 0, ""lines"": 2}, ""src/vim9cmds.c"": {""insertions"": 3, ""deletions"": 3, ""lines"": 6}, ""src/vim9expr.c"": {""insertions"": 1, ""deletions"": 1, ""lines"": 2}}"
2022-01-01 16:01:23,0699b040e6794d27ffdca241a4358d7c31876385,Bram Moolenaar,3,1,4,2,"{""src/typval.c"": {""insertions"": 1, ""deletions"": 1, ""lines"": 2}, ""src/version.c"": {""insertions"": 2, ""deletions"": 0, ""lines"": 2}}"
2022-01-01 15:58:22,74409f62790a93daf0965c71da01ff76aa0fa5a5,Bram Moolenaar,161,131,292,39,"{""src/buffer.c"": {""insertions"": 1, ""deletions"": 1, ""lines"": 2}, ""src/bufwrite.c"": {""insertions"": 1, ""deletions"": 1, ""lines"": 2}, ""src/clientserver.c"": {""insertions"": 1, ""deletions"": 1, ""lines"": 2}, ""src/cmdhist.c"": {""insertions"": 2, ""deletions"": 2, ""lines"": 4}, ""src/dict.c"": {""insertions"": 3, ""deletions"": 3, ""lines"": 6}, ""src/edit.c"": {""insertions"": 1, ""deletions"": 1, ""lines"": 2}, ""src/errors.h"": {""insertions"": 72, ""deletions"": 0, ""lines"": 72}, ""src/eval.c"": {""insertions"": 3, ""deletions"": 3, ""lines"": 6}, ""src/evalfunc.c"": {""insertions"": 2, ""deletions"": 2, ""lines"": 4}, ""src/evalvars.c"": {""insertions"": 5, ""deletions"": 5, ""lines"": 10}, ""src/ex_cmds.c"": {""insertions"": 2, ""deletions"": 2, ""lines"": 4}, ""src/ex_docmd.c"": {""insertions"": 12, ""deletions"": 12, ""lines"": 24}, ""src/ex_eval.c"": {""insertions"": 1, ""deletions"": 1, ""lines"": 2}, ""src/ex_getln.c"": {""insertions"": 2, ""deletions"": 2, ""lines"": 4}, ""src/globals.h"": {""insertions"": 0, ""deletions"": 44, ""lines"": 44}, ""src/gui_w32.c"": {""insertions"": 1, ""deletions"": 1, ""lines"": 2}, ""src/gui_x11.c"": {""insertions"": 1, ""deletions"": 1, ""lines"": 2}, ""src/if_xcmdsrv.c"": {""insertions"": 1, ""deletions"": 1, ""lines"": 2}, ""src/insexpand.c"": {""insertions"": 1, ""deletions"": 1, ""lines"": 2}, ""src/json.c"": {""insertions"": 2, ""deletions"": 2, ""lines"": 4}, ""src/match.c"": {""insertions"": 1, ""deletions"": 1, ""lines"": 2}, ""src/menu.c"": {""insertions"": 1, ""deletions"": 1, ""lines"": 2}, ""src/option.c"": {""insertions"": 9, ""deletions"": 9, ""lines"": 18}, ""src/optionstr.c"": {""insertions"": 1, ""deletions"": 1, ""lines"": 2}, ""src/os_mswin.c"": {""insertions"": 1, ""deletions"": 1, ""lines"": 2}, ""src/quickfix.c"": {""insertions"": 3, ""deletions"": 3, ""lines"": 6}, ""src/regexp_bt.c"": {""insertions"": 4, ""deletions"": 4, ""lines"": 8}, ""src/regexp_nfa.c"": {""insertions"": 2, ""deletions"": 2, ""lines"": 4}, ""src/scriptfile.c"": {""insertions"": 1, ""deletions"": 1, ""lines"": 2}, ""src/sign.c"": {""insertions"": 1, ""deletions"": 1, ""lines"": 2}, ""src/spellfile.c"": {""insertions"": 1, ""deletions"": 1, ""lines"": 2}, ""src/undo.c"": {""insertions"": 3, ""deletions"": 3, ""lines"": 6}, ""src/userfunc.c"": {""insertions"": 5, ""deletions"": 5, ""lines"": 10}, ""src/version.c"": {""insertions"": 2, ""deletions"": 0, ""lines"": 2}, ""src/vim9cmds.c"": {""insertions"": 4, ""deletions"": 4, ""lines"": 8}, ""src/vim9compile.c"": {""insertions"": 1, ""deletions"": 1, ""lines"": 2}, ""src/vim9execute.c"": {""insertions"": 1, ""deletions"": 1, ""lines"": 2}, ""src/vim9expr.c"": {""insertions"": 5, ""deletions"": 5, ""lines"": 10}, ""src/window.c"": {""insertions"": 1, ""deletions"": 1, ""lines"": 2}}"
2022-01-01 14:59:44,56200eed62e59ad831f6564dcafe346e6f97ac20,naohiro ono,40,15,55,8,"{""runtime/doc/builtin.txt"": {""insertions"": 14, ""deletions"": 9, ""lines"": 23}, ""runtime/doc/eval.txt"": {""insertions"": 3, ""deletions"": 0, ""lines"": 3}, ""src/evalvars.c"": {""insertions"": 2, ""deletions"": 0, ""lines"": 2}, ""src/testdir/test_cursor_func.vim"": {""insertions"": 12, ""deletions"": 0, ""lines"": 12}, ""src/testdir/test_normal.vim"": {""insertions"": 4, ""deletions"": 4, ""lines"": 8}, ""src/testdir/test_put.vim"": {""insertions"": 1, ""deletions"": 1, ""lines"": 2}, ""src/version.c"": {""insertions"": 2, ""deletions"": 0, ""lines"": 2}, ""src/vim.h"": {""insertions"": 2, ""deletions"": 1, ""lines"": 3}}"
2022-01-01 14:25:55,e70cec976026ce72d09b6589ebba4677581063ac,Bram Moolenaar,5,3,8,3,"{""src/strings.c"": {""insertions"": 2, ""deletions"": 2, ""lines"": 4}, ""src/version.c"": {""insertions"": 2, ""deletions"": 0, ""lines"": 2}, ""src/vim9compile.c"": {""insertions"": 1, ""deletions"": 1, ""lines"": 2}}"
2022-01-01 14:19:49,460ae5dfca31fa627531c263184849976755cf6b,Bram Moolenaar,403,334,737,70,"{""src/arglist.c"": {""insertions"": 2, ""deletions"": 2, ""lines"": 4}, ""src/autocmd.c"": {""insertions"": 3, ""deletions"": 3, ""lines"": 6}, ""src/blob.c"": {""insertions"": 7, ""deletions"": 7, ""lines"": 14}, ""src/bufwrite.c"": {""insertions"": 1, ""deletions"": 1, ""lines"": 2}, ""src/channel.c"": {""insertions"": 1, ""deletions"": 1, ""lines"": 2}, ""src/cmdexpand.c"": {""insertions"": 2, ""deletions"": 2, ""lines"": 4}, ""src/dict.c"": {""insertions"": 3, ""deletions"": 3, ""lines"": 6}, ""src/diff.c"": {""insertions"": 1, ""deletions"": 1, ""lines"": 2}, ""src/errors.h"": {""insertions"": 130, ""deletions"": 1, ""lines"": 131}, ""src/eval.c"": {""insertions"": 9, ""deletions"": 9, ""lines"": 18}, ""src/evalfunc.c"": {""insertions"": 11, ""deletions"": 11, ""lines"": 22}, ""src/evalvars.c"": {""insertions"": 10, ""deletions"": 10, ""lines"": 20}, ""src/ex_cmds.c"": {""insertions"": 4, ""deletions"": 4, ""lines"": 8}, ""src/ex_docmd.c"": {""insertions"": 6, ""deletions"": 7, ""lines"": 13}, ""src/feature.h"": {""insertions"": 12, ""deletions"": 0, ""lines"": 12}, ""src/fileio.c"": {""insertions"": 2, ""deletions"": 2, ""lines"": 4}, ""src/filepath.c"": {""insertions"": 5, ""deletions"": 5, ""lines"": 10}, ""src/getchar.c"": {""insertions"": 1, ""deletions"": 1, ""lines"": 2}, ""src/globals.h"": {""insertions"": 0, ""deletions"": 74, ""lines"": 74}, ""src/gui_gtk_x11.c"": {""insertions"": 2, ""deletions"": 2, ""lines"": 4}, ""src/gui_x11.c"": {""insertions"": 1, ""deletions"": 1, ""lines"": 2}, ""src/hardcopy.c"": {""insertions"": 1, ""deletions"": 1, ""lines"": 2}, ""src/help.c"": {""insertions"": 1, ""deletions"": 1, ""lines"": 2}, ""src/highlight.c"": {""insertions"": 3, ""deletions"": 3, ""lines"": 6}, ""src/if_cscope.c"": {""insertions"": 1, ""deletions"": 1, ""lines"": 2}, ""src/if_lua.c"": {""insertions"": 2, ""deletions"": 2, ""lines"": 4}, ""src/if_mzsch.c"": {""insertions"": 4, ""deletions"": 4, ""lines"": 8}, ""src/if_perl.xs"": {""insertions"": 1, ""deletions"": 1, ""lines"": 2}, ""src/if_python.c"": {""insertions"": 3, ""deletions"": 3, ""lines"": 6}, ""src/if_python3.c"": {""insertions"": 3, ""deletions"": 3, ""lines"": 6}, ""src/if_ruby.c"": {""insertions"": 2, ""deletions"": 2, ""lines"": 4}, ""src/if_tcl.c"": {""insertions"": 2, ""deletions"": 2, ""lines"": 4}, ""src/if_xcmdsrv.c"": {""insertions"": 1, ""deletions"": 1, ""lines"": 2}, ""src/indent.c"": {""insertions"": 2, ""deletions"": 2, ""lines"": 4}, ""src/insexpand.c"": {""insertions"": 3, ""deletions"": 2, ""lines"": 5}, ""src/job.c"": {""insertions"": 1, ""deletions"": 1, ""lines"": 2}, ""src/list.c"": {""insertions"": 18, ""deletions"": 18, ""lines"": 36}, ""src/main.c"": {""insertions"": 1, ""deletions"": 1, ""lines"": 2}, ""src/map.c"": {""insertions"": 1, ""deletions"": 1, ""lines"": 2}, ""src/match.c"": {""insertions"": 2, ""deletions"": 2, ""lines"": 4}, ""src/mbyte.c"": {""insertions"": 3, ""deletions"": 3, ""lines"": 6}, ""src/message.c"": {""insertions"": 3, ""deletions"": 3, ""lines"": 6}, ""src/misc1.c"": {""insertions"": 6, ""deletions"": 6, ""lines"": 12}, ""src/option.c"": {""insertions"": 22, ""deletions"": 22, ""lines"": 44}, ""src/optionstr.c"": {""insertions"": 1, ""deletions"": 1, ""lines"": 2}, ""src/os_mswin.c"": {""insertions"": 2, ""deletions"": 2, ""lines"": 4}, ""src/os_unix.c"": {""insertions"": 7, ""deletions"": 7, ""lines"": 14}, ""src/os_win32.c"": {""insertions"": 5, ""deletions"": 5, ""lines"": 10}, ""src/popupwin.c"": {""insertions"": 9, ""deletions"": 9, ""lines"": 18}, ""src/profiler.c"": {""insertions"": 1, ""deletions"": 1, ""lines"": 2}, ""src/quickfix.c"": {""insertions"": 10, ""deletions"": 10, ""lines"": 20}, ""src/scriptfile.c"": {""insertions"": 1, ""deletions"": 1, ""lines"": 2}, ""src/search.c"": {""insertions"": 3, ""deletions"": 3, ""lines"": 6}, ""src/session.c"": {""insertions"": 1, ""deletions"": 1, ""lines"": 2}, ""src/sign.c"": {""insertions"": 9, ""deletions"": 9, ""lines"": 18}, ""src/spell.c"": {""insertions"": 1, ""deletions"": 1, ""lines"": 2}, ""src/spellfile.c"": {""insertions"": 8, ""deletions"": 8, ""lines"": 16}, ""src/spellsuggest.c"": {""insertions"": 2, ""deletions"": 2, ""lines"": 4}, ""src/syntax.c"": {""insertions"": 1, ""deletions"": 1, ""lines"": 2}, ""src/tag.c"": {""insertions"": 1, ""deletions"": 1, ""lines"": 2}, ""src/terminal.c"": {""insertions"": 10, ""deletions"": 10, ""lines"": 20}, ""src/testing.c"": {""insertions"": 2, ""deletions"": 2, ""lines"": 4}, ""src/textprop.c"": {""insertions"": 10, ""deletions"": 10, ""lines"": 20}, ""src/typval.c"": {""insertions"": 1, ""deletions"": 1, ""lines"": 2}, ""src/userfunc.c"": {""insertions"": 4, ""deletions"": 4, ""lines"": 8}, ""src/version.c"": {""insertions"": 2, ""deletions"": 0, ""lines"": 2}, ""src/vim9execute.c"": {""insertions"": 10, ""deletions"": 10, ""lines"": 20}, ""src/vim9expr.c"": {""insertions"": 1, ""deletions"": 1, ""lines"": 2}, ""src/vim9instr.c"": {""insertions"": 1, ""deletions"": 1, ""lines"": 2}, ""src/vim9script.c"": {""insertions"": 1, ""deletions"": 1, ""lines"": 2}}"
2022-01-01 12:42:56,b37a65e4bf08c4eec4fa5b81a5efc3945fca44de,Bram Moolenaar,15,0,15,3,"{""src/getchar.c"": {""insertions"": 3, ""deletions"": 0, ""lines"": 3}, ""src/testdir/test_feedkeys.vim"": {""insertions"": 10, ""deletions"": 0, ""lines"": 10}, ""src/version.c"": {""insertions"": 2, ""deletions"": 0, ""lines"": 2}}"
2022-01-01 12:17:00,b79ee0c299d786627784f7304ba84b80e78ece26,Bram Moolenaar,22,5,27,4,"{""runtime/doc/vim9.txt"": {""insertions"": 2, ""deletions"": 5, ""lines"": 7}, ""src/evalfunc.c"": {""insertions"": 1, ""deletions"": 0, ""lines"": 1}, ""src/testdir/test_vim9_script.vim"": {""insertions"": 17, ""deletions"": 0, ""lines"": 17}, ""src/version.c"": {""insertions"": 2, ""deletions"": 0, ""lines"": 2}}"
2022-01-01 11:38:42,654b729c4c9951f2a46c161d1e9fefdc223fc94e,Alex Vear,7,5,12,3,"{""runtime/filetype.vim"": {""insertions"": 3, ""deletions"": 3, ""lines"": 6}, ""src/testdir/test_filetype.vim"": {""insertions"": 2, ""deletions"": 2, ""lines"": 4}, ""src/version.c"": {""insertions"": 2, ""deletions"": 0, ""lines"": 2}}"
2022-01-01 00:55:28,096ca73dacd748a65d080197b842eef6f4423096,Bram Moolenaar,6,2,8,3,"{""src/errors.h"": {""insertions"": 3, ""deletions"": 1, ""lines"": 4}, ""src/message.c"": {""insertions"": 1, ""deletions"": 1, ""lines"": 2}, ""src/version.c"": {""insertions"": 2, ""deletions"": 0, ""lines"": 2}}"
2021-12-31 23:15:53,d0819d11ecdf3bca4b0800ef905091b5e175b6f4,Bram Moolenaar,4,1,5,2,"{""src/regexp_bt.c"": {""insertions"": 2, ""deletions"": 1, ""lines"": 3}, ""src/version.c"": {""insertions"": 2, ""deletions"": 0, ""lines"": 2}}"
2021-12-31 22:49:24,436b5adc9770a2568209dd5ab1f98bd1afc91898,Bram Moolenaar,427,403,830,62,"{""src/arglist.c"": {""insertions"": 1, ""deletions"": 1, ""lines"": 2}, ""src/autocmd.c"": {""insertions"": 1, ""deletions"": 1, ""lines"": 2}, ""src/blob.c"": {""insertions"": 2, ""deletions"": 2, ""lines"": 4}, ""src/bufwrite.c"": {""insertions"": 4, ""deletions"": 4, ""lines"": 8}, ""src/channel.c"": {""insertions"": 6, ""deletions"": 6, ""lines"": 12}, ""src/clipboard.c"": {""insertions"": 2, ""deletions"": 2, ""lines"": 4}, ""src/cmdexpand.c"": {""insertions"": 2, ""deletions"": 2, ""lines"": 4}, ""src/debugger.c"": {""insertions"": 2, ""deletions"": 2, ""lines"": 4}, ""src/dict.c"": {""insertions"": 2, ""deletions"": 2, ""lines"": 4}, ""src/errors.h"": {""insertions"": 48, ""deletions"": 1, ""lines"": 49}, ""src/eval.c"": {""insertions"": 1, ""deletions"": 1, ""lines"": 2}, ""src/evalfunc.c"": {""insertions"": 18, ""deletions"": 18, ""lines"": 36}, ""src/evalvars.c"": {""insertions"": 9, ""deletions"": 9, ""lines"": 18}, ""src/evalwindow.c"": {""insertions"": 2, ""deletions"": 2, ""lines"": 4}, ""src/ex_cmds.c"": {""insertions"": 8, ""deletions"": 8, ""lines"": 16}, ""src/ex_docmd.c"": {""insertions"": 19, ""deletions"": 19, ""lines"": 38}, ""src/ex_eval.c"": {""insertions"": 10, ""deletions"": 10, ""lines"": 20}, ""src/ex_getln.c"": {""insertions"": 1, ""deletions"": 1, ""lines"": 2}, ""src/fileio.c"": {""insertions"": 1, ""deletions"": 1, ""lines"": 2}, ""src/filepath.c"": {""insertions"": 2, ""deletions"": 2, ""lines"": 4}, ""src/globals.h"": {""insertions"": 2, ""deletions"": 30, ""lines"": 32}, ""src/gui_gtk_x11.c"": {""insertions"": 1, ""deletions"": 1, ""lines"": 2}, ""src/gui_haiku.cc"": {""insertions"": 2, ""deletions"": 2, ""lines"": 4}, ""src/gui_photon.c"": {""insertions"": 1, ""deletions"": 1, ""lines"": 2}, ""src/gui_w32.c"": {""insertions"": 1, ""deletions"": 1, ""lines"": 2}, ""src/gui_x11.c"": {""insertions"": 3, ""deletions"": 3, ""lines"": 6}, ""src/highlight.c"": {""insertions"": 1, ""deletions"": 1, ""lines"": 2}, ""src/indent.c"": {""insertions"": 8, ""deletions"": 5, ""lines"": 13}, ""src/insexpand.c"": {""insertions"": 1, ""deletions"": 1, ""lines"": 2}, ""src/job.c"": {""insertions"": 36, ""deletions"": 36, ""lines"": 72}, ""src/json.c"": {""insertions"": 2, ""deletions"": 2, ""lines"": 4}, ""src/list.c"": {""insertions"": 3, ""deletions"": 3, ""lines"": 6}, ""src/map.c"": {""insertions"": 2, ""deletions"": 2, ""lines"": 4}, ""src/mark.c"": {""insertions"": 4, ""deletions"": 4, ""lines"": 8}, ""src/match.c"": {""insertions"": 5, ""deletions"": 5, ""lines"": 10}, ""src/mbyte.c"": {""insertions"": 2, ""deletions"": 2, ""lines"": 4}, ""src/menu.c"": {""insertions"": 3, ""deletions"": 3, ""lines"": 6}, ""src/message.c"": {""insertions"": 1, ""deletions"": 1, ""lines"": 2}, ""src/misc2.c"": {""insertions"": 2, ""deletions"": 2, ""lines"": 4}, ""src/ops.c"": {""insertions"": 1, ""deletions"": 1, ""lines"": 2}, ""src/option.c"": {""insertions"": 13, ""deletions"": 13, ""lines"": 26}, ""src/optionstr.c"": {""insertions"": 83, ""deletions"": 83, ""lines"": 166}, ""src/popupwin.c"": {""insertions"": 8, ""deletions"": 8, ""lines"": 16}, ""src/quickfix.c"": {""insertions"": 2, ""deletions"": 2, ""lines"": 4}, ""src/screen.c"": {""insertions"": 7, ""deletions"": 7, ""lines"": 14}, ""src/scriptfile.c"": {""insertions"": 4, ""deletions"": 4, ""lines"": 8}, ""src/search.c"": {""insertions"": 7, ""deletions"": 7, ""lines"": 14}, ""src/sign.c"": {""insertions"": 13, ""deletions"": 13, ""lines"": 26}, ""src/spell.c"": {""insertions"": 2, ""deletions"": 2, ""lines"": 4}, ""src/spellfile.c"": {""insertions"": 1, ""deletions"": 1, ""lines"": 2}, ""src/strings.c"": {""insertions"": 5, ""deletions"": 5, ""lines"": 10}, ""src/syntax.c"": {""insertions"": 6, ""deletions"": 6, ""lines"": 12}, ""src/terminal.c"": {""insertions"": 9, ""deletions"": 9, ""lines"": 18}, ""src/testing.c"": {""insertions"": 12, ""deletions"": 12, ""lines"": 24}, ""src/textprop.c"": {""insertions"": 9, ""deletions"": 9, ""lines"": 18}, ""src/time.c"": {""insertions"": 5, ""deletions"": 5, ""lines"": 10}, ""src/userfunc.c"": {""insertions"": 4, ""deletions"": 4, ""lines"": 8}, ""src/version.c"": {""insertions"": 2, ""deletions"": 0, ""lines"": 2}, ""src/vim9cmds.c"": {""insertions"": 6, ""deletions"": 6, ""lines"": 12}, ""src/vim9execute.c"": {""insertions"": 1, ""deletions"": 1, ""lines"": 2}, ""src/vim9script.c"": {""insertions"": 2, ""deletions"": 2, ""lines"": 4}, ""src/window.c"": {""insertions"": 4, ""deletions"": 4, ""lines"": 8}}"
2021-12-31 19:59:55,f1474d801bbdb73406dd3d1f931f515f99e86dfa,Bram Moolenaar,145,47,192,9,"{""src/alloc.c"": {""insertions"": 2, ""deletions"": 2, ""lines"": 4}, ""src/arglist.c"": {""insertions"": 2, ""deletions"": 2, ""lines"": 4}, ""src/autocmd.c"": {""insertions"": 3, ""deletions"": 4, ""lines"": 7}, ""src/blob.c"": {""insertions"": 1, ""deletions"": 1, ""lines"": 2}, ""src/blowfish.c"": {""insertions"": 5, ""deletions"": 5, ""lines"": 10}, ""src/buffer.c"": {""insertions"": 9, ""deletions"": 11, ""lines"": 20}, ""src/bufwrite.c"": {""insertions"": 21, ""deletions"": 22, ""lines"": 43}, ""src/errors.h"": {""insertions"": 100, ""deletions"": 0, ""lines"": 100}, ""src/version.c"": {""insertions"": 2, ""deletions"": 0, ""lines"": 2}}"
2021-12-31 18:49:43,6d0570117ac86b7979bf249de5741088212d6e17,Bram Moolenaar,122,45,167,13,"{""src/autocmd.c"": {""insertions"": 5, ""deletions"": 5, ""lines"": 10}, ""src/bufwrite.c"": {""insertions"": 8, ""deletions"": 8, ""lines"": 16}, ""src/errors.h"": {""insertions"": 79, ""deletions"": 2, ""lines"": 81}, ""src/evalvars.c"": {""insertions"": 1, ""deletions"": 1, ""lines"": 2}, ""src/ex_docmd.c"": {""insertions"": 3, ""deletions"": 3, ""lines"": 6}, ""src/ex_eval.c"": {""insertions"": 3, ""deletions"": 3, ""lines"": 6}, ""src/ex_getln.c"": {""insertions"": 1, ""deletions"": 1, ""lines"": 2}, ""src/fileio.c"": {""insertions"": 9, ""deletions"": 9, ""lines"": 18}, ""src/getchar.c"": {""insertions"": 2, ""deletions"": 2, ""lines"": 4}, ""src/gui.c"": {""insertions"": 1, ""deletions"": 1, ""lines"": 2}, ""src/locale.c"": {""insertions"": 1, ""deletions"": 1, ""lines"": 2}, ""src/map.c"": {""insertions"": 7, ""deletions"": 9, ""lines"": 16}, ""src/version.c"": {""insertions"": 2, ""deletions"": 0, ""lines"": 2}}"
2021-12-31 17:33:47,ef089f50f9d6685c7a0ab94f9133576d7beec32b,Yegappan Lakshmanan,6,0,6,2,"{""src/version.c"": {""insertions"": 2, ""deletions"": 0, ""lines"": 2}, ""src/xxd/xxd.c"": {""insertions"": 4, ""deletions"": 0, ""lines"": 4}}"
2021-12-31 17:25:48,1a9922243a90f213894d5c58cd063465eea3350f,Bram Moolenaar,112,51,163,15,"{""src/arglist.c"": {""insertions"": 3, ""deletions"": 3, ""lines"": 6}, ""src/bufwrite.c"": {""insertions"": 2, ""deletions"": 1, ""lines"": 3}, ""src/errors.h"": {""insertions"": 64, ""deletions"": 3, ""lines"": 67}, ""src/evalvars.c"": {""insertions"": 1, ""deletions"": 1, ""lines"": 2}, ""src/ex_cmds2.c"": {""insertions"": 1, ""deletions"": 1, ""lines"": 2}, ""src/ex_docmd.c"": {""insertions"": 12, ""deletions"": 12, ""lines"": 24}, ""src/ex_eval.c"": {""insertions"": 4, ""deletions"": 4, ""lines"": 8}, ""src/globals.h"": {""insertions"": 0, ""deletions"": 3, ""lines"": 3}, ""src/help.c"": {""insertions"": 1, ""deletions"": 1, ""lines"": 2}, ""src/scriptfile.c"": {""insertions"": 2, ""deletions"": 2, ""lines"": 4}, ""src/usercmd.c"": {""insertions"": 11, ""deletions"": 11, ""lines"": 22}, ""src/userfunc.c"": {""insertions"": 3, ""deletions"": 3, ""lines"": 6}, ""src/version.c"": {""insertions"": 2, ""deletions"": 0, ""lines"": 2}, ""src/vim9cmds.c"": {""insertions"": 3, ""deletions"": 3, ""lines"": 6}, ""src/vim9compile.c"": {""insertions"": 3, ""deletions"": 3, ""lines"": 6}}"
2021-12-31 15:21:53,4b1478093eb8b8bebc94b1f596e0afc25db4d189,zeertzjq,2,1,3,2,"{""src/evalfunc.c"": {""insertions"": 0, ""deletions"": 1, ""lines"": 1}, ""src/version.c"": {""insertions"": 2, ""deletions"": 0, ""lines"": 2}}"
2021-12-31 15:09:27,eb822a280cf4706f7e67319ced1cdf3243b27e20,Bram Moolenaar,77,29,106,8,"{""src/debugger.c"": {""insertions"": 1, ""deletions"": 1, ""lines"": 2}, ""src/errors.h"": {""insertions"": 48, ""deletions"": 0, ""lines"": 48}, ""src/ex_cmds.c"": {""insertions"": 11, ""deletions"": 12, ""lines"": 23}, ""src/globals.h"": {""insertions"": 0, ""deletions"": 1, ""lines"": 1}, ""src/help.c"": {""insertions"": 6, ""deletions"": 6, ""lines"": 12}, ""src/sign.c"": {""insertions"": 8, ""deletions"": 8, ""lines"": 16}, ""src/spellfile.c"": {""insertions"": 1, ""deletions"": 1, ""lines"": 2}, ""src/version.c"": {""insertions"": 2, ""deletions"": 0, ""lines"": 2}}"
2021-12-31 14:06:45,9a015111a56d0011ced40d98f46a9841d1457b51,Bram Moolenaar,48,3,51,4,"{""src/testdir/test_vim9_assign.vim"": {""insertions"": 3, ""deletions"": 3, ""lines"": 6}, ""src/testdir/test_vim9_func.vim"": {""insertions"": 12, ""deletions"": 0, ""lines"": 12}, ""src/version.c"": {""insertions"": 2, ""deletions"": 0, ""lines"": 2}, ""src/vim9compile.c"": {""insertions"": 31, ""deletions"": 0, ""lines"": 31}}"
2021-12-31 12:59:53,6ad84ab3e48d9490e4139df04f2c55b136f5501d,Yegappan Lakshmanan,605,562,1167,2,"{""src/insexpand.c"": {""insertions"": 603, ""deletions"": 562, ""lines"": 1165}, ""src/version.c"": {""insertions"": 2, ""deletions"": 0, ""lines"": 2}}"
2021-12-31 12:19:22,1fa3de1ce806ba18ebcc00c6d9a0678a84735463,zeertzjq,51,1,52,3,"{""src/ex_cmds.c"": {""insertions"": 5, ""deletions"": 1, ""lines"": 6}, ""src/testdir/test_excmd.vim"": {""insertions"": 44, ""deletions"": 0, ""lines"": 44}, ""src/version.c"": {""insertions"": 2, ""deletions"": 0, ""lines"": 2}}"
2021-12-30 20:24:12,04fb916684829f6aa12f33f14d0d0023b458f200,Bram Moolenaar,798,822,1620,9,"{""runtime/doc/builtin.txt"": {""insertions"": 1, ""deletions"": 1, ""lines"": 2}, ""runtime/doc/change.txt"": {""insertions"": 3, ""deletions"": 2, ""lines"": 5}, ""runtime/doc/eval.txt"": {""insertions"": 8, ""deletions"": 6, ""lines"": 14}, ""runtime/doc/filetype.txt"": {""insertions"": 3, ""deletions"": 3, ""lines"": 6}, ""runtime/doc/insert.txt"": {""insertions"": 6, ""deletions"": 1, ""lines"": 7}, ""runtime/doc/tags"": {""insertions"": 4, ""deletions"": 2, ""lines"": 6}, ""runtime/doc/todo.txt"": {""insertions"": 1, ""deletions"": 4, ""lines"": 5}, ""runtime/doc/usr_41.txt"": {""insertions"": 764, ""deletions"": 795, ""lines"": 1559}, ""runtime/syntax/vim.vim"": {""insertions"": 8, ""deletions"": 8, ""lines"": 16}}"
2021-12-30 17:09:05,d293981d2b76b40013143fe2302b910585e50808,Bram Moolenaar,17,3,20,3,"{""src/testdir/test_vim9_func.vim"": {""insertions"": 14, ""deletions"": 3, ""lines"": 17}, ""src/version.c"": {""insertions"": 2, ""deletions"": 0, ""lines"": 2}, ""src/vim9compile.c"": {""insertions"": 1, ""deletions"": 0, ""lines"": 1}}"
2021-12-30 15:29:18,94f3192b03ed27474db80b4d3a409e107140738b,Bram Moolenaar,19,4,23,3,"{""src/charset.c"": {""insertions"": 9, ""deletions"": 4, ""lines"": 13}, ""src/testdir/test_regexp_latin.vim"": {""insertions"": 8, ""deletions"": 0, ""lines"": 8}, ""src/version.c"": {""insertions"": 2, ""deletions"": 0, ""lines"": 2}}"
2021-12-30 14:49:43,4c13e5e6763c6eb36a343a2b8235ea227202e952,Bram Moolenaar,17,2,19,3,"{""src/regexp.c"": {""insertions"": 7, ""deletions"": 2, ""lines"": 9}, ""src/testdir/test_regexp_latin.vim"": {""insertions"": 8, ""deletions"": 0, ""lines"": 8}, ""src/version.c"": {""insertions"": 2, ""deletions"": 0, ""lines"": 2}}"
2021-12-30 13:59:20,cfe3af284a26178f4838df7c7489b2a1edd4c3a1,Bram Moolenaar,14,9,23,2,"{""src/version.c"": {""insertions"": 2, ""deletions"": 0, ""lines"": 2}, ""src/vim9type.c"": {""insertions"": 12, ""deletions"": 9, ""lines"": 21}}"
2021-12-30 13:45:57,f38aad85cf8e4e930c96cb843bc136949c8dbd29,zeertzjq,4,2,6,2,"{""src/ex_docmd.c"": {""insertions"": 2, ""deletions"": 2, ""lines"": 4}, ""src/version.c"": {""insertions"": 2, ""deletions"": 0, ""lines"": 2}}"
2021-12-30 13:32:09,1c67f3a9779b99bed7aacb3108abbb649445d3ed,Bram Moolenaar,7,1,8,3,"{""src/message.c"": {""insertions"": 4, ""deletions"": 1, ""lines"": 5}, ""src/testdir/runtest.vim"": {""insertions"": 1, ""deletions"": 0, ""lines"": 1}, ""src/version.c"": {""insertions"": 2, ""deletions"": 0, ""lines"": 2}}"
2021-12-30 13:29:00,13789bf10338a0d049c78acfdc0870fc63e63f4f,Bram Moolenaar,53,0,53,4,"{""src/testdir/test_vim9_assign.vim"": {""insertions"": 30, ""deletions"": 0, ""lines"": 30}, ""src/userfunc.c"": {""insertions"": 6, ""deletions"": 0, ""lines"": 6}, ""src/version.c"": {""insertions"": 2, ""deletions"": 0, ""lines"": 2}, ""src/vim9type.c"": {""insertions"": 15, ""deletions"": 0, ""lines"": 15}}"
2021-12-30 11:40:53,5d2e007ccbfbd749a1f201d06965b8811ff50e6e,Yegappan Lakshmanan,757,594,1351,3,"{""src/insexpand.c"": {""insertions"": 736, ""deletions"": 594, ""lines"": 1330}, ""src/testdir/test_ins_complete.vim"": {""insertions"": 19, ""deletions"": 0, ""lines"": 19}, ""src/version.c"": {""insertions"": 2, ""deletions"": 0, ""lines"": 2}}"
2021-12-30 10:51:45,491669701c72578f273db53e579d8a03a9deac0c,Bram Moolenaar,3,4,7,2,"{""src/diff.c"": {""insertions"": 1, ""deletions"": 4, ""lines"": 5}, ""src/version.c"": {""insertions"": 2, ""deletions"": 0, ""lines"": 2}}"
2021-12-30 10:32:25,8e7cc6b920ddea37deaa5e6b7b3bdfff2222d137,Bram Moolenaar,4,0,4,2,"{""src/insexpand.c"": {""insertions"": 2, ""deletions"": 0, ""lines"": 2}, ""src/version.c"": {""insertions"": 2, ""deletions"": 0, ""lines"": 2}}"
2021-12-29 19:41:47,ab16ad33ba10dd12ff6660fa57b88f1a30ddd8ba,dbivolaru,94,7,101,6,"{""runtime/doc/autocmd.txt"": {""insertions"": 2, ""deletions"": 2, ""lines"": 4}, ""src/ex_docmd.c"": {""insertions"": 1, ""deletions"": 2, ""lines"": 3}, ""src/os_unix.c"": {""insertions"": 36, ""deletions"": 3, ""lines"": 39}, ""src/proto/ex_docmd.pro"": {""insertions"": 1, ""deletions"": 0, ""lines"": 1}, ""src/testdir/test_signals.vim"": {""insertions"": 52, ""deletions"": 0, ""lines"": 52}, ""src/version.c"": {""insertions"": 2, ""deletions"": 0, ""lines"": 2}}"
2021-12-29 19:22:44,94fb8274ca8c93a10102d41c8bcc848f75cb7334,Bram Moolenaar,36,1,37,5,"{""src/match.c"": {""insertions"": 1, ""deletions"": 1, ""lines"": 2}, ""src/testdir/dumps/Test_match_with_incsearch_1.dump"": {""insertions"": 6, ""deletions"": 0, ""lines"": 6}, ""src/testdir/dumps/Test_match_with_incsearch_2.dump"": {""insertions"": 6, ""deletions"": 0, ""lines"": 6}, ""src/testdir/test_match.vim"": {""insertions"": 21, ""deletions"": 0, ""lines"": 21}, ""src/version.c"": {""insertions"": 2, ""deletions"": 0, ""lines"": 2}}"
2021-12-29 18:16:21,5a664fe57fe7ba65a771bc95ef1c205e4db193b7,Yegappan Lakshmanan,4,1,5,3,"{""src/os_mswin.c"": {""insertions"": 1, ""deletions"": 1, ""lines"": 2}, ""src/testdir/test_fnamemodify.vim"": {""insertions"": 1, ""deletions"": 0, ""lines"": 1}, ""src/version.c"": {""insertions"": 2, ""deletions"": 0, ""lines"": 2}}"
2021-12-29 18:09:13,ba26367fea3b63df49d274f3d5cca0af38402add,Bram Moolenaar,42,19,61,5,"{""src/cindent.c"": {""insertions"": 17, ""deletions"": 14, ""lines"": 31}, ""src/proto/cindent.pro"": {""insertions"": 1, ""deletions"": 0, ""lines"": 1}, ""src/search.c"": {""insertions"": 7, ""deletions"": 5, ""lines"": 12}, ""src/testdir/test_textformat.vim"": {""insertions"": 15, ""deletions"": 0, ""lines"": 15}, ""src/version.c"": {""insertions"": 2, ""deletions"": 0, ""lines"": 2}}"
2021-12-29 17:38:46,edc6f103907a004b9e2265e232dc8be8bc594601,Yegappan Lakshmanan,552,346,898,3,"{""src/insexpand.c"": {""insertions"": 505, ""deletions"": 345, ""lines"": 850}, ""src/testdir/test_ins_complete.vim"": {""insertions"": 45, ""deletions"": 1, ""lines"": 46}, ""src/version.c"": {""insertions"": 2, ""deletions"": 0, ""lines"": 2}}"
2021-12-29 16:44:48,ccc1644f95e7833c23fa0d440e42293c1622fdcb,Sean Dewar,26,16,42,2,"{""src/testdir/test_diffmode.vim"": {""insertions"": 24, ""deletions"": 16, ""lines"": 40}, ""src/version.c"": {""insertions"": 2, ""deletions"": 0, ""lines"": 2}}"
2021-12-29 16:05:31,5d20fbf2e79b96a39abbdadc486b656cdcc67ed6,Bram Moolenaar,33,1,34,3,"{""src/edit.c"": {""insertions"": 15, ""deletions"": 0, ""lines"": 15}, ""src/testdir/test_textformat.vim"": {""insertions"": 16, ""deletions"": 1, ""lines"": 17}, ""src/version.c"": {""insertions"": 2, ""deletions"": 0, ""lines"": 2}}"
2021-12-29 15:15:47,5ea5f373729589acb38ce3f3ca338e8a6d398bdc,Bram Moolenaar,28,2,30,3,"{""src/change.c"": {""insertions"": 3, ""deletions"": 2, ""lines"": 5}, ""src/testdir/test_textformat.vim"": {""insertions"": 23, ""deletions"": 0, ""lines"": 23}, ""src/version.c"": {""insertions"": 2, ""deletions"": 0, ""lines"": 2}}"
2021-12-29 14:39:08,3d0abad5bf4fe125e219f1b56c4e8200cb900e2a,Richard Doty,25,14,39,3,"{""src/ex_docmd.c"": {""insertions"": 16, ""deletions"": 14, ""lines"": 30}, ""src/testdir/test_cd.vim"": {""insertions"": 7, ""deletions"": 0, ""lines"": 7}, ""src/version.c"": {""insertions"": 2, ""deletions"": 0, ""lines"": 2}}"
2021-12-29 14:09:32,264d3ddac0f9474816c20a0e92014d6f7f4b08ac,Bram Moolenaar,28,2,30,3,"{""src/testdir/test_textformat.vim"": {""insertions"": 15, ""deletions"": 0, ""lines"": 15}, ""src/textformat.c"": {""insertions"": 11, ""deletions"": 2, ""lines"": 13}, ""src/version.c"": {""insertions"": 2, ""deletions"": 0, ""lines"": 2}}"
2021-12-29 11:59:53,febb78fa1798e0f95983b3f7881419a754886df5,Bram Moolenaar,5,0,5,2,"{""src/diff.c"": {""insertions"": 3, ""deletions"": 0, ""lines"": 3}, ""src/version.c"": {""insertions"": 2, ""deletions"": 0, ""lines"": 2}}"
2021-12-28 20:59:56,c97f9a55bd020b94d92c392516d763ed5e43d872,Bram Moolenaar,11,9,20,7,"{""src/ex_docmd.c"": {""insertions"": 1, ""deletions"": 1, ""lines"": 2}, ""src/ex_getln.c"": {""insertions"": 4, ""deletions"": 4, ""lines"": 8}, ""src/normal.c"": {""insertions"": 1, ""deletions"": 1, ""lines"": 2}, ""src/proto/ex_getln.pro"": {""insertions"": 1, ""deletions"": 1, ""lines"": 2}, ""src/register.c"": {""insertions"": 1, ""deletions"": 1, ""lines"": 2}, ""src/userfunc.c"": {""insertions"": 1, ""deletions"": 1, ""lines"": 2}, ""src/version.c"": {""insertions"": 2, ""deletions"": 0, ""lines"": 2}}"
2021-12-28 20:53:30,10c75c4a09a604ea674a2700aacb55914750b86d,Bram Moolenaar,5,0,5,2,"{""src/option.c"": {""insertions"": 3, ""deletions"": 0, ""lines"": 3}, ""src/version.c"": {""insertions"": 2, ""deletions"": 0, ""lines"": 2}}"
2021-12-28 20:49:56,11ceb7d949e7c2fb36509a79dfe8df54fbdfa666,Bram Moolenaar,6,3,9,2,"{""src/userfunc.c"": {""insertions"": 4, ""deletions"": 3, ""lines"": 7}, ""src/version.c"": {""insertions"": 2, ""deletions"": 0, ""lines"": 2}}"
2021-12-28 20:18:50,8c697e3698e7dbe0a3c4524ac360b78ceb852b23,Bram Moolenaar,4,1,5,2,"{""src/userfunc.c"": {""insertions"": 2, ""deletions"": 1, ""lines"": 3}, ""src/version.c"": {""insertions"": 2, ""deletions"": 0, ""lines"": 2}}"
2021-12-28 20:03:43,92f246e4f9936f15471d5ee71b9afd5f3e6e0653,Bram Moolenaar,10,1,11,2,"{""src/evalwindow.c"": {""insertions"": 8, ""deletions"": 1, ""lines"": 9}, ""src/version.c"": {""insertions"": 2, ""deletions"": 0, ""lines"": 2}}"
2021-12-28 18:30:05,06f6095623cfcc72da08748c058d13b465652fd4,Bram Moolenaar,131,4,135,7,"{""src/diff.c"": {""insertions"": 12, ""deletions"": 4, ""lines"": 16}, ""src/testdir/dumps/Test_diff_bin_01.dump"": {""insertions"": 20, ""deletions"": 0, ""lines"": 20}, ""src/testdir/dumps/Test_diff_bin_02.dump"": {""insertions"": 20, ""deletions"": 0, ""lines"": 20}, ""src/testdir/dumps/Test_diff_bin_03.dump"": {""insertions"": 20, ""deletions"": 0, ""lines"": 20}, ""src/testdir/dumps/Test_diff_bin_04.dump"": {""insertions"": 20, ""deletions"": 0, ""lines"": 20}, ""src/testdir/test_diffmode.vim"": {""insertions"": 37, ""deletions"": 0, ""lines"": 37}, ""src/version.c"": {""insertions"": 2, ""deletions"": 0, ""lines"": 2}}"
2021-12-28 17:55:26,7473a84cf935f64ddd4ea7fe7eee0f9c51c50b60,Bram Moolenaar,56,22,78,5,"{""src/errors.h"": {""insertions"": 2, ""deletions"": 2, ""lines"": 4}, ""src/testdir/test_vim9_func.vim"": {""insertions"": 12, ""deletions"": 3, ""lines"": 15}, ""src/userfunc.c"": {""insertions"": 33, ""deletions"": 16, ""lines"": 49}, ""src/version.c"": {""insertions"": 2, ""deletions"": 0, ""lines"": 2}, ""src/vim9compile.c"": {""insertions"": 7, ""deletions"": 1, ""lines"": 8}}"
2021-12-28 17:23:12,4bf1006cae7e87259ccd5219128c3dba75774441,Bram Moolenaar,23,1,24,3,"{""src/testdir/test_vim9_func.vim"": {""insertions"": 19, ""deletions"": 1, ""lines"": 20}, ""src/userfunc.c"": {""insertions"": 2, ""deletions"": 0, ""lines"": 2}, ""src/version.c"": {""insertions"": 2, ""deletions"": 0, ""lines"": 2}}"
2021-12-28 15:51:45,8bb3fe4d4dcd27c02e903f6772fdc8fe2e9eba70,ichizok,98,31,129,10,"{""ci/config.mk.clang-12.sed"": {""insertions"": 2, ""deletions"": 2, ""lines"": 4}, ""ci/config.mk.clang.sed"": {""insertions"": 1, ""deletions"": 1, ""lines"": 2}, ""ci/config.mk.sed"": {""insertions"": 2, ""deletions"": 1, ""lines"": 3}, ""src/Makefile"": {""insertions"": 13, ""deletions"": 12, ""lines"": 25}, ""src/auto/configure"": {""insertions"": 12, ""deletions"": 0, ""lines"": 12}, ""src/config.mk.in"": {""insertions"": 6, ""deletions"": 0, ""lines"": 6}, ""src/configure.ac"": {""insertions"": 6, ""deletions"": 0, ""lines"": 6}, ""src/if_ruby.c"": {""insertions"": 47, ""deletions"": 10, ""lines"": 57}, ""src/version.c"": {""insertions"": 2, ""deletions"": 0, ""lines"": 2}, ""src/vim.h"": {""insertions"": 7, ""deletions"": 5, ""lines"": 12}}"
2021-12-28 13:54:41,d9da86e94ea8dbaa056270a666892945c40a6674,Lewis Russell,146,116,262,2,"{""src/diff.c"": {""insertions"": 144, ""deletions"": 116, ""lines"": 260}, ""src/version.c"": {""insertions"": 2, ""deletions"": 0, ""lines"": 2}}"
2021-12-28 13:15:05,90c317f2246a7fb4bd4e3feb0778b53627bc9fad,Bram Moolenaar,41,4,45,3,"{""src/evalwindow.c"": {""insertions"": 19, ""deletions"": 4, ""lines"": 23}, ""src/testdir/test_autochdir.vim"": {""insertions"": 20, ""deletions"": 0, ""lines"": 20}, ""src/version.c"": {""insertions"": 2, ""deletions"": 0, ""lines"": 2}}"
2021-12-28 11:24:49,8b6256f6ec075cca40341e61ebc9f538b4902dd1,Bram Moolenaar,39,14,53,5,"{""runtime/doc/builtin.txt"": {""insertions"": 4, ""deletions"": 3, ""lines"": 7}, ""src/evalbuffer.c"": {""insertions"": 18, ""deletions"": 9, ""lines"": 27}, ""src/testdir/test_vim9_builtin.vim"": {""insertions"": 12, ""deletions"": 1, ""lines"": 13}, ""src/typval.c"": {""insertions"": 3, ""deletions"": 1, ""lines"": 4}, ""src/version.c"": {""insertions"": 2, ""deletions"": 0, ""lines"": 2}}"
2021-12-27 21:42:57,be4e223eadaa765bf2957f196e4d4b6014057bd1,Bram Moolenaar,7,6,13,2,"{""src/testdir/test_function_lists.vim"": {""insertions"": 5, ""deletions"": 6, ""lines"": 11}, ""src/version.c"": {""insertions"": 2, ""deletions"": 0, ""lines"": 2}}"
2021-12-27 21:33:07,a4d131d11052cafcc5baad2273ef48e0dd4d09c5,Bram Moolenaar,1837,1549,3386,16,"{""runtime/autoload/ccomplete.vim"": {""insertions"": 484, ""deletions"": 425, ""lines"": 909}, ""runtime/doc/change.txt"": {""insertions"": 7, ""deletions"": 1, ""lines"": 8}, ""runtime/doc/cmdline.txt"": {""insertions"": 10, ""deletions"": 1, ""lines"": 11}, ""runtime/doc/editing.txt"": {""insertions"": 4, ""deletions"": 1, ""lines"": 5}, ""runtime/doc/fold.txt"": {""insertions"": 0, ""deletions"": 2, ""lines"": 2}, ""runtime/doc/help.txt"": {""insertions"": 1, ""deletions"": 1, ""lines"": 2}, ""runtime/doc/insert.txt"": {""insertions"": 7, ""deletions"": 1, ""lines"": 8}, ""runtime/doc/map.txt"": {""insertions"": 2, ""deletions"": 2, ""lines"": 4}, ""runtime/doc/motion.txt"": {""insertions"": 4, ""deletions"": 1, ""lines"": 5}, ""runtime/doc/options.txt"": {""insertions"": 1, ""deletions"": 1, ""lines"": 2}, ""runtime/doc/remote.txt"": {""insertions"": 1, ""deletions"": 1, ""lines"": 2}, ""runtime/doc/repeat.txt"": {""insertions"": 4, ""deletions"": 1, ""lines"": 5}, ""runtime/doc/tags"": {""insertions"": 514, ""deletions"": 504, ""lines"": 1018}, ""runtime/doc/todo.txt"": {""insertions"": 6, ""deletions"": 29, ""lines"": 35}, ""runtime/filetype.vim"": {""insertions"": 1, ""deletions"": 1, ""lines"": 2}, ""src/po/tr.po"": {""insertions"": 791, ""deletions"": 577, ""lines"": 1368}}"
2021-12-27 21:28:34,1cae5a0a034d0545360387407a7a409310f1efe2,Bram Moolenaar,10137,10092,20229,6,"{""runtime/doc/Makefile"": {""insertions"": 2, ""deletions"": 0, ""lines"": 2}, ""runtime/doc/builtin.txt"": {""insertions"": 10125, ""deletions"": 0, ""lines"": 10125}, ""runtime/doc/eval.txt"": {""insertions"": 6, ""deletions"": 10091, ""lines"": 10097}, ""runtime/doc/help.txt"": {""insertions"": 1, ""deletions"": 0, ""lines"": 1}, ""runtime/doc/remote.txt"": {""insertions"": 1, ""deletions"": 1, ""lines"": 2}, ""src/version.c"": {""insertions"": 2, ""deletions"": 0, ""lines"": 2}}"
2021-12-27 20:57:06,8dac2acd6a79d571ff5409d9c90b4c9e73237eb4,Bram Moolenaar,31,8,39,7,"{""src/errors.h"": {""insertions"": 4, ""deletions"": 0, ""lines"": 4}, ""src/eval.c"": {""insertions"": 5, ""deletions"": 2, ""lines"": 7}, ""src/evalbuffer.c"": {""insertions"": 2, ""deletions"": 0, ""lines"": 2}, ""src/indent.c"": {""insertions"": 6, ""deletions"": 0, ""lines"": 6}, ""src/testdir/test_vim9_builtin.vim"": {""insertions"": 8, ""deletions"": 0, ""lines"": 8}, ""src/textprop.c"": {""insertions"": 4, ""deletions"": 6, ""lines"": 10}, ""src/version.c"": {""insertions"": 2, ""deletions"": 0, ""lines"": 2}}"
2021-12-27 19:28:37,4b28ba3245df8274303c79429972f9dc9438e4aa,Bram Moolenaar,21,1,22,3,"{""src/insexpand.c"": {""insertions"": 6, ""deletions"": 1, ""lines"": 7}, ""src/testdir/test_ins_complete.vim"": {""insertions"": 13, ""deletions"": 0, ""lines"": 13}, ""src/version.c"": {""insertions"": 2, ""deletions"": 0, ""lines"": 2}}"
2021-12-27 17:21:41,af4a61a85d6e8cacc35324f266934bc463a21673,Dominique Pelle,109,107,216,58,"{""src/alloc.c"": {""insertions"": 1, ""deletions"": 1, ""lines"": 2}, ""src/blowfish.c"": {""insertions"": 1, ""deletions"": 1, ""lines"": 2}, ""src/buffer.c"": {""insertions"": 2, ""deletions"": 2, ""lines"": 4}, ""src/cindent.c"": {""insertions"": 5, ""deletions"": 5, ""lines"": 10}, ""src/clipboard.c"": {""insertions"": 3, ""deletions"": 3, ""lines"": 6}, ""src/diff.c"": {""insertions"": 3, ""deletions"": 3, ""lines"": 6}, ""src/drawline.c"": {""insertions"": 2, ""deletions"": 2, ""lines"": 4}, ""src/edit.c"": {""insertions"": 2, ""deletions"": 2, ""lines"": 4}, ""src/ex_cmds.c"": {""insertions"": 1, ""deletions"": 1, ""lines"": 2}, ""src/ex_docmd.c"": {""insertions"": 2, ""deletions"": 2, ""lines"": 4}, ""src/findfile.c"": {""insertions"": 2, ""deletions"": 2, ""lines"": 4}, ""src/fold.c"": {""insertions"": 1, ""deletions"": 1, ""lines"": 2}, ""src/getchar.c"": {""insertions"": 3, ""deletions"": 3, ""lines"": 6}, ""src/gui.c"": {""insertions"": 8, ""deletions"": 8, ""lines"": 16}, ""src/gui_athena.c"": {""insertions"": 1, ""deletions"": 1, ""lines"": 2}, ""src/gui_gtk.c"": {""insertions"": 1, ""deletions"": 1, ""lines"": 2}, ""src/gui_motif.c"": {""insertions"": 1, ""deletions"": 1, ""lines"": 2}, ""src/gui_photon.c"": {""insertions"": 1, ""deletions"": 1, ""lines"": 2}, ""src/gui_w32.c"": {""insertions"": 5, ""deletions"": 5, ""lines"": 10}, ""src/gui_xmebw.c"": {""insertions"": 1, ""deletions"": 1, ""lines"": 2}, ""src/if_python.c"": {""insertions"": 2, ""deletions"": 2, ""lines"": 4}, ""src/if_python3.c"": {""insertions"": 1, ""deletions"": 1, ""lines"": 2}, ""src/if_xcmdsrv.c"": {""insertions"": 1, ""deletions"": 1, ""lines"": 2}, ""src/main.c"": {""insertions"": 1, ""deletions"": 1, ""lines"": 2}, ""src/memline.c"": {""insertions"": 1, ""deletions"": 1, ""lines"": 2}, ""src/menu.c"": {""insertions"": 3, ""deletions"": 3, ""lines"": 6}, ""src/message.c"": {""insertions"": 1, ""deletions"": 1, ""lines"": 2}, ""src/misc1.c"": {""insertions"": 1, ""deletions"": 1, ""lines"": 2}, ""src/move.c"": {""insertions"": 2, ""deletions"": 2, ""lines"": 4}, ""src/option.c"": {""insertions"": 2, ""deletions"": 2, ""lines"": 4}, ""src/os_amiga.c"": {""insertions"": 1, ""deletions"": 1, ""lines"": 2}, ""src/os_mac.h"": {""insertions"": 1, ""deletions"": 1, ""lines"": 2}, ""src/os_mac_conv.c"": {""insertions"": 1, ""deletions"": 1, ""lines"": 2}, ""src/os_mswin.c"": {""insertions"": 2, ""deletions"": 2, ""lines"": 4}, ""src/os_unix.c"": {""insertions"": 1, ""deletions"": 1, ""lines"": 2}, ""src/os_win32.c"": {""insertions"": 2, ""deletions"": 2, ""lines"": 4}, ""src/os_win32.h"": {""insertions"": 1, ""deletions"": 1, ""lines"": 2}, ""src/quickfix.c"": {""insertions"": 1, ""deletions"": 1, ""lines"": 2}, ""src/regexp_nfa.c"": {""insertions"": 2, ""deletions"": 2, ""lines"": 4}, ""src/screen.c"": {""insertions"": 11, ""deletions"": 11, ""lines"": 22}, ""src/scriptfile.c"": {""insertions"": 1, ""deletions"": 1, ""lines"": 2}, ""src/spell.c"": {""insertions"": 4, ""deletions"": 4, ""lines"": 8}, ""src/spellfile.c"": {""insertions"": 2, ""deletions"": 2, ""lines"": 4}, ""src/spellsuggest.c"": {""insertions"": 1, ""deletions"": 1, ""lines"": 2}, ""src/strings.c"": {""insertions"": 1, ""deletions"": 1, ""lines"": 2}, ""src/term.c"": {""insertions"": 1, ""deletions"": 1, ""lines"": 2}, ""src/terminal.c"": {""insertions"": 1, ""deletions"": 1, ""lines"": 2}, ""src/testdir/test_debugger.vim"": {""insertions"": 1, ""deletions"": 1, ""lines"": 2}, ""src/testdir/test_source.vim"": {""insertions"": 1, ""deletions"": 1, ""lines"": 2}, ""src/textformat.c"": {""insertions"": 1, ""deletions"": 1, ""lines"": 2}, ""src/userfunc.c"": {""insertions"": 1, ""deletions"": 1, ""lines"": 2}, ""src/version.c"": {""insertions"": 2, ""deletions"": 0, ""lines"": 2}, ""src/vim.h"": {""insertions"": 1, ""deletions"": 1, ""lines"": 2}, ""src/vim9.h"": {""insertions"": 1, ""deletions"": 1, ""lines"": 2}, ""src/vim9cmds.c"": {""insertions"": 1, ""deletions"": 1, ""lines"": 2}, ""src/vim9execute.c"": {""insertions"": 1, ""deletions"": 1, ""lines"": 2}, ""src/winclip.c"": {""insertions"": 2, ""deletions"": 2, ""lines"": 4}, ""src/window.c"": {""insertions"": 2, ""deletions"": 2, ""lines"": 4}}"
2021-12-27 15:39:57,5da36052a4bb0f3a9747ec3a8ab9d85e058e39fa,Bram Moolenaar,204,125,329,4,"{""runtime/doc/eval.txt"": {""insertions"": 186, ""deletions"": 109, ""lines"": 295}, ""runtime/doc/vim9.txt"": {""insertions"": 10, ""deletions"": 10, ""lines"": 20}, ""src/version.c"": {""insertions"": 2, ""deletions"": 0, ""lines"": 2}, ""src/vim9expr.c"": {""insertions"": 6, ""deletions"": 6, ""lines"": 12}}"
2021-12-27 12:52:07,bf7ff61af490a2fbc0d9c7d42f3bb7eb7d37127e,Bram Moolenaar,368,258,626,2,"{""src/insexpand.c"": {""insertions"": 366, ""deletions"": 258, ""lines"": 624}, ""src/version.c"": {""insertions"": 2, ""deletions"": 0, ""lines"": 2}}"
2021-12-27 12:29:19,ef8f04b1d1daf2e0be8fa38dedcae84ebfc5ffb4,Bram Moolenaar,9,0,9,3,"{""src/evalfunc.c"": {""insertions"": 1, ""deletions"": 0, ""lines"": 1}, ""src/testdir/test_vim9_builtin.vim"": {""insertions"": 6, ""deletions"": 0, ""lines"": 6}, ""src/version.c"": {""insertions"": 2, ""deletions"": 0, ""lines"": 2}}"
2021-12-27 11:54:37,23018f2d4b6f85512af117d346eee9b14a4637a6,Bram Moolenaar,15,1,16,3,"{""src/list.c"": {""insertions"": 2, ""deletions"": 1, ""lines"": 3}, ""src/testdir/test_vim9_builtin.vim"": {""insertions"": 11, ""deletions"": 0, ""lines"": 11}, ""src/version.c"": {""insertions"": 2, ""deletions"": 0, ""lines"": 2}}"
2021-12-27 10:35:52,bbdd3fb804bf69684f7b0f49d3c0a0b039daec02,Bram Moolenaar,4,2,6,3,"{""runtime/filetype.vim"": {""insertions"": 1, ""deletions"": 1, ""lines"": 2}, ""src/testdir/test_filetype.vim"": {""insertions"": 1, ""deletions"": 1, ""lines"": 2}, ""src/version.c"": {""insertions"": 2, ""deletions"": 0, ""lines"": 2}}"
2021-12-26 21:54:43,27708e6c7b6f444fd599f3dc5015336b002b874d,Yegappan Lakshmanan,60,4,64,9,"{""runtime/doc/fold.txt"": {""insertions"": 6, ""deletions"": 1, ""lines"": 7}, ""src/optionstr.c"": {""insertions"": 4, ""deletions"": 1, ""lines"": 5}, ""src/strings.c"": {""insertions"": 0, ""deletions"": 2, ""lines"": 2}, ""src/testdir/test_blob.vim"": {""insertions"": 14, ""deletions"": 0, ""lines"": 14}, ""src/testdir/test_expr.vim"": {""insertions"": 1, ""deletions"": 0, ""lines"": 1}, ""src/testdir/test_filter_map.vim"": {""insertions"": 1, ""deletions"": 0, ""lines"": 1}, ""src/testdir/test_fold.vim"": {""insertions"": 31, ""deletions"": 0, ""lines"": 31}, ""src/testdir/test_listdict.vim"": {""insertions"": 1, ""deletions"": 0, ""lines"": 1}, ""src/version.c"": {""insertions"": 2, ""deletions"": 0, ""lines"": 2}}"
2021-12-26 20:20:34,c553a21e189aa440515a19c5b25f8b6b50c5d53d,Bram Moolenaar,61,30,91,6,"{""src/errors.h"": {""insertions"": 35, ""deletions"": 1, ""lines"": 36}, ""src/ex_cmds.c"": {""insertions"": 2, ""deletions"": 2, ""lines"": 4}, ""src/testdir/test_user_func.vim"": {""insertions"": 1, ""deletions"": 1, ""lines"": 2}, ""src/userfunc.c"": {""insertions"": 18, ""deletions"": 23, ""lines"": 41}, ""src/version.c"": {""insertions"": 2, ""deletions"": 0, ""lines"": 2}, ""src/viminfo.c"": {""insertions"": 3, ""deletions"": 3, ""lines"": 6}}"
2021-12-26 18:09:31,1f318c6eac3d894a3fb9c68c53512cdd75e8f6b4,Bram Moolenaar,8,16,24,2,"{""runtime/doc/vim9.txt"": {""insertions"": 6, ""deletions"": 16, ""lines"": 22}, ""src/version.c"": {""insertions"": 2, ""deletions"": 0, ""lines"": 2}}"
2021-12-26 17:31:35,c88ac94a0bdc70012558813404821fe077f1de20,Bram Moolenaar,7,1,8,3,"{""runtime/filetype.vim"": {""insertions"": 4, ""deletions"": 0, ""lines"": 4}, ""src/testdir/test_filetype.vim"": {""insertions"": 1, ""deletions"": 1, ""lines"": 2}, ""src/version.c"": {""insertions"": 2, ""deletions"": 0, ""lines"": 2}}"
2021-12-26 17:18:14,7319981f21cbd51267c8cc80b37ed56d8ee78ea7,Bram Moolenaar,65,9,74,3,"{""src/evalfunc.c"": {""insertions"": 22, ""deletions"": 2, ""lines"": 24}, ""src/testdir/test_vim9_builtin.vim"": {""insertions"": 41, ""deletions"": 7, ""lines"": 48}, ""src/version.c"": {""insertions"": 2, ""deletions"": 0, ""lines"": 2}}"
2021-12-26 15:00:07,71c41255f6a074c4df4dc6f9e97d347e565253a1,Bram Moolenaar,11,6,17,3,"{""src/normal.c"": {""insertions"": 1, ""deletions"": 6, ""lines"": 7}, ""src/testdir/test_normal.vim"": {""insertions"": 8, ""deletions"": 0, ""lines"": 8}, ""src/version.c"": {""insertions"": 2, ""deletions"": 0, ""lines"": 2}}"
2021-12-26 14:23:22,9c23f9bb5fe435b28245ba8ac65aa0ca6b902c04,Bram Moolenaar,62,26,88,6,"{""src/proto/userfunc.pro"": {""insertions"": 1, ""deletions"": 1, ""lines"": 2}, ""src/testdir/test_vim9_func.vim"": {""insertions"": 20, ""deletions"": 0, ""lines"": 20}, ""src/userfunc.c"": {""insertions"": 16, ""deletions"": 10, ""lines"": 26}, ""src/version.c"": {""insertions"": 2, ""deletions"": 0, ""lines"": 2}, ""src/vim9compile.c"": {""insertions"": 20, ""deletions"": 14, ""lines"": 34}, ""src/vim9execute.c"": {""insertions"": 3, ""deletions"": 1, ""lines"": 4}}"
2021-12-26 12:07:30,71eb3ad5790ef3d16369e2fceb040980d75539cf,Bram Moolenaar,68,3,71,6,"{""runtime/doc/options.txt"": {""insertions"": 10, ""deletions"": 0, ""lines"": 10}, ""runtime/doc/vim9.txt"": {""insertions"": 1, ""deletions"": 0, ""lines"": 1}, ""src/scriptfile.c"": {""insertions"": 7, ""deletions"": 2, ""lines"": 9}, ""src/structs.h"": {""insertions"": 1, ""deletions"": 0, ""lines"": 1}, ""src/testdir/test_vim9_script.vim"": {""insertions"": 47, ""deletions"": 1, ""lines"": 48}, ""src/version.c"": {""insertions"": 2, ""deletions"": 0, ""lines"": 2}}"
2021-12-26 10:51:39,8bb65f230d3025037f34021a72616038da0601ee,Yegappan Lakshmanan,265,8,273,13,"{""runtime/doc/diff.txt"": {""insertions"": 10, ""deletions"": 0, ""lines"": 10}, ""runtime/doc/fold.txt"": {""insertions"": 7, ""deletions"": 0, ""lines"": 7}, ""runtime/doc/options.txt"": {""insertions"": 20, ""deletions"": 0, ""lines"": 20}, ""runtime/doc/print.txt"": {""insertions"": 5, ""deletions"": 0, ""lines"": 5}, ""src/optionstr.c"": {""insertions"": 83, ""deletions"": 8, ""lines"": 91}, ""src/testdir/test_diffmode.vim"": {""insertions"": 20, ""deletions"": 0, ""lines"": 20}, ""src/testdir/test_edit.vim"": {""insertions"": 10, ""deletions"": 0, ""lines"": 10}, ""src/testdir/test_fold.vim"": {""insertions"": 26, ""deletions"": 0, ""lines"": 26}, ""src/testdir/test_gf.vim"": {""insertions"": 26, ""deletions"": 0, ""lines"": 26}, ""src/testdir/test_gui.vim"": {""insertions"": 9, ""deletions"": 0, ""lines"": 9}, ""src/testdir/test_hardcopy.vim"": {""insertions"": 8, ""deletions"": 0, ""lines"": 8}, ""src/testdir/test_normal.vim"": {""insertions"": 39, ""deletions"": 0, ""lines"": 39}, ""src/version.c"": {""insertions"": 2, ""deletions"": 0, ""lines"": 2}}"
2021-12-25 22:10:42,ec86520f946a40d5c4a92d6a11d6928faa13abd4,Bram Moolenaar,5,2,7,2,"{""src/evalfunc.c"": {""insertions"": 3, ""deletions"": 2, ""lines"": 5}, ""src/version.c"": {""insertions"": 2, ""deletions"": 0, ""lines"": 2}}"
2021-12-25 22:00:49,fb9dcb080b5143d3021a8c1d6deaf143f2ca3a48,Bram Moolenaar,20,0,20,2,"{""src/testdir/test_vim9_disassemble.vim"": {""insertions"": 18, ""deletions"": 0, ""lines"": 18}, ""src/version.c"": {""insertions"": 2, ""deletions"": 0, ""lines"": 2}}"
2021-12-25 21:43:28,1802405d71da20dff510690bf14f6da085836125,Bram Moolenaar,80,12,92,7,"{""src/evalfunc.c"": {""insertions"": 52, ""deletions"": 4, ""lines"": 56}, ""src/globals.h"": {""insertions"": 1, ""deletions"": 0, ""lines"": 1}, ""src/list.c"": {""insertions"": 1, ""deletions"": 1, ""lines"": 2}, ""src/testdir/test_vim9_builtin.vim"": {""insertions"": 20, ""deletions"": 3, ""lines"": 23}, ""src/testdir/test_vim9_expr.vim"": {""insertions"": 3, ""deletions"": 3, ""lines"": 6}, ""src/testdir/test_vim9_script.vim"": {""insertions"": 1, ""deletions"": 1, ""lines"": 2}, ""src/version.c"": {""insertions"": 2, ""deletions"": 0, ""lines"": 2}}"
2021-12-25 19:58:22,db8e5c21b98c5998df4ab94e0b94bd9fdaf35c83,Bram Moolenaar,17,0,17,2,"{""src/testdir/test_vim9_func.vim"": {""insertions"": 15, ""deletions"": 0, ""lines"": 15}, ""src/version.c"": {""insertions"": 2, ""deletions"": 0, ""lines"": 2}}"
2021-12-25 19:43:44,ae1068afde6dfc6fd3e3f54512dbd089e1559053,Bram Moolenaar,6,1,7,3,"{""src/evalfunc.c"": {""insertions"": 2, ""deletions"": 1, ""lines"": 3}, ""src/testdir/test_vim9_builtin.vim"": {""insertions"": 2, ""deletions"": 0, ""lines"": 2}, ""src/version.c"": {""insertions"": 2, ""deletions"": 0, ""lines"": 2}}"
2021-12-25 19:29:21,223d0a6bc8dc68039ceb6660de9576fafe178d73,Bram Moolenaar,27,1,28,6,"{""src/errors.h"": {""insertions"": 2, ""deletions"": 0, ""lines"": 2}, ""src/evalfunc.c"": {""insertions"": 2, ""deletions"": 1, ""lines"": 3}, ""src/proto/typval.pro"": {""insertions"": 1, ""deletions"": 0, ""lines"": 1}, ""src/testdir/test_vim9_builtin.vim"": {""insertions"": 3, ""deletions"": 0, ""lines"": 3}, ""src/typval.c"": {""insertions"": 17, ""deletions"": 0, ""lines"": 17}, ""src/version.c"": {""insertions"": 2, ""deletions"": 0, ""lines"": 2}}"
2021-12-25 18:23:24,5cd647935d0834b3064aa36384b8f6730fadadd6,Bram Moolenaar,51,23,74,7,"{""src/proto/vim9instr.pro"": {""insertions"": 1, ""deletions"": 1, ""lines"": 2}, ""src/testdir/test_vim9_disassemble.vim"": {""insertions"": 12, ""deletions"": 11, ""lines"": 23}, ""src/version.c"": {""insertions"": 2, ""deletions"": 0, ""lines"": 2}, ""src/vim9cmds.c"": {""insertions"": 1, ""deletions"": 1, ""lines"": 2}, ""src/vim9compile.c"": {""insertions"": 9, ""deletions"": 2, ""lines"": 11}, ""src/vim9execute.c"": {""insertions"": 12, ""deletions"": 2, ""lines"": 14}, ""src/vim9instr.c"": {""insertions"": 14, ""deletions"": 6, ""lines"": 20}}"
2021-12-25 15:13:18,35cfd793aad7c4bfba4a9bedf5c435c44e4293d0,Bram Moolenaar,12,5,17,2,"{""src/ui.c"": {""insertions"": 10, ""deletions"": 5, ""lines"": 15}, ""src/version.c"": {""insertions"": 2, ""deletions"": 0, ""lines"": 2}}"
2021-12-25 11:20:30,7f4a628efefd893a3cad3a1fdde340c98360f705,Yegappan Lakshmanan,16,0,16,3,"{"".github/workflows/ci.yml"": {""insertions"": 7, ""deletions"": 0, ""lines"": 7}, "".github/workflows/codeql-analysis.yml"": {""insertions"": 7, ""deletions"": 0, ""lines"": 7}, ""src/version.c"": {""insertions"": 2, ""deletions"": 0, ""lines"": 2}}"
2021-12-24 21:36:12,d787e40fdbe6f4d8bf47d36186c1d9d51c29b853,Bram Moolenaar,141,117,258,5,"{""src/evalvars.c"": {""insertions"": 122, ""deletions"": 113, ""lines"": 235}, ""src/proto/evalvars.pro"": {""insertions"": 2, ""deletions"": 1, ""lines"": 3}, ""src/testdir/test_vim9_expr.vim"": {""insertions"": 14, ""deletions"": 1, ""lines"": 15}, ""src/version.c"": {""insertions"": 2, ""deletions"": 0, ""lines"": 2}, ""src/vim9instr.c"": {""insertions"": 1, ""deletions"": 2, ""lines"": 3}}"
2021-12-24 20:47:38,e7f4abd38b6e05100c699900c8f87281e363beb2,Yegappan Lakshmanan,84,39,123,8,"{""src/evalfunc.c"": {""insertions"": 1, ""deletions"": 12, ""lines"": 13}, ""src/evalvars.c"": {""insertions"": 12, ""deletions"": 1, ""lines"": 13}, ""src/option.c"": {""insertions"": 1, ""deletions"": 26, ""lines"": 27}, ""src/proto/userfunc.pro"": {""insertions"": 1, ""deletions"": 0, ""lines"": 1}, ""src/testdir/test_expr.vim"": {""insertions"": 15, ""deletions"": 0, ""lines"": 15}, ""src/testdir/test_normal.vim"": {""insertions"": 12, ""deletions"": 0, ""lines"": 12}, ""src/userfunc.c"": {""insertions"": 40, ""deletions"": 0, ""lines"": 40}, ""src/version.c"": {""insertions"": 2, ""deletions"": 0, ""lines"": 2}}"
2021-12-24 20:28:03,73a024209cbfbd5b39a2e974084d807c6131e2ed,Nir Lichtman,99,29,128,8,"{""runtime/doc/editing.txt"": {""insertions"": 9, ""deletions"": 2, ""lines"": 11}, ""runtime/doc/index.txt"": {""insertions"": 1, ""deletions"": 0, ""lines"": 1}, ""src/arglist.c"": {""insertions"": 27, ""deletions"": 0, ""lines"": 27}, ""src/ex_cmdidxs.h"": {""insertions"": 27, ""deletions"": 27, ""lines"": 54}, ""src/ex_cmds.h"": {""insertions"": 3, ""deletions"": 0, ""lines"": 3}, ""src/proto/arglist.pro"": {""insertions"": 1, ""deletions"": 0, ""lines"": 1}, ""src/testdir/test_arglist.vim"": {""insertions"": 29, ""deletions"": 0, ""lines"": 29}, ""src/version.c"": {""insertions"": 2, ""deletions"": 0, ""lines"": 2}}"
2021-12-24 19:54:52,806da5176e9e9ab011d927c4ca33a8dde1769539,Bram Moolenaar,6,4,10,3,"{""src/errors.h"": {""insertions"": 3, ""deletions"": 3, ""lines"": 6}, ""src/testdir/test_mapping.vim"": {""insertions"": 1, ""deletions"": 1, ""lines"": 2}, ""src/version.c"": {""insertions"": 2, ""deletions"": 0, ""lines"": 2}}"
2021-12-24 19:24:47,b6db1467622be046dbf00b2213fd9f49f4f3cccb,Bram Moolenaar,5,2,7,4,"{""src/autocmd.c"": {""insertions"": 1, ""deletions"": 1, ""lines"": 2}, ""src/testdir/test_arglist.vim"": {""insertions"": 1, ""deletions"": 1, ""lines"": 2}, ""src/testdir/test_autocmd.vim"": {""insertions"": 1, ""deletions"": 0, ""lines"": 1}, ""src/version.c"": {""insertions"": 2, ""deletions"": 0, ""lines"": 2}}"
2021-12-24 18:58:46,679140c56bbabf12a199d94f584b1b9dfc9809fd,Bram Moolenaar,8,10,18,2,"{""src/testdir/test_arglist.vim"": {""insertions"": 6, ""deletions"": 10, ""lines"": 16}, ""src/version.c"": {""insertions"": 2, ""deletions"": 0, ""lines"": 2}}"
2021-12-24 18:11:27,6f98371532fcff911b462d51bc64f2ce8a6ae682,Bram Moolenaar,12,0,12,3,"{""src/arglist.c"": {""insertions"": 3, ""deletions"": 0, ""lines"": 3}, ""src/testdir/test_arglist.vim"": {""insertions"": 7, ""deletions"": 0, ""lines"": 7}, ""src/version.c"": {""insertions"": 2, ""deletions"": 0, ""lines"": 2}}"
2021-12-24 16:46:14,5937c7505f444dd896f336fa0119a93a55ebe9a2,Bram Moolenaar,4,0,4,2,"{""src/ex_cmds.c"": {""insertions"": 2, ""deletions"": 0, ""lines"": 2}, ""src/version.c"": {""insertions"": 2, ""deletions"": 0, ""lines"": 2}}"
2021-12-24 13:18:38,fa3b72348d88343390fbe212cfc230fec1602fc2,Bram Moolenaar,1748,1285,3033,29,"{""runtime/autoload/dist/ft.vim"": {""insertions"": 1, ""deletions"": 1, ""lines"": 2}, ""runtime/doc/eval.txt"": {""insertions"": 7, ""deletions"": 4, ""lines"": 11}, ""runtime/doc/map.txt"": {""insertions"": 39, ""deletions"": 19, ""lines"": 58}, ""runtime/doc/options.txt"": {""insertions"": 3, ""deletions"": 3, ""lines"": 6}, ""runtime/doc/quickref.txt"": {""insertions"": 2, ""deletions"": 1, ""lines"": 3}, ""runtime/doc/syntax.txt"": {""insertions"": 1, ""deletions"": 1, ""lines"": 2}, ""runtime/doc/tags"": {""insertions"": 3, ""deletions"": 0, ""lines"": 3}, ""runtime/doc/term.txt"": {""insertions"": 1, ""deletions"": 1, ""lines"": 2}, ""runtime/doc/terminal.txt"": {""insertions"": 3, ""deletions"": 1, ""lines"": 4}, ""runtime/doc/todo.txt"": {""insertions"": 13, ""deletions"": 9, ""lines"": 22}, ""runtime/doc/various.txt"": {""insertions"": 11, ""deletions"": 8, ""lines"": 19}, ""runtime/doc/vim9.txt"": {""insertions"": 4, ""deletions"": 4, ""lines"": 8}, ""runtime/filetype.vim"": {""insertions"": 1, ""deletions"": 1, ""lines"": 2}, ""runtime/ftplugin/zsh.vim"": {""insertions"": 4, ""deletions"": 4, ""lines"": 8}, ""runtime/indent/sh.vim"": {""insertions"": 1, ""deletions"": 1, ""lines"": 2}, ""runtime/indent/xml.vim"": {""insertions"": 7, ""deletions"": 1, ""lines"": 8}, ""runtime/menu.vim"": {""insertions"": 6, ""deletions"": 1, ""lines"": 7}, ""runtime/optwin.vim"": {""insertions"": 1, ""deletions"": 1, ""lines"": 2}, ""runtime/pack/dist/opt/matchit/autoload/matchit.vim"": {""insertions"": 132, ""deletions"": 119, ""lines"": 251}, ""runtime/pack/dist/opt/matchit/doc/matchit.txt"": {""insertions"": 10, ""deletions"": 3, ""lines"": 13}, ""runtime/pack/dist/opt/matchit/plugin/matchit.vim"": {""insertions"": 24, ""deletions"": 18, ""lines"": 42}, ""runtime/pack/dist/opt/termdebug/plugin/termdebug.vim"": {""insertions"": 10, ""deletions"": 5, ""lines"": 15}, ""runtime/syntax/debcontrol.vim"": {""insertions"": 10, ""deletions"": 10, ""lines"": 20}, ""runtime/syntax/dep3patch.vim"": {""insertions"": 57, ""deletions"": 0, ""lines"": 57}, ""runtime/syntax/dtd.vim"": {""insertions"": 3, ""deletions"": 3, ""lines"": 6}, ""runtime/syntax/vim.vim"": {""insertions"": 16, ""deletions"": 16, ""lines"": 32}, ""runtime/syntax/xml.vim"": {""insertions"": 8, ""deletions"": 4, ""lines"": 12}, ""runtime/syntax/zsh.vim"": {""insertions"": 11, ""deletions"": 212, ""lines"": 223}, ""src/po/de.po"": {""insertions"": 1359, ""deletions"": 834, ""lines"": 2193}}"
2021-12-24 12:02:43,d3f00f54bf955bd01767db3a0af25866bc112ec7,zeertzjq,8,18,26,2,"{""src/evalfunc.c"": {""insertions"": 6, ""deletions"": 18, ""lines"": 24}, ""src/version.c"": {""insertions"": 2, ""deletions"": 0, ""lines"": 2}}"
2021-12-24 11:57:06,6073f13f557c53928a2a9071495178599c38e798,h-east,3,1,4,2,"{""src/main.c"": {""insertions"": 1, ""deletions"": 1, ""lines"": 2}, ""src/version.c"": {""insertions"": 2, ""deletions"": 0, ""lines"": 2}}"
2021-12-24 11:33:56,70a120b72b2b48800f881725c58241cd170893f8,Bram Moolenaar,4,1,5,3,"{""runtime/filetype.vim"": {""insertions"": 1, ""deletions"": 0, ""lines"": 1}, ""src/testdir/test_filetype.vim"": {""insertions"": 1, ""deletions"": 1, ""lines"": 2}, ""src/version.c"": {""insertions"": 2, ""deletions"": 0, ""lines"": 2}}"
2021-12-24 10:48:30,51e64b2789eb7e60f7c5892a43426ab4ec1a54aa,Bram Moolenaar,48,47,95,2,"{""src/evalfunc.c"": {""insertions"": 46, ""deletions"": 47, ""lines"": 93}, ""src/version.c"": {""insertions"": 2, ""deletions"": 0, ""lines"": 2}}"
2021-12-23 21:14:37,310091d20f26f6472fefc31e19004684f3d640bf,Bram Moolenaar,44,1,45,3,"{""src/testdir/test_vim9_script.vim"": {""insertions"": 40, ""deletions"": 0, ""lines"": 40}, ""src/version.c"": {""insertions"": 2, ""deletions"": 0, ""lines"": 2}, ""src/vim9execute.c"": {""insertions"": 2, ""deletions"": 1, ""lines"": 3}}"
2021-12-22 21:40:33,28fbbeac7046f33db350294908eecb380042d553,Bram Moolenaar,61,6,67,3,"{""src/testdir/test_vim9_expr.vim"": {""insertions"": 30, ""deletions"": 0, ""lines"": 30}, ""src/typval.c"": {""insertions"": 29, ""deletions"": 6, ""lines"": 35}, ""src/version.c"": {""insertions"": 2, ""deletions"": 0, ""lines"": 2}}"
2021-12-22 20:55:30,f2f0bddf303e37d4d532ca22e2d53179c20b1d19,zeertzjq,54,0,54,3,"{""src/cindent.c"": {""insertions"": 4, ""deletions"": 0, ""lines"": 4}, ""src/testdir/test_cindent.vim"": {""insertions"": 48, ""deletions"": 0, ""lines"": 48}, ""src/version.c"": {""insertions"": 2, ""deletions"": 0, ""lines"": 2}}"
2021-12-22 20:29:09,b4168fd917e869912e0649fe13c10e5e6a595199,Bram Moolenaar,5,2,7,2,"{""src/dict.c"": {""insertions"": 3, ""deletions"": 2, ""lines"": 5}, ""src/version.c"": {""insertions"": 2, ""deletions"": 0, ""lines"": 2}}"
2021-12-22 19:45:28,a80aad717464760a5a50ac2201ce35b24a0cf7a5,James McCoy,94,26,120,9,"{""runtime/doc/options.txt"": {""insertions"": 2, ""deletions"": 2, ""lines"": 4}, ""runtime/doc/sign.txt"": {""insertions"": 9, ""deletions"": 0, ""lines"": 9}, ""src/drawline.c"": {""insertions"": 7, ""deletions"": 0, ""lines"": 7}, ""src/popupwin.c"": {""insertions"": 1, ""deletions"": 1, ""lines"": 2}, ""src/proto/sign.pro"": {""insertions"": 1, ""deletions"": 1, ""lines"": 2}, ""src/sign.c"": {""insertions"": 47, ""deletions"": 5, ""lines"": 52}, ""src/structs.h"": {""insertions"": 1, ""deletions"": 0, ""lines"": 1}, ""src/testdir/test_signs.vim"": {""insertions"": 24, ""deletions"": 17, ""lines"": 41}, ""src/version.c"": {""insertions"": 2, ""deletions"": 0, ""lines"": 2}}"
2021-12-22 19:19:08,82b3b4c6cf2973fe767f8e2311482af0bd95267e,Bram Moolenaar,6,1,7,3,"{""runtime/filetype.vim"": {""insertions"": 3, ""deletions"": 1, ""lines"": 4}, ""src/testdir/test_filetype.vim"": {""insertions"": 1, ""deletions"": 0, ""lines"": 1}, ""src/version.c"": {""insertions"": 2, ""deletions"": 0, ""lines"": 2}}"
2021-12-22 18:45:37,080182216e605df3428cc699b9fd7e761368d12f,Bram Moolenaar,34,3,37,4,"{""src/evalfunc.c"": {""insertions"": 11, ""deletions"": 2, ""lines"": 13}, ""src/testdir/test_vim9_builtin.vim"": {""insertions"": 7, ""deletions"": 0, ""lines"": 7}, ""src/testdir/vim9.vim"": {""insertions"": 14, ""deletions"": 1, ""lines"": 15}, ""src/version.c"": {""insertions"": 2, ""deletions"": 0, ""lines"": 2}}"
2021-12-22 18:19:26,f973eeb4911de09258e84cb2248dc0f9392824b4,Yegappan Lakshmanan,975,872,1847,13,"{""src/blob.c"": {""insertions"": 276, ""deletions"": 48, ""lines"": 324}, ""src/dict.c"": {""insertions"": 250, ""deletions"": 39, ""lines"": 289}, ""src/list.c"": {""insertions"": 203, ""deletions"": 780, ""lines"": 983}, ""src/proto/blob.pro"": {""insertions"": 5, ""deletions"": 0, ""lines"": 5}, ""src/proto/dict.pro"": {""insertions"": 4, ""deletions"": 1, ""lines"": 5}, ""src/proto/list.pro"": {""insertions"": 1, ""deletions"": 0, ""lines"": 1}, ""src/proto/strings.pro"": {""insertions"": 3, ""deletions"": 0, ""lines"": 3}, ""src/strings.c"": {""insertions"": 180, ""deletions"": 4, ""lines"": 184}, ""src/structs.h"": {""insertions"": 8, ""deletions"": 0, ""lines"": 8}, ""src/testdir/test_filter_map.vim"": {""insertions"": 1, ""deletions"": 0, ""lines"": 1}, ""src/testdir/test_listdict.vim"": {""insertions"": 26, ""deletions"": 0, ""lines"": 26}, ""src/testdir/test_sort.vim"": {""insertions"": 16, ""deletions"": 0, ""lines"": 16}, ""src/version.c"": {""insertions"": 2, ""deletions"": 0, ""lines"": 2}}"
2021-12-22 15:21:15,1aeccdb464d81f0af047b399cbad160307a91f7c,Nir Lichtman,10,4,14,3,"{""src/GvimExt/gvimext.cpp"": {""insertions"": 7, ""deletions"": 3, ""lines"": 10}, ""src/GvimExt/gvimext.h"": {""insertions"": 1, ""deletions"": 1, ""lines"": 2}, ""src/version.c"": {""insertions"": 2, ""deletions"": 0, ""lines"": 2}}"
2021-12-22 13:18:39,fa46ead31abe66494da775921feefece02ce6d95,Bram Moolenaar,35,26,61,5,"{""src/testdir/test_vim9_func.vim"": {""insertions"": 3, ""deletions"": 13, ""lines"": 16}, ""src/version.c"": {""insertions"": 2, ""deletions"": 0, ""lines"": 2}, ""src/vim9compile.c"": {""insertions"": 8, ""deletions"": 6, ""lines"": 14}, ""src/vim9expr.c"": {""insertions"": 2, ""deletions"": 1, ""lines"": 3}, ""src/vim9type.c"": {""insertions"": 20, ""deletions"": 6, ""lines"": 26}}"
2021-12-21 13:30:42,1b5f7a6202406b7d7ac804960602350e42b8be80,Bram Moolenaar,33,12,45,3,"{""src/testdir/test_vim9_disassemble.vim"": {""insertions"": 26, ""deletions"": 10, ""lines"": 36}, ""src/version.c"": {""insertions"": 2, ""deletions"": 0, ""lines"": 2}, ""src/vim9type.c"": {""insertions"": 5, ""deletions"": 2, ""lines"": 7}}"
2021-12-21 13:19:42,d92813a59877c707e4b64bea6d786aad152acb45,Yegappan Lakshmanan,488,374,862,2,"{""src/list.c"": {""insertions"": 486, ""deletions"": 374, ""lines"": 860}, ""src/version.c"": {""insertions"": 2, ""deletions"": 0, ""lines"": 2}}"
2021-12-21 12:32:17,59618fed4ce118d12686c2e5c7c09601c8177817,Bram Moolenaar,121,36,157,7,"{""src/evalfunc.c"": {""insertions"": 55, ""deletions"": 24, ""lines"": 79}, ""src/globals.h"": {""insertions"": 7, ""deletions"": 0, ""lines"": 7}, ""src/testdir/test_vim9_func.vim"": {""insertions"": 33, ""deletions"": 0, ""lines"": 33}, ""src/version.c"": {""insertions"": 2, ""deletions"": 0, ""lines"": 2}, ""src/vim9cmds.c"": {""insertions"": 5, ""deletions"": 2, ""lines"": 7}, ""src/vim9expr.c"": {""insertions"": 10, ""deletions"": 6, ""lines"": 16}, ""src/vim9instr.c"": {""insertions"": 9, ""deletions"": 4, ""lines"": 13}}"
2021-12-21 09:42:09,0d807107b66e0d30d4f338c272962af5714c400e,Bram Moolenaar,20,18,38,5,"{""src/version.c"": {""insertions"": 2, ""deletions"": 0, ""lines"": 2}, ""src/vim9.h"": {""insertions"": 2, ""deletions"": 2, ""lines"": 4}, ""src/vim9cmds.c"": {""insertions"": 11, ""deletions"": 11, ""lines"": 22}, ""src/vim9execute.c"": {""insertions"": 4, ""deletions"": 4, ""lines"": 8}, ""src/vim9instr.c"": {""insertions"": 1, ""deletions"": 1, ""lines"": 2}}"
2021-12-21 09:12:23,6f79e614b25caebd35cf0d82b6f3b7e0733849ec,Bram Moolenaar,38,6,44,7,"{""runtime/doc/options.txt"": {""insertions"": 12, ""deletions"": 0, ""lines"": 12}, ""runtime/doc/term.txt"": {""insertions"": 9, ""deletions"": 2, ""lines"": 11}, ""runtime/optwin.vim"": {""insertions"": 8, ""deletions"": 0, ""lines"": 8}, ""src/option.h"": {""insertions"": 2, ""deletions"": 1, ""lines"": 3}, ""src/optiondefs.h"": {""insertions"": 3, ""deletions"": 0, ""lines"": 3}, ""src/term.c"": {""insertions"": 2, ""deletions"": 3, ""lines"": 5}, ""src/version.c"": {""insertions"": 2, ""deletions"": 0, ""lines"": 2}}"
2021-12-20 22:12:53,8d95d7091da08d0a236be4a16616e3dda388e58d,Bram Moolenaar,13,11,24,2,"{""src/Makefile"": {""insertions"": 11, ""deletions"": 11, ""lines"": 22}, ""src/version.c"": {""insertions"": 2, ""deletions"": 0, ""lines"": 2}}"
2021-12-20 21:35:59,dab17a0689a2f31f69f428975f84b0c3c7ba3030,Bram Moolenaar,28,0,28,3,"{""src/evalwindow.c"": {""insertions"": 4, ""deletions"": 0, ""lines"": 4}, ""src/testdir/test_execute_func.vim"": {""insertions"": 22, ""deletions"": 0, ""lines"": 22}, ""src/version.c"": {""insertions"": 2, ""deletions"": 0, ""lines"": 2}}"
2021-12-20 15:53:13,39713d3acbfb6673775158a0171c7389c07f25df,Bram Moolenaar,8,0,8,2,"{""Filelist"": {""insertions"": 6, ""deletions"": 0, ""lines"": 6}, ""src/version.c"": {""insertions"": 2, ""deletions"": 0, ""lines"": 2}}"
2021-12-20 15:04:29,dc7c366f3aae65ee691010b08f37acfb26e0742b,Bram Moolenaar,9356,9078,18434,18,"{""src/Make_ami.mak"": {""insertions"": 3, ""deletions"": 0, ""lines"": 3}, ""src/Make_cyg_ming.mak"": {""insertions"": 9, ""deletions"": 0, ""lines"": 9}, ""src/Make_mvc.mak"": {""insertions"": 12, ""deletions"": 0, ""lines"": 12}, ""src/Make_vms.mms"": {""insertions"": 19, ""deletions"": 1, ""lines"": 20}, ""src/Makefile"": {""insertions"": 41, ""deletions"": 11, ""lines"": 52}, ""src/proto.h"": {""insertions"": 5, ""deletions"": 0, ""lines"": 5}, ""src/proto/vim9cmds.pro"": {""insertions"": 33, ""deletions"": 0, ""lines"": 33}, ""src/proto/vim9compile.pro"": {""insertions"": 14, ""deletions"": 10, ""lines"": 24}, ""src/proto/vim9expr.pro"": {""insertions"": 17, ""deletions"": 0, ""lines"": 17}, ""src/proto/vim9instr.pro"": {""insertions"": 72, ""deletions"": 0, ""lines"": 72}, ""src/version.c"": {""insertions"": 2, ""deletions"": 0, ""lines"": 2}, ""src/vim9.h"": {""insertions"": 201, ""deletions"": 7, ""lines"": 208}, ""src/vim9cmds.c"": {""insertions"": 2274, ""deletions"": 0, ""lines"": 2274}, ""src/vim9compile.c"": {""insertions"": 1547, ""deletions"": 9044, ""lines"": 10591}, ""src/vim9execute.c"": {""insertions"": 4, ""deletions"": 4, ""lines"": 8}, ""src/vim9expr.c"": {""insertions"": 2893, ""deletions"": 0, ""lines"": 2893}, ""src/vim9instr.c"": {""insertions"": 2208, ""deletions"": 0, ""lines"": 2208}, ""src/vim9script.c"": {""insertions"": 2, ""deletions"": 1, ""lines"": 3}}"
2021-12-20 12:25:03,a99fb23842f055c511bfe1b62de7bbd14d5a99c0,Bram Moolenaar,16,8,24,5,"{""src/errors.h"": {""insertions"": 2, ""deletions"": 0, ""lines"": 2}, ""src/testdir/test_vim9_cmd.vim"": {""insertions"": 4, ""deletions"": 0, ""lines"": 4}, ""src/testdir/test_vim9_script.vim"": {""insertions"": 1, ""deletions"": 1, ""lines"": 2}, ""src/version.c"": {""insertions"": 2, ""deletions"": 0, ""lines"": 2}, ""src/vim9compile.c"": {""insertions"": 7, ""deletions"": 7, ""lines"": 14}}"
2021-12-20 10:55:35,003312b1d2ee2f4922f473b8bf50af6663c0efac,Bram Moolenaar,63,7,70,4,"{""src/testdir/test_vim9_cmd.vim"": {""insertions"": 17, ""deletions"": 0, ""lines"": 17}, ""src/testdir/test_vim9_script.vim"": {""insertions"": 37, ""deletions"": 3, ""lines"": 40}, ""src/version.c"": {""insertions"": 2, ""deletions"": 0, ""lines"": 2}, ""src/vim9compile.c"": {""insertions"": 7, ""deletions"": 4, ""lines"": 11}}"
2021-12-20 09:36:27,2f9f4ccfc8f1d4a56761dc1cc1e9e20190a72c74,Bram Moolenaar,68,14,82,3,"{""src/evalfunc.c"": {""insertions"": 7, ""deletions"": 13, ""lines"": 20}, ""src/testdir/test_vim9_builtin.vim"": {""insertions"": 59, ""deletions"": 1, ""lines"": 60}, ""src/version.c"": {""insertions"": 2, ""deletions"": 0, ""lines"": 2}}"
2021-12-19 21:34:05,fea43e44c008a7ca73b506ddab0f47b63b5d2126,Bram Moolenaar,598,508,1106,4,"{""src/testdir/test_expr.vim"": {""insertions"": 577, ""deletions"": 493, ""lines"": 1070}, ""src/testdir/vim9.vim"": {""insertions"": 17, ""deletions"": 14, ""lines"": 31}, ""src/version.c"": {""insertions"": 2, ""deletions"": 0, ""lines"": 2}, ""src/vim9compile.c"": {""insertions"": 2, ""deletions"": 1, ""lines"": 3}}"
2021-12-19 19:19:31,bc404bfb32cf2bef34050d2aeae0ea72ccf980cc,Yegappan Lakshmanan,14,4,18,5,"{""src/blob.c"": {""insertions"": 1, ""deletions"": 0, ""lines"": 1}, ""src/regexp_nfa.c"": {""insertions"": 3, ""deletions"": 3, ""lines"": 6}, ""src/testdir/test_blob.vim"": {""insertions"": 7, ""deletions"": 0, ""lines"": 7}, ""src/testdir/test_messages.vim"": {""insertions"": 1, ""deletions"": 1, ""lines"": 2}, ""src/version.c"": {""insertions"": 2, ""deletions"": 0, ""lines"": 2}}"
2021-12-19 18:33:23,86b3ab4fa0de3e8884ab6a6ced2a70592b937d0f,Bram Moolenaar,1009,997,2006,13,"{""src/testdir/test_execute_func.vim"": {""insertions"": 1, ""deletions"": 1, ""lines"": 2}, ""src/testdir/test_float_func.vim"": {""insertions"": 1, ""deletions"": 1, ""lines"": 2}, ""src/testdir/test_functions.vim"": {""insertions"": 3, ""deletions"": 3, ""lines"": 6}, ""src/testdir/test_glob2regpat.vim"": {""insertions"": 1, ""deletions"": 1, ""lines"": 2}, ""src/testdir/test_listdict.vim"": {""insertions"": 1, ""deletions"": 1, ""lines"": 2}, ""src/testdir/test_vim9_assign.vim"": {""insertions"": 12, ""deletions"": 12, ""lines"": 24}, ""src/testdir/test_vim9_builtin.vim"": {""insertions"": 833, ""deletions"": 833, ""lines"": 1666}, ""src/testdir/test_vim9_cmd.vim"": {""insertions"": 4, ""deletions"": 4, ""lines"": 8}, ""src/testdir/test_vim9_expr.vim"": {""insertions"": 104, ""deletions"": 104, ""lines"": 208}, ""src/testdir/test_vim9_func.vim"": {""insertions"": 1, ""deletions"": 1, ""lines"": 2}, ""src/testdir/test_vim9_script.vim"": {""insertions"": 10, ""deletions"": 10, ""lines"": 20}, ""src/testdir/vim9.vim"": {""insertions"": 36, ""deletions"": 26, ""lines"": 62}, ""src/version.c"": {""insertions"": 2, ""deletions"": 0, ""lines"": 2}}"
2021-12-19 17:27:06,700e6b166298ecfb53fe4bf593085b29ca78d556,Bram Moolenaar,17,17,34,2,"{""src/testdir/test_listdict.vim"": {""insertions"": 15, ""deletions"": 17, ""lines"": 32}, ""src/version.c"": {""insertions"": 2, ""deletions"": 0, ""lines"": 2}}"
2021-12-19 15:17:21,f47c5a8e2d8eda7c2c8a9cccf9568eb56c03a0cf,Bram Moolenaar,41,6,47,5,"{""src/errors.h"": {""insertions"": 2, ""deletions"": 0, ""lines"": 2}, ""src/eval.c"": {""insertions"": 8, ""deletions"": 2, ""lines"": 10}, ""src/testdir/test_listdict.vim"": {""insertions"": 10, ""deletions"": 3, ""lines"": 13}, ""src/version.c"": {""insertions"": 2, ""deletions"": 0, ""lines"": 2}, ""src/vim9compile.c"": {""insertions"": 19, ""deletions"": 1, ""lines"": 20}}"
2021-12-19 12:33:05,265f811f5a2dac81d9698f5202a661a04ed095f1,Bram Moolenaar,313,202,515,4,"{""src/proto/typval.pro"": {""insertions"": 7, ""deletions"": 2, ""lines"": 9}, ""src/typval.c"": {""insertions"": 269, ""deletions"": 161, ""lines"": 430}, ""src/version.c"": {""insertions"": 2, ""deletions"": 0, ""lines"": 2}, ""src/vim9execute.c"": {""insertions"": 35, ""deletions"": 39, ""lines"": 74}}"
2021-12-19 11:06:35,2de5371a755abd287dab6ff544924715a76d4abe,Bram Moolenaar,11,1,12,3,"{""src/eval.c"": {""insertions"": 2, ""deletions"": 1, ""lines"": 3}, ""src/testdir/test_messages.vim"": {""insertions"": 7, ""deletions"": 0, ""lines"": 7}, ""src/version.c"": {""insertions"": 2, ""deletions"": 0, ""lines"": 2}}"
2021-12-19 10:35:15,389b72196e6aaeafe3f907c73d271f2c6b931140,Yegappan Lakshmanan,582,473,1055,4,"{""runtime/doc/eval.txt"": {""insertions"": 7, ""deletions"": 5, ""lines"": 12}, ""src/list.c"": {""insertions"": 570, ""deletions"": 468, ""lines"": 1038}, ""src/testdir/test_listdict.vim"": {""insertions"": 3, ""deletions"": 0, ""lines"": 3}, ""src/version.c"": {""insertions"": 2, ""deletions"": 0, ""lines"": 2}}"
2021-12-18 18:33:46,0ccb5842f5fb103763d106c7aa364d758343c35a,rbtnn,149,40,189,9,"{""runtime/doc/eval.txt"": {""insertions"": 4, ""deletions"": 3, ""lines"": 7}, ""src/errors.h"": {""insertions"": 5, ""deletions"": 1, ""lines"": 6}, ""src/evalfunc.c"": {""insertions"": 16, ""deletions"": 1, ""lines"": 17}, ""src/list.c"": {""insertions"": 71, ""deletions"": 17, ""lines"": 88}, ""src/proto/typval.pro"": {""insertions"": 1, ""deletions"": 0, ""lines"": 1}, ""src/testdir/test_listdict.vim"": {""insertions"": 25, ""deletions"": 4, ""lines"": 29}, ""src/testdir/test_vim9_builtin.vim"": {""insertions"": 6, ""deletions"": 6, ""lines"": 12}, ""src/typval.c"": {""insertions"": 19, ""deletions"": 8, ""lines"": 27}, ""src/version.c"": {""insertions"": 2, ""deletions"": 0, ""lines"": 2}}"
2021-12-18 16:54:31,605ec91e5a7330d61be313637e495fa02a6dc264,Bram Moolenaar,9,2,11,3,"{""src/eval.c"": {""insertions"": 5, ""deletions"": 2, ""lines"": 7}, ""src/testdir/test_lambda.vim"": {""insertions"": 2, ""deletions"": 0, ""lines"": 2}, ""src/version.c"": {""insertions"": 2, ""deletions"": 0, ""lines"": 2}}"
2021-12-18 15:32:46,60618c8f1a7ea55452837a446525272142286471,zeertzjq,23,5,28,4,"{""src/screen.c"": {""insertions"": 4, ""deletions"": 4, ""lines"": 8}, ""src/testdir/test_display.vim"": {""insertions"": 2, ""deletions"": 0, ""lines"": 2}, ""src/testdir/test_listchars.vim"": {""insertions"": 15, ""deletions"": 1, ""lines"": 16}, ""src/version.c"": {""insertions"": 2, ""deletions"": 0, ""lines"": 2}}"
2021-12-18 12:40:52,0dc4d8eaecc3acc26c3bee906d98097f9faa90bd,Dominique Pelle,8,2,10,2,"{""src/testdir/test_vim9_builtin.vim"": {""insertions"": 6, ""deletions"": 2, ""lines"": 8}, ""src/version.c"": {""insertions"": 2, ""deletions"": 0, ""lines"": 2}}"
2021-12-18 12:31:33,44a8977de467241a2f9959253d06eff53a8baad9,Bram Moolenaar,69,9,78,5,"{""src/proto/vim9type.pro"": {""insertions"": 1, ""deletions"": 0, ""lines"": 1}, ""src/testdir/test_vim9_assign.vim"": {""insertions"": 17, ""deletions"": 0, ""lines"": 17}, ""src/version.c"": {""insertions"": 2, ""deletions"": 0, ""lines"": 2}, ""src/vim9compile.c"": {""insertions"": 6, ""deletions"": 3, ""lines"": 9}, ""src/vim9type.c"": {""insertions"": 43, ""deletions"": 6, ""lines"": 49}}"
2021-12-17 20:52:57,647ab4cede4dbf412d24748f8e0a64d1cb9239f4,James McCoy,62,0,62,4,"{""runtime/autoload/dist/ft.vim"": {""insertions"": 17, ""deletions"": 0, ""lines"": 17}, ""runtime/filetype.vim"": {""insertions"": 3, ""deletions"": 0, ""lines"": 3}, ""src/testdir/test_filetype.vim"": {""insertions"": 40, ""deletions"": 0, ""lines"": 40}, ""src/version.c"": {""insertions"": 2, ""deletions"": 0, ""lines"": 2}}"
2021-12-17 20:36:15,422085f1c87cb6bea879158b8b05c4a5cf7ab48b,Bram Moolenaar,31,9,40,3,"{""src/testdir/test_listdict.vim"": {""insertions"": 12, ""deletions"": 0, ""lines"": 12}, ""src/version.c"": {""insertions"": 2, ""deletions"": 0, ""lines"": 2}, ""src/vim9execute.c"": {""insertions"": 17, ""deletions"": 9, ""lines"": 26}}"
2021-12-17 20:15:38,71b768509250b12696e8cc90e5902029f1b5433d,Bram Moolenaar,93,35,128,7,"{""src/errors.h"": {""insertions"": 18, ""deletions"": 0, ""lines"": 18}, ""src/evalvars.c"": {""insertions"": 24, ""deletions"": 12, ""lines"": 36}, ""src/globals.h"": {""insertions"": 0, ""deletions"": 1, ""lines"": 1}, ""src/testdir/test_listdict.vim"": {""insertions"": 13, ""deletions"": 8, ""lines"": 21}, ""src/testdir/test_vim9_assign.vim"": {""insertions"": 16, ""deletions"": 0, ""lines"": 16}, ""src/version.c"": {""insertions"": 2, ""deletions"": 0, ""lines"": 2}, ""src/vim9execute.c"": {""insertions"": 20, ""deletions"": 14, ""lines"": 34}}"
2021-12-17 18:01:31,ddc80aff575dd60c04c79621a0358cf0abaac53a,rbtnn,19,72,91,2,"{""src/typval.c"": {""insertions"": 17, ""deletions"": 72, ""lines"": 89}, ""src/version.c"": {""insertions"": 2, ""deletions"": 0, ""lines"": 2}}"
2021-12-17 17:32:29,354b23a9f87fd8c5aec457d88320a0a5bce4b985,Dominique Pelle,20,0,20,2,"{""src/testdir/test_syntax.vim"": {""insertions"": 18, ""deletions"": 0, ""lines"": 18}, ""src/version.c"": {""insertions"": 2, ""deletions"": 0, ""lines"": 2}}"
2021-12-17 16:21:20,db1a410b610b2c1941311acc57dcc4afec20720e,Yegappan Lakshmanan,282,40,322,7,"{""src/option.c"": {""insertions"": 26, ""deletions"": 4, ""lines"": 30}, ""src/testdir/dumps/Test_set_tagfunc_on_cmdline.dump"": {""insertions"": 0, ""deletions"": 6, ""lines"": 6}, ""src/testdir/test_ins_complete.vim"": {""insertions"": 150, ""deletions"": 12, ""lines"": 162}, ""src/testdir/test_normal.vim"": {""insertions"": 34, ""deletions"": 1, ""lines"": 35}, ""src/testdir/test_quickfix.vim"": {""insertions"": 17, ""deletions"": 0, ""lines"": 17}, ""src/testdir/test_tagfunc.vim"": {""insertions"": 53, ""deletions"": 17, ""lines"": 70}, ""src/version.c"": {""insertions"": 2, ""deletions"": 0, ""lines"": 2}}"
2021-12-17 16:00:04,d2ff705af32862b4da49d213613233f93343874c,Bram Moolenaar,11,4,15,2,"{""src/autocmd.c"": {""insertions"": 9, ""deletions"": 4, ""lines"": 13}, ""src/version.c"": {""insertions"": 2, ""deletions"": 0, ""lines"": 2}}"
2021-12-17 14:46:12,02929a372e5e14db1b85abdc7d4515d6b2d81888,Bram Moolenaar,23,2,25,2,"{""src/eval.c"": {""insertions"": 21, ""deletions"": 2, ""lines"": 23}, ""src/version.c"": {""insertions"": 2, ""deletions"": 0, ""lines"": 2}}"
2021-12-17 12:45:22,259f443a934c6f2447a14bfe54403903416a9af0,Bram Moolenaar,18,4,22,4,"{""runtime/doc/vim9.txt"": {""insertions"": 6, ""deletions"": 3, ""lines"": 9}, ""src/ex_cmds.h"": {""insertions"": 1, ""deletions"": 1, ""lines"": 2}, ""src/testdir/test_vim9_expr.vim"": {""insertions"": 9, ""deletions"": 0, ""lines"": 9}, ""src/version.c"": {""insertions"": 2, ""deletions"": 0, ""lines"": 2}}"
2021-12-17 11:44:33,deda6441e457072df39cdc8744dcd685d77fa273,Bram Moolenaar,9,2,11,2,"{""src/testdir/test_channel.vim"": {""insertions"": 7, ""deletions"": 2, ""lines"": 9}, ""src/version.c"": {""insertions"": 2, ""deletions"": 0, ""lines"": 2}}"
2021-12-17 09:44:33,c3f91c0648f4b04a6a9ceb4ccec45ea767a63796,ichizok,27,0,27,3,"{""src/autocmd.c"": {""insertions"": 5, ""deletions"": 0, ""lines"": 5}, ""src/testdir/test_terminal3.vim"": {""insertions"": 20, ""deletions"": 0, ""lines"": 20}, ""src/version.c"": {""insertions"": 2, ""deletions"": 0, ""lines"": 2}}"
2021-12-16 21:11:26,994a0a298bfbdd03e2eaae64268739d617080644,Bram Moolenaar,4,2,6,2,"{""src/testdir/test_vimscript.vim"": {""insertions"": 2, ""deletions"": 2, ""lines"": 4}, ""src/version.c"": {""insertions"": 2, ""deletions"": 0, ""lines"": 2}}"
2021-12-16 21:07:35,23e72369ffa2c18e9fda1e5d77f4397dc4700764,Bram Moolenaar,3,7,10,3,"{""src/testdir/dumps/Test_opfunc_error.dump"": {""insertions"": 0, ""deletions"": 6, ""lines"": 6}, ""src/testdir/test_vim9_func.vim"": {""insertions"": 1, ""deletions"": 1, ""lines"": 2}, ""src/version.c"": {""insertions"": 2, ""deletions"": 0, ""lines"": 2}}"
2021-12-16 20:56:57,e124204c4f8ea8b4fe5357b7613092a7acb5feb8,Bram Moolenaar,137,74,211,19,"{""src/buffer.c"": {""insertions"": 4, ""deletions"": 4, ""lines"": 8}, ""src/dict.c"": {""insertions"": 1, ""deletions"": 1, ""lines"": 2}, ""src/diff.c"": {""insertions"": 8, ""deletions"": 8, ""lines"": 16}, ""src/digraph.c"": {""insertions"": 2, ""deletions"": 2, ""lines"": 4}, ""src/errors.h"": {""insertions"": 65, ""deletions"": 1, ""lines"": 66}, ""src/eval.c"": {""insertions"": 7, ""deletions"": 7, ""lines"": 14}, ""src/evalfunc.c"": {""insertions"": 5, ""deletions"": 4, ""lines"": 9}, ""src/evalvars.c"": {""insertions"": 1, ""deletions"": 1, ""lines"": 2}, ""src/globals.h"": {""insertions"": 0, ""deletions"": 9, ""lines"": 9}, ""src/misc2.c"": {""insertions"": 1, ""deletions"": 1, ""lines"": 2}, ""src/quickfix.c"": {""insertions"": 1, ""deletions"": 1, ""lines"": 2}, ""src/typval.c"": {""insertions"": 4, ""deletions"": 4, ""lines"": 8}, ""src/ui.c"": {""insertions"": 1, ""deletions"": 1, ""lines"": 2}, ""src/userfunc.c"": {""insertions"": 8, ""deletions"": 6, ""lines"": 14}, ""src/version.c"": {""insertions"": 2, ""deletions"": 0, ""lines"": 2}, ""src/vim9compile.c"": {""insertions"": 17, ""deletions"": 15, ""lines"": 32}, ""src/vim9execute.c"": {""insertions"": 6, ""deletions"": 5, ""lines"": 11}, ""src/vim9type.c"": {""insertions"": 3, ""deletions"": 3, ""lines"": 6}, ""src/window.c"": {""insertions"": 1, ""deletions"": 1, ""lines"": 2}}"
2021-12-16 19:45:47,94c785d235dccacf6cdf38c5903115b61ca8a981,Bram Moolenaar,22,0,22,4,"{""src/option.c"": {""insertions"": 3, ""deletions"": 0, ""lines"": 3}, ""src/testdir/dumps/Test_set_tagfunc_on_cmdline.dump"": {""insertions"": 6, ""deletions"": 0, ""lines"": 6}, ""src/testdir/test_tagfunc.vim"": {""insertions"": 11, ""deletions"": 0, ""lines"": 11}, ""src/version.c"": {""insertions"": 2, ""deletions"": 0, ""lines"": 2}}"
2021-12-16 18:02:07,8103527da7f12ff21c2566222748518ee093432c,Bram Moolenaar,52,2,54,4,"{""src/edit.c"": {""insertions"": 7, ""deletions"": 2, ""lines"": 9}, ""src/terminal.c"": {""insertions"": 17, ""deletions"": 0, ""lines"": 17}, ""src/testdir/test_terminal.vim"": {""insertions"": 26, ""deletions"": 0, ""lines"": 26}, ""src/version.c"": {""insertions"": 2, ""deletions"": 0, ""lines"": 2}}"
2021-12-16 16:14:11,f79cbf6512863c167bc794035df067e3a3e474f3,Bram Moolenaar,9,1,10,4,"{"".github/ISSUE_TEMPLATE/bug_report.yml"": {""insertions"": 5, ""deletions"": 0, ""lines"": 5}, ""Filelist"": {""insertions"": 1, ""deletions"": 0, ""lines"": 1}, ""README.md"": {""insertions"": 1, ""deletions"": 1, ""lines"": 2}, ""src/version.c"": {""insertions"": 2, ""deletions"": 0, ""lines"": 2}}"
2021-12-16 15:49:43,b15cf44c1d9c92a2ac07cff415071e31a9ad88fa,Bram Moolenaar,30,2,32,4,"{""src/testdir/test_vim9_disassemble.vim"": {""insertions"": 1, ""deletions"": 1, ""lines"": 2}, ""src/testdir/test_vim9_func.vim"": {""insertions"": 12, ""deletions"": 0, ""lines"": 12}, ""src/version.c"": {""insertions"": 2, ""deletions"": 0, ""lines"": 2}, ""src/vim9compile.c"": {""insertions"": 15, ""deletions"": 1, ""lines"": 16}}"
2021-12-16 14:45:13,52797bae1710621926c03a2611c40a692c96fb44,Bram Moolenaar,15,4,19,6,"{""src/getchar.c"": {""insertions"": 2, ""deletions"": 2, ""lines"": 4}, ""src/gui_motif.c"": {""insertions"": 1, ""deletions"": 1, ""lines"": 2}, ""src/mbyte.c"": {""insertions"": 6, ""deletions"": 0, ""lines"": 6}, ""src/regexp_nfa.c"": {""insertions"": 1, ""deletions"": 1, ""lines"": 2}, ""src/testdir/test_edit.vim"": {""insertions"": 3, ""deletions"": 0, ""lines"": 3}, ""src/version.c"": {""insertions"": 2, ""deletions"": 0, ""lines"": 2}}"
2021-12-16 14:41:10,0e6adf8a29d5c2c96c42cc7157f71bf22c2ad471,Bram Moolenaar,503,452,955,25,"{"".github/CODEOWNERS"": {""insertions"": 3, ""deletions"": 0, ""lines"": 3}, ""runtime/doc/editing.txt"": {""insertions"": 1, ""deletions"": 1, ""lines"": 2}, ""runtime/doc/eval.txt"": {""insertions"": 1, ""deletions"": 1, ""lines"": 2}, ""runtime/doc/helphelp.txt"": {""insertions"": 2, ""deletions"": 2, ""lines"": 4}, ""runtime/doc/map.txt"": {""insertions"": 18, ""deletions"": 11, ""lines"": 29}, ""runtime/doc/message.txt"": {""insertions"": 1, ""deletions"": 1, ""lines"": 2}, ""runtime/doc/motion.txt"": {""insertions"": 1, ""deletions"": 1, ""lines"": 2}, ""runtime/doc/tags"": {""insertions"": 5, ""deletions"": 0, ""lines"": 5}, ""runtime/doc/term.txt"": {""insertions"": 5, ""deletions"": 1, ""lines"": 6}, ""runtime/doc/testing.txt"": {""insertions"": 3, ""deletions"": 2, ""lines"": 5}, ""runtime/doc/todo.txt"": {""insertions"": 6, ""deletions"": 8, ""lines"": 14}, ""runtime/doc/various.txt"": {""insertions"": 2, ""deletions"": 2, ""lines"": 4}, ""runtime/doc/vim9.txt"": {""insertions"": 15, ""deletions"": 1, ""lines"": 16}, ""runtime/filetype.vim"": {""insertions"": 1, ""deletions"": 1, ""lines"": 2}, ""runtime/ftplugin/i3config.vim"": {""insertions"": 13, ""deletions"": 0, ""lines"": 13}, ""runtime/ftplugin/solution.vim"": {""insertions"": 37, ""deletions"": 0, ""lines"": 37}, ""runtime/optwin.vim"": {""insertions"": 3, ""deletions"": 5, ""lines"": 8}, ""runtime/pack/dist/opt/termdebug/plugin/termdebug.vim"": {""insertions"": 29, ""deletions"": 11, ""lines"": 40}, ""runtime/syntax/c.vim"": {""insertions"": 1, ""deletions"": 2, ""lines"": 3}, ""runtime/syntax/css.vim"": {""insertions"": 17, ""deletions"": 12, ""lines"": 29}, ""runtime/syntax/i3config.vim"": {""insertions"": 256, ""deletions"": 0, ""lines"": 256}, ""runtime/syntax/python.vim"": {""insertions"": 3, ""deletions"": 2, ""lines"": 5}, ""runtime/syntax/texinfo.vim"": {""insertions"": 28, ""deletions"": 378, ""lines"": 406}, ""runtime/syntax/vim.vim"": {""insertions"": 10, ""deletions"": 10, ""lines"": 20}, ""src/testdir/README.txt"": {""insertions"": 42, ""deletions"": 0, ""lines"": 42}}"
2021-12-16 13:06:10,6df0f2759d12ec0bc999b2963ecea4387a2bc516,Yegappan Lakshmanan,14,1,15,5,"{""src/Make_mvc.mak"": {""insertions"": 8, ""deletions"": 0, ""lines"": 8}, ""src/findfile.c"": {""insertions"": 1, ""deletions"": 1, ""lines"": 2}, ""src/os_mswin.c"": {""insertions"": 2, ""deletions"": 0, ""lines"": 2}, ""src/testdir/test_fnamemodify.vim"": {""insertions"": 1, ""deletions"": 0, ""lines"": 1}, ""src/version.c"": {""insertions"": 2, ""deletions"": 0, ""lines"": 2}}"
2021-12-16 10:05:41,6ecf58b0d7d9b8fbba780d19d2e6c0f227df715b,Bram Moolenaar,7,4,11,2,"{""src/testdir/test_visual.vim"": {""insertions"": 5, ""deletions"": 4, ""lines"": 9}, ""src/version.c"": {""insertions"": 2, ""deletions"": 0, ""lines"": 2}}"
2021-12-16 08:21:09,2d877599ee1cede063ef4abe3a2272e67c116238,Bram Moolenaar,130,64,194,8,"{""src/errors.h"": {""insertions"": 2, ""deletions"": 0, ""lines"": 2}, ""src/evalfunc.c"": {""insertions"": 17, ""deletions"": 1, ""lines"": 18}, ""src/list.c"": {""insertions"": 3, ""deletions"": 2, ""lines"": 5}, ""src/proto/typval.pro"": {""insertions"": 1, ""deletions"": 0, ""lines"": 1}, ""src/testdir/test_filter_map.vim"": {""insertions"": 78, ""deletions"": 56, ""lines"": 134}, ""src/testdir/test_vim9_builtin.vim"": {""insertions"": 5, ""deletions"": 5, ""lines"": 10}, ""src/typval.c"": {""insertions"": 22, ""deletions"": 0, ""lines"": 22}, ""src/version.c"": {""insertions"": 2, ""deletions"": 0, ""lines"": 2}}"
2021-12-15 21:29:19,19569ca6d805de7a2ac95ee7b0c52475a9d5d851,Bram Moolenaar,3,1,4,2,"{"".github/workflows/ci.yml"": {""insertions"": 1, ""deletions"": 1, ""lines"": 2}, ""src/version.c"": {""insertions"": 2, ""deletions"": 0, ""lines"": 2}}"
2021-12-15 21:08:50,8ee6028de3daa9af9e5f90fa9e583ff407bee04f,Bram Moolenaar,11,2,13,3,"{""src/ops.c"": {""insertions"": 5, ""deletions"": 2, ""lines"": 7}, ""src/testdir/test_visual.vim"": {""insertions"": 4, ""deletions"": 0, ""lines"": 4}, ""src/version.c"": {""insertions"": 2, ""deletions"": 0, ""lines"": 2}}"
2021-12-15 19:46:59,427f065a885629db430dd06ccda8b1318b8a5e92,Bram Moolenaar,4,2,6,3,"{""src/testdir/dumps/Test_popupwin_three_errors_1.dump"": {""insertions"": 1, ""deletions"": 1, ""lines"": 2}, ""src/testdir/dumps/Test_popupwin_three_errors_2.dump"": {""insertions"": 1, ""deletions"": 1, ""lines"": 2}, ""src/version.c"": {""insertions"": 2, ""deletions"": 0, ""lines"": 2}}"
2021-12-15 19:14:54,c479ce032f5d4d14bab9e479acbf42d758879893,rbtnn,169,27,196,5,"{""runtime/doc/eval.txt"": {""insertions"": 34, ""deletions"": 24, ""lines"": 58}, ""src/errors.h"": {""insertions"": 2, ""deletions"": 0, ""lines"": 2}, ""src/list.c"": {""insertions"": 67, ""deletions"": 1, ""lines"": 68}, ""src/testdir/test_filter_map.vim"": {""insertions"": 64, ""deletions"": 2, ""lines"": 66}, ""src/version.c"": {""insertions"": 2, ""deletions"": 0, ""lines"": 2}}"
2021-12-15 17:53:40,f87dac04c351583241ea1c4ec4228516431e6f22,Bram Moolenaar,38,24,62,4,"{""src/ex_cmds.h"": {""insertions"": 21, ""deletions"": 20, ""lines"": 41}, ""src/ex_docmd.c"": {""insertions"": 1, ""deletions"": 1, ""lines"": 2}, ""src/testdir/test_usercommands.vim"": {""insertions"": 14, ""deletions"": 3, ""lines"": 17}, ""src/version.c"": {""insertions"": 2, ""deletions"": 0, ""lines"": 2}}"
2021-12-15 16:38:33,1821d1498ca57dc3f7a21767c253a778d9b113fb,Mike Williams,3,1,4,2,"{""src/userfunc.c"": {""insertions"": 1, ""deletions"": 1, ""lines"": 2}, ""src/version.c"": {""insertions"": 2, ""deletions"": 0, ""lines"": 2}}"
2021-12-15 15:41:44,ce7eada12ea16c830332042f0021a9564bbb25af,Bram Moolenaar,34,4,38,6,"{""src/charset.c"": {""insertions"": 15, ""deletions"": 2, ""lines"": 17}, ""src/eval.c"": {""insertions"": 1, ""deletions"": 1, ""lines"": 2}, ""src/ex_docmd.c"": {""insertions"": 1, ""deletions"": 1, ""lines"": 2}, ""src/proto/charset.pro"": {""insertions"": 1, ""deletions"": 0, ""lines"": 1}, ""src/testdir/test_vim9_expr.vim"": {""insertions"": 14, ""deletions"": 0, ""lines"": 14}, ""src/version.c"": {""insertions"": 2, ""deletions"": 0, ""lines"": 2}}"
2021-12-15 13:30:43,cfabad9bcf45650dee1f1f41ec4047f82a12f323,Bram Moolenaar,8,2,10,3,"{""runtime/filetype.vim"": {""insertions"": 4, ""deletions"": 1, ""lines"": 5}, ""src/testdir/test_filetype.vim"": {""insertions"": 2, ""deletions"": 1, ""lines"": 3}, ""src/version.c"": {""insertions"": 2, ""deletions"": 0, ""lines"": 2}}"
2021-12-15 12:28:22,a5d78d1f1123d9ffccd5ba58f2d2dec44cc59e94,Bram Moolenaar,12,0,12,3,"{""src/ex_docmd.c"": {""insertions"": 4, ""deletions"": 0, ""lines"": 4}, ""src/testdir/test_quickfix.vim"": {""insertions"": 6, ""deletions"": 0, ""lines"": 6}, ""src/version.c"": {""insertions"": 2, ""deletions"": 0, ""lines"": 2}}"
2021-12-15 12:06:43,57bc2333b1d713bc54f8e33ef3ef7ac169af2ac4,Bram Moolenaar,45,20,65,2,"{""src/userfunc.c"": {""insertions"": 43, ""deletions"": 20, ""lines"": 63}, ""src/version.c"": {""insertions"": 2, ""deletions"": 0, ""lines"": 2}}"
2021-12-14 20:26:53,7c0fb800302c3bdd2dfa5ba10d0caa806e9500f6,Bram Moolenaar,3,0,3,2,"{""src/testdir/test_vim9_func.vim"": {""insertions"": 1, ""deletions"": 0, ""lines"": 1}, ""src/version.c"": {""insertions"": 2, ""deletions"": 0, ""lines"": 2}}"
2021-12-14 18:57:45,b334137acffd7a2b2ab8524e54d4c55ebf4518ea,Bram Moolenaar,13,3,16,3,"{""src/eval.c"": {""insertions"": 1, ""deletions"": 1, ""lines"": 2}, ""src/testdir/test_vim9_expr.vim"": {""insertions"": 10, ""deletions"": 2, ""lines"": 12}, ""src/version.c"": {""insertions"": 2, ""deletions"": 0, ""lines"": 2}}"
2021-12-14 18:14:37,7509ad8b0fad56f88288977decbeca3640406c82,Bram Moolenaar,100,12,112,6,"{""src/eval.c"": {""insertions"": 4, ""deletions"": 9, ""lines"": 13}, ""src/proto/vim9execute.pro"": {""insertions"": 1, ""deletions"": 0, ""lines"": 1}, ""src/structs.h"": {""insertions"": 7, ""deletions"": 2, ""lines"": 9}, ""src/testdir/test_vim9_func.vim"": {""insertions"": 35, ""deletions"": 0, ""lines"": 35}, ""src/version.c"": {""insertions"": 2, ""deletions"": 0, ""lines"": 2}, ""src/vim9execute.c"": {""insertions"": 51, ""deletions"": 1, ""lines"": 52}}"
2021-12-14 14:29:16,919c12c19a9785b856bc32dfe6cd8e9277178b62,Bram Moolenaar,5,3,8,2,"{""src/version.c"": {""insertions"": 2, ""deletions"": 0, ""lines"": 2}, ""src/vim9execute.c"": {""insertions"": 3, ""deletions"": 3, ""lines"": 6}}"
2021-12-14 12:06:16,f8a79fc3468645019532331bf8b36d1f7b403ef4,Bram Moolenaar,28,2,30,4,"{""src/eval.c"": {""insertions"": 1, ""deletions"": 1, ""lines"": 2}, ""src/testdir/test_vim9_script.vim"": {""insertions"": 15, ""deletions"": 0, ""lines"": 15}, ""src/userfunc.c"": {""insertions"": 10, ""deletions"": 1, ""lines"": 11}, ""src/version.c"": {""insertions"": 2, ""deletions"": 0, ""lines"": 2}}"
2021-12-14 11:16:31,c2958585f6c7ce4d822d3191ba501c0757b3ffff,Bram Moolenaar,4,3,7,2,"{""src/testdir/test_terminal.vim"": {""insertions"": 2, ""deletions"": 3, ""lines"": 5}, ""src/version.c"": {""insertions"": 2, ""deletions"": 0, ""lines"": 2}}"
2021-12-14 09:34:41,8176be159859deb9cf6455565bd7b24b3dcf17b9,Quentin Hibon,7,0,7,3,"{""runtime/filetype.vim"": {""insertions"": 4, ""deletions"": 0, ""lines"": 4}, ""src/testdir/test_filetype.vim"": {""insertions"": 1, ""deletions"": 0, ""lines"": 1}, ""src/version.c"": {""insertions"": 2, ""deletions"": 0, ""lines"": 2}}"
2021-12-14 09:01:38,6206877c511c636cbeb2a2b911451af316b62d00,Bram Moolenaar,4,1,5,2,"{""src/option.c"": {""insertions"": 2, ""deletions"": 1, ""lines"": 3}, ""src/version.c"": {""insertions"": 2, ""deletions"": 0, ""lines"": 2}}"
2021-12-14 08:41:38,829c8e87e2d99b9d87c9c745e74750177c0298df,Bram Moolenaar,5,3,8,2,"{""src/terminal.c"": {""insertions"": 3, ""deletions"": 3, ""lines"": 6}, ""src/version.c"": {""insertions"": 2, ""deletions"": 0, ""lines"": 2}}"
2021-12-13 22:17:44,0407d270342d363c6297a7556cd904b4c434df54,Bram Moolenaar,6,2,8,2,"{""src/testdir/test_terminal.vim"": {""insertions"": 4, ""deletions"": 2, ""lines"": 6}, ""src/version.c"": {""insertions"": 2, ""deletions"": 0, ""lines"": 2}}"
2021-12-13 21:59:09,3194e5bf87f8e08f519b947a03c46677616cd7e3,Bram Moolenaar,53,2,55,5,"{""src/drawscreen.c"": {""insertions"": 7, ""deletions"": 0, ""lines"": 7}, ""src/proto/terminal.pro"": {""insertions"": 1, ""deletions"": 0, ""lines"": 1}, ""src/terminal.c"": {""insertions"": 16, ""deletions"": 2, ""lines"": 18}, ""src/testdir/test_terminal.vim"": {""insertions"": 27, ""deletions"": 0, ""lines"": 27}, ""src/version.c"": {""insertions"": 2, ""deletions"": 0, ""lines"": 2}}"
2021-12-13 20:37:59,6840a0ffe8d27a8773a500ba17550cdf2ad12cbc,Bram Moolenaar,105,44,149,3,"{""src/auto/configure"": {""insertions"": 55, ""deletions"": 22, ""lines"": 77}, ""src/configure.ac"": {""insertions"": 48, ""deletions"": 22, ""lines"": 70}, ""src/version.c"": {""insertions"": 2, ""deletions"": 0, ""lines"": 2}}"
2021-12-13 19:14:52,80d60910ff493f7b8ea52156e4c7df7e70a348c6,Bram Moolenaar,3,1,4,2,"{""src/userfunc.c"": {""insertions"": 1, ""deletions"": 1, ""lines"": 2}, ""src/version.c"": {""insertions"": 2, ""deletions"": 0, ""lines"": 2}}"
2021-12-13 18:19:55,3b309f11db7904efcae0177c2825597042c07427,Bram Moolenaar,65,10,75,4,"{""src/testdir/dumps/Test_opfunc_error.dump"": {""insertions"": 6, ""deletions"": 0, ""lines"": 6}, ""src/testdir/test_vim9_func.vim"": {""insertions"": 48, ""deletions"": 10, ""lines"": 58}, ""src/userfunc.c"": {""insertions"": 9, ""deletions"": 0, ""lines"": 9}, ""src/version.c"": {""insertions"": 2, ""deletions"": 0, ""lines"": 2}}"
2021-12-13 14:40:53,1e78deb0779bc403a914712f0842a65d2949dfdf,Bram Moolenaar,6,9,15,3,"{""runtime/doc/message.txt"": {""insertions"": 1, ""deletions"": 2, ""lines"": 3}, ""src/feature.h"": {""insertions"": 3, ""deletions"": 7, ""lines"": 10}, ""src/version.c"": {""insertions"": 2, ""deletions"": 0, ""lines"": 2}}"
2021-12-13 14:26:44,851f86b951cdd67ad9cf3149e46169d1375c8d82,Bram Moolenaar,87,84,171,8,"{""src/eval.c"": {""insertions"": 18, ""deletions"": 18, ""lines"": 36}, ""src/list.c"": {""insertions"": 6, ""deletions"": 6, ""lines"": 12}, ""src/regexp.c"": {""insertions"": 3, ""deletions"": 3, ""lines"": 6}, ""src/structs.h"": {""insertions"": 9, ""deletions"": 9, ""lines"": 18}, ""src/terminal.c"": {""insertions"": 3, ""deletions"": 3, ""lines"": 6}, ""src/userfunc.c"": {""insertions"": 43, ""deletions"": 42, ""lines"": 85}, ""src/version.c"": {""insertions"": 2, ""deletions"": 0, ""lines"": 2}, ""src/vim9execute.c"": {""insertions"": 3, ""deletions"": 3, ""lines"": 6}}"
2021-12-13 13:12:53,739f13a55b4982efb37ebc9282e7f79975fff982,Bram Moolenaar,9,122,131,17,"{""runtime/doc/motion.txt"": {""insertions"": 0, ""deletions"": 7, ""lines"": 7}, ""runtime/doc/various.txt"": {""insertions"": 1, ""deletions"": 1, ""lines"": 2}, ""src/buffer.c"": {""insertions"": 0, ""deletions"": 2, ""lines"": 2}, ""src/change.c"": {""insertions"": 0, ""deletions"": 4, ""lines"": 4}, ""src/evalfunc.c"": {""insertions"": 1, ""deletions"": 15, ""lines"": 16}, ""src/ex_docmd.c"": {""insertions"": 0, ""deletions"": 6, ""lines"": 6}, ""src/feature.h"": {""insertions"": 1, ""deletions"": 7, ""lines"": 8}, ""src/mark.c"": {""insertions"": 1, ""deletions"": 25, ""lines"": 26}, ""src/normal.c"": {""insertions"": 2, ""deletions"": 8, ""lines"": 10}, ""src/structs.h"": {""insertions"": 0, ""deletions"": 4, ""lines"": 4}, ""src/testdir/test_changelist.vim"": {""insertions"": 0, ""deletions"": 4, ""lines"": 4}, ""src/testdir/test_jumplist.vim"": {""insertions"": 0, ""deletions"": 4, ""lines"": 4}, ""src/testdir/test_normal.vim"": {""insertions"": 0, ""deletions"": 2, ""lines"": 2}, ""src/undo.c"": {""insertions"": 1, ""deletions"": 3, ""lines"": 4}, ""src/version.c"": {""insertions"": 2, ""deletions"": 4, ""lines"": 6}, ""src/viminfo.c"": {""insertions"": 0, ""deletions"": 20, ""lines"": 20}, ""src/window.c"": {""insertions"": 0, ""deletions"": 6, ""lines"": 6}}"
2021-12-13 11:31:04,33b968dc60c5fa39451098e680c7559ebc65d1a7,Bram Moolenaar,18,3,21,3,"{""src/testdir/test_vim9_func.vim"": {""insertions"": 12, ""deletions"": 0, ""lines"": 12}, ""src/userfunc.c"": {""insertions"": 4, ""deletions"": 3, ""lines"": 7}, ""src/version.c"": {""insertions"": 2, ""deletions"": 0, ""lines"": 2}}"
2021-12-12 21:02:03,ef082e12df2cafe177b2ac9f6922393223ccf83b,Bram Moolenaar,28,2,30,3,"{""src/evalvars.c"": {""insertions"": 7, ""deletions"": 2, ""lines"": 9}, ""src/testdir/test_vim9_func.vim"": {""insertions"": 19, ""deletions"": 0, ""lines"": 19}, ""src/version.c"": {""insertions"": 2, ""deletions"": 0, ""lines"": 2}}"
2021-12-12 20:08:05,04ef1fb13d200f770952e670357dddadb6210dd4,Yegappan Lakshmanan,386,304,690,6,"{""src/testdir/test_iminsert.vim"": {""insertions"": 11, ""deletions"": 6, ""lines"": 17}, ""src/testdir/test_ins_complete.vim"": {""insertions"": 215, ""deletions"": 185, ""lines"": 400}, ""src/testdir/test_normal.vim"": {""insertions"": 71, ""deletions"": 61, ""lines"": 132}, ""src/testdir/test_quickfix.vim"": {""insertions"": 7, ""deletions"": 0, ""lines"": 7}, ""src/testdir/test_tagfunc.vim"": {""insertions"": 80, ""deletions"": 52, ""lines"": 132}, ""src/version.c"": {""insertions"": 2, ""deletions"": 0, ""lines"": 2}}"
2021-12-12 19:10:44,d2439e0443ee26931ab93874c05cc7f57e9af93d,Bram Moolenaar,5,3,8,2,"{""src/change.c"": {""insertions"": 3, ""deletions"": 3, ""lines"": 6}, ""src/version.c"": {""insertions"": 2, ""deletions"": 0, ""lines"": 2}}"
2021-12-12 18:50:19,3bb79dc191a1dec14606b1b94b968a6808906700,Bram Moolenaar,7,9,16,2,"{""src/testdir/test_terminal2.vim"": {""insertions"": 5, ""deletions"": 9, ""lines"": 14}, ""src/version.c"": {""insertions"": 2, ""deletions"": 0, ""lines"": 2}}"
2021-12-12 16:42:09,fa9a8e0fd1143d2b47611c6cc13e32f6283448a4,ichizok,9,3,12,2,"{""src/testdir/test_window_cmd.vim"": {""insertions"": 7, ""deletions"": 3, ""lines"": 10}, ""src/version.c"": {""insertions"": 2, ""deletions"": 0, ""lines"": 2}}"
2021-12-12 16:26:44,6ae8fae8696623b527c7fb22567f6a3705b2f0dd,Yegappan Lakshmanan,1091,898,1989,19,"{""src/eval.c"": {""insertions"": 28, ""deletions"": 0, ""lines"": 28}, ""src/evalbuffer.c"": {""insertions"": 15, ""deletions"": 21, ""lines"": 36}, ""src/evalvars.c"": {""insertions"": 0, ""deletions"": 1, ""lines"": 1}, ""src/gui_xim.c"": {""insertions"": 19, ""deletions"": 1, ""lines"": 20}, ""src/insexpand.c"": {""insertions"": 15, ""deletions"": 0, ""lines"": 15}, ""src/ops.c"": {""insertions"": 18, ""deletions"": 2, ""lines"": 20}, ""src/proto/eval.pro"": {""insertions"": 1, ""deletions"": 0, ""lines"": 1}, ""src/proto/gui_xim.pro"": {""insertions"": 1, ""deletions"": 0, ""lines"": 1}, ""src/proto/insexpand.pro"": {""insertions"": 1, ""deletions"": 0, ""lines"": 1}, ""src/proto/ops.pro"": {""insertions"": 1, ""deletions"": 0, ""lines"": 1}, ""src/proto/tag.pro"": {""insertions"": 1, ""deletions"": 0, ""lines"": 1}, ""src/quickfix.c"": {""insertions"": 11, ""deletions"": 2, ""lines"": 13}, ""src/tag.c"": {""insertions"": 20, ""deletions"": 4, ""lines"": 24}, ""src/testdir/test_iminsert.vim"": {""insertions"": 121, ""deletions"": 109, ""lines"": 230}, ""src/testdir/test_ins_complete.vim"": {""insertions"": 465, ""deletions"": 492, ""lines"": 957}, ""src/testdir/test_normal.vim"": {""insertions"": 119, ""deletions"": 129, ""lines"": 248}, ""src/testdir/test_quickfix.vim"": {""insertions"": 126, ""deletions"": 0, ""lines"": 126}, ""src/testdir/test_tagfunc.vim"": {""insertions"": 127, ""deletions"": 137, ""lines"": 264}, ""src/version.c"": {""insertions"": 2, ""deletions"": 0, ""lines"": 2}}"
2021-12-12 14:16:39,6e371ecb27227ff8fedd8561d0f3880a17576848,Bram Moolenaar,118,24,142,11,"{""src/change.c"": {""insertions"": 47, ""deletions"": 10, ""lines"": 57}, ""src/cindent.c"": {""insertions"": 23, ""deletions"": 6, ""lines"": 29}, ""src/edit.c"": {""insertions"": 2, ""deletions"": 1, ""lines"": 3}, ""src/normal.c"": {""insertions"": 1, ""deletions"": 1, ""lines"": 2}, ""src/proto/change.pro"": {""insertions"": 1, ""deletions"": 1, ""lines"": 2}, ""src/proto/search.pro"": {""insertions"": 1, ""deletions"": 0, ""lines"": 1}, ""src/search.c"": {""insertions"": 1, ""deletions"": 2, ""lines"": 3}, ""src/testdir/test_cindent.vim"": {""insertions"": 2, ""deletions"": 2, ""lines"": 4}, ""src/testdir/test_textformat.vim"": {""insertions"": 30, ""deletions"": 0, ""lines"": 30}, ""src/textformat.c"": {""insertions"": 8, ""deletions"": 1, ""lines"": 9}, ""src/version.c"": {""insertions"": 2, ""deletions"": 0, ""lines"": 2}}"
2021-12-12 11:44:11,9a4ec5a62632af040c278a189e256043740f5c7f,Bram Moolenaar,10,5,15,1,"{"".github/ISSUE_TEMPLATE/bug_report.yml"": {""insertions"": 10, ""deletions"": 5, ""lines"": 15}}"
2021-12-12 11:34:22,4e30b5c3bc83fe6a87f4d50720638e8bb4e16428,Bram Moolenaar,2,2,4,1,"{"".github/ISSUE_TEMPLATE/bug_report.yml"": {""insertions"": 2, ""deletions"": 2, ""lines"": 4}}"
2021-12-11 18:46:29,4f16e9de985c5178e9cf15d69facfec6f15a5e09,Bram Moolenaar,3,1,4,2,"{""src/testdir/test_functions.vim"": {""insertions"": 1, ""deletions"": 1, ""lines"": 2}, ""src/version.c"": {""insertions"": 2, ""deletions"": 0, ""lines"": 2}}"
2021-12-11 17:34:19,48c0196378a1fa408ebae4f578a62095d8a80c6f,ichizok,6,3,9,2,"{"".github/workflows/ci.yml"": {""insertions"": 4, ""deletions"": 3, ""lines"": 7}, ""src/version.c"": {""insertions"": 2, ""deletions"": 0, ""lines"": 2}}"
2021-12-11 17:24:39,7b1463bca36d16e70afd6779e4fbb30761048c91,Bram Moolenaar,18,2,20,2,"{""runtime/doc/options.txt"": {""insertions"": 16, ""deletions"": 2, ""lines"": 18}, ""src/version.c"": {""insertions"": 2, ""deletions"": 0, ""lines"": 2}}"
2021-12-11 16:14:07,2ef9156b4284e4a52613c36e3d4667245273a28d,Bram Moolenaar,51,19,70,9,"{""src/eval.c"": {""insertions"": 3, ""deletions"": 1, ""lines"": 4}, ""src/proto/userfunc.pro"": {""insertions"": 2, ""deletions"": 2, ""lines"": 4}, ""src/structs.h"": {""insertions"": 2, ""deletions"": 0, ""lines"": 2}, ""src/testdir/test_functions.vim"": {""insertions"": 6, ""deletions"": 0, ""lines"": 6}, ""src/testdir/test_vim9_func.vim"": {""insertions"": 1, ""deletions"": 1, ""lines"": 2}, ""src/testdir/test_vim9_script.vim"": {""insertions"": 9, ""deletions"": 0, ""lines"": 9}, ""src/userfunc.c"": {""insertions"": 16, ""deletions"": 7, ""lines"": 23}, ""src/version.c"": {""insertions"": 2, ""deletions"": 0, ""lines"": 2}, ""src/vim9execute.c"": {""insertions"": 10, ""deletions"": 8, ""lines"": 18}}"
2021-12-11 13:54:46,052ff291d72bc9c176f9562f021d7e8e030e74c0,Bram Moolenaar,46,10,56,5,"{""src/evalvars.c"": {""insertions"": 1, ""deletions"": 1, ""lines"": 2}, ""src/testdir/test_vim9_script.vim"": {""insertions"": 13, ""deletions"": 2, ""lines"": 15}, ""src/userfunc.c"": {""insertions"": 29, ""deletions"": 7, ""lines"": 36}, ""src/version.c"": {""insertions"": 2, ""deletions"": 0, ""lines"": 2}, ""src/vim.h"": {""insertions"": 1, ""deletions"": 0, ""lines"": 1}}"
2021-12-11 12:33:52,a416861c643b03fe5dec9f3bf8c1c9e054b5a9c7,Bram Moolenaar,3,1,4,2,"{""runtime/optwin.vim"": {""insertions"": 1, ""deletions"": 1, ""lines"": 2}, ""src/version.c"": {""insertions"": 2, ""deletions"": 0, ""lines"": 2}}"
2021-12-11 12:28:08,29f3a4591528130fded3fe1d63d74bcf22ab4f6c,Bakudankun,49,12,61,9,"{""runtime/doc/editing.txt"": {""insertions"": 6, ""deletions"": 5, ""lines"": 11}, ""runtime/doc/quickref.txt"": {""insertions"": 1, ""deletions"": 0, ""lines"": 1}, ""runtime/optwin.vim"": {""insertions"": 4, ""deletions"": 0, ""lines"": 4}, ""src/ex_docmd.c"": {""insertions"": 7, ""deletions"": 4, ""lines"": 11}, ""src/option.h"": {""insertions"": 1, ""deletions"": 0, ""lines"": 1}, ""src/optiondefs.h"": {""insertions"": 4, ""deletions"": 0, ""lines"": 4}, ""src/testdir/runtest.vim"": {""insertions"": 3, ""deletions"": 3, ""lines"": 6}, ""src/testdir/test_options.vim"": {""insertions"": 21, ""deletions"": 0, ""lines"": 21}, ""src/version.c"": {""insertions"": 2, ""deletions"": 0, ""lines"": 2}}"
2021-12-10 21:46:09,205f29c3e9b895dbaa4f738046da455a93c3812a,Bram Moolenaar,30,2,32,3,"{""src/testdir/test_usercommands.vim"": {""insertions"": 19, ""deletions"": 0, ""lines"": 19}, ""src/usercmd.c"": {""insertions"": 9, ""deletions"": 2, ""lines"": 11}, ""src/version.c"": {""insertions"": 2, ""deletions"": 0, ""lines"": 2}}"
2021-12-10 21:05:53,9537e37b1124a0584e5f2af10756baca78bc73a1,Bram Moolenaar,8,1,9,2,"{""src/testdir/test_vim9_script.vim"": {""insertions"": 6, ""deletions"": 1, ""lines"": 7}, ""src/version.c"": {""insertions"": 2, ""deletions"": 0, ""lines"": 2}}"
2021-12-10 20:39:17,1daedc838126bf6fe30221192cfe36aa1b56b454,=?UTF-8?q?Bj=C3=B6rn=20Linse?=,8,8,16,2,"{""src/spellfile.c"": {""insertions"": 6, ""deletions"": 8, ""lines"": 14}, ""src/version.c"": {""insertions"": 2, ""deletions"": 0, ""lines"": 2}}"
2021-12-10 20:15:15,f8e9eb8e173bf0ff9560192ae888941ef8302269,Bram Moolenaar,28,2,30,3,"{""src/tag.c"": {""insertions"": 7, ""deletions"": 2, ""lines"": 9}, ""src/testdir/test_taglist.vim"": {""insertions"": 19, ""deletions"": 0, ""lines"": 19}, ""src/version.c"": {""insertions"": 2, ""deletions"": 0, ""lines"": 2}}"
2021-12-10 16:55:58,9fffef9f3562e05755e4b3c46509b2eeeb623ff7,Bram Moolenaar,32,4,36,3,"{""src/testdir/test_vim9_script.vim"": {""insertions"": 23, ""deletions"": 0, ""lines"": 23}, ""src/version.c"": {""insertions"": 2, ""deletions"": 0, ""lines"": 2}, ""src/vim9compile.c"": {""insertions"": 7, ""deletions"": 4, ""lines"": 11}}"
2021-12-10 13:40:08,b711814cb64b60ec4918e3e1fb2ca5c50d6e9340,Bram Moolenaar,29,28,57,3,"{""src/structs.h"": {""insertions"": 2, ""deletions"": 1, ""lines"": 3}, ""src/version.c"": {""insertions"": 2, ""deletions"": 0, ""lines"": 2}, ""src/window.c"": {""insertions"": 25, ""deletions"": 27, ""lines"": 52}}"
2021-12-10 12:11:09,8a7374f8c4eb4c016270ad908a43af4ddedcbf56,Bram Moolenaar,26,13,39,2,"{""src/version.c"": {""insertions"": 2, ""deletions"": 0, ""lines"": 2}, ""src/window.c"": {""insertions"": 24, ""deletions"": 13, ""lines"": 37}}"
2021-12-10 10:57:08,ff39a650b2bd31e30d1bb8766e8560f9a14a7137,Bram Moolenaar,3,2,5,2,"{""src/testdir/test_timers.vim"": {""insertions"": 1, ""deletions"": 2, ""lines"": 3}, ""src/version.c"": {""insertions"": 2, ""deletions"": 0, ""lines"": 2}}"
2021-12-10 10:37:38,dd297bc11d2793ba61638972778c57f2da14e8b5,Bram Moolenaar,49,3,52,5,"{""src/evalvars.c"": {""insertions"": 3, ""deletions"": 2, ""lines"": 5}, ""src/structs.h"": {""insertions"": 1, ""deletions"": 0, ""lines"": 1}, ""src/testdir/test_vim9_func.vim"": {""insertions"": 19, ""deletions"": 0, ""lines"": 19}, ""src/version.c"": {""insertions"": 2, ""deletions"": 0, ""lines"": 2}, ""src/vim9script.c"": {""insertions"": 24, ""deletions"": 1, ""lines"": 25}}"
2021-12-09 21:08:01,dee78e1ce857985c06ff18e20daeadfe1622b8ae,ichizok,29,8,37,5,"{"".github/workflows/ci.yml"": {""insertions"": 14, ""deletions"": 6, ""lines"": 20}, ""ci/config.mk.clang-12.sed"": {""insertions"": 3, ""deletions"": 0, ""lines"": 3}, ""src/os_unix.c"": {""insertions"": 9, ""deletions"": 1, ""lines"": 10}, ""src/spellfile.c"": {""insertions"": 1, ""deletions"": 1, ""lines"": 2}, ""src/version.c"": {""insertions"": 2, ""deletions"": 0, ""lines"": 2}}"
2021-12-09 20:54:21,4c8c634365bc6d4d462635aed5e0f7ad2262d590,Gregory Anders,7,1,8,3,"{""runtime/filetype.vim"": {""insertions"": 3, ""deletions"": 0, ""lines"": 3}, ""src/testdir/test_filetype.vim"": {""insertions"": 2, ""deletions"": 1, ""lines"": 3}, ""src/version.c"": {""insertions"": 2, ""deletions"": 0, ""lines"": 2}}"
2021-12-09 18:42:57,95b2dd0c008f0977ebb3cbe233a5064001a332e1,Bram Moolenaar,11,1,12,3,"{""src/testdir/test_timers.vim"": {""insertions"": 7, ""deletions"": 0, ""lines"": 7}, ""src/time.c"": {""insertions"": 2, ""deletions"": 1, ""lines"": 3}, ""src/version.c"": {""insertions"": 2, ""deletions"": 0, ""lines"": 2}}"
2021-12-09 17:44:01,e8a92b6166e32f8e583e01c9f541cf81cf76f8e6,Bram Moolenaar,3,1,4,2,"{""src/eval.c"": {""insertions"": 1, ""deletions"": 1, ""lines"": 2}, ""src/version.c"": {""insertions"": 2, ""deletions"": 0, ""lines"": 2}}"
2021-12-09 16:40:18,c4ec338fb80ebfb5d631f0718fdd1a1c04d9ed82,Bram Moolenaar,16,1,17,3,"{""src/eval.c"": {""insertions"": 9, ""deletions"": 1, ""lines"": 10}, ""src/testdir/test_functions.vim"": {""insertions"": 5, ""deletions"": 0, ""lines"": 5}, ""src/version.c"": {""insertions"": 2, ""deletions"": 0, ""lines"": 2}}"
2021-12-09 14:23:43,dcb53be4418fe263a71c7738315241031df6c986,Bram Moolenaar,90,19,109,6,"{""src/testdir/test_vim9_disassemble.vim"": {""insertions"": 11, ""deletions"": 5, ""lines"": 16}, ""src/testdir/test_vim9_func.vim"": {""insertions"": 22, ""deletions"": 0, ""lines"": 22}, ""src/version.c"": {""insertions"": 2, ""deletions"": 0, ""lines"": 2}, ""src/vim9.h"": {""insertions"": 3, ""deletions"": 2, ""lines"": 5}, ""src/vim9compile.c"": {""insertions"": 30, ""deletions"": 9, ""lines"": 39}, ""src/vim9execute.c"": {""insertions"": 22, ""deletions"": 3, ""lines"": 25}}"
2021-12-09 11:57:22,d0fb907253a5c5a71b1f231f3ddec24098fb4e21,Bram Moolenaar,59,0,59,6,"{""src/edit.c"": {""insertions"": 5, ""deletions"": 0, ""lines"": 5}, ""src/normal.c"": {""insertions"": 5, ""deletions"": 0, ""lines"": 5}, ""src/proto/window.pro"": {""insertions"": 1, ""deletions"": 0, ""lines"": 1}, ""src/testdir/test_window_cmd.vim"": {""insertions"": 34, ""deletions"": 0, ""lines"": 34}, ""src/version.c"": {""insertions"": 2, ""deletions"": 0, ""lines"": 2}, ""src/window.c"": {""insertions"": 12, ""deletions"": 0, ""lines"": 12}}"
2021-12-09 10:51:05,e50507126f532a0b0ae65e201a6372b7ea5b0ccd,Bram Moolenaar,45,42,87,16,"{""src/beval.c"": {""insertions"": 1, ""deletions"": 1, ""lines"": 2}, ""src/channel.c"": {""insertions"": 2, ""deletions"": 2, ""lines"": 4}, ""src/drawscreen.c"": {""insertions"": 8, ""deletions"": 3, ""lines"": 11}, ""src/ex_getln.c"": {""insertions"": 4, ""deletions"": 0, ""lines"": 4}, ""src/job.c"": {""insertions"": 1, ""deletions"": 1, ""lines"": 2}, ""src/popupwin.c"": {""insertions"": 1, ""deletions"": 1, ""lines"": 2}, ""src/proto/drawscreen.pro"": {""insertions"": 1, ""deletions"": 1, ""lines"": 2}, ""src/sound.c"": {""insertions"": 2, ""deletions"": 2, ""lines"": 4}, ""src/terminal.c"": {""insertions"": 1, ""deletions"": 1, ""lines"": 2}, ""src/testdir/dumps/Test_terminal_focus_1.dump"": {""insertions"": 2, ""deletions"": 2, ""lines"": 4}, ""src/testdir/dumps/Test_terminal_focus_2.dump"": {""insertions"": 2, ""deletions"": 2, ""lines"": 4}, ""src/testdir/dumps/Test_terminal_focus_3.dump"": {""insertions"": 6, ""deletions"": 0, ""lines"": 6}, ""src/testdir/test_terminal.vim"": {""insertions"": 10, ""deletions"": 2, ""lines"": 12}, ""src/time.c"": {""insertions"": 1, ""deletions"": 1, ""lines"": 2}, ""src/ui.c"": {""insertions"": 1, ""deletions"": 23, ""lines"": 24}, ""src/version.c"": {""insertions"": 2, ""deletions"": 0, ""lines"": 2}}"
2021-12-09 09:27:06,56150da6879a96db1c84c7ec4ceedeb84969f606,Yegappan Lakshmanan,17,3,20,3,"{""src/quickfix.c"": {""insertions"": 8, ""deletions"": 3, ""lines"": 11}, ""src/testdir/test_quickfix.vim"": {""insertions"": 7, ""deletions"": 0, ""lines"": 7}, ""src/version.c"": {""insertions"": 2, ""deletions"": 0, ""lines"": 2}}"
2021-12-08 22:13:38,a48d4e44a24191f5495e17d7616771c20ae3e3c1,Bram Moolenaar,86,8,94,7,"{""src/proto/terminal.pro"": {""insertions"": 1, ""deletions"": 0, ""lines"": 1}, ""src/terminal.c"": {""insertions"": 33, ""deletions"": 8, ""lines"": 41}, ""src/testdir/dumps/Test_terminal_focus_1.dump"": {""insertions"": 6, ""deletions"": 0, ""lines"": 6}, ""src/testdir/dumps/Test_terminal_focus_2.dump"": {""insertions"": 6, ""deletions"": 0, ""lines"": 6}, ""src/testdir/test_terminal.vim"": {""insertions"": 34, ""deletions"": 0, ""lines"": 34}, ""src/ui.c"": {""insertions"": 4, ""deletions"": 0, ""lines"": 4}, ""src/version.c"": {""insertions"": 2, ""deletions"": 0, ""lines"": 2}}"
2021-12-08 21:00:24,48873aebc05608e9e5e56b8628ae6d2789ab7c48,Bram Moolenaar,3,0,3,2,"{""src/os_unix.c"": {""insertions"": 1, ""deletions"": 0, ""lines"": 1}, ""src/version.c"": {""insertions"": 2, ""deletions"": 0, ""lines"": 2}}"
2021-12-08 20:03:31,78a61068cf2c83e611d954a0fb413a09ad59dc07,Yegappan Lakshmanan,50,10,60,4,"{""src/quickfix.c"": {""insertions"": 8, ""deletions"": 8, ""lines"": 16}, ""src/testdir/test_quickfix.vim"": {""insertions"": 36, ""deletions"": 0, ""lines"": 36}, ""src/version.c"": {""insertions"": 2, ""deletions"": 0, ""lines"": 2}, ""src/window.c"": {""insertions"": 4, ""deletions"": 2, ""lines"": 6}}"
2021-12-08 10:46:21,2172bff36417ddd90653531edc65897411c83b3f,Yegappan Lakshmanan,483,400,883,4,"{""src/testdir/test_ins_complete.vim"": {""insertions"": 240, ""deletions"": 266, ""lines"": 506}, ""src/testdir/test_normal.vim"": {""insertions"": 177, ""deletions"": 64, ""lines"": 241}, ""src/testdir/test_tagfunc.vim"": {""insertions"": 64, ""deletions"": 70, ""lines"": 134}, ""src/version.c"": {""insertions"": 2, ""deletions"": 0, ""lines"": 2}}"
2021-12-07 21:29:20,f7f7aaf8aaad34a38d3f159e031c5bcf3394f8f1,erw7,14,2,16,4,"{""src/errors.h"": {""insertions"": 2, ""deletions"": 0, ""lines"": 2}, ""src/highlight.c"": {""insertions"": 9, ""deletions"": 2, ""lines"": 11}, ""src/testdir/test_highlight.vim"": {""insertions"": 1, ""deletions"": 0, ""lines"": 1}, ""src/version.c"": {""insertions"": 2, ""deletions"": 0, ""lines"": 2}}"
2021-12-07 12:23:57,4dc24eb5adbcc76838fae1e900936dd230209d96,Yegappan Lakshmanan,59,8,67,9,"{""src/insexpand.c"": {""insertions"": 0, ""deletions"": 2, ""lines"": 2}, ""src/job.c"": {""insertions"": 3, ""deletions"": 2, ""lines"": 5}, ""src/option.c"": {""insertions"": 1, ""deletions"": 1, ""lines"": 2}, ""src/tag.c"": {""insertions"": 2, ""deletions"": 1, ""lines"": 3}, ""src/testdir/test_iminsert.vim"": {""insertions"": 13, ""deletions"": 0, ""lines"": 13}, ""src/testdir/test_ins_complete.vim"": {""insertions"": 28, ""deletions"": 0, ""lines"": 28}, ""src/testdir/test_tagfunc.vim"": {""insertions"": 5, ""deletions"": 0, ""lines"": 5}, ""src/userfunc.c"": {""insertions"": 5, ""deletions"": 2, ""lines"": 7}, ""src/version.c"": {""insertions"": 2, ""deletions"": 0, ""lines"": 2}}"
2021-12-07 11:03:39,92c33eb2735045d25fceed3b607f44d7156c59c1,Bram Moolenaar,4,3,7,2,"{""src/evalvars.c"": {""insertions"": 2, ""deletions"": 3, ""lines"": 5}, ""src/version.c"": {""insertions"": 2, ""deletions"": 0, ""lines"": 2}}"
2021-12-06 19:51:01,ecabb511074b3f56cdd5067553c947a291d04e17,Bram Moolenaar,42,8,50,3,"{""src/testdir/test_indent.vim"": {""insertions"": 32, ""deletions"": 6, ""lines"": 38}, ""src/textformat.c"": {""insertions"": 8, ""deletions"": 2, ""lines"": 10}, ""src/version.c"": {""insertions"": 2, ""deletions"": 0, ""lines"": 2}}"
2021-12-06 15:13:31,3e55a973b5cab5823335e24b7e4885429c885921,Bram Moolenaar,1,1,2,1,"{""README.md"": {""insertions"": 1, ""deletions"": 1, ""lines"": 2}}"
2021-12-06 15:06:54,2336c376d5796446d44622b0dfa8fd3fd1a5d22b,Bram Moolenaar,7,3,10,4,"{""src/proto/userfunc.pro"": {""insertions"": 1, ""deletions"": 0, ""lines"": 1}, ""src/userfunc.c"": {""insertions"": 1, ""deletions"": 1, ""lines"": 2}, ""src/version.c"": {""insertions"": 2, ""deletions"": 0, ""lines"": 2}, ""src/vim9execute.c"": {""insertions"": 3, ""deletions"": 2, ""lines"": 5}}"
2021-12-06 11:24:09,8603be338ac810446f23c092f21bc6082f787519,h-east,6,4,10,2,"{""src/beval.c"": {""insertions"": 4, ""deletions"": 4, ""lines"": 8}, ""src/version.c"": {""insertions"": 2, ""deletions"": 0, ""lines"": 2}}"
2021-12-06 11:03:55,6409553b6e3b4de4e1d72b8ee5445595214581ff,Yegappan Lakshmanan,344,85,429,18,"{""runtime/doc/options.txt"": {""insertions"": 4, ""deletions"": 3, ""lines"": 7}, ""src/eval.c"": {""insertions"": 4, ""deletions"": 4, ""lines"": 8}, ""src/evalvars.c"": {""insertions"": 20, ""deletions"": 5, ""lines"": 25}, ""src/if_mzsch.c"": {""insertions"": 10, ""deletions"": 10, ""lines"": 20}, ""src/if_ruby.c"": {""insertions"": 2, ""deletions"": 2, ""lines"": 4}, ""src/if_tcl.c"": {""insertions"": 1, ""deletions"": 1, ""lines"": 2}, ""src/option.c"": {""insertions"": 19, ""deletions"": 11, ""lines"": 30}, ""src/option.h"": {""insertions"": 1, ""deletions"": 0, ""lines"": 1}, ""src/optiondefs.h"": {""insertions"": 8, ""deletions"": 8, ""lines"": 16}, ""src/proto/eval.pro"": {""insertions"": 1, ""deletions"": 1, ""lines"": 2}, ""src/proto/option.pro"": {""insertions"": 2, ""deletions"": 2, ""lines"": 4}, ""src/spell.c"": {""insertions"": 1, ""deletions"": 1, ""lines"": 2}, ""src/testdir/test_iminsert.vim"": {""insertions"": 32, ""deletions"": 12, ""lines"": 44}, ""src/testdir/test_ins_complete.vim"": {""insertions"": 177, ""deletions"": 15, ""lines"": 192}, ""src/testdir/test_tagfunc.vim"": {""insertions"": 53, ""deletions"": 3, ""lines"": 56}, ""src/typval.c"": {""insertions"": 3, ""deletions"": 3, ""lines"": 6}, ""src/version.c"": {""insertions"": 2, ""deletions"": 0, ""lines"": 2}, ""src/vim9compile.c"": {""insertions"": 4, ""deletions"": 4, ""lines"": 8}}"
2021-12-05 22:19:27,40bcec1bac34d34a3d4d7c5f6b2cc1f163acbd00,Bram Moolenaar,65,36,101,18,"{""src/blob.c"": {""insertions"": 1, ""deletions"": 1, ""lines"": 2}, ""src/buffer.c"": {""insertions"": 9, ""deletions"": 9, ""lines"": 18}, ""src/channel.c"": {""insertions"": 4, ""deletions"": 2, ""lines"": 6}, ""src/errors.h"": {""insertions"": 28, ""deletions"": 0, ""lines"": 28}, ""src/ex_docmd.c"": {""insertions"": 1, ""deletions"": 1, ""lines"": 2}, ""src/globals.h"": {""insertions"": 0, ""deletions"": 5, ""lines"": 5}, ""src/job.c"": {""insertions"": 5, ""deletions"": 3, ""lines"": 8}, ""src/list.c"": {""insertions"": 1, ""deletions"": 1, ""lines"": 2}, ""src/mark.c"": {""insertions"": 1, ""deletions"": 1, ""lines"": 2}, ""src/misc1.c"": {""insertions"": 1, ""deletions"": 1, ""lines"": 2}, ""src/os_unix.c"": {""insertions"": 2, ""deletions"": 2, ""lines"": 4}, ""src/popupwin.c"": {""insertions"": 1, ""deletions"": 1, ""lines"": 2}, ""src/register.c"": {""insertions"": 1, ""deletions"": 1, ""lines"": 2}, ""src/session.c"": {""insertions"": 1, ""deletions"": 1, ""lines"": 2}, ""src/spellfile.c"": {""insertions"": 5, ""deletions"": 5, ""lines"": 10}, ""src/term.c"": {""insertions"": 1, ""deletions"": 1, ""lines"": 2}, ""src/userfunc.c"": {""insertions"": 1, ""deletions"": 1, ""lines"": 2}, ""src/version.c"": {""insertions"": 2, ""deletions"": 0, ""lines"": 2}}"
2021-12-05 21:54:04,4700398e384f38f752b432e187462f404b96847d,Bram Moolenaar,223,113,336,27,"{""runtime/autoload/dist/ft.vim"": {""insertions"": 1, ""deletions"": 1, ""lines"": 2}, ""runtime/doc/channel.txt"": {""insertions"": 5, ""deletions"": 4, ""lines"": 9}, ""runtime/doc/cmdline.txt"": {""insertions"": 5, ""deletions"": 3, ""lines"": 8}, ""runtime/doc/filetype.txt"": {""insertions"": 0, ""deletions"": 8, ""lines"": 8}, ""runtime/doc/motion.txt"": {""insertions"": 5, ""deletions"": 1, ""lines"": 6}, ""runtime/doc/options.txt"": {""insertions"": 9, ""deletions"": 4, ""lines"": 13}, ""runtime/doc/popup.txt"": {""insertions"": 1, ""deletions"": 1, ""lines"": 2}, ""runtime/doc/quickfix.txt"": {""insertions"": 4, ""deletions"": 4, ""lines"": 8}, ""runtime/doc/sign.txt"": {""insertions"": 6, ""deletions"": 4, ""lines"": 10}, ""runtime/doc/syntax.txt"": {""insertions"": 8, ""deletions"": 0, ""lines"": 8}, ""runtime/doc/tags"": {""insertions"": 5, ""deletions"": 1, ""lines"": 6}, ""runtime/doc/term.txt"": {""insertions"": 15, ""deletions"": 3, ""lines"": 18}, ""runtime/doc/todo.txt"": {""insertions"": 5, ""deletions"": 11, ""lines"": 16}, ""runtime/doc/various.txt"": {""insertions"": 6, ""deletions"": 6, ""lines"": 12}, ""runtime/doc/vim9.txt"": {""insertions"": 12, ""deletions"": 5, ""lines"": 17}, ""runtime/doc/windows.txt"": {""insertions"": 3, ""deletions"": 1, ""lines"": 4}, ""runtime/doc/xxd-fr.1"": {""insertions"": 1, ""deletions"": 1, ""lines"": 2}, ""runtime/doc/xxd-fr.UTF-8.1"": {""insertions"": 1, ""deletions"": 1, ""lines"": 2}, ""runtime/filetype.vim"": {""insertions"": 1, ""deletions"": 1, ""lines"": 2}, ""runtime/indent/vim.vim"": {""insertions"": 2, ""deletions"": 1, ""lines"": 3}, ""runtime/pack/dist/opt/termdebug/plugin/termdebug.vim"": {""insertions"": 15, ""deletions"": 10, ""lines"": 25}, ""runtime/syntax/django.vim"": {""insertions"": 2, ""deletions"": 1, ""lines"": 3}, ""runtime/syntax/squirrel.vim"": {""insertions"": 50, ""deletions"": 0, ""lines"": 50}, ""runtime/syntax/vb.vim"": {""insertions"": 47, ""deletions"": 37, ""lines"": 84}, ""runtime/syntax/vim.vim"": {""insertions"": 3, ""deletions"": 3, ""lines"": 6}, ""runtime/tools/demoserver.py"": {""insertions"": 8, ""deletions"": 1, ""lines"": 9}, ""src/xdiff/README.txt"": {""insertions"": 3, ""deletions"": 0, ""lines"": 3}}"
2021-12-05 21:46:34,12f3c1b77fb39dc338304d5484cdbc99da27389a,Bram Moolenaar,57,33,90,11,"{""src/bufwrite.c"": {""insertions"": 1, ""deletions"": 1, ""lines"": 2}, ""src/cmdexpand.c"": {""insertions"": 1, ""deletions"": 1, ""lines"": 2}, ""src/errors.h"": {""insertions"": 34, ""deletions"": 0, ""lines"": 34}, ""src/getchar.c"": {""insertions"": 1, ""deletions"": 1, ""lines"": 2}, ""src/globals.h"": {""insertions"": 0, ""deletions"": 6, ""lines"": 6}, ""src/memfile.c"": {""insertions"": 2, ""deletions"": 2, ""lines"": 4}, ""src/regexp.c"": {""insertions"": 0, ""deletions"": 6, ""lines"": 6}, ""src/regexp_bt.c"": {""insertions"": 11, ""deletions"": 11, ""lines"": 22}, ""src/regexp_nfa.c"": {""insertions"": 4, ""deletions"": 4, ""lines"": 8}, ""src/tag.c"": {""insertions"": 1, ""deletions"": 1, ""lines"": 2}, ""src/version.c"": {""insertions"": 2, ""deletions"": 0, ""lines"": 2}}"
2021-12-05 19:10:04,e5710a02cb78c2a0a868ea55740835c78ddecbb4,Bram Moolenaar,2,37,39,4,"{""src/errors.h"": {""insertions"": 0, ""deletions"": 2, ""lines"": 2}, ""src/sign.c"": {""insertions"": 0, ""deletions"": 30, ""lines"": 30}, ""src/testdir/test_signs.vim"": {""insertions"": 0, ""deletions"": 5, ""lines"": 5}, ""src/version.c"": {""insertions"": 2, ""deletions"": 0, ""lines"": 2}}"
2021-12-05 17:45:49,0bac5fc5e125b7aa0f3b596c9b7f4381279e6688,Bram Moolenaar,56,10,66,3,"{""src/sign.c"": {""insertions"": 26, ""deletions"": 7, ""lines"": 33}, ""src/testdir/test_signs.vim"": {""insertions"": 28, ""deletions"": 3, ""lines"": 31}, ""src/version.c"": {""insertions"": 2, ""deletions"": 0, ""lines"": 2}}"
2021-12-05 17:20:24,c7d5fc8622f03cca8d1a9a54d4703e8f0c9941d0,Bram Moolenaar,39,2,41,3,"{""src/testdir/test_vim9_script.vim"": {""insertions"": 35, ""deletions"": 0, ""lines"": 35}, ""src/version.c"": {""insertions"": 2, ""deletions"": 0, ""lines"": 2}, ""src/vim9execute.c"": {""insertions"": 2, ""deletions"": 2, ""lines"": 4}}"
2021-12-05 13:40:01,f661cee847d2c17652b0ad0d703d2e3ac8610265,Dominique Pelle,2,1,3,2,"{""src/testdir/test_autochdir.vim"": {""insertions"": 0, ""deletions"": 1, ""lines"": 1}, ""src/version.c"": {""insertions"": 2, ""deletions"": 0, ""lines"": 2}}"
2021-12-05 13:21:18,f645ee47c85940d05f492a1b3932fbcdfd4204b3,Dominique Pelle,13,0,13,3,"{""src/testdir/test_options.vim"": {""insertions"": 6, ""deletions"": 0, ""lines"": 6}, ""src/testdir/test_spell.vim"": {""insertions"": 5, ""deletions"": 0, ""lines"": 5}, ""src/version.c"": {""insertions"": 2, ""deletions"": 0, ""lines"": 2}}"
2021-12-05 13:02:50,5e18ccc60bdddc4aa39ab039f1a7c918f29e67ce,Bram Moolenaar,34,0,34,4,"{""src/errors.h"": {""insertions"": 2, ""deletions"": 0, ""lines"": 2}, ""src/sign.c"": {""insertions"": 26, ""deletions"": 0, ""lines"": 26}, ""src/testdir/test_signs.vim"": {""insertions"": 4, ""deletions"": 0, ""lines"": 4}, ""src/version.c"": {""insertions"": 2, ""deletions"": 0, ""lines"": 2}}"
2021-12-05 12:39:21,f589fd3e1047cdf90566b68aaf9a13389e54d26a,Dominique Pelle,9,3,12,3,"{""src/testdir/test_autochdir.vim"": {""insertions"": 3, ""deletions"": 3, ""lines"": 6}, ""src/testdir/test_termcodes.vim"": {""insertions"": 4, ""deletions"": 0, ""lines"": 4}, ""src/version.c"": {""insertions"": 2, ""deletions"": 0, ""lines"": 2}}"
2021-12-05 12:06:24,e031fe90cf2e375ce861ff5e5e281e4ad229ebb9,Bram Moolenaar,22,3,25,3,"{""src/ex_docmd.c"": {""insertions"": 7, ""deletions"": 3, ""lines"": 10}, ""src/testdir/test_ex_mode.vim"": {""insertions"": 13, ""deletions"": 0, ""lines"": 13}, ""src/version.c"": {""insertions"": 2, ""deletions"": 0, ""lines"": 2}}"
2021-12-05 11:36:23,c7269f862748c3b0f56b5a651019e18c7d5190ee,Bram Moolenaar,14,0,14,4,"{""src/alloc.c"": {""insertions"": 3, ""deletions"": 0, ""lines"": 3}, ""src/if_tcl.c"": {""insertions"": 8, ""deletions"": 0, ""lines"": 8}, ""src/proto/if_tcl.pro"": {""insertions"": 1, ""deletions"": 0, ""lines"": 1}, ""src/version.c"": {""insertions"": 2, ""deletions"": 0, ""lines"": 2}}"
2021-12-04 22:03:34,dea4a616376c6500894c16e26057ce16d7ef9f0e,Bram Moolenaar,36,0,36,3,"{""src/testdir/test_autochdir.vim"": {""insertions"": 29, ""deletions"": 0, ""lines"": 29}, ""src/version.c"": {""insertions"": 2, ""deletions"": 0, ""lines"": 2}, ""src/window.c"": {""insertions"": 5, ""deletions"": 0, ""lines"": 5}}"
2021-12-04 17:20:27,23bdef2571b589414cd9744059abd507b043996b,Bram Moolenaar,4,1,5,2,"{""src/misc1.c"": {""insertions"": 2, ""deletions"": 1, ""lines"": 3}, ""src/version.c"": {""insertions"": 2, ""deletions"": 0, ""lines"": 2}}"
2021-12-04 15:12:40,8dea145e39a2569153cb63487d3403a46a882189,Dominique Pelle,4,0,4,2,"{""src/testdir/test_cd.vim"": {""insertions"": 2, ""deletions"": 0, ""lines"": 2}, ""src/version.c"": {""insertions"": 2, ""deletions"": 0, ""lines"": 2}}"
2021-12-04 15:00:23,853a7692d19deb6b7c2cabce989b57c8b9908596,Bram Moolenaar,7,1,8,2,"{""src/testdir/test_vim9_fails.vim"": {""insertions"": 5, ""deletions"": 1, ""lines"": 6}, ""src/version.c"": {""insertions"": 2, ""deletions"": 0, ""lines"": 2}}"
2021-12-04 14:02:30,7645da568c5e3b4ee339a2e99c3b3af790619787,Yegappan Lakshmanan,215,16,231,8,"{""runtime/doc/options.txt"": {""insertions"": 5, ""deletions"": 1, ""lines"": 6}, ""src/alloc.c"": {""insertions"": 1, ""deletions"": 0, ""lines"": 1}, ""src/gui_xim.c"": {""insertions"": 33, ""deletions"": 4, ""lines"": 37}, ""src/optionstr.c"": {""insertions"": 17, ""deletions"": 0, ""lines"": 17}, ""src/proto/gui_xim.pro"": {""insertions"": 3, ""deletions"": 0, ""lines"": 3}, ""src/testdir/test_iminsert.vim"": {""insertions"": 140, ""deletions"": 0, ""lines"": 140}, ""src/testdir/test_ins_complete.vim"": {""insertions"": 14, ""deletions"": 11, ""lines"": 25}, ""src/version.c"": {""insertions"": 2, ""deletions"": 0, ""lines"": 2}}"
2021-12-04 13:15:10,01a4dcbceefa99696bd1ef8631c3f7ce9f6e0cc2,Bram Moolenaar,4,0,4,2,"{""src/version.c"": {""insertions"": 2, ""deletions"": 0, ""lines"": 2}, ""src/vim9execute.c"": {""insertions"": 2, ""deletions"": 0, ""lines"": 2}}"
2021-12-04 11:57:00,b579f6ebbfa826d228abec1e1b24c05894517c27,Bram Moolenaar,12,7,19,4,"{""src/testdir/test_vim9_cmd.vim"": {""insertions"": 5, ""deletions"": 0, ""lines"": 5}, ""src/usercmd.c"": {""insertions"": 1, ""deletions"": 0, ""lines"": 1}, ""src/version.c"": {""insertions"": 2, ""deletions"": 0, ""lines"": 2}, ""src/vim9compile.c"": {""insertions"": 4, ""deletions"": 7, ""lines"": 11}}"
2021-12-03 21:18:14,cd2f8f0e0007bb77fc2035e6ad6227bb6661c612,Bram Moolenaar,3,1,4,2,"{""src/testdir/test_set.vim"": {""insertions"": 1, ""deletions"": 1, ""lines"": 2}, ""src/version.c"": {""insertions"": 2, ""deletions"": 0, ""lines"": 2}}"
2021-12-03 20:43:24,15a24f08987e3831be255333bb84b7bc9c00db24,Bram Moolenaar,48,12,60,5,"{""src/option.c"": {""insertions"": 7, ""deletions"": 6, ""lines"": 13}, ""src/proto/term.pro"": {""insertions"": 1, ""deletions"": 1, ""lines"": 2}, ""src/term.c"": {""insertions"": 8, ""deletions"": 5, ""lines"": 13}, ""src/testdir/test_set.vim"": {""insertions"": 30, ""deletions"": 0, ""lines"": 30}, ""src/version.c"": {""insertions"": 2, ""deletions"": 0, ""lines"": 2}}"
2021-12-03 19:24:41,800b01b0c8a5983e23d8caa2be6c73d195448193,Bram Moolenaar,12,6,18,3,"{""runtime/filetype.vim"": {""insertions"": 8, ""deletions"": 4, ""lines"": 12}, ""src/testdir/test_filetype.vim"": {""insertions"": 2, ""deletions"": 2, ""lines"": 4}, ""src/version.c"": {""insertions"": 2, ""deletions"": 0, ""lines"": 2}}"
2021-12-03 17:44:26,6f42cb6e5159b323814a53bbc82def4f2cfb17ad,Matt Dunford,6,0,6,3,"{""runtime/filetype.vim"": {""insertions"": 3, ""deletions"": 0, ""lines"": 3}, ""src/testdir/test_filetype.vim"": {""insertions"": 1, ""deletions"": 0, ""lines"": 1}, ""src/version.c"": {""insertions"": 2, ""deletions"": 0, ""lines"": 2}}"
2021-12-03 13:57:00,04b7b4bf7fe57375bf3c4ed3fd087fc0bb0147ba,kuuote,6,0,6,3,"{""src/blob.c"": {""insertions"": 1, ""deletions"": 0, ""lines"": 1}, ""src/testdir/test_blob.vim"": {""insertions"": 3, ""deletions"": 0, ""lines"": 3}, ""src/version.c"": {""insertions"": 2, ""deletions"": 0, ""lines"": 2}}"
2021-12-03 13:20:29,c14b57c0795671bafca14433bc376acfe6135a3a,Bram Moolenaar,65,6,71,3,"{""src/term.c"": {""insertions"": 41, ""deletions"": 6, ""lines"": 47}, ""src/testdir/test_termcodes.vim"": {""insertions"": 22, ""deletions"": 0, ""lines"": 22}, ""src/version.c"": {""insertions"": 2, ""deletions"": 0, ""lines"": 2}}"
2021-12-03 11:44:03,c903695be54189fd7199121e9cd669e722fbc9c2,Bram Moolenaar,13,6,19,3,"{""runtime/filetype.vim"": {""insertions"": 10, ""deletions"": 5, ""lines"": 15}, ""src/testdir/test_filetype.vim"": {""insertions"": 1, ""deletions"": 1, ""lines"": 2}, ""src/version.c"": {""insertions"": 2, ""deletions"": 0, ""lines"": 2}}"
2021-12-03 11:09:29,8658c759f05b317707d56e3b65a5ef63930c7498,Yegappan Lakshmanan,740,17,757,14,"{""runtime/doc/options.txt"": {""insertions"": 10, ""deletions"": 4, ""lines"": 14}, ""src/buffer.c"": {""insertions"": 3, ""deletions"": 0, ""lines"": 3}, ""src/insexpand.c"": {""insertions"": 135, ""deletions"": 2, ""lines"": 137}, ""src/option.c"": {""insertions"": 3, ""deletions"": 1, ""lines"": 4}, ""src/optionstr.c"": {""insertions"": 23, ""deletions"": 0, ""lines"": 23}, ""src/proto/insexpand.pro"": {""insertions"": 6, ""deletions"": 0, ""lines"": 6}, ""src/proto/tag.pro"": {""insertions"": 1, ""deletions"": 1, ""lines"": 2}, ""src/proto/userfunc.pro"": {""insertions"": 1, ""deletions"": 0, ""lines"": 1}, ""src/structs.h"": {""insertions"": 3, ""deletions"": 0, ""lines"": 3}, ""src/tag.c"": {""insertions"": 2, ""deletions"": 2, ""lines"": 4}, ""src/testdir/test_ins_complete.vim"": {""insertions"": 500, ""deletions"": 0, ""lines"": 500}, ""src/testdir/test_tagfunc.vim"": {""insertions"": 28, ""deletions"": 7, ""lines"": 35}, ""src/userfunc.c"": {""insertions"": 23, ""deletions"": 0, ""lines"": 23}, ""src/version.c"": {""insertions"": 2, ""deletions"": 0, ""lines"": 2}}"
2021-12-02 20:44:42,021ef351c2127cf8aa5668a881435a0a12774644,Bram Moolenaar,4,0,4,2,"{""src/errors.h"": {""insertions"": 2, ""deletions"": 0, ""lines"": 2}, ""src/version.c"": {""insertions"": 2, ""deletions"": 0, ""lines"": 2}}"
2021-12-02 19:46:57,acdc911e4e1120ef29d86fce8e890c72cdd1bf30,Bram Moolenaar,35,0,35,4,"{""src/drawline.c"": {""insertions"": 5, ""deletions"": 0, ""lines"": 5}, ""src/testdir/dumps/Test_prop_after_linebreak.dump"": {""insertions"": 10, ""deletions"": 0, ""lines"": 10}, ""src/testdir/test_textprop.vim"": {""insertions"": 18, ""deletions"": 0, ""lines"": 18}, ""src/version.c"": {""insertions"": 2, ""deletions"": 0, ""lines"": 2}}"
2021-12-02 18:55:16,5e86964bf48ddbfa20261bda84db391c80a36dca,Bram Moolenaar,2,18,20,2,"{""src/register.c"": {""insertions"": 0, ""deletions"": 18, ""lines"": 18}, ""src/version.c"": {""insertions"": 2, ""deletions"": 0, ""lines"": 2}}"
2021-12-02 18:42:33,9ac38129b6d409f73e29b1d51a5d459cf050410f,Bram Moolenaar,14,1,15,3,"{""src/errors.h"": {""insertions"": 2, ""deletions"": 1, ""lines"": 3}, ""src/register.c"": {""insertions"": 10, ""deletions"": 0, ""lines"": 10}, ""src/version.c"": {""insertions"": 2, ""deletions"": 0, ""lines"": 2}}"
2021-12-02 16:38:52,69c76171f1a78b829196f72d7010fbe1d9ad2944,Bram Moolenaar,26,1,27,4,"{""src/errors.h"": {""insertions"": 2, ""deletions"": 0, ""lines"": 2}, ""src/testdir/test_vim9_func.vim"": {""insertions"": 15, ""deletions"": 0, ""lines"": 15}, ""src/version.c"": {""insertions"": 2, ""deletions"": 0, ""lines"": 2}, ""src/vim9execute.c"": {""insertions"": 7, ""deletions"": 1, ""lines"": 8}}"
2021-12-02 12:30:22,f8bc0ce2671d7f7f73760f665b52e4f00a1bbcac,Bram Moolenaar,8,6,14,2,"{""src/testdir/test_buffer.vim"": {""insertions"": 6, ""deletions"": 6, ""lines"": 12}, ""src/version.c"": {""insertions"": 2, ""deletions"": 0, ""lines"": 2}}"
2021-12-02 11:34:21,3569c0de67bc9c723621297ae827d5e3353793a1,Bram Moolenaar,8,3,11,2,"{""src/drawline.c"": {""insertions"": 6, ""deletions"": 3, ""lines"": 9}, ""src/version.c"": {""insertions"": 2, ""deletions"": 0, ""lines"": 2}}"
2021-12-01 17:38:01,db9ff9ab5d7ce1fcc2c4106e7ad49151a323996c,Bram Moolenaar,49,6,55,5,"{""src/testdir/test_vim9_assign.vim"": {""insertions"": 21, ""deletions"": 0, ""lines"": 21}, ""src/testdir/test_vim9_disassemble.vim"": {""insertions"": 0, ""deletions"": 1, ""lines"": 1}, ""src/testdir/test_vim9_script.vim"": {""insertions"": 4, ""deletions"": 2, ""lines"": 6}, ""src/version.c"": {""insertions"": 2, ""deletions"": 0, ""lines"": 2}, ""src/vim9compile.c"": {""insertions"": 22, ""deletions"": 3, ""lines"": 25}}"
2021-12-01 15:22:56,e4eed8c6db693a9183b776032570ce2f89dcffb6,Bram Moolenaar,136,45,181,7,"{""src/ex_docmd.c"": {""insertions"": 50, ""deletions"": 37, ""lines"": 87}, ""src/proto/ex_docmd.pro"": {""insertions"": 2, ""deletions"": 1, ""lines"": 3}, ""src/testdir/test_vim9_disassemble.vim"": {""insertions"": 19, ""deletions"": 0, ""lines"": 19}, ""src/version.c"": {""insertions"": 2, ""deletions"": 0, ""lines"": 2}, ""src/vim9.h"": {""insertions"": 1, ""deletions"": 0, ""lines"": 1}, ""src/vim9compile.c"": {""insertions"": 37, ""deletions"": 7, ""lines"": 44}, ""src/vim9execute.c"": {""insertions"": 25, ""deletions"": 0, ""lines"": 25}}"
2021-12-01 12:41:31,f0e496a85a89fb1fd21b6af6363dcfc276331110,Bram Moolenaar,17,11,28,3,"{""src/testdir/test_vim9_builtin.vim"": {""insertions"": 1, ""deletions"": 11, ""lines"": 12}, ""src/testdir/test_vim9_fails.vim"": {""insertions"": 14, ""deletions"": 0, ""lines"": 14}, ""src/version.c"": {""insertions"": 2, ""deletions"": 0, ""lines"": 2}}"
2021-12-01 11:24:52,7e5503c17a3f142e6b28f344d899c9ab9e75a844,DungSaga,14,18,32,2,"{""src/version.c"": {""insertions"": 2, ""deletions"": 0, ""lines"": 2}, ""src/xxd/xxd.c"": {""insertions"": 12, ""deletions"": 18, ""lines"": 30}}"
2021-12-01 10:54:24,0b226f60be5c30c32fb01fc0b6dc11286e7e2313,Christian Brabandt,19,3,22,3,"{""src/quickfix.c"": {""insertions"": 2, ""deletions"": 3, ""lines"": 5}, ""src/testdir/test_quickfix.vim"": {""insertions"": 15, ""deletions"": 0, ""lines"": 15}, ""src/version.c"": {""insertions"": 2, ""deletions"": 0, ""lines"": 2}}"
2021-12-01 10:30:07,05e59e3a9ffddbf93c7af02cd2ba1d0f822d4625,Yegappan Lakshmanan,114,18,132,5,"{""runtime/doc/options.txt"": {""insertions"": 9, ""deletions"": 1, ""lines"": 10}, ""src/insexpand.c"": {""insertions"": 4, ""deletions"": 5, ""lines"": 9}, ""src/option.c"": {""insertions"": 1, ""deletions"": 1, ""lines"": 2}, ""src/testdir/test_tagfunc.vim"": {""insertions"": 98, ""deletions"": 11, ""lines"": 109}, ""src/version.c"": {""insertions"": 2, ""deletions"": 0, ""lines"": 2}}"
2021-12-01 10:10:22,56a8ffdb6e903615ed824a503f5fa6382b5b3df5,Bram Moolenaar,17,2,19,3,"{""src/testdir/test_vim9_cmd.vim"": {""insertions"": 11, ""deletions"": 2, ""lines"": 13}, ""src/version.c"": {""insertions"": 2, ""deletions"": 0, ""lines"": 2}, ""src/vim9compile.c"": {""insertions"": 4, ""deletions"": 0, ""lines"": 4}}"
2021-12-01 09:27:20,3d2e031d4f0e1559e4a4f99de5eb2330f38f8eb5,Bram Moolenaar,24,20,44,4,"{""runtime/doc/vim9.txt"": {""insertions"": 4, ""deletions"": 10, ""lines"": 14}, ""src/testdir/test_vim9_cmd.vim"": {""insertions"": 11, ""deletions"": 4, ""lines"": 15}, ""src/version.c"": {""insertions"": 2, ""deletions"": 0, ""lines"": 2}, ""src/vim9compile.c"": {""insertions"": 7, ""deletions"": 6, ""lines"": 13}}"
2021-11-30 21:58:19,fad2742d538123abb9b384a053fd581f2acf6bb0,Bram Moolenaar,27,12,39,3,"{""src/testdir/test_vim9_cmd.vim"": {""insertions"": 9, ""deletions"": 0, ""lines"": 9}, ""src/version.c"": {""insertions"": 2, ""deletions"": 0, ""lines"": 2}, ""src/vim9compile.c"": {""insertions"": 16, ""deletions"": 12, ""lines"": 28}}"
2021-11-30 21:39:39,69535d8a0a1ba09047fc1b5bed86a8965302a4fa,Bram Moolenaar,3,2,5,2,"{""src/testdir/test_vim9_cmd.vim"": {""insertions"": 1, ""deletions"": 2, ""lines"": 3}, ""src/version.c"": {""insertions"": 2, ""deletions"": 0, ""lines"": 2}}"
2021-11-30 20:57:38,90770b746ea2e72954c536d8acf41d241ca2f37e,Bram Moolenaar,37,7,44,3,"{""src/testdir/test_vim9_disassemble.vim"": {""insertions"": 32, ""deletions"": 0, ""lines"": 32}, ""src/version.c"": {""insertions"": 2, ""deletions"": 0, ""lines"": 2}, ""src/vim9compile.c"": {""insertions"": 3, ""deletions"": 7, ""lines"": 10}}"
2021-11-30 20:22:49,42eba04522d6be04393f59a9eab47833e7594650,Bram Moolenaar,31,1,32,4,"{""src/drawline.c"": {""insertions"": 1, ""deletions"": 1, ""lines"": 2}, ""src/testdir/dumps/Test_prop_after_tab.dump"": {""insertions"": 10, ""deletions"": 0, ""lines"": 10}, ""src/testdir/test_textprop.vim"": {""insertions"": 18, ""deletions"": 0, ""lines"": 18}, ""src/version.c"": {""insertions"": 2, ""deletions"": 0, ""lines"": 2}}"
2021-11-30 18:25:08,eba3b7f6645c8f856132b4c06a009a3b0a44e21c,Bram Moolenaar,44,13,57,5,"{""src/evalfunc.c"": {""insertions"": 2, ""deletions"": 3, ""lines"": 5}, ""src/proto/userfunc.pro"": {""insertions"": 1, ""deletions"": 0, ""lines"": 1}, ""src/testdir/test_expr.vim"": {""insertions"": 7, ""deletions"": 0, ""lines"": 7}, ""src/userfunc.c"": {""insertions"": 32, ""deletions"": 10, ""lines"": 42}, ""src/version.c"": {""insertions"": 2, ""deletions"": 0, ""lines"": 2}}"
2021-11-30 16:14:49,ab36e6ae7b87b0295fb19270e4339a734875c6b1,Bram Moolenaar,66,17,83,5,"{""runtime/doc/vim9.txt"": {""insertions"": 4, ""deletions"": 5, ""lines"": 9}, ""src/errors.h"": {""insertions"": 1, ""deletions"": 2, ""lines"": 3}, ""src/testdir/test_vim9_assign.vim"": {""insertions"": 54, ""deletions"": 1, ""lines"": 55}, ""src/version.c"": {""insertions"": 2, ""deletions"": 0, ""lines"": 2}, ""src/vim9compile.c"": {""insertions"": 5, ""deletions"": 9, ""lines"": 14}}"
2021-11-30 13:02:58,53ba95e4f0a82f6dab1791bb01f6cddc9b3f61b3,Bram Moolenaar,11,6,17,4,"{""runtime/autoload/dist/ft.vim"": {""insertions"": 1, ""deletions"": 1, ""lines"": 2}, ""runtime/filetype.vim"": {""insertions"": 6, ""deletions"": 3, ""lines"": 9}, ""src/testdir/test_filetype.vim"": {""insertions"": 2, ""deletions"": 2, ""lines"": 4}, ""src/version.c"": {""insertions"": 2, ""deletions"": 0, ""lines"": 2}}"
2021-11-30 11:56:22,98cb90ef865089a5ddd20bc0303d449fb7d97fb2,Bram Moolenaar,13,9,22,4,"{""src/dict.c"": {""insertions"": 6, ""deletions"": 8, ""lines"": 14}, ""src/testdir/test_listdict.vim"": {""insertions"": 3, ""deletions"": 0, ""lines"": 3}, ""src/typval.c"": {""insertions"": 2, ""deletions"": 1, ""lines"": 3}, ""src/version.c"": {""insertions"": 2, ""deletions"": 0, ""lines"": 2}}"
2021-11-29 22:02:12,c750d91a07ace532e993349aa5c13dda5c888cc0,Bram Moolenaar,26,33,59,2,"{""src/version.c"": {""insertions"": 2, ""deletions"": 0, ""lines"": 2}, ""src/vim9compile.c"": {""insertions"": 24, ""deletions"": 33, ""lines"": 57}}"
2021-11-29 21:12:35,6b839ac77586f69a814d2940f59f0125f55c5f81,Bram Moolenaar,49,1,50,4,"{""src/drawline.c"": {""insertions"": 19, ""deletions"": 1, ""lines"": 20}, ""src/testdir/dumps/Test_prop_linebreak.dump"": {""insertions"": 10, ""deletions"": 0, ""lines"": 10}, ""src/testdir/test_textprop.vim"": {""insertions"": 18, ""deletions"": 0, ""lines"": 18}, ""src/version.c"": {""insertions"": 2, ""deletions"": 0, ""lines"": 2}}"
2021-11-29 20:39:38,651fca85c71a4c5807f8f828f9ded30fbd754325,Bram Moolenaar,56,244,300,34,"{""runtime/doc/options.txt"": {""insertions"": 0, ""deletions"": 12, ""lines"": 12}, ""runtime/doc/various.txt"": {""insertions"": 1, ""deletions"": 1, ""lines"": 2}, ""src/alloc.c"": {""insertions"": 0, ""deletions"": 2, ""lines"": 2}, ""src/arglist.c"": {""insertions"": 0, ""deletions"": 6, ""lines"": 6}, ""src/autocmd.c"": {""insertions"": 0, ""deletions"": 2, ""lines"": 2}, ""src/buffer.c"": {""insertions"": 0, ""deletions"": 8, ""lines"": 8}, ""src/bufwrite.c"": {""insertions"": 0, ""deletions"": 2, ""lines"": 2}, ""src/change.c"": {""insertions"": 0, ""deletions"": 4, ""lines"": 4}, ""src/drawscreen.c"": {""insertions"": 3, ""deletions"": 4, ""lines"": 7}, ""src/evalfunc.c"": {""insertions"": 1, ""deletions"": 7, ""lines"": 8}, ""src/ex_cmds.c"": {""insertions"": 0, ""deletions"": 2, ""lines"": 2}, ""src/ex_docmd.c"": {""insertions"": 0, ""deletions"": 10, ""lines"": 10}, ""src/feature.h"": {""insertions"": 6, ""deletions"": 8, ""lines"": 14}, ""src/globals.h"": {""insertions"": 11, ""deletions"": 4, ""lines"": 15}, ""src/gui.c"": {""insertions"": 2, ""deletions"": 9, ""lines"": 11}, ""src/gui_gtk_x11.c"": {""insertions"": 0, ""deletions"": 2, ""lines"": 2}, ""src/if_xcmdsrv.c"": {""insertions"": 0, ""deletions"": 2, ""lines"": 2}, ""src/locale.c"": {""insertions"": 0, ""deletions"": 2, ""lines"": 2}, ""src/main.c"": {""insertions"": 1, ""deletions"": 3, ""lines"": 4}, ""src/misc2.c"": {""insertions"": 0, ""deletions"": 2, ""lines"": 2}, ""src/netbeans.c"": {""insertions"": 0, ""deletions"": 4, ""lines"": 4}, ""src/option.c"": {""insertions"": 0, ""deletions"": 24, ""lines"": 24}, ""src/option.h"": {""insertions"": 0, ""deletions"": 4, ""lines"": 4}, ""src/optiondefs.h"": {""insertions"": 0, ""deletions"": 25, ""lines"": 25}, ""src/optionstr.c"": {""insertions"": 2, ""deletions"": 12, ""lines"": 14}, ""src/os_amiga.c"": {""insertions"": 0, ""deletions"": 6, ""lines"": 6}, ""src/os_mswin.c"": {""insertions"": 11, ""deletions"": 19, ""lines"": 30}, ""src/os_unix.c"": {""insertions"": 5, ""deletions"": 21, ""lines"": 26}, ""src/os_win32.c"": {""insertions"": 7, ""deletions"": 21, ""lines"": 28}, ""src/regexp.c"": {""insertions"": 1, ""deletions"": 2, ""lines"": 3}, ""src/term.c"": {""insertions"": 2, ""deletions"": 6, ""lines"": 8}, ""src/ui.c"": {""insertions"": 1, ""deletions"": 2, ""lines"": 3}, ""src/version.c"": {""insertions"": 2, ""deletions"": 4, ""lines"": 6}, ""src/window.c"": {""insertions"": 0, ""deletions"": 2, ""lines"": 2}}"
2021-11-29 19:18:57,0c359af5c0fd106d3f57cc0bb7cef1c89b5e1e10,Bram Moolenaar,44,3,47,6,"{""src/drawline.c"": {""insertions"": 7, ""deletions"": 1, ""lines"": 8}, ""src/match.c"": {""insertions"": 7, ""deletions"": 1, ""lines"": 8}, ""src/proto/match.pro"": {""insertions"": 1, ""deletions"": 1, ""lines"": 2}, ""src/testdir/dumps/Test_match_linebreak.dump"": {""insertions"": 10, ""deletions"": 0, ""lines"": 10}, ""src/testdir/test_match.vim"": {""insertions"": 17, ""deletions"": 0, ""lines"": 17}, ""src/version.c"": {""insertions"": 2, ""deletions"": 0, ""lines"": 2}}"
2021-11-29 17:38:02,0b74d00693f2ff5f45cb5808197df7d1aaa5cb41,Bram Moolenaar,70,18,88,8,"{""runtime/doc/popup.txt"": {""insertions"": 3, ""deletions"": 0, ""lines"": 3}, ""src/mouse.c"": {""insertions"": 2, ""deletions"": 1, ""lines"": 3}, ""src/popupwin.c"": {""insertions"": 12, ""deletions"": 2, ""lines"": 14}, ""src/testdir/dumps/Test_popupwin_drag_05.dump"": {""insertions"": 10, ""deletions"": 0, ""lines"": 10}, ""src/testdir/dumps/Test_popupwin_drag_06.dump"": {""insertions"": 10, ""deletions"": 0, ""lines"": 10}, ""src/testdir/test_popupwin.vim"": {""insertions"": 24, ""deletions"": 9, ""lines"": 33}, ""src/version.c"": {""insertions"": 2, ""deletions"": 0, ""lines"": 2}, ""src/vim.h"": {""insertions"": 7, ""deletions"": 6, ""lines"": 13}}"
2021-11-29 16:01:49,7f2c34166402740a661131d6341bbf874bdb3d48,Bram Moolenaar,9,1,10,3,"{""src/evalvars.c"": {""insertions"": 1, ""deletions"": 1, ""lines"": 2}, ""src/testdir/test_vim9_assign.vim"": {""insertions"": 6, ""deletions"": 0, ""lines"": 6}, ""src/version.c"": {""insertions"": 2, ""deletions"": 0, ""lines"": 2}}"
2021-11-29 13:44:55,5c1ec439f0a69e9aa7ece9bbb7d916f48f58be1e,Bram Moolenaar,30,3,33,3,"{""src/eval.c"": {""insertions"": 9, ""deletions"": 3, ""lines"": 12}, ""src/testdir/test_listdict.vim"": {""insertions"": 19, ""deletions"": 0, ""lines"": 19}, ""src/version.c"": {""insertions"": 2, ""deletions"": 0, ""lines"": 2}}"
2021-11-29 12:12:43,af377e34b01ba00f9520d2b9de1f911e72db0114,Bram Moolenaar,78,3,81,5,"{""src/charset.c"": {""insertions"": 33, ""deletions"": 1, ""lines"": 34}, ""src/ex_docmd.c"": {""insertions"": 14, ""deletions"": 2, ""lines"": 16}, ""src/proto/charset.pro"": {""insertions"": 1, ""deletions"": 0, ""lines"": 1}, ""src/testdir/test_usercommands.vim"": {""insertions"": 28, ""deletions"": 0, ""lines"": 28}, ""src/version.c"": {""insertions"": 2, ""deletions"": 0, ""lines"": 2}}"
2021-11-29 10:36:19,293eb9ba4669b1500370502397d399681e7098f0,Bram Moolenaar,10,1,11,3,"{""src/errors.h"": {""insertions"": 2, ""deletions"": 1, ""lines"": 3}, ""src/version.c"": {""insertions"": 2, ""deletions"": 0, ""lines"": 2}, ""src/vim9execute.c"": {""insertions"": 6, ""deletions"": 0, ""lines"": 6}}"
2021-11-28 22:00:12,38453528c3372293d70c8e85471a6188749ff331,Bram Moolenaar,83,29,112,8,"{""src/errors.h"": {""insertions"": 1, ""deletions"": 2, ""lines"": 3}, ""src/structs.h"": {""insertions"": 1, ""deletions"": 0, ""lines"": 1}, ""src/testdir/test_vim9_func.vim"": {""insertions"": 27, ""deletions"": 3, ""lines"": 30}, ""src/userfunc.c"": {""insertions"": 4, ""deletions"": 4, ""lines"": 8}, ""src/version.c"": {""insertions"": 2, ""deletions"": 0, ""lines"": 2}, ""src/vim9.h"": {""insertions"": 2, ""deletions"": 1, ""lines"": 3}, ""src/vim9compile.c"": {""insertions"": 22, ""deletions"": 12, ""lines"": 34}, ""src/vim9execute.c"": {""insertions"": 24, ""deletions"": 7, ""lines"": 31}}"
2021-11-28 21:33:36,f566666e888685b6442a0e7f34c73ba56f6db49a,Bram Moolenaar,4,0,4,2,"{""src/gui.c"": {""insertions"": 2, ""deletions"": 0, ""lines"": 2}, ""src/version.c"": {""insertions"": 2, ""deletions"": 0, ""lines"": 2}}"
2021-11-28 20:24:17,06bffe836c98a65d270579f08004503ffce9931c,Bram Moolenaar,20,1,21,3,"{""src/ex_docmd.c"": {""insertions"": 8, ""deletions"": 1, ""lines"": 9}, ""src/testdir/test_vim9_cmd.vim"": {""insertions"": 10, ""deletions"": 0, ""lines"": 10}, ""src/version.c"": {""insertions"": 2, ""deletions"": 0, ""lines"": 2}}"
2021-11-28 19:53:42,3ccb5795168793e1b119a028da4035f77cef9f69,Bram Moolenaar,235,179,414,2,"{""src/evalvars.c"": {""insertions"": 233, ""deletions"": 179, ""lines"": 412}, ""src/version.c"": {""insertions"": 2, ""deletions"": 0, ""lines"": 2}}"
2021-11-28 18:41:05,2e0f3ecb7046e6d7915327270f836c48ad033a67,Christian Brabandt,6,0,6,2,"{""src/gui.c"": {""insertions"": 4, ""deletions"": 0, ""lines"": 4}, ""src/version.c"": {""insertions"": 2, ""deletions"": 0, ""lines"": 2}}"
2021-11-27 22:47:43,59f4f9505ae7ca2499904b94100db103e5ada5a6,Bram Moolenaar,57,15,72,3,"{""src/ops.c"": {""insertions"": 30, ""deletions"": 15, ""lines"": 45}, ""src/testdir/test_blockedit.vim"": {""insertions"": 25, ""deletions"": 0, ""lines"": 25}, ""src/version.c"": {""insertions"": 2, ""deletions"": 0, ""lines"": 2}}"
2021-11-27 17:22:07,3d14c0f2b964195d08b34bb43f89ec5f99255194,Bram Moolenaar,105,7,112,7,"{""runtime/autoload/dist/ft.vim"": {""insertions"": 17, ""deletions"": 0, ""lines"": 17}, ""runtime/doc/filetype.txt"": {""insertions"": 14, ""deletions"": 5, ""lines"": 19}, ""runtime/doc/syntax.txt"": {""insertions"": 8, ""deletions"": 0, ""lines"": 8}, ""runtime/filetype.vim"": {""insertions"": 4, ""deletions"": 1, ""lines"": 5}, ""runtime/scripts.vim"": {""insertions"": 4, ""deletions"": 0, ""lines"": 4}, ""src/testdir/test_filetype.vim"": {""insertions"": 56, ""deletions"": 1, ""lines"": 57}, ""src/version.c"": {""insertions"": 2, ""deletions"": 0, ""lines"": 2}}"
2021-11-27 14:31:47,c07f11e42fc2eac5e750bf05aa3030f9b02a22ca,Bram Moolenaar,10,2,12,3,"{""runtime/filetype.vim"": {""insertions"": 7, ""deletions"": 1, ""lines"": 8}, ""src/testdir/test_filetype.vim"": {""insertions"": 1, ""deletions"": 1, ""lines"": 2}, ""src/version.c"": {""insertions"": 2, ""deletions"": 0, ""lines"": 2}}"
2021-11-27 13:28:24,e9b0b40b7978f683977922233b42dd439ef31920,Bram Moolenaar,33,0,33,3,"{""src/ops.c"": {""insertions"": 4, ""deletions"": 0, ""lines"": 4}, ""src/testdir/test_blockedit.vim"": {""insertions"": 27, ""deletions"": 0, ""lines"": 27}, ""src/version.c"": {""insertions"": 2, ""deletions"": 0, ""lines"": 2}}"
2021-11-27 11:42:50,279d733dfb838cbabe88c8b8d3549d1493a49bbe,Bram Moolenaar,27,8,35,3,"{""src/ex_cmds.h"": {""insertions"": 8, ""deletions"": 8, ""lines"": 16}, ""src/testdir/test_vim9_cmd.vim"": {""insertions"": 17, ""deletions"": 0, ""lines"": 17}, ""src/version.c"": {""insertions"": 2, ""deletions"": 0, ""lines"": 2}}"
2021-11-27 10:57:26,6304be625ce44dcfedc6735164d0b853578581c8,Bram Moolenaar,171,131,302,12,"{""runtime/colors/tools/check_colors.vim"": {""insertions"": 10, ""deletions"": 4, ""lines"": 14}, ""runtime/doc/cmdline.txt"": {""insertions"": 6, ""deletions"": 4, ""lines"": 10}, ""runtime/doc/eval.txt"": {""insertions"": 1, ""deletions"": 0, ""lines"": 1}, ""runtime/doc/options.txt"": {""insertions"": 1, ""deletions"": 1, ""lines"": 2}, ""runtime/doc/repeat.txt"": {""insertions"": 5, ""deletions"": 1, ""lines"": 6}, ""runtime/doc/sign.txt"": {""insertions"": 4, ""deletions"": 7, ""lines"": 11}, ""runtime/doc/tags"": {""insertions"": 3, ""deletions"": 0, ""lines"": 3}, ""runtime/doc/todo.txt"": {""insertions"": 4, ""deletions"": 6, ""lines"": 10}, ""runtime/doc/vim9.txt"": {""insertions"": 5, ""deletions"": 1, ""lines"": 6}, ""runtime/ftplugin/jsonc.vim"": {""insertions"": 2, ""deletions"": 8, ""lines"": 10}, ""runtime/pack/dist/opt/termdebug/plugin/termdebug.vim"": {""insertions"": 116, ""deletions"": 85, ""lines"": 201}, ""runtime/syntax/vim.vim"": {""insertions"": 14, ""deletions"": 14, ""lines"": 28}}"
2021-11-26 17:36:51,7824fc80f675b8098e6483ce082e287aad14b6da,Bram Moolenaar,40,28,68,5,"{""src/evalvars.c"": {""insertions"": 13, ""deletions"": 7, ""lines"": 20}, ""src/proto/vim9script.pro"": {""insertions"": 1, ""deletions"": 1, ""lines"": 2}, ""src/testdir/test_vim9_assign.vim"": {""insertions"": 10, ""deletions"": 0, ""lines"": 10}, ""src/version.c"": {""insertions"": 2, ""deletions"": 0, ""lines"": 2}, ""src/vim9script.c"": {""insertions"": 14, ""deletions"": 20, ""lines"": 34}}"
2021-11-26 15:57:40,bfc5786a61693aaadc3e45f80a2f147c3a6711a3,Bram Moolenaar,24,0,24,4,"{""src/mouse.c"": {""insertions"": 1, ""deletions"": 0, ""lines"": 1}, ""src/testdir/dumps/Test_popupwin_drag_04.dump"": {""insertions"": 10, ""deletions"": 0, ""lines"": 10}, ""src/testdir/test_popupwin.vim"": {""insertions"": 11, ""deletions"": 0, ""lines"": 11}, ""src/version.c"": {""insertions"": 2, ""deletions"": 0, ""lines"": 2}}"
2021-11-26 13:59:27,d1d8a595bd03bf9ff6ba1440101daa98b19249fd,DungSaga,13,14,27,2,"{""src/version.c"": {""insertions"": 2, ""deletions"": 0, ""lines"": 2}, ""src/xxd/xxd.c"": {""insertions"": 11, ""deletions"": 14, ""lines"": 25}}"
2021-11-26 13:01:41,7329cfab36356c48edab7ed68f6244eb9e20a5b1,Doug Kearns,15,1,16,3,"{""runtime/autoload/dist/ft.vim"": {""insertions"": 3, ""deletions"": 1, ""lines"": 4}, ""src/testdir/test_filetype.vim"": {""insertions"": 10, ""deletions"": 0, ""lines"": 10}, ""src/version.c"": {""insertions"": 2, ""deletions"": 0, ""lines"": 2}}"
2021-11-25 20:40:11,85be8563fe5aff686e9e30d6afff401ccd976f2a,Bram Moolenaar,6,2,8,2,"{""src/register.c"": {""insertions"": 4, ""deletions"": 2, ""lines"": 6}, ""src/version.c"": {""insertions"": 2, ""deletions"": 0, ""lines"": 2}}"
2021-11-25 19:31:15,4d07253a485819b3a9fd923d263e722ea2109c12,Bram Moolenaar,30,3,33,3,"{""src/register.c"": {""insertions"": 15, ""deletions"": 3, ""lines"": 18}, ""src/testdir/test_put.vim"": {""insertions"": 13, ""deletions"": 0, ""lines"": 13}, ""src/version.c"": {""insertions"": 2, ""deletions"": 0, ""lines"": 2}}"
2021-11-25 15:11:03,309ce251897512d42da2b0df0ff100dc303e688a,Bram Moolenaar,2,782,784,2,"{""runtime/rgb.txt"": {""insertions"": 0, ""deletions"": 782, ""lines"": 782}, ""src/version.c"": {""insertions"": 2, ""deletions"": 0, ""lines"": 2}}"
2021-11-25 14:43:18,ba8c92687d53c91bbc20c867a49e0988819ea2d5,Bram Moolenaar,12,4,16,2,"{""src/message.c"": {""insertions"": 10, ""deletions"": 4, ""lines"": 14}, ""src/version.c"": {""insertions"": 2, ""deletions"": 0, ""lines"": 2}}"
2021-11-25 13:52:37,96e7a5928e1e7a350cd6c6d0b9376305190046e7,Bram Moolenaar,5,2,7,2,"{""src/memline.c"": {""insertions"": 3, ""deletions"": 2, ""lines"": 5}, ""src/version.c"": {""insertions"": 2, ""deletions"": 0, ""lines"": 2}}"
2021-11-25 13:39:28,0bd8d0563853ab821a018fb9cdd85f674684fe57,Bram Moolenaar,5,2,7,3,"{""src/globals.h"": {""insertions"": 1, ""deletions"": 0, ""lines"": 1}, ""src/message.c"": {""insertions"": 2, ""deletions"": 2, ""lines"": 4}, ""src/version.c"": {""insertions"": 2, ""deletions"": 0, ""lines"": 2}}"
2021-11-25 13:26:19,71b36206be14c3b6334765d44a38d413eca751c7,Bram Moolenaar,4,2,6,2,"{""src/version.c"": {""insertions"": 2, ""deletions"": 0, ""lines"": 2}, ""src/xxd/xxd.c"": {""insertions"": 2, ""deletions"": 2, ""lines"": 4}}"
2021-11-25 13:04:48,34c20ff85b87be587ea5d0398812441b502ee6a5,Bram Moolenaar,30,2,32,3,"{""src/testdir/test_prompt_buffer.vim"": {""insertions"": 25, ""deletions"": 0, ""lines"": 25}, ""src/version.c"": {""insertions"": 2, ""deletions"": 0, ""lines"": 2}, ""src/window.c"": {""insertions"": 3, ""deletions"": 2, ""lines"": 5}}"
2021-11-25 11:16:50,8af87bd6b1808ffcafdd73b1d7501dd50b9d15bc,Bram Moolenaar,70,69,139,2,"{""src/version.c"": {""insertions"": 2, ""deletions"": 0, ""lines"": 2}, ""src/xxd/xxd.c"": {""insertions"": 68, ""deletions"": 69, ""lines"": 137}}"
2021-11-25 10:50:12,bd228fd097b41a798f90944b5d1245eddd484142,Bram Moolenaar,12,2,14,3,"{""src/help.c"": {""insertions"": 1, ""deletions"": 2, ""lines"": 3}, ""src/testdir/test_help.vim"": {""insertions"": 9, ""deletions"": 0, ""lines"": 9}, ""src/version.c"": {""insertions"": 2, ""deletions"": 0, ""lines"": 2}}"
2021-11-24 20:28:31,bb277fd89fd7c665d51be2a08993732d46c208ef,Yegappan Lakshmanan,89,46,135,3,"{""src/highlight.c"": {""insertions"": 72, ""deletions"": 46, ""lines"": 118}, ""src/testdir/test_highlight.vim"": {""insertions"": 15, ""deletions"": 0, ""lines"": 15}, ""src/version.c"": {""insertions"": 2, ""deletions"": 0, ""lines"": 2}}"
2021-11-24 19:55:46,510d8e6056d89d903511c4498afec23f76b4f2a4,Bram Moolenaar,10,6,16,2,"{""src/libvterm/src/state.c"": {""insertions"": 8, ""deletions"": 6, ""lines"": 14}, ""src/version.c"": {""insertions"": 2, ""deletions"": 0, ""lines"": 2}}"
2021-11-24 19:30:55,7da341560ec8db7e81cd80092b046b60a482fbbe,Bram Moolenaar,971,256,1227,18,"{""Filelist"": {""insertions"": 1, ""deletions"": 0, ""lines"": 1}, ""src/libvterm/Makefile"": {""insertions"": 2, ""deletions"": 2, ""lines"": 4}, ""src/libvterm/doc/seqs.txt"": {""insertions"": 265, ""deletions"": 218, ""lines"": 483}, ""src/libvterm/include/vterm.h"": {""insertions"": 26, ""deletions"": 1, ""lines"": 27}, ""src/libvterm/src/mouse.c"": {""insertions"": 3, ""deletions"": 0, ""lines"": 3}, ""src/libvterm/src/parser.c"": {""insertions"": 51, ""deletions"": 4, ""lines"": 55}, ""src/libvterm/src/state.c"": {""insertions"": 321, ""deletions"": 5, ""lines"": 326}, ""src/libvterm/src/vterm.c"": {""insertions"": 20, ""deletions"": 12, ""lines"": 32}, ""src/libvterm/src/vterm_internal.h"": {""insertions"": 23, ""deletions"": 1, ""lines"": 24}, ""src/libvterm/t/02parser.test"": {""insertions"": 52, ""deletions"": 4, ""lines"": 56}, ""src/libvterm/t/17state_mouse.test"": {""insertions"": 9, ""deletions"": 0, ""lines"": 9}, ""src/libvterm/t/29state_fallback.test"": {""insertions"": 12, ""deletions"": 0, ""lines"": 12}, ""src/libvterm/t/40state_selection.test"": {""insertions"": 55, ""deletions"": 0, ""lines"": 55}, ""src/libvterm/t/harness.c"": {""insertions"": 113, ""deletions"": 3, ""lines"": 116}, ""src/libvterm/t/run-test.pl"": {""insertions"": 11, ""deletions"": 3, ""lines"": 14}, ""src/libvterm/vterm.pc.in"": {""insertions"": 1, ""deletions"": 2, ""lines"": 3}, ""src/terminal.c"": {""insertions"": 4, ""deletions"": 1, ""lines"": 5}, ""src/version.c"": {""insertions"": 2, ""deletions"": 0, ""lines"": 2}}"
2021-11-24 16:32:55,19916a8c8920b6a1fd737ffa6d4e363fc7a96319,Yegappan Lakshmanan,125,6,131,9,"{""runtime/doc/options.txt"": {""insertions"": 6, ""deletions"": 4, ""lines"": 10}, ""src/buffer.c"": {""insertions"": 1, ""deletions"": 0, ""lines"": 1}, ""src/option.c"": {""insertions"": 2, ""deletions"": 0, ""lines"": 2}, ""src/optionstr.c"": {""insertions"": 9, ""deletions"": 0, ""lines"": 9}, ""src/proto/tag.pro"": {""insertions"": 3, ""deletions"": 0, ""lines"": 3}, ""src/structs.h"": {""insertions"": 2, ""deletions"": 1, ""lines"": 3}, ""src/tag.c"": {""insertions"": 50, ""deletions"": 1, ""lines"": 51}, ""src/testdir/test_tagfunc.vim"": {""insertions"": 50, ""deletions"": 0, ""lines"": 50}, ""src/version.c"": {""insertions"": 2, ""deletions"": 0, ""lines"": 2}}"
2021-11-24 16:20:13,e413ea04b716effb28eb49dbc98ad3f9f761545a,Bram Moolenaar,104,18,122,12,"{""runtime/doc/sign.txt"": {""insertions"": 15, ""deletions"": 0, ""lines"": 15}, ""runtime/doc/syntax.txt"": {""insertions"": 4, ""deletions"": 0, ""lines"": 4}, ""src/drawline.c"": {""insertions"": 27, ""deletions"": 4, ""lines"": 31}, ""src/highlight.c"": {""insertions"": 2, ""deletions"": 0, ""lines"": 2}, ""src/optiondefs.h"": {""insertions"": 1, ""deletions"": 1, ""lines"": 2}, ""src/popupwin.c"": {""insertions"": 1, ""deletions"": 1, ""lines"": 2}, ""src/proto/sign.pro"": {""insertions"": 1, ""deletions"": 1, ""lines"": 2}, ""src/sign.c"": {""insertions"": 38, ""deletions"": 3, ""lines"": 41}, ""src/structs.h"": {""insertions"": 1, ""deletions"": 0, ""lines"": 1}, ""src/testdir/test_signs.vim"": {""insertions"": 9, ""deletions"": 7, ""lines"": 16}, ""src/version.c"": {""insertions"": 2, ""deletions"": 0, ""lines"": 2}, ""src/vim.h"": {""insertions"": 3, ""deletions"": 1, ""lines"": 4}}"
2021-11-24 15:32:57,1f2453fec6f8f0f315f00ca7b562a02090cb1e37,presuku,74,17,91,3,"{""src/strings.c"": {""insertions"": 12, ""deletions"": 17, ""lines"": 29}, ""src/testdir/test_expr.vim"": {""insertions"": 60, ""deletions"": 0, ""lines"": 60}, ""src/version.c"": {""insertions"": 2, ""deletions"": 0, ""lines"": 2}}"
2021-11-24 15:13:26,cf1e0239ceec96396fa51f494e442c799ccd45fb,Bram Moolenaar,5,3,8,2,"{""src/fold.c"": {""insertions"": 3, ""deletions"": 3, ""lines"": 6}, ""src/version.c"": {""insertions"": 2, ""deletions"": 0, ""lines"": 2}}"
2021-11-24 14:59:17,8bc07e800c2af36686aadd4178cc2671f5c454d4,Bram Moolenaar,7,5,12,2,"{""src/testdir/test_put.vim"": {""insertions"": 5, ""deletions"": 5, ""lines"": 10}, ""src/version.c"": {""insertions"": 2, ""deletions"": 0, ""lines"": 2}}"
2021-11-24 13:40:29,9b0e82f35ed4e98414333e71b71ca56219683d16,Bram Moolenaar,3,1,4,2,"{""src/normal.c"": {""insertions"": 1, ""deletions"": 1, ""lines"": 2}, ""src/version.c"": {""insertions"": 2, ""deletions"": 0, ""lines"": 2}}"
2021-11-24 12:17:53,03725c5795ae5b8c14da4a39cd0ce723c6dd4304,Bram Moolenaar,64,6,70,6,"{""src/errors.h"": {""insertions"": 2, ""deletions"": 0, ""lines"": 2}, ""src/ex_docmd.c"": {""insertions"": 15, ""deletions"": 1, ""lines"": 16}, ""src/normal.c"": {""insertions"": 12, ""deletions"": 5, ""lines"": 17}, ""src/testdir/test_excmd.vim"": {""insertions"": 12, ""deletions"": 0, ""lines"": 12}, ""src/testdir/test_normal.vim"": {""insertions"": 21, ""deletions"": 0, ""lines"": 21}, ""src/version.c"": {""insertions"": 2, ""deletions"": 0, ""lines"": 2}}"
2021-11-24 11:18:07,48608b4a4bfab4b9c0c9199d57b7e876c56db74c,DungSaga,28,9,37,3,"{""src/testdir/test_xxd.vim"": {""insertions"": 14, ""deletions"": 0, ""lines"": 14}, ""src/version.c"": {""insertions"": 2, ""deletions"": 0, ""lines"": 2}, ""src/xxd/xxd.c"": {""insertions"": 12, ""deletions"": 9, ""lines"": 21}}"
2021-11-23 22:16:34,112bed0cbeac84f73dca2682c5c2d74fabe1114d,Bram Moolenaar,26,1,27,3,"{""src/testdir/test_debugger.vim"": {""insertions"": 23, ""deletions"": 0, ""lines"": 23}, ""src/version.c"": {""insertions"": 2, ""deletions"": 0, ""lines"": 2}, ""src/vim9execute.c"": {""insertions"": 1, ""deletions"": 1, ""lines"": 2}}"
2021-11-23 14:52:06,65259b5c6a8ad4edaf6eeb8dbb7b50342c64d403,Bram Moolenaar,13,1,14,3,"{""src/ex_eval.c"": {""insertions"": 4, ""deletions"": 1, ""lines"": 5}, ""src/testdir/test_vim9_cmd.vim"": {""insertions"": 7, ""deletions"": 0, ""lines"": 7}, ""src/version.c"": {""insertions"": 2, ""deletions"": 0, ""lines"": 2}}"
2021-11-23 12:35:57,cc9d725bbb515baf172c2be21de12d35a961e4ee,Mike Williams,3,1,4,2,"{""src/version.c"": {""insertions"": 2, ""deletions"": 0, ""lines"": 2}, ""src/vim9compile.c"": {""insertions"": 1, ""deletions"": 1, ""lines"": 2}}"
2021-11-23 12:27:48,ee93e327ba31e8efb1b7de6209bdc992778b809b,Chris Dalton,23,1,24,2,"{""src/gui_gtk_x11.c"": {""insertions"": 21, ""deletions"": 1, ""lines"": 22}, ""src/version.c"": {""insertions"": 2, ""deletions"": 0, ""lines"": 2}}"
2021-11-23 12:07:25,b771b6b5fe2ec36d23c21ab8229b15c80780468c,Milly,3,0,3,2,"{""src/terminal.c"": {""insertions"": 1, ""deletions"": 0, ""lines"": 1}, ""src/version.c"": {""insertions"": 2, ""deletions"": 0, ""lines"": 2}}"
2021-11-23 11:46:32,e021662f39b38ef7cf27e13850d0ce6890e48376,Yegappan Lakshmanan,425,31,456,4,"{""runtime/doc/textprop.txt"": {""insertions"": 41, ""deletions"": 5, ""lines"": 46}, ""src/testdir/test_textprop.vim"": {""insertions"": 150, ""deletions"": 1, ""lines"": 151}, ""src/textprop.c"": {""insertions"": 232, ""deletions"": 25, ""lines"": 257}, ""src/version.c"": {""insertions"": 2, ""deletions"": 0, ""lines"": 2}}"
2021-11-22 21:58:41,04b568b38f848293e1ae0e680685280151acb386,Bram Moolenaar,26,0,26,4,"{""src/errors.h"": {""insertions"": 2, ""deletions"": 0, ""lines"": 2}, ""src/evalvars.c"": {""insertions"": 5, ""deletions"": 0, ""lines"": 5}, ""src/testdir/test_vim9_cmd.vim"": {""insertions"": 17, ""deletions"": 0, ""lines"": 17}, ""src/version.c"": {""insertions"": 2, ""deletions"": 0, ""lines"": 2}}"
2021-11-22 20:10:18,3b3755fe19e9ded2a1c45f14b2c6fa065bcaf2c6,Bram Moolenaar,38,9,47,7,"{""src/dict.c"": {""insertions"": 1, ""deletions"": 1, ""lines"": 2}, ""src/eval.c"": {""insertions"": 1, ""deletions"": 1, ""lines"": 2}, ""src/evalvars.c"": {""insertions"": 4, ""deletions"": 3, ""lines"": 7}, ""src/proto/evalvars.pro"": {""insertions"": 1, ""deletions"": 1, ""lines"": 2}, ""src/testdir/test_vim9_script.vim"": {""insertions"": 25, ""deletions"": 1, ""lines"": 26}, ""src/version.c"": {""insertions"": 2, ""deletions"": 0, ""lines"": 2}, ""src/vim9compile.c"": {""insertions"": 4, ""deletions"": 2, ""lines"": 6}}"
2021-11-22 18:31:02,7a53f29c031f54ab67a803e5e3f8cb44e4edc4bc,Bram Moolenaar,21,3,24,3,"{""src/ex_eval.c"": {""insertions"": 4, ""deletions"": 3, ""lines"": 7}, ""src/testdir/test_vim9_script.vim"": {""insertions"": 15, ""deletions"": 0, ""lines"": 15}, ""src/version.c"": {""insertions"": 2, ""deletions"": 0, ""lines"": 2}}"
2021-11-22 17:21:48,4671e88d7d3ed12206d9cdd8892fe3b2cbc0d6ab,Bram Moolenaar,11,3,14,2,"{""src/gui.c"": {""insertions"": 9, ""deletions"": 3, ""lines"": 12}, ""src/version.c"": {""insertions"": 2, ""deletions"": 0, ""lines"": 2}}"
2021-11-22 17:18:44,ce59b9f29244d98e55e3ec6be341c4d521159e8f,Dusan Popovic,39,7,46,2,"{""src/gui.c"": {""insertions"": 37, ""deletions"": 7, ""lines"": 44}, ""src/version.c"": {""insertions"": 2, ""deletions"": 0, ""lines"": 2}}"
2021-11-22 15:37:15,c449271f4efa44725c40116a95b213813040312f,Bram Moolenaar,26,0,26,4,"{""src/errors.h"": {""insertions"": 2, ""deletions"": 0, ""lines"": 2}, ""src/scriptfile.c"": {""insertions"": 14, ""deletions"": 0, ""lines"": 14}, ""src/testdir/test_vim9_builtin.vim"": {""insertions"": 8, ""deletions"": 0, ""lines"": 8}, ""src/version.c"": {""insertions"": 2, ""deletions"": 0, ""lines"": 2}}"
2021-11-22 15:05:46,7d5b8becc342e49e491053ea842e59f82d072001,Bram Moolenaar,47,8,55,3,"{""src/ex_eval.c"": {""insertions"": 17, ""deletions"": 7, ""lines"": 24}, ""src/testdir/test_vim9_cmd.vim"": {""insertions"": 28, ""deletions"": 1, ""lines"": 29}, ""src/version.c"": {""insertions"": 2, ""deletions"": 0, ""lines"": 2}}"
2021-11-22 14:16:08,2228cd72cf7c6f326e4e41179e88d37595ca4abc,Bram Moolenaar,58,9,67,5,"{""src/normal.c"": {""insertions"": 23, ""deletions"": 3, ""lines"": 26}, ""src/ops.c"": {""insertions"": 10, ""deletions"": 4, ""lines"": 14}, ""src/proto/normal.pro"": {""insertions"": 1, ""deletions"": 0, ""lines"": 1}, ""src/testdir/test_normal.vim"": {""insertions"": 22, ""deletions"": 2, ""lines"": 24}, ""src/version.c"": {""insertions"": 2, ""deletions"": 0, ""lines"": 2}}"
2021-11-22 12:47:39,a3f83feb63eae5464a620ae793c002eb45f7a838,zeertzjq,9,11,20,3,"{""src/getchar.c"": {""insertions"": 3, ""deletions"": 7, ""lines"": 10}, ""src/map.c"": {""insertions"": 4, ""deletions"": 4, ""lines"": 8}, ""src/version.c"": {""insertions"": 2, ""deletions"": 0, ""lines"": 2}}"
2021-11-22 12:06:06,73448a27a8e13b9b26759abeb092fd13a0e93238,Bram Moolenaar,3,1,4,2,"{""Filelist"": {""insertions"": 1, ""deletions"": 1, ""lines"": 2}, ""src/version.c"": {""insertions"": 2, ""deletions"": 0, ""lines"": 2}}"
2021-11-22 11:57:31,581f41adb3ba1dc95bf4fc7c434427e1203be5e8,DungSaga,8,14,22,2,"{""src/version.c"": {""insertions"": 2, ""deletions"": 0, ""lines"": 2}, ""src/xxd/xxd.c"": {""insertions"": 6, ""deletions"": 14, ""lines"": 20}}"
2021-11-21 21:13:36,88a4205f1cfbdc328e987ab00521fc8a22447fc3,Bram Moolenaar,1634,949,2583,19,"{"".github/CODEOWNERS"": {""insertions"": 2, ""deletions"": 0, ""lines"": 2}, ""runtime/defaults.vim"": {""insertions"": 5, ""deletions"": 4, ""lines"": 9}, ""runtime/doc/autocmd.txt"": {""insertions"": 2, ""deletions"": 2, ""lines"": 4}, ""runtime/doc/eval.txt"": {""insertions"": 9, ""deletions"": 6, ""lines"": 15}, ""runtime/doc/helphelp.txt"": {""insertions"": 3, ""deletions"": 3, ""lines"": 6}, ""runtime/doc/map.txt"": {""insertions"": 6, ""deletions"": 1, ""lines"": 7}, ""runtime/doc/options.txt"": {""insertions"": 1, ""deletions"": 1, ""lines"": 2}, ""runtime/doc/syntax.txt"": {""insertions"": 6, ""deletions"": 6, ""lines"": 12}, ""runtime/doc/tags"": {""insertions"": 1, ""deletions"": 0, ""lines"": 1}, ""runtime/doc/usr_20.txt"": {""insertions"": 2, ""deletions"": 2, ""lines"": 4}, ""runtime/doc/visual.txt"": {""insertions"": 3, ""deletions"": 2, ""lines"": 5}, ""runtime/ftplugin/indent.vim"": {""insertions"": 4, ""deletions"": 3, ""lines"": 7}, ""runtime/ftplugin/vb.vim"": {""insertions"": 54, ""deletions"": 28, ""lines"": 82}, ""runtime/pack/dist/opt/termdebug/plugin/termdebug.vim"": {""insertions"": 98, ""deletions"": 51, ""lines"": 149}, ""runtime/syntax/indent.vim"": {""insertions"": 5, ""deletions"": 4, ""lines"": 9}, ""runtime/syntax/vim.vim"": {""insertions"": 4, ""deletions"": 4, ""lines"": 8}, ""src/po/cs.cp1250.po"": {""insertions"": 1, ""deletions"": 1, ""lines"": 2}, ""src/po/cs.po"": {""insertions"": 1, ""deletions"": 1, ""lines"": 2}, ""src/po/eo.po"": {""insertions"": 1427, ""deletions"": 830, ""lines"": 2257}}"
2021-11-21 14:51:13,eea32afdb83ae281a63152f7494f79ec7e45ff55,Bram Moolenaar,42,0,42,5,"{""src/channel.c"": {""insertions"": 4, ""deletions"": 0, ""lines"": 4}, ""src/proto/terminal.pro"": {""insertions"": 1, ""deletions"": 0, ""lines"": 1}, ""src/terminal.c"": {""insertions"": 18, ""deletions"": 0, ""lines"": 18}, ""src/testdir/test_terminal.vim"": {""insertions"": 17, ""deletions"": 0, ""lines"": 17}, ""src/version.c"": {""insertions"": 2, ""deletions"": 0, ""lines"": 2}}"
2021-11-21 12:27:13,7f0c4b418e01d6e056a74de2f22fcbad613b7591,Volodymyr Kot,3,1,4,2,"{""src/main.c"": {""insertions"": 1, ""deletions"": 1, ""lines"": 2}, ""src/version.c"": {""insertions"": 2, ""deletions"": 0, ""lines"": 2}}"
2021-11-21 12:13:56,4785fe02bba14c4e0aede0fa425ca790a1cb98d7,ii14,9,2,11,3,"{""src/cmdexpand.c"": {""insertions"": 4, ""deletions"": 2, ""lines"": 6}, ""src/testdir/test_cmdline.vim"": {""insertions"": 3, ""deletions"": 0, ""lines"": 3}, ""src/version.c"": {""insertions"": 2, ""deletions"": 0, ""lines"": 2}}"
2021-11-21 11:36:04,923dce2b07ff185c0ef661f3eca47bc17655f01b,Dominique Pelle,39,38,77,21,"{""src/testdir/runtest.vim"": {""insertions"": 1, ""deletions"": 1, ""lines"": 2}, ""src/testdir/test_debugger.vim"": {""insertions"": 5, ""deletions"": 5, ""lines"": 10}, ""src/testdir/test_diffmode.vim"": {""insertions"": 2, ""deletions"": 2, ""lines"": 4}, ""src/testdir/test_edit.vim"": {""insertions"": 3, ""deletions"": 3, ""lines"": 6}, ""src/testdir/test_excmd.vim"": {""insertions"": 1, ""deletions"": 1, ""lines"": 2}, ""src/testdir/test_flatten.vim"": {""insertions"": 1, ""deletions"": 1, ""lines"": 2}, ""src/testdir/test_ins_complete.vim"": {""insertions"": 1, ""deletions"": 1, ""lines"": 2}, ""src/testdir/test_normal.vim"": {""insertions"": 3, ""deletions"": 3, ""lines"": 6}, ""src/testdir/test_options.vim"": {""insertions"": 1, ""deletions"": 1, ""lines"": 2}, ""src/testdir/test_python2.vim"": {""insertions"": 1, ""deletions"": 1, ""lines"": 2}, ""src/testdir/test_python3.vim"": {""insertions"": 1, ""deletions"": 1, ""lines"": 2}, ""src/testdir/test_quickfix.vim"": {""insertions"": 4, ""deletions"": 4, ""lines"": 8}, ""src/testdir/test_recover.vim"": {""insertions"": 1, ""deletions"": 1, ""lines"": 2}, ""src/testdir/test_spellfile.vim"": {""insertions"": 1, ""deletions"": 1, ""lines"": 2}, ""src/testdir/test_syntax.vim"": {""insertions"": 1, ""deletions"": 2, ""lines"": 3}, ""src/testdir/test_termcodes.vim"": {""insertions"": 3, ""deletions"": 3, ""lines"": 6}, ""src/testdir/test_textobjects.vim"": {""insertions"": 1, ""deletions"": 1, ""lines"": 2}, ""src/testdir/test_trycatch.vim"": {""insertions"": 1, ""deletions"": 1, ""lines"": 2}, ""src/testdir/test_vim9_script.vim"": {""insertions"": 2, ""deletions"": 2, ""lines"": 4}, ""src/testdir/test_viminfo.vim"": {""insertions"": 3, ""deletions"": 3, ""lines"": 6}, ""src/version.c"": {""insertions"": 2, ""deletions"": 0, ""lines"": 2}}"
2021-11-21 11:15:49,2c23670300b18f2f799d0602ff5225caa55b0d67,Bram Moolenaar,3,5,8,2,"{""src/gui_gtk_x11.c"": {""insertions"": 1, ""deletions"": 5, ""lines"": 6}, ""src/version.c"": {""insertions"": 2, ""deletions"": 0, ""lines"": 2}}"
2021-11-20 22:03:30,3c19b5050040fb74e4e39048f17dce853fdafc08,Dusan Popovic,22,11,33,2,"{""src/gui_gtk_x11.c"": {""insertions"": 20, ""deletions"": 11, ""lines"": 31}, ""src/version.c"": {""insertions"": 2, ""deletions"": 0, ""lines"": 2}}"
2021-11-20 21:46:20,d604d78e7b2e63d118814d0fa0b4b702ec52aeed,Bram Moolenaar,15,1,16,3,"{""src/testdir/test_vim9_func.vim"": {""insertions"": 12, ""deletions"": 1, ""lines"": 13}, ""src/userfunc.c"": {""insertions"": 1, ""deletions"": 0, ""lines"": 1}, ""src/version.c"": {""insertions"": 2, ""deletions"": 0, ""lines"": 2}}"
2021-11-20 21:35:41,a755fdbe80bed4897e06028f0044c208e0f9d8cb,Bram Moolenaar,17,1,18,3,"{""src/testdir/test_vim9_func.vim"": {""insertions"": 14, ""deletions"": 0, ""lines"": 14}, ""src/userfunc.c"": {""insertions"": 1, ""deletions"": 1, ""lines"": 2}, ""src/version.c"": {""insertions"": 2, ""deletions"": 0, ""lines"": 2}}"
2021-11-20 20:42:29,9cd9385db7d1d2b2dc38a511d121e366a5dae511,Yamagi,4,1,5,2,"{""src/gui_gtk_x11.c"": {""insertions"": 2, ""deletions"": 1, ""lines"": 3}, ""src/version.c"": {""insertions"": 2, ""deletions"": 0, ""lines"": 2}}"
2021-11-20 19:50:59,c8a9fe541d3bee36d2760ed156997ddbb0142ee1,Bram Moolenaar,12,2,14,3,"{""src/syntax.c"": {""insertions"": 2, ""deletions"": 2, ""lines"": 4}, ""src/testdir/test_vim9_cmd.vim"": {""insertions"": 8, ""deletions"": 0, ""lines"": 8}, ""src/version.c"": {""insertions"": 2, ""deletions"": 0, ""lines"": 2}}"
2021-11-20 19:38:31,d85fccdfed58108c4e0958d0b17c64690b5f073f,presuku,16,4,20,3,"{""src/strings.c"": {""insertions"": 9, ""deletions"": 4, ""lines"": 13}, ""src/testdir/test_expr.vim"": {""insertions"": 5, ""deletions"": 0, ""lines"": 5}, ""src/version.c"": {""insertions"": 2, ""deletions"": 0, ""lines"": 2}}"
2021-11-20 19:13:39,a1198124370a366ff02811a43845a631b5c6e7f0,mityu,73,12,85,6,"{""src/evalvars.c"": {""insertions"": 2, ""deletions"": 4, ""lines"": 6}, ""src/ex_getln.c"": {""insertions"": 9, ""deletions"": 0, ""lines"": 9}, ""src/proto/ex_getln.pro"": {""insertions"": 1, ""deletions"": 0, ""lines"": 1}, ""src/testdir/test_ins_complete.vim"": {""insertions"": 49, ""deletions"": 0, ""lines"": 49}, ""src/usercmd.c"": {""insertions"": 10, ""deletions"": 8, ""lines"": 18}, ""src/version.c"": {""insertions"": 2, ""deletions"": 0, ""lines"": 2}}"
2021-11-20 13:47:45,87fd0924e2d85213cc111ee7a5122f92216a37c7,Bram Moolenaar,1041,197,1238,43,"{""src/highlight.c"": {""insertions"": 5, ""deletions"": 0, ""lines"": 5}, ""src/libvterm/include/vterm.h"": {""insertions"": 12, ""deletions"": 1, ""lines"": 13}, ""src/option.c"": {""insertions"": 4, ""deletions"": 0, ""lines"": 4}, ""src/optionstr.c"": {""insertions"": 1, ""deletions"": 4, ""lines"": 5}, ""src/popupwin.c"": {""insertions"": 5, ""deletions"": 0, ""lines"": 5}, ""src/proto/terminal.pro"": {""insertions"": 3, ""deletions"": 1, ""lines"": 4}, ""src/structs.h"": {""insertions"": 11, ""deletions"": 0, ""lines"": 11}, ""src/terminal.c"": {""insertions"": 202, ""deletions"": 181, ""lines"": 383}, ""src/testdir/dumps/Test_terminal_color_MyTermCol.dump"": {""insertions"": 15, ""deletions"": 0, ""lines"": 15}, ""src/testdir/dumps/Test_terminal_color_MyTermCol_over_Terminal.dump"": {""insertions"": 15, ""deletions"": 0, ""lines"": 15}, ""src/testdir/dumps/Test_terminal_color_MyWinCol.dump"": {""insertions"": 15, ""deletions"": 0, ""lines"": 15}, ""src/testdir/dumps/Test_terminal_color_MyWinCol_over_group.dump"": {""insertions"": 15, ""deletions"": 0, ""lines"": 15}, ""src/testdir/dumps/Test_terminal_color_Terminal.dump"": {""insertions"": 15, ""deletions"": 0, ""lines"": 15}, ""src/testdir/dumps/Test_terminal_color_gui_MyTermCol.dump"": {""insertions"": 15, ""deletions"": 0, ""lines"": 15}, ""src/testdir/dumps/Test_terminal_color_gui_MyWinCol.dump"": {""insertions"": 15, ""deletions"": 0, ""lines"": 15}, ""src/testdir/dumps/Test_terminal_color_gui_Terminal.dump"": {""insertions"": 15, ""deletions"": 0, ""lines"": 15}, ""src/testdir/dumps/Test_terminal_color_gui_transp_MyTermCol.dump"": {""insertions"": 15, ""deletions"": 0, ""lines"": 15}, ""src/testdir/dumps/Test_terminal_color_gui_transp_MyWinCol.dump"": {""insertions"": 15, ""deletions"": 0, ""lines"": 15}, ""src/testdir/dumps/Test_terminal_color_gui_transp_Terminal.dump"": {""insertions"": 15, ""deletions"": 0, ""lines"": 15}, ""src/testdir/dumps/Test_terminal_color_transp_MyTermCol.dump"": {""insertions"": 15, ""deletions"": 0, ""lines"": 15}, ""src/testdir/dumps/Test_terminal_color_transp_MyWinCol.dump"": {""insertions"": 15, ""deletions"": 0, ""lines"": 15}, ""src/testdir/dumps/Test_terminal_color_transp_Terminal.dump"": {""insertions"": 15, ""deletions"": 0, ""lines"": 15}, ""src/testdir/dumps/Test_terminal_popup_MyPopupHlCol.dump"": {""insertions"": 15, ""deletions"": 0, ""lines"": 15}, ""src/testdir/dumps/Test_terminal_popup_MyTermCol_over_Terminal.dump"": {""insertions"": 15, ""deletions"": 0, ""lines"": 15}, ""src/testdir/dumps/Test_terminal_popup_MyWinCol.dump"": {""insertions"": 15, ""deletions"": 0, ""lines"": 15}, ""src/testdir/dumps/Test_terminal_popup_MyWinCol_over_group.dump"": {""insertions"": 15, ""deletions"": 0, ""lines"": 15}, ""src/testdir/dumps/Test_terminal_popup_gui_MyPopupHlCol.dump"": {""insertions"": 15, ""deletions"": 0, ""lines"": 15}, ""src/testdir/dumps/Test_terminal_popup_gui_MyTermCol.dump"": {""insertions"": 15, ""deletions"": 0, ""lines"": 15}, ""src/testdir/dumps/Test_terminal_popup_gui_MyWinCol.dump"": {""insertions"": 15, ""deletions"": 0, ""lines"": 15}, ""src/testdir/dumps/Test_terminal_popup_gui_Terminal.dump"": {""insertions"": 15, ""deletions"": 0, ""lines"": 15}, ""src/testdir/dumps/Test_terminal_popup_gui_transp_MyPopupHlCol.dump"": {""insertions"": 15, ""deletions"": 0, ""lines"": 15}, ""src/testdir/dumps/Test_terminal_popup_gui_transp_MyTermCol.dump"": {""insertions"": 15, ""deletions"": 0, ""lines"": 15}, ""src/testdir/dumps/Test_terminal_popup_gui_transp_MyWinCol.dump"": {""insertions"": 15, ""deletions"": 0, ""lines"": 15}, ""src/testdir/dumps/Test_terminal_popup_gui_transp_Terminal.dump"": {""insertions"": 15, ""deletions"": 0, ""lines"": 15}, ""src/testdir/dumps/Test_terminal_popup_transp_MyPopupHlCol.dump"": {""insertions"": 15, ""deletions"": 0, ""lines"": 15}, ""src/testdir/dumps/Test_terminal_popup_transp_MyTermCol.dump"": {""insertions"": 15, ""deletions"": 0, ""lines"": 15}, ""src/testdir/dumps/Test_terminal_popup_transp_MyWinCol.dump"": {""insertions"": 15, ""deletions"": 0, ""lines"": 15}, ""src/testdir/dumps/Test_terminal_popup_transp_Terminal.dump"": {""insertions"": 15, ""deletions"": 0, ""lines"": 15}, ""src/testdir/dumps/Test_terminal_wincolor_split_MyWinCol.dump"": {""insertions"": 15, ""deletions"": 0, ""lines"": 15}, ""src/testdir/dumps/Test_terminal_wincolor_split_MyWinCol2.dump"": {""insertions"": 15, ""deletions"": 0, ""lines"": 15}, ""src/testdir/test_terminal3.vim"": {""insertions"": 310, ""deletions"": 10, ""lines"": 320}, ""src/version.c"": {""insertions"": 2, ""deletions"": 0, ""lines"": 2}, ""src/window.c"": {""insertions"": 6, ""deletions"": 0, ""lines"": 6}}"
2021-11-20 11:14:24,cdf5fdb2948ecdd24c6a1e27ed33dfa847c2b3e4,Bram Moolenaar,8,0,8,4,"{""runtime/doc/eval.txt"": {""insertions"": 3, ""deletions"": 0, ""lines"": 3}, ""src/evalwindow.c"": {""insertions"": 1, ""deletions"": 0, ""lines"": 1}, ""src/testdir/test_bufwintabinfo.vim"": {""insertions"": 2, ""deletions"": 0, ""lines"": 2}, ""src/version.c"": {""insertions"": 2, ""deletions"": 0, ""lines"": 2}}"
2021-11-20 10:38:25,b8e642f7ace5382b4dacb7a8effd86f22b828cc1,Bram Moolenaar,10,3,13,3,"{""src/autocmd.c"": {""insertions"": 2, ""deletions"": 0, ""lines"": 2}, ""src/testdir/test_autocmd.vim"": {""insertions"": 6, ""deletions"": 3, ""lines"": 9}, ""src/version.c"": {""insertions"": 2, ""deletions"": 0, ""lines"": 2}}"
2021-11-19 19:41:13,2de9b7c7c8791da8853a9a7ca9c467867465b655,Bram Moolenaar,19,5,24,3,"{""src/cindent.c"": {""insertions"": 5, ""deletions"": 5, ""lines"": 10}, ""src/testdir/test_cindent.vim"": {""insertions"": 12, ""deletions"": 0, ""lines"": 12}, ""src/version.c"": {""insertions"": 2, ""deletions"": 0, ""lines"": 2}}"
2021-11-19 17:01:08,3ad695328f94e0197e84454f125c7f3464091d0c,Bram Moolenaar,29,0,29,5,"{""src/buffer.c"": {""insertions"": 5, ""deletions"": 0, ""lines"": 5}, ""src/proto/terminal.pro"": {""insertions"": 1, ""deletions"": 0, ""lines"": 1}, ""src/terminal.c"": {""insertions"": 9, ""deletions"": 0, ""lines"": 9}, ""src/testdir/test_terminal.vim"": {""insertions"": 12, ""deletions"": 0, ""lines"": 12}, ""src/version.c"": {""insertions"": 2, ""deletions"": 0, ""lines"": 2}}"
2021-11-19 12:37:36,8b8d829faf04fe3706c04f7f7000054acd3254e7,Christian Brabandt,19,7,26,4,"{""runtime/doc/map.txt"": {""insertions"": 0, ""deletions"": 3, ""lines"": 3}, ""src/os_unix.c"": {""insertions"": 11, ""deletions"": 4, ""lines"": 15}, ""src/testdir/test_expand.vim"": {""insertions"": 6, ""deletions"": 0, ""lines"": 6}, ""src/version.c"": {""insertions"": 2, ""deletions"": 0, ""lines"": 2}}"
2021-11-19 11:59:08,64be6aa3a54ecfe355d4a03e1200650c301e7f29,zeertzjq,11,1,12,3,"{""src/ex_docmd.c"": {""insertions"": 1, ""deletions"": 1, ""lines"": 2}, ""src/testdir/test_autochdir.vim"": {""insertions"": 8, ""deletions"": 0, ""lines"": 8}, ""src/version.c"": {""insertions"": 2, ""deletions"": 0, ""lines"": 2}}"
2021-11-19 11:35:32,1d69ef410ab2adb0351d559ff9753d6cdd4befdf,Bram Moolenaar,3,1,4,2,"{""src/version.c"": {""insertions"": 2, ""deletions"": 0, ""lines"": 2}, ""src/vim.h"": {""insertions"": 1, ""deletions"": 1, ""lines"": 2}}"
2021-11-19 11:28:04,b3a29558eedac9979f5276ae914934b7b7cbe06b,Bram Moolenaar,338,270,608,12,"{""src/Make_cyg_ming.mak"": {""insertions"": 1, ""deletions"": 1, ""lines"": 2}, ""src/Make_mvc.mak"": {""insertions"": 1, ""deletions"": 1, ""lines"": 2}, ""src/Make_vms.mms"": {""insertions"": 122, ""deletions"": 122, ""lines"": 244}, ""src/Makefile"": {""insertions"": 146, ""deletions"": 146, ""lines"": 292}, ""src/alloc.c"": {""insertions"": 1, ""deletions"": 0, ""lines"": 1}, ""src/auto/configure"": {""insertions"": 29, ""deletions"": 0, ""lines"": 29}, ""src/config.h.in"": {""insertions"": 3, ""deletions"": 0, ""lines"": 3}, ""src/configure.ac"": {""insertions"": 10, ""deletions"": 0, ""lines"": 10}, ""src/proto/term.pro"": {""insertions"": 1, ""deletions"": 0, ""lines"": 1}, ""src/term.c"": {""insertions"": 22, ""deletions"": 0, ""lines"": 22}, ""src/{term.h => termdefs.h}"": {""insertions"": 0, ""deletions"": 0, ""lines"": 0}, ""src/version.c"": {""insertions"": 2, ""deletions"": 0, ""lines"": 2}}"
2021-11-18 22:08:57,777175b0df8c5ec3cd30d19a2e887e661ac209c8,Yegappan Lakshmanan,185,41,226,10,"{""runtime/doc/map.txt"": {""insertions"": 14, ""deletions"": 0, ""lines"": 14}, ""runtime/doc/options.txt"": {""insertions"": 17, ""deletions"": 3, ""lines"": 20}, ""src/ops.c"": {""insertions"": 26, ""deletions"": 1, ""lines"": 27}, ""src/option.c"": {""insertions"": 47, ""deletions"": 0, ""lines"": 47}, ""src/optionstr.c"": {""insertions"": 9, ""deletions"": 1, ""lines"": 10}, ""src/proto/ops.pro"": {""insertions"": 2, ""deletions"": 0, ""lines"": 2}, ""src/proto/option.pro"": {""insertions"": 2, ""deletions"": 1, ""lines"": 3}, ""src/quickfix.c"": {""insertions"": 2, ""deletions"": 35, ""lines"": 37}, ""src/testdir/test_normal.vim"": {""insertions"": 64, ""deletions"": 0, ""lines"": 64}, ""src/version.c"": {""insertions"": 2, ""deletions"": 0, ""lines"": 2}}"
2021-11-18 20:47:31,851c7a699ae00bdc14a4db874cf722b7b7393b53,Bram Moolenaar,29,6,35,4,"{""runtime/doc/eval.txt"": {""insertions"": 3, ""deletions"": 3, ""lines"": 6}, ""src/filepath.c"": {""insertions"": 5, ""deletions"": 3, ""lines"": 8}, ""src/testdir/test_cd.vim"": {""insertions"": 19, ""deletions"": 0, ""lines"": 19}, ""src/version.c"": {""insertions"": 2, ""deletions"": 0, ""lines"": 2}}"
2021-11-18 18:53:45,0526815c15170a5926e1008600ec29d42d8b64c2,Bram Moolenaar,51,4,55,9,"{""src/buffer.c"": {""insertions"": 3, ""deletions"": 0, ""lines"": 3}, ""src/ex_docmd.c"": {""insertions"": 4, ""deletions"": 1, ""lines"": 5}, ""src/globals.h"": {""insertions"": 1, ""deletions"": 0, ""lines"": 1}, ""src/main.c"": {""insertions"": 2, ""deletions"": 1, ""lines"": 3}, ""src/netbeans.c"": {""insertions"": 3, ""deletions"": 0, ""lines"": 3}, ""src/os_win32.c"": {""insertions"": 3, ""deletions"": 2, ""lines"": 5}, ""src/testdir/test_autochdir.vim"": {""insertions"": 29, ""deletions"": 0, ""lines"": 29}, ""src/version.c"": {""insertions"": 2, ""deletions"": 0, ""lines"": 2}, ""src/window.c"": {""insertions"": 4, ""deletions"": 0, ""lines"": 4}}"
2021-11-18 15:37:29,3cad47038547e694cfa26ba39c399f610d2054bd,Shougo Matsushita,11,10,21,2,"{""src/testdir/test_arglist.vim"": {""insertions"": 9, ""deletions"": 10, ""lines"": 19}, ""src/version.c"": {""insertions"": 2, ""deletions"": 0, ""lines"": 2}}"
2021-11-18 13:56:37,818ff25cd1aabf60b9cd239da2f1328a959954f7,Christian Brabandt,101,1,102,3,"{""src/testdir/test_indent.vim"": {""insertions"": 75, ""deletions"": 0, ""lines"": 75}, ""src/textformat.c"": {""insertions"": 24, ""deletions"": 1, ""lines"": 25}, ""src/version.c"": {""insertions"": 2, ""deletions"": 0, ""lines"": 2}}"
2021-11-17 20:40:16,6555500bcf280716187eea9dba22d4f69bc0a501,Bakudankun,88,5,93,8,"{""src/popupmenu.c"": {""insertions"": 2, ""deletions"": 2, ""lines"": 4}, ""src/popupwin.c"": {""insertions"": 5, ""deletions"": 1, ""lines"": 6}, ""src/proto/popupmenu.pro"": {""insertions"": 1, ""deletions"": 1, ""lines"": 2}, ""src/screen.c"": {""insertions"": 1, ""deletions"": 1, ""lines"": 2}, ""src/testdir/dumps/Test_popupwin_popupmenu_masking_1.dump"": {""insertions"": 14, ""deletions"": 0, ""lines"": 14}, ""src/testdir/dumps/Test_popupwin_popupmenu_masking_2.dump"": {""insertions"": 14, ""deletions"": 0, ""lines"": 14}, ""src/testdir/test_popupwin.vim"": {""insertions"": 49, ""deletions"": 0, ""lines"": 49}, ""src/version.c"": {""insertions"": 2, ""deletions"": 0, ""lines"": 2}}"
2021-11-17 19:01:53,e015d99abb4276f47ce97bad1ad5ff0c658b1c8a,Bram Moolenaar,5,3,8,2,"{""src/findfile.c"": {""insertions"": 3, ""deletions"": 3, ""lines"": 6}, ""src/version.c"": {""insertions"": 2, ""deletions"": 0, ""lines"": 2}}"
2021-11-17 18:22:56,64066b9acd9f8cffdf4840f797748f938a13f2d6,Bram Moolenaar,19,1,20,4,"{""src/regexp.c"": {""insertions"": 1, ""deletions"": 1, ""lines"": 2}, ""src/regexp_nfa.c"": {""insertions"": 8, ""deletions"": 0, ""lines"": 8}, ""src/testdir/test_regexp_latin.vim"": {""insertions"": 8, ""deletions"": 0, ""lines"": 8}, ""src/version.c"": {""insertions"": 2, ""deletions"": 0, ""lines"": 2}}"
2021-11-17 18:00:31,615ddd5342b50a6878a907062aa471740bd9a847,Bram Moolenaar,22,2,24,4,"{""src/findfile.c"": {""insertions"": 8, ""deletions"": 0, ""lines"": 8}, ""src/normal.c"": {""insertions"": 4, ""deletions"": 2, ""lines"": 6}, ""src/testdir/test_visual.vim"": {""insertions"": 8, ""deletions"": 0, ""lines"": 8}, ""src/version.c"": {""insertions"": 2, ""deletions"": 0, ""lines"": 2}}"
2021-11-17 16:52:40,a062006b9de0b2947ab5fb376c6e67ef92a8cd69,Bram Moolenaar,12,2,14,3,"{""src/normal.c"": {""insertions"": 1, ""deletions"": 1, ""lines"": 2}, ""src/testdir/test_edit.vim"": {""insertions"": 9, ""deletions"": 1, ""lines"": 10}, ""src/version.c"": {""insertions"": 2, ""deletions"": 0, ""lines"": 2}}"
2021-11-17 15:51:52,3075a45592fe76f2febb6321632a23e352efe949,Bram Moolenaar,65,17,82,7,"{""src/insexpand.c"": {""insertions"": 4, ""deletions"": 4, ""lines"": 8}, ""src/misc1.c"": {""insertions"": 37, ""deletions"": 4, ""lines"": 41}, ""src/proto/misc1.pro"": {""insertions"": 2, ""deletions"": 0, ""lines"": 2}, ""src/register.c"": {""insertions"": 9, ""deletions"": 9, ""lines"": 18}, ""src/structs.h"": {""insertions"": 5, ""deletions"": 0, ""lines"": 5}, ""src/testdir/test_edit.vim"": {""insertions"": 6, ""deletions"": 0, ""lines"": 6}, ""src/version.c"": {""insertions"": 2, ""deletions"": 0, ""lines"": 2}}"
2021-11-17 14:01:14,125ffd21f9601a90b845f1d50c24da0d3938bb59,Egor Zvorykin,15,0,15,4,"{""runtime/defaults.vim"": {""insertions"": 11, ""deletions"": 0, ""lines"": 11}, ""src/testdir/test_autocmd.vim"": {""insertions"": 1, ""deletions"": 0, ""lines"": 1}, ""src/testdir/test_cmdline.vim"": {""insertions"": 1, ""deletions"": 0, ""lines"": 1}, ""src/version.c"": {""insertions"": 2, ""deletions"": 0, ""lines"": 2}}"
2021-11-16 20:03:56,9459b8d461d6f8345bfa3fb9b3b4297a7950b0bc,presuku,30,145,175,3,"{""src/gui.h"": {""insertions"": 0, ""deletions"": 1, ""lines"": 1}, ""src/gui_gtk_x11.c"": {""insertions"": 28, ""deletions"": 144, ""lines"": 172}, ""src/version.c"": {""insertions"": 2, ""deletions"": 0, ""lines"": 2}}"
2021-11-16 19:20:56,d3682c5f28380695a53cbb927deb94ffa3261eca,Bram Moolenaar,3,0,3,2,"{""Filelist"": {""insertions"": 1, ""deletions"": 0, ""lines"": 1}, ""src/version.c"": {""insertions"": 2, ""deletions"": 0, ""lines"": 2}}"
2021-11-16 19:18:26,519cc559b08b800edc429688aece7ad6a00d41eb,Bram Moolenaar,365,141,506,29,"{"".github/CODEOWNERS"": {""insertions"": 3, ""deletions"": 0, ""lines"": 3}, ""runtime/autoload/zip.vim"": {""insertions"": 21, ""deletions"": 15, ""lines"": 36}, ""runtime/doc/eval.txt"": {""insertions"": 4, ""deletions"": 4, ""lines"": 8}, ""runtime/doc/helphelp.txt"": {""insertions"": 13, ""deletions"": 9, ""lines"": 22}, ""runtime/doc/if_pyth.txt"": {""insertions"": 6, ""deletions"": 1, ""lines"": 7}, ""runtime/doc/map.txt"": {""insertions"": 4, ""deletions"": 1, ""lines"": 5}, ""runtime/doc/options.txt"": {""insertions"": 1, ""deletions"": 1, ""lines"": 2}, ""runtime/doc/pi_zip.txt"": {""insertions"": 4, ""deletions"": 1, ""lines"": 5}, ""runtime/doc/syntax.txt"": {""insertions"": 1, ""deletions"": 1, ""lines"": 2}, ""runtime/doc/tags"": {""insertions"": 4, ""deletions"": 2, ""lines"": 6}, ""runtime/doc/terminal.txt"": {""insertions"": 2, ""deletions"": 2, ""lines"": 4}, ""runtime/doc/todo.txt"": {""insertions"": 4, ""deletions"": 9, ""lines"": 13}, ""runtime/doc/usr_20.txt"": {""insertions"": 5, ""deletions"": 5, ""lines"": 10}, ""runtime/filetype.vim"": {""insertions"": 1, ""deletions"": 1, ""lines"": 2}, ""runtime/ftplugin/aap.vim"": {""insertions"": 10, ""deletions"": 3, ""lines"": 13}, ""runtime/ftplugin/diff.vim"": {""insertions"": 8, ""deletions"": 3, ""lines"": 11}, ""runtime/ftplugin/lua.vim"": {""insertions"": 21, ""deletions"": 17, ""lines"": 38}, ""runtime/ftplugin/routeros.vim"": {""insertions"": 29, ""deletions"": 0, ""lines"": 29}, ""runtime/ftplugin/zimbu.vim"": {""insertions"": 57, ""deletions"": 4, ""lines"": 61}, ""runtime/pack/dist/opt/matchit/doc/matchit.txt"": {""insertions"": 2, ""deletions"": 2, ""lines"": 4}, ""runtime/pack/dist/opt/termdebug/plugin/termdebug.vim"": {""insertions"": 3, ""deletions"": 1, ""lines"": 4}, ""runtime/plugin/zipPlugin.vim"": {""insertions"": 1, ""deletions"": 1, ""lines"": 2}, ""runtime/syntax/autoit.vim"": {""insertions"": 2, ""deletions"": 1, ""lines"": 3}, ""runtime/syntax/gdb.vim"": {""insertions"": 7, ""deletions"": 6, ""lines"": 13}, ""runtime/syntax/gnuplot.vim"": {""insertions"": 23, ""deletions"": 18, ""lines"": 41}, ""runtime/syntax/lisp.vim"": {""insertions"": 14, ""deletions"": 12, ""lines"": 26}, ""runtime/syntax/routeros.vim"": {""insertions"": 91, ""deletions"": 0, ""lines"": 91}, ""runtime/syntax/tcl.vim"": {""insertions"": 10, ""deletions"": 10, ""lines"": 20}, ""runtime/syntax/vim.vim"": {""insertions"": 14, ""deletions"": 11, ""lines"": 25}}"
2021-11-16 17:50:34,728104da6cd561b8cb2c7142769f7526d725958e,Bram Moolenaar,2,0,2,1,"{""src/version.c"": {""insertions"": 2, ""deletions"": 0, ""lines"": 2}}"
2021-11-16 17:19:30,2a16dc6613368c54d526850bcbcd03c3fec1be67,Yegappan Lakshmanan,142,35,177,5,"{""runtime/doc/eval.txt"": {""insertions"": 16, ""deletions"": 1, ""lines"": 17}, ""src/highlight.c"": {""insertions"": 35, ""deletions"": 17, ""lines"": 52}, ""src/testdir/test_highlight.vim"": {""insertions"": 88, ""deletions"": 15, ""lines"": 103}, ""src/testdir/test_vim9_builtin.vim"": {""insertions"": 1, ""deletions"": 0, ""lines"": 1}, ""src/testdir/test_vim9_cmd.vim"": {""insertions"": 2, ""deletions"": 2, ""lines"": 4}}"
2021-11-16 16:38:42,c143fa0778fa0d8744867318bb7f7a2e63cf37d7,Bram Moolenaar,6,1,7,3,"{""runtime/filetype.vim"": {""insertions"": 3, ""deletions"": 0, ""lines"": 3}, ""src/testdir/test_filetype.vim"": {""insertions"": 1, ""deletions"": 1, ""lines"": 2}, ""src/version.c"": {""insertions"": 2, ""deletions"": 0, ""lines"": 2}}"
2021-11-16 15:28:10,b1b163efd7bb3ca68cce101d4e431559d2944a8e,Bram Moolenaar,11,0,11,4,"{""runtime/filetype.vim"": {""insertions"": 3, ""deletions"": 0, ""lines"": 3}, ""runtime/scripts.vim"": {""insertions"": 4, ""deletions"": 0, ""lines"": 4}, ""src/testdir/test_filetype.vim"": {""insertions"": 2, ""deletions"": 0, ""lines"": 2}, ""src/version.c"": {""insertions"": 2, ""deletions"": 0, ""lines"": 2}}"
2021-11-16 13:08:56,1be7e215830d6ec9aa6200aac4ef34ac0ae85af5,K.Takata,5,0,5,2,"{""src/testdir/test_python3.vim"": {""insertions"": 3, ""deletions"": 0, ""lines"": 3}, ""src/version.c"": {""insertions"": 2, ""deletions"": 0, ""lines"": 2}}"
2021-11-16 12:50:46,fa53722367c3793fda95dac665af74b8651065e9,ichizok,68,29,97,3,"{""src/register.c"": {""insertions"": 35, ""deletions"": 27, ""lines"": 62}, ""src/testdir/test_put.vim"": {""insertions"": 31, ""deletions"": 2, ""lines"": 33}, ""src/version.c"": {""insertions"": 2, ""deletions"": 0, ""lines"": 2}}"
2021-11-16 11:53:13,314b773abbb9b1ce0020d83482c6daf7ad6a42a2,Bram Moolenaar,10,0,10,2,"{""runtime/scripts.vim"": {""insertions"": 8, ""deletions"": 0, ""lines"": 8}, ""src/version.c"": {""insertions"": 2, ""deletions"": 0, ""lines"": 2}}"
2021-11-16 11:10:11,782b4bbc163e03ebe98d25bc62b9d82cba8f91a1,Bram Moolenaar,4,2,6,3,"{""runtime/filetype.vim"": {""insertions"": 1, ""deletions"": 1, ""lines"": 2}, ""src/testdir/test_filetype.vim"": {""insertions"": 1, ""deletions"": 1, ""lines"": 2}, ""src/version.c"": {""insertions"": 2, ""deletions"": 0, ""lines"": 2}}"
2021-11-15 21:44:11,0818ab82e7058145366ebbe759f0b3f74724bdfd,zainin,7,0,7,3,"{""runtime/filetype.vim"": {""insertions"": 3, ""deletions"": 0, ""lines"": 3}, ""src/testdir/test_filetype.vim"": {""insertions"": 2, ""deletions"": 0, ""lines"": 2}, ""src/version.c"": {""insertions"": 2, ""deletions"": 0, ""lines"": 2}}"
2021-11-15 17:13:11,36968af1558b295b5fdf56973d5dcc75fce85658,Bram Moolenaar,20,1,21,3,"{""runtime/doc/options.txt"": {""insertions"": 3, ""deletions"": 0, ""lines"": 3}, ""src/terminal.c"": {""insertions"": 15, ""deletions"": 1, ""lines"": 16}, ""src/version.c"": {""insertions"": 2, ""deletions"": 0, ""lines"": 2}}"
2021-11-15 11:22:09,733b124a9098d5e2f028fd2e12012b831c9e9024,Yegappan Lakshmanan,18,5,23,3,"{""src/popupwin.c"": {""insertions"": 5, ""deletions"": 5, ""lines"": 10}, ""src/testdir/test_vim9_cmd.vim"": {""insertions"": 11, ""deletions"": 0, ""lines"": 11}, ""src/version.c"": {""insertions"": 2, ""deletions"": 0, ""lines"": 2}}"
2021-11-14 14:05:18,0d5a12ea041c112b06b1aafde38846ae4cff8f4c,Bram Moolenaar,8,2,10,2,"{""src/getchar.c"": {""insertions"": 6, ""deletions"": 2, ""lines"": 8}, ""src/version.c"": {""insertions"": 2, ""deletions"": 0, ""lines"": 2}}"
2021-11-14 13:46:05,786e05beb5bf4a50cffacd0968f1409aa6af3c6b,Bram Moolenaar,44,29,73,2,"{""src/version.c"": {""insertions"": 2, ""deletions"": 0, ""lines"": 2}, ""src/xxd/xxd.c"": {""insertions"": 42, ""deletions"": 29, ""lines"": 71}}"
2021-11-14 11:41:31,7f13b24ab6aca808262e68680d8fe5f082670ebd,Bram Moolenaar,58,30,88,5,"{""src/evalwindow.c"": {""insertions"": 4, ""deletions"": 0, ""lines"": 4}, ""src/proto/window.pro"": {""insertions"": 1, ""deletions"": 0, ""lines"": 1}, ""src/testdir/test_execute_func.vim"": {""insertions"": 12, ""deletions"": 0, ""lines"": 12}, ""src/version.c"": {""insertions"": 2, ""deletions"": 0, ""lines"": 2}, ""src/window.c"": {""insertions"": 39, ""deletions"": 30, ""lines"": 69}}"
2021-11-13 18:44:37,6a950a6007f27d9d0ce32ef8dcaf5c9d0f1b5aab,Dominique Pelle,7,0,7,2,"{""src/testdir/test_highlight.vim"": {""insertions"": 5, ""deletions"": 0, ""lines"": 5}, ""src/version.c"": {""insertions"": 2, ""deletions"": 0, ""lines"": 2}}"
2021-11-13 12:38:49,23beefed73aadb243fb67cf944e3d60fe8c038bb,naohiro ono,84,4,88,6,"{""runtime/doc/autocmd.txt"": {""insertions"": 7, ""deletions"": 0, ""lines"": 7}, ""src/autocmd.c"": {""insertions"": 3, ""deletions"": 1, ""lines"": 4}, ""src/testdir/test_autocmd.vim"": {""insertions"": 43, ""deletions"": 3, ""lines"": 46}, ""src/version.c"": {""insertions"": 2, ""deletions"": 0, ""lines"": 2}, ""src/vim.h"": {""insertions"": 1, ""deletions"": 0, ""lines"": 1}, ""src/window.c"": {""insertions"": 28, ""deletions"": 0, ""lines"": 28}}"
2021-11-13 10:50:01,a0fca17251bf491db7b8d302ce22dee844597e82,Drew Vogel,24,35,59,5,"{""runtime/doc/eval.txt"": {""insertions"": 1, ""deletions"": 1, ""lines"": 2}, ""src/highlight.c"": {""insertions"": 0, ""deletions"": 33, ""lines"": 33}, ""src/proto/highlight.pro"": {""insertions"": 0, ""deletions"": 1, ""lines"": 1}, ""src/testdir/test_highlight.vim"": {""insertions"": 21, ""deletions"": 0, ""lines"": 21}, ""src/version.c"": {""insertions"": 2, ""deletions"": 0, ""lines"": 2}}"
2021-11-13 10:27:40,5300be620c77950caa5296019408ee02e60097e8,Bram Moolenaar,11,1,12,4,"{""runtime/doc/terminal.txt"": {""insertions"": 2, ""deletions"": 1, ""lines"": 3}, ""src/job.c"": {""insertions"": 5, ""deletions"": 0, ""lines"": 5}, ""src/testdir/test_terminal.vim"": {""insertions"": 2, ""deletions"": 0, ""lines"": 2}, ""src/version.c"": {""insertions"": 2, ""deletions"": 0, ""lines"": 2}}"
2021-11-12 19:52:47,606efc7df4c94104bbd24248106dd0e4ee6f7cfa,Bram Moolenaar,6,5,11,2,"{""src/optionstr.c"": {""insertions"": 4, ""deletions"": 5, ""lines"": 9}, ""src/version.c"": {""insertions"": 2, ""deletions"": 0, ""lines"": 2}}"
2021-11-12 16:09:54,0a15c7676bccb0c9483579106318e785c6e40a7f,Bram Moolenaar,3,1,4,2,"{""src/testdir/test_compiler.vim"": {""insertions"": 1, ""deletions"": 1, ""lines"": 2}, ""src/version.c"": {""insertions"": 2, ""deletions"": 0, ""lines"": 2}}"
2021-11-12 16:06:03,326e7da609a1b115b0ed535e89e970afebe99e35,Bram Moolenaar,4,2,6,2,"{""src/testdir/test_usercommands.vim"": {""insertions"": 2, ""deletions"": 2, ""lines"": 4}, ""src/version.c"": {""insertions"": 2, ""deletions"": 0, ""lines"": 2}}"
2021-11-12 16:01:15,88137396733896eb5e49c2b3b73d9a496d6ce49a,Bram Moolenaar,13,2,15,4,"{""src/job.c"": {""insertions"": 5, ""deletions"": 1, ""lines"": 6}, ""src/terminal.c"": {""insertions"": 2, ""deletions"": 1, ""lines"": 3}, ""src/testdir/test_terminal.vim"": {""insertions"": 4, ""deletions"": 0, ""lines"": 4}, ""src/version.c"": {""insertions"": 2, ""deletions"": 0, ""lines"": 2}}"
2021-11-12 11:25:11,58ef8a31d7087d495ab1582be5b7a22796ac2451,Bram Moolenaar,20,5,25,6,"{""runtime/doc/map.txt"": {""insertions"": 3, ""deletions"": 0, ""lines"": 3}, ""src/ex_cmds.h"": {""insertions"": 1, ""deletions"": 0, ""lines"": 1}, ""src/ex_cmds2.c"": {""insertions"": 1, ""deletions"": 1, ""lines"": 2}, ""src/testdir/test_compiler.vim"": {""insertions"": 3, ""deletions"": 0, ""lines"": 3}, ""src/usercmd.c"": {""insertions"": 10, ""deletions"": 4, ""lines"": 14}, ""src/version.c"": {""insertions"": 2, ""deletions"": 0, ""lines"": 2}}"
2021-11-12 10:30:04,0c71114aede81a209b7efc126b4bf19f11d58955,Bram Moolenaar,58,3,61,5,"{""src/normal.c"": {""insertions"": 11, ""deletions"": 3, ""lines"": 14}, ""src/testdir/dumps/Test_searchstatgd_1.dump"": {""insertions"": 10, ""deletions"": 0, ""lines"": 10}, ""src/testdir/dumps/Test_searchstatgd_2.dump"": {""insertions"": 10, ""deletions"": 0, ""lines"": 10}, ""src/testdir/test_search_stat.vim"": {""insertions"": 25, ""deletions"": 0, ""lines"": 25}, ""src/version.c"": {""insertions"": 2, ""deletions"": 0, ""lines"": 2}}"
2021-11-07 20:27:04,113cb513f76d8866cbb6dc85fa18aded753e01da,Bram Moolenaar,359,416,775,48,"{"".github/CODEOWNERS"": {""insertions"": 3, ""deletions"": 0, ""lines"": 3}, ""runtime/autoload/clojurecomplete.vim"": {""insertions"": 5, ""deletions"": 5, ""lines"": 10}, ""runtime/doc/eval.txt"": {""insertions"": 45, ""deletions"": 11, ""lines"": 56}, ""runtime/doc/gui_w32.txt"": {""insertions"": 1, ""deletions"": 1, ""lines"": 2}, ""runtime/doc/indent.txt"": {""insertions"": 24, ""deletions"": 35, ""lines"": 59}, ""runtime/doc/insert.txt"": {""insertions"": 21, ""deletions"": 25, ""lines"": 46}, ""runtime/doc/options.txt"": {""insertions"": 7, ""deletions"": 4, ""lines"": 11}, ""runtime/doc/syntax.txt"": {""insertions"": 51, ""deletions"": 33, ""lines"": 84}, ""runtime/doc/tags"": {""insertions"": 14, ""deletions"": 0, ""lines"": 14}, ""runtime/doc/tips.txt"": {""insertions"": 2, ""deletions"": 1, ""lines"": 3}, ""runtime/doc/todo.txt"": {""insertions"": 11, ""deletions"": 3, ""lines"": 14}, ""runtime/doc/usr_06.txt"": {""insertions"": 2, ""deletions"": 2, ""lines"": 4}, ""runtime/ftplugin/clojure.vim"": {""insertions"": 6, ""deletions"": 6, ""lines"": 12}, ""runtime/ftplugin/mail.vim"": {""insertions"": 9, ""deletions"": 1, ""lines"": 10}, ""runtime/ftplugin/meson.vim"": {""insertions"": 21, ""deletions"": 2, ""lines"": 23}, ""runtime/ftplugin/spec.vim"": {""insertions"": 2, ""deletions"": 2, ""lines"": 4}, ""runtime/indent/clojure.vim"": {""insertions"": 8, ""deletions"": 11, ""lines"": 19}, ""runtime/indent/meson.vim"": {""insertions"": 2, ""deletions"": 0, ""lines"": 2}, ""runtime/indent/vim.vim"": {""insertions"": 2, ""deletions"": 2, ""lines"": 4}, ""runtime/optwin.vim"": {""insertions"": 2, ""deletions"": 2, ""lines"": 4}, ""runtime/pack/dist/opt/termdebug/plugin/termdebug.vim"": {""insertions"": 22, ""deletions"": 7, ""lines"": 29}, ""runtime/syntax/arduino.vim"": {""insertions"": 1, ""deletions"": 1, ""lines"": 2}, ""runtime/syntax/clojure.vim"": {""insertions"": 34, ""deletions"": 35, ""lines"": 69}, ""runtime/syntax/help_ru.vim"": {""insertions"": 2, ""deletions"": 2, ""lines"": 4}, ""runtime/syntax/meson.vim"": {""insertions"": 11, ""deletions"": 7, ""lines"": 18}, ""runtime/syntax/sh.vim"": {""insertions"": 4, ""deletions"": 4, ""lines"": 8}, ""runtime/syntax/vim.vim"": {""insertions"": 28, ""deletions"": 29, ""lines"": 57}, ""runtime/tutor/tutor.da.utf-8"": {""insertions"": 1, ""deletions"": 1, ""lines"": 2}, ""src/po/ca.po"": {""insertions"": 0, ""deletions"": 3, ""lines"": 3}, ""src/po/da.po"": {""insertions"": 0, ""deletions"": 3, ""lines"": 3}, ""src/po/de.po"": {""insertions"": 0, ""deletions"": 3, ""lines"": 3}, ""src/po/eo.po"": {""insertions"": 0, ""deletions"": 3, ""lines"": 3}, ""src/po/fi.po"": {""insertions"": 0, ""deletions"": 3, ""lines"": 3}, ""src/po/fr.po"": {""insertions"": 0, ""deletions"": 3, ""lines"": 3}, ""src/po/ga.po"": {""insertions"": 0, ""deletions"": 3, ""lines"": 3}, ""src/po/it.po"": {""insertions"": 18, ""deletions"": 127, ""lines"": 145}, ""src/po/ja.euc-jp.po"": {""insertions"": 0, ""deletions"": 3, ""lines"": 3}, ""src/po/ja.po"": {""insertions"": 0, ""deletions"": 3, ""lines"": 3}, ""src/po/ja.sjis.po"": {""insertions"": 0, ""deletions"": 3, ""lines"": 3}, ""src/po/ko.UTF-8.po"": {""insertions"": 0, ""deletions"": 3, ""lines"": 3}, ""src/po/ko.po"": {""insertions"": 0, ""deletions"": 3, ""lines"": 3}, ""src/po/pt_BR.po"": {""insertions"": 0, ""deletions"": 3, ""lines"": 3}, ""src/po/ru.cp1251.po"": {""insertions"": 0, ""deletions"": 3, ""lines"": 3}, ""src/po/ru.po"": {""insertions"": 0, ""deletions"": 3, ""lines"": 3}, ""src/po/sr.po"": {""insertions"": 0, ""deletions"": 3, ""lines"": 3}, ""src/po/tr.po"": {""insertions"": 0, ""deletions"": 3, ""lines"": 3}, ""src/po/uk.cp1251.po"": {""insertions"": 0, ""deletions"": 3, ""lines"": 3}, ""src/po/uk.po"": {""insertions"": 0, ""deletions"": 3, ""lines"": 3}}"
2021-11-04 15:46:05,15d9890eee53afc61eb0a03b878a19cb5672f732,Bram Moolenaar,11,1,12,3,"{""src/spellsuggest.c"": {""insertions"": 1, ""deletions"": 1, ""lines"": 2}, ""src/testdir/test_spell.vim"": {""insertions"": 8, ""deletions"": 0, ""lines"": 8}, ""src/version.c"": {""insertions"": 2, ""deletions"": 0, ""lines"": 2}}"
2021-11-04 15:10:11,0b5b06cb4777d1401fdf83e7d48d287662236e7e,Bram Moolenaar,12,0,12,3,"{""src/ex_docmd.c"": {""insertions"": 1, ""deletions"": 0, ""lines"": 1}, ""src/testdir/test_put.vim"": {""insertions"": 9, ""deletions"": 0, ""lines"": 9}, ""src/version.c"": {""insertions"": 2, ""deletions"": 0, ""lines"": 2}}"
2021-11-04 13:28:29,aaec1d4fb12efb82b87ad322e95994de77b1a833,Christian Brabandt,22,1,23,3,"{""src/normal.c"": {""insertions"": 8, ""deletions"": 1, ""lines"": 9}, ""src/testdir/test_normal.vim"": {""insertions"": 12, ""deletions"": 0, ""lines"": 12}, ""src/version.c"": {""insertions"": 2, ""deletions"": 0, ""lines"": 2}}"
2021-11-03 22:31:44,4b2c8047679b737dcb0cd15c313ee51553aed617,Christian Brabandt,8,1,9,2,"{""src/testdir/runtest.vim"": {""insertions"": 6, ""deletions"": 1, ""lines"": 7}, ""src/version.c"": {""insertions"": 2, ""deletions"": 0, ""lines"": 2}}"
2021-11-03 22:25:06,b32aa8a6a10983836d5987f1e42035f88d47bf6e,Bram Moolenaar,2,0,2,1,"{""src/version.c"": {""insertions"": 2, ""deletions"": 0, ""lines"": 2}}"
2021-11-03 21:56:45,d1a8d658e1b16cf8579fc72cf7aa6a29a57ff5ef,Yegappan Lakshmanan,724,0,724,9,"{""runtime/doc/eval.txt"": {""insertions"": 89, ""deletions"": 0, ""lines"": 89}, ""runtime/doc/syntax.txt"": {""insertions"": 1, ""deletions"": 0, ""lines"": 1}, ""runtime/doc/usr_41.txt"": {""insertions"": 2, ""deletions"": 0, ""lines"": 2}, ""runtime/doc/windows.txt"": {""insertions"": 1, ""deletions"": 0, ""lines"": 1}, ""src/evalfunc.c"": {""insertions"": 4, ""deletions"": 0, ""lines"": 4}, ""src/highlight.c"": {""insertions"": 454, ""deletions"": 0, ""lines"": 454}, ""src/proto/highlight.pro"": {""insertions"": 2, ""deletions"": 0, ""lines"": 2}, ""src/testdir/test_highlight.vim"": {""insertions"": 161, ""deletions"": 0, ""lines"": 161}, ""src/testdir/test_vim9_builtin.vim"": {""insertions"": 10, ""deletions"": 0, ""lines"": 10}}"
2021-11-03 13:43:16,0f0044125c2a5dcde2c4605efc39d2e237eed024,Bram Moolenaar,6,0,6,2,"{""src/testdir/test_put.vim"": {""insertions"": 4, ""deletions"": 0, ""lines"": 4}, ""src/version.c"": {""insertions"": 2, ""deletions"": 0, ""lines"": 2}}"
2021-11-03 13:15:47,a63780b9770699bf8fda93affeab2c728bc76912,Sean Dewar,3,1,4,2,"{""src/evalfunc.c"": {""insertions"": 1, ""deletions"": 1, ""lines"": 2}, ""src/version.c"": {""insertions"": 2, ""deletions"": 0, ""lines"": 2}}"
2021-11-02 23:11:00,e551ccfb9311eea5252d1c3106ff7a53c762d994,Bram Moolenaar,11,3,14,2,"{""src/register.c"": {""insertions"": 9, ""deletions"": 3, ""lines"": 12}, ""src/version.c"": {""insertions"": 2, ""deletions"": 0, ""lines"": 2}}"
2021-11-02 22:48:49,8a1962d1355096af55e84b1ea2f0baf5f1c5a5bc,Bram Moolenaar,5,2,7,2,"{""src/register.c"": {""insertions"": 3, ""deletions"": 2, ""lines"": 5}, ""src/version.c"": {""insertions"": 2, ""deletions"": 0, ""lines"": 2}}"
2021-11-02 21:39:49,69b3072d984480935ec412b32b97fea974d2b689,Bram Moolenaar,14,9,23,5,"{""src/evalvars.c"": {""insertions"": 6, ""deletions"": 0, ""lines"": 6}, ""src/register.c"": {""insertions"": 2, ""deletions"": 1, ""lines"": 3}, ""src/testdir/test_put.vim"": {""insertions"": 0, ""deletions"": 7, ""lines"": 7}, ""src/version.c"": {""insertions"": 2, ""deletions"": 0, ""lines"": 2}, ""src/vim.h"": {""insertions"": 4, ""deletions"": 1, ""lines"": 5}}"
2021-11-02 20:56:07,7a33ebfc5b04353aa7674972087d581def8fdcc1,zeertzjq,15,5,20,3,"{""src/testdir/test_listchars.vim"": {""insertions"": 11, ""deletions"": 5, ""lines"": 16}, ""src/version.c"": {""insertions"": 2, ""deletions"": 0, ""lines"": 2}, ""src/window.c"": {""insertions"": 2, ""deletions"": 0, ""lines"": 2}}"
2021-11-02 20:24:38,e2f66064d1c643f0cf12c4791de04bb123705a0c,Bram Moolenaar,3,1,4,2,"{""src/mbyte.c"": {""insertions"": 1, ""deletions"": 1, ""lines"": 2}, ""src/version.c"": {""insertions"": 2, ""deletions"": 0, ""lines"": 2}}"
2021-11-01 22:58:43,ec6e63079dde24a1d74b4103775e74d00f9215ec,Bram Moolenaar,6,0,6,2,"{""src/testdir/test_put.vim"": {""insertions"": 4, ""deletions"": 0, ""lines"": 4}, ""src/version.c"": {""insertions"": 2, ""deletions"": 0, ""lines"": 2}}"
2021-11-01 22:44:33,fd916d654d9731b3515abf7bc1ac12bd3632b601,Christian Brabandt,9,4,13,2,"{""src/os_win32.c"": {""insertions"": 7, ""deletions"": 4, ""lines"": 11}, ""src/version.c"": {""insertions"": 2, ""deletions"": 0, ""lines"": 2}}"
2021-10-31 20:19:17,8753c1dd2c2a5c2c7ff63a9bfb14cd4b9bb9c87f,Dominique Pelle,7,1,8,2,"{""src/testdir/test_edit.vim"": {""insertions"": 5, ""deletions"": 1, ""lines"": 6}, ""src/version.c"": {""insertions"": 2, ""deletions"": 0, ""lines"": 2}}"
2021-10-28 20:06:05,9cd063e3195a4c250c8016fa340922ab21fda252,Dominique Pelle,19,0,19,2,"{""src/testdir/test_edit.vim"": {""insertions"": 17, ""deletions"": 0, ""lines"": 17}, ""src/version.c"": {""insertions"": 2, ""deletions"": 0, ""lines"": 2}}"
2021-10-28 19:49:06,44db603f691b58a8531e8ff528e0a7ce644257b2,Gary Johnson,17,0,17,2,"{""src/version.c"": {""insertions"": 2, ""deletions"": 0, ""lines"": 2}, ""src/vim.h"": {""insertions"": 15, ""deletions"": 0, ""lines"": 15}}"
2021-10-26 11:00:01,2446ec9b567ce2b72bd06d121f200f40bbdc8a84,Bram Moolenaar,217,199,416,2,"{""src/Makefile"": {""insertions"": 215, ""deletions"": 199, ""lines"": 414}, ""src/version.c"": {""insertions"": 2, ""deletions"": 0, ""lines"": 2}}"
2021-10-25 16:07:04,777e7c21b7627be80961848ac560cb0a9978ff43,Bram Moolenaar,21,4,25,3,"{""src/move.c"": {""insertions"": 0, ""deletions"": 1, ""lines"": 1}, ""src/testdir/test_normal.vim"": {""insertions"": 19, ""deletions"": 3, ""lines"": 22}, ""src/version.c"": {""insertions"": 2, ""deletions"": 0, ""lines"": 2}}"
2021-10-25 09:30:14,2a52196b78f3fcc0e9fad538984272c5fd8d85db,Bram Moolenaar,4,2,6,2,"{""src/highlight.c"": {""insertions"": 2, ""deletions"": 2, ""lines"": 4}, ""src/version.c"": {""insertions"": 2, ""deletions"": 0, ""lines"": 2}}"
2021-10-24 19:35:07,e30d10253fa634c4f60daa798d029245f4eed393,Drew Vogel,1364,398,1762,26,"{""Filelist"": {""insertions"": 1, ""deletions"": 1, ""lines"": 2}, ""READMEdir/README_extra.txt"": {""insertions"": 0, ""deletions"": 1, ""lines"": 1}, ""nsis/gvim.nsi"": {""insertions"": 2, ""deletions"": 1, ""lines"": 3}, ""runtime/colors/README.txt"": {""insertions"": 2, ""deletions"": 1, ""lines"": 3}, ""runtime/colors/lists/csscolors.vim"": {""insertions"": 166, ""deletions"": 0, ""lines"": 166}, ""runtime/colors/lists/default.vim"": {""insertions"": 801, ""deletions"": 0, ""lines"": 801}, ""runtime/doc/eval.txt"": {""insertions"": 37, ""deletions"": 0, ""lines"": 37}, ""runtime/doc/gui_w32.txt"": {""insertions"": 4, ""deletions"": 14, ""lines"": 18}, ""runtime/doc/message.txt"": {""insertions"": 5, ""deletions"": 0, ""lines"": 5}, ""runtime/doc/os_haiku.txt"": {""insertions"": 2, ""deletions"": 3, ""lines"": 5}, ""runtime/doc/syntax.txt"": {""insertions"": 28, ""deletions"": 1, ""lines"": 29}, ""runtime/doc/usr_06.txt"": {""insertions"": 24, ""deletions"": 1, ""lines"": 25}, ""src/Makefile"": {""insertions"": 1, ""deletions"": 10, ""lines"": 11}, ""src/errors.h"": {""insertions"": 6, ""deletions"": 0, ""lines"": 6}, ""src/evalvars.c"": {""insertions"": 3, ""deletions"": 0, ""lines"": 3}, ""src/globals.h"": {""insertions"": 0, ""deletions"": 3, ""lines"": 3}, ""src/gui.c"": {""insertions"": 1, ""deletions"": 1, ""lines"": 2}, ""src/gui_haiku.cc"": {""insertions"": 1, ""deletions"": 158, ""lines"": 159}, ""src/highlight.c"": {""insertions"": 232, ""deletions"": 1, ""lines"": 233}, ""src/job.c"": {""insertions"": 1, ""deletions"": 1, ""lines"": 2}, ""src/proto/highlight.pro"": {""insertions"": 6, ""deletions"": 0, ""lines"": 6}, ""src/proto/term.pro"": {""insertions"": 0, ""deletions"": 2, ""lines"": 2}, ""src/term.c"": {""insertions"": 1, ""deletions"": 198, ""lines"": 199}, ""src/testdir/test_highlight.vim"": {""insertions"": 36, ""deletions"": 0, ""lines"": 36}, ""src/version.c"": {""insertions"": 2, ""deletions"": 0, ""lines"": 2}, ""src/vim.h"": {""insertions"": 2, ""deletions"": 1, ""lines"": 3}}"
2021-10-24 13:50:07,3c5904d2a5d7861c227a4c3cd4ddcbc51014c838,James McCoy,7,39,46,2,"{""src/if_cscope.c"": {""insertions"": 5, ""deletions"": 39, ""lines"": 44}, ""src/version.c"": {""insertions"": 2, ""deletions"": 0, ""lines"": 2}}"
2021-10-23 12:32:30,844fb64a605d60131827503a001b2d1aa232b078,Bram Moolenaar,63,20,83,8,"{""src/eval.c"": {""insertions"": 16, ""deletions"": 7, ""lines"": 23}, ""src/globals.h"": {""insertions"": 2, ""deletions"": 2, ""lines"": 4}, ""src/proto/eval.pro"": {""insertions"": 1, ""deletions"": 0, ""lines"": 1}, ""src/structs.h"": {""insertions"": 5, ""deletions"": 2, ""lines"": 7}, ""src/testdir/test_vim9_func.vim"": {""insertions"": 20, ""deletions"": 0, ""lines"": 20}, ""src/userfunc.c"": {""insertions"": 8, ""deletions"": 3, ""lines"": 11}, ""src/version.c"": {""insertions"": 2, ""deletions"": 0, ""lines"": 2}, ""src/vim9compile.c"": {""insertions"": 9, ""deletions"": 6, ""lines"": 15}}"
2021-10-23 11:34:27,ee56f3f119c4378a5b62b4d504cff3373b363308,Bram Moolenaar,5,2,7,2,"{""src/ex_eval.c"": {""insertions"": 3, ""deletions"": 2, ""lines"": 5}, ""src/version.c"": {""insertions"": 2, ""deletions"": 0, ""lines"": 2}}"
2021-10-23 11:08:41,079ba76ae7a7d0ef404cb9b41dff2663ff41f51b,Bram Moolenaar,520,280,800,19,"{"".github/CODEOWNERS"": {""insertions"": 1, ""deletions"": 0, ""lines"": 1}, ""runtime/doc/eval.txt"": {""insertions"": 1, ""deletions"": 1, ""lines"": 2}, ""runtime/doc/insert.txt"": {""insertions"": 2, ""deletions"": 2, ""lines"": 4}, ""runtime/doc/map.txt"": {""insertions"": 4, ""deletions"": 1, ""lines"": 5}, ""runtime/doc/options.txt"": {""insertions"": 3, ""deletions"": 2, ""lines"": 5}, ""runtime/doc/quickref.txt"": {""insertions"": 2, ""deletions"": 1, ""lines"": 3}, ""runtime/doc/tags"": {""insertions"": 8, ""deletions"": 0, ""lines"": 8}, ""runtime/doc/todo.txt"": {""insertions"": 1, ""deletions"": 3, ""lines"": 4}, ""runtime/ftplugin/changelog.vim"": {""insertions"": 16, ""deletions"": 10, ""lines"": 26}, ""runtime/ftplugin/nsis.vim"": {""insertions"": 2, ""deletions"": 2, ""lines"": 4}, ""runtime/indent/dosbatch.vim"": {""insertions"": 3, ""deletions"": 1, ""lines"": 4}, ""runtime/indent/nsis.vim"": {""insertions"": 3, ""deletions"": 1, ""lines"": 4}, ""runtime/indent/teraterm.vim"": {""insertions"": 3, ""deletions"": 1, ""lines"": 4}, ""runtime/optwin.vim"": {""insertions"": 6, ""deletions"": 1, ""lines"": 7}, ""runtime/syntax/arduino.vim"": {""insertions"": 64, ""deletions"": 35, ""lines"": 99}, ""runtime/syntax/debchangelog.vim"": {""insertions"": 3, ""deletions"": 2, ""lines"": 5}, ""runtime/syntax/debsources.vim"": {""insertions"": 3, ""deletions"": 2, ""lines"": 5}, ""runtime/syntax/nsis.vim"": {""insertions"": 35, ""deletions"": 7, ""lines"": 42}, ""src/po/it.po"": {""insertions"": 360, ""deletions"": 208, ""lines"": 568}}"
2021-10-23 09:25:21,06ca48a40f049f20347c9630a180457d1f1aece5,Bram Moolenaar,3,1,4,2,"{""src/testdir/test_vim9_script.vim"": {""insertions"": 1, ""deletions"": 1, ""lines"": 2}, ""src/version.c"": {""insertions"": 2, ""deletions"": 0, ""lines"": 2}}"
2021-10-22 21:17:53,5fe07d2e08f05c6f3905fecdf07f4cfad4d6ed17,Bram Moolenaar,77,7,84,3,"{""src/testdir/test_vim9_script.vim"": {""insertions"": 27, ""deletions"": 0, ""lines"": 27}, ""src/userfunc.c"": {""insertions"": 48, ""deletions"": 7, ""lines"": 55}, ""src/version.c"": {""insertions"": 2, ""deletions"": 0, ""lines"": 2}}"
2021-10-22 19:56:55,841c225b9ef8c5bdf5e02968a0bd62521fff6ca8,Bram Moolenaar,41,6,47,4,"{""src/diff.c"": {""insertions"": 16, ""deletions"": 6, ""lines"": 22}, ""src/testdir/dumps/Test_diff_scroll_change_03.dump"": {""insertions"": 20, ""deletions"": 0, ""lines"": 20}, ""src/testdir/test_diffmode.vim"": {""insertions"": 3, ""deletions"": 0, ""lines"": 3}, ""src/version.c"": {""insertions"": 2, ""deletions"": 0, ""lines"": 2}}"
2021-10-22 17:56:39,25def2c8b8bd7b0c3d5f020207c717a880b05d50,=?UTF-8?q?Magnus=20Gro=C3=9F?=,82,22,104,8,"{""runtime/doc/autocmd.txt"": {""insertions"": 9, ""deletions"": 4, ""lines"": 13}, ""src/autocmd.c"": {""insertions"": 17, ""deletions"": 0, ""lines"": 17}, ""src/insexpand.c"": {""insertions"": 7, ""deletions"": 0, ""lines"": 7}, ""src/misc1.c"": {""insertions"": 8, ""deletions"": 3, ""lines"": 11}, ""src/normal.c"": {""insertions"": 6, ""deletions"": 1, ""lines"": 7}, ""src/terminal.c"": {""insertions"": 1, ""deletions"": 0, ""lines"": 1}, ""src/testdir/test_edit.vim"": {""insertions"": 32, ""deletions"": 14, ""lines"": 46}, ""src/version.c"": {""insertions"": 2, ""deletions"": 0, ""lines"": 2}}"
2021-10-22 14:55:31,a2ffb435209716dc7aeb4783333f6ea19f5d28a7,DungSaga,48,62,110,2,"{""src/version.c"": {""insertions"": 2, ""deletions"": 0, ""lines"": 2}, ""src/xxd/xxd.c"": {""insertions"": 46, ""deletions"": 62, ""lines"": 108}}"
2021-10-22 14:11:37,5a5c111e79d1ea4b24133eaf44deab42a8e78eed,Bram Moolenaar,16,7,23,2,"{""src/testdir/test_xxd.vim"": {""insertions"": 14, ""deletions"": 7, ""lines"": 21}, ""src/version.c"": {""insertions"": 2, ""deletions"": 0, ""lines"": 2}}"
2021-10-22 11:55:42,47810464aa4f9edbf222c02a860a3ec560b0b7a1,DungSaga,45,7,52,3,"{""src/testdir/test_xxd.vim"": {""insertions"": 33, ""deletions"": 0, ""lines"": 33}, ""src/version.c"": {""insertions"": 2, ""deletions"": 0, ""lines"": 2}, ""src/xxd/xxd.c"": {""insertions"": 10, ""deletions"": 7, ""lines"": 17}}"
2021-10-21 17:01:13,94e7d345c156a722bb161b73238c4ba1d27ec586,itchyny,3,1,4,2,"{""src/misc1.c"": {""insertions"": 1, ""deletions"": 1, ""lines"": 2}, ""src/version.c"": {""insertions"": 2, ""deletions"": 0, ""lines"": 2}}"
2021-10-21 10:39:53,ae38a9db7770b38889fbf06908cc69d42b463a73,Shougo Matsushita,19,1,20,3,"{""src/cmdexpand.c"": {""insertions"": 2, ""deletions"": 1, ""lines"": 3}, ""src/testdir/test_cmdline.vim"": {""insertions"": 15, ""deletions"": 0, ""lines"": 15}, ""src/version.c"": {""insertions"": 2, ""deletions"": 0, ""lines"": 2}}"
2021-10-21 09:50:44,b811de5d49a23b20df82a80533d0602cda49029e,zeertzjq,20,18,38,2,"{""src/testdir/test_autocmd.vim"": {""insertions"": 18, ""deletions"": 18, ""lines"": 36}, ""src/version.c"": {""insertions"": 2, ""deletions"": 0, ""lines"": 2}}"
2021-10-20 22:08:11,d68a0044858d00de6100def1e389a3a9c1cdbcdc,Bram Moolenaar,32,4,36,3,"{""src/gui_gtk_x11.c"": {""insertions"": 8, ""deletions"": 4, ""lines"": 12}, ""src/testdir/test_gui.vim"": {""insertions"": 22, ""deletions"": 0, ""lines"": 22}, ""src/version.c"": {""insertions"": 2, ""deletions"": 0, ""lines"": 2}}"
2021-10-20 20:58:42,1d30fde3c989a962e0e1af4cbcf90e1ea483f1f4,Bram Moolenaar,36,9,45,6,"{""src/buffer.c"": {""insertions"": 4, ""deletions"": 3, ""lines"": 7}, ""src/ex_cmds.c"": {""insertions"": 8, ""deletions"": 4, ""lines"": 12}, ""src/quickfix.c"": {""insertions"": 3, ""deletions"": 2, ""lines"": 5}, ""src/testdir/test_quickfix.vim"": {""insertions"": 17, ""deletions"": 0, ""lines"": 17}, ""src/version.c"": {""insertions"": 2, ""deletions"": 0, ""lines"": 2}, ""src/vim.h"": {""insertions"": 2, ""deletions"": 0, ""lines"": 2}}"
2021-10-20 16:21:24,09f7723d5a8694889350b13e3f6b4a9c3ed4c41f,zeertzjq,4,0,4,2,"{""src/errors.h"": {""insertions"": 2, ""deletions"": 0, ""lines"": 2}, ""src/version.c"": {""insertions"": 2, ""deletions"": 0, ""lines"": 2}}"
2021-10-20 10:01:15,94358a1e6e640ca5ebeb295efdddd4e92b700673,zeertzjq,56,3,59,6,"{""runtime/doc/eval.txt"": {""insertions"": 3, ""deletions"": 0, ""lines"": 3}, ""src/errors.h"": {""insertions"": 4, ""deletions"": 0, ""lines"": 4}, ""src/mbyte.c"": {""insertions"": 35, ""deletions"": 1, ""lines"": 36}, ""src/optionstr.c"": {""insertions"": 2, ""deletions"": 2, ""lines"": 4}, ""src/testdir/test_utf8.vim"": {""insertions"": 10, ""deletions"": 0, ""lines"": 10}, ""src/version.c"": {""insertions"": 2, ""deletions"": 0, ""lines"": 2}}"
2021-10-20 09:00:05,051a40c8d91d4595c69a27375f739367d806a475,itchyny,6,1,7,2,"{""src/os_unix.c"": {""insertions"": 4, ""deletions"": 1, ""lines"": 5}, ""src/version.c"": {""insertions"": 2, ""deletions"": 0, ""lines"": 2}}"
2021-10-19 21:12:25,8b0e62c93b6dad5ec5b2c7558d4f7b78c46216d2,Bram Moolenaar,8,2,10,3,"{""src/memline.c"": {""insertions"": 5, ""deletions"": 1, ""lines"": 6}, ""src/testdir/test_swap.vim"": {""insertions"": 1, ""deletions"": 1, ""lines"": 2}, ""src/version.c"": {""insertions"": 2, ""deletions"": 0, ""lines"": 2}}"
2021-10-19 19:48:52,c5935a859ee31d56a565878d7a231fc59b7ddc01,Bram Moolenaar,63,102,165,2,"{""src/buffer.c"": {""insertions"": 61, ""deletions"": 102, ""lines"": 163}, ""src/version.c"": {""insertions"": 2, ""deletions"": 0, ""lines"": 2}}"
2021-10-19 19:24:34,731fba1081079d5c0251fca2626043ce6e86b1f2,Bram Moolenaar,6,0,6,2,"{""src/highlight.c"": {""insertions"": 4, ""deletions"": 0, ""lines"": 4}, ""src/version.c"": {""insertions"": 2, ""deletions"": 0, ""lines"": 2}}"
2021-10-19 19:08:45,f47ebf1e1a0a6473b10fb4c92c9c6427aab4dc91,Bram Moolenaar,15,1,16,3,"{""src/register.c"": {""insertions"": 1, ""deletions"": 1, ""lines"": 2}, ""src/testdir/test_put.vim"": {""insertions"": 12, ""deletions"": 0, ""lines"": 12}, ""src/version.c"": {""insertions"": 2, ""deletions"": 0, ""lines"": 2}}"
2021-10-19 13:22:03,604e207e277767a67cbf4a6a179080efb830b9e7,Bram Moolenaar,7,0,7,2,"{""src/gui_gtk.c"": {""insertions"": 5, ""deletions"": 0, ""lines"": 5}, ""src/version.c"": {""insertions"": 2, ""deletions"": 0, ""lines"": 2}}"
2021-10-19 12:44:52,d43d8e28db9afe693002a39e003ba1ece1a8319a,Yegappan Lakshmanan,8,4,12,2,"{""src/highlight.c"": {""insertions"": 6, ""deletions"": 4, ""lines"": 10}, ""src/version.c"": {""insertions"": 2, ""deletions"": 0, ""lines"": 2}}"
2021-10-19 10:15:41,75c30e96cf280a8cc01ac01c41a9252db3e503cc,naohiro ono,23,0,23,3,"{""src/ops.c"": {""insertions"": 5, ""deletions"": 0, ""lines"": 5}, ""src/testdir/test_functions.vim"": {""insertions"": 16, ""deletions"": 0, ""lines"": 16}, ""src/version.c"": {""insertions"": 2, ""deletions"": 0, ""lines"": 2}}"
2021-10-18 21:13:57,ad6b90c33cc239794a6694ef53e8baeee2ed97bd,Yegappan Lakshmanan,932,787,1719,2,"{""src/highlight.c"": {""insertions"": 930, ""deletions"": 787, ""lines"": 1717}, ""src/version.c"": {""insertions"": 2, ""deletions"": 0, ""lines"": 2}}"
2021-10-18 19:56:39,9b0b844d252ea84b3607f39603b4afa8cb002418,Dominique Pelle,7,3,10,2,"{""src/drawscreen.c"": {""insertions"": 5, ""deletions"": 3, ""lines"": 8}, ""src/version.c"": {""insertions"": 2, ""deletions"": 0, ""lines"": 2}}"
2021-10-18 13:37:13,944eeb44fb6e9d6d28474a1348d27c07873892f9,Bram Moolenaar,4,1,5,2,"{""src/testdir/test_stat.vim"": {""insertions"": 2, ""deletions"": 1, ""lines"": 3}, ""src/version.c"": {""insertions"": 2, ""deletions"": 0, ""lines"": 2}}"
2021-10-18 12:16:03,375c35a63fdb91e8db2a9965f94d56ae87135fff,DungSaga,8,11,19,2,"{""src/version.c"": {""insertions"": 2, ""deletions"": 0, ""lines"": 2}, ""src/xxd/xxd.c"": {""insertions"": 6, ""deletions"": 11, ""lines"": 17}}"
2021-10-17 20:53:58,e08aee60abc59f517d3e263fdb9ba4a0196d507c,Bram Moolenaar,13,3,16,3,"{""src/mark.c"": {""insertions"": 1, ""deletions"": 3, ""lines"": 4}, ""src/testdir/test_marks.vim"": {""insertions"": 10, ""deletions"": 0, ""lines"": 10}, ""src/version.c"": {""insertions"": 2, ""deletions"": 0, ""lines"": 2}}"
2021-10-17 17:05:26,39c47c310487b72bc78ff197b5a068a0bcf830de,Bram Moolenaar,9,4,13,2,"{""src/testdir/test_cmdline.vim"": {""insertions"": 7, ""deletions"": 4, ""lines"": 11}, ""src/version.c"": {""insertions"": 2, ""deletions"": 0, ""lines"": 2}}"
2021-10-17 16:20:23,21c1a0c2f10575dbb72fa873d33f0c1f6e170aa7,Bram Moolenaar,38,15,53,11,"{""src/cmdexpand.c"": {""insertions"": 5, ""deletions"": 2, ""lines"": 7}, ""src/evalfunc.c"": {""insertions"": 1, ""deletions"": 1, ""lines"": 2}, ""src/ex_getln.c"": {""insertions"": 12, ""deletions"": 7, ""lines"": 19}, ""src/normal.c"": {""insertions"": 1, ""deletions"": 1, ""lines"": 2}, ""src/proto/ex_getln.pro"": {""insertions"": 1, ""deletions"": 1, ""lines"": 2}, ""src/session.c"": {""insertions"": 1, ""deletions"": 1, ""lines"": 2}, ""src/terminal.c"": {""insertions"": 1, ""deletions"": 1, ""lines"": 2}, ""src/testdir/test_cmdline.vim"": {""insertions"": 6, ""deletions"": 0, ""lines"": 6}, ""src/version.c"": {""insertions"": 2, ""deletions"": 0, ""lines"": 2}, ""src/vim.h"": {""insertions"": 6, ""deletions"": 0, ""lines"": 6}, ""src/vim9execute.c"": {""insertions"": 2, ""deletions"": 1, ""lines"": 3}}"
2021-10-17 15:09:08,34a364877f0c726cdc0779e6999fded9ba959ebe,Atsushi SUGAWARA,3,1,4,2,"{""src/version.c"": {""insertions"": 2, ""deletions"": 0, ""lines"": 2}, ""src/xxd/xxd.c"": {""insertions"": 1, ""deletions"": 1, ""lines"": 2}}"
2021-10-17 13:13:09,f4d8b76d304dabc39c06d2344cd4c7b28484811b,Bram Moolenaar,109,51,160,9,"{""runtime/doc/insert.txt"": {""insertions"": 58, ""deletions"": 16, ""lines"": 74}, ""runtime/doc/options.txt"": {""insertions"": 12, ""deletions"": 19, ""lines"": 31}, ""src/insexpand.c"": {""insertions"": 4, ""deletions"": 5, ""lines"": 9}, ""src/option.c"": {""insertions"": 15, ""deletions"": 3, ""lines"": 18}, ""src/option.h"": {""insertions"": 2, ""deletions"": 2, ""lines"": 4}, ""src/optiondefs.h"": {""insertions"": 2, ""deletions"": 2, ""lines"": 4}, ""src/structs.h"": {""insertions"": 3, ""deletions"": 1, ""lines"": 4}, ""src/testdir/test_edit.vim"": {""insertions"": 11, ""deletions"": 3, ""lines"": 14}, ""src/version.c"": {""insertions"": 2, ""deletions"": 0, ""lines"": 2}}"
2021-10-17 10:33:47,9d4b8caf9eddb2db09395587c621309f4513befa,Bram Moolenaar,4,1,5,2,"{""src/gui_gtk_x11.c"": {""insertions"": 2, ""deletions"": 1, ""lines"": 3}, ""src/version.c"": {""insertions"": 2, ""deletions"": 0, ""lines"": 2}}"
2021-10-16 20:58:27,40bd5a15405206b130d487af0ca61b5d9b5859f8,Bram Moolenaar,99,150,249,5,"{""src/testdir/check.vim"": {""insertions"": 8, ""deletions"": 0, ""lines"": 8}, ""src/testdir/setup_gui.vim"": {""insertions"": 0, ""deletions"": 1, ""lines"": 1}, ""src/testdir/test_gui.vim"": {""insertions"": 79, ""deletions"": 123, ""lines"": 202}, ""src/testdir/test_gui_init.vim"": {""insertions"": 10, ""deletions"": 26, ""lines"": 36}, ""src/version.c"": {""insertions"": 2, ""deletions"": 0, ""lines"": 2}}"
2021-10-16 20:14:11,d4c4bfa0078a959ff90ef30288fd31d9d38f23d7,Bram Moolenaar,11,9,20,6,"{""src/buffer.c"": {""insertions"": 1, ""deletions"": 1, ""lines"": 2}, ""src/insexpand.c"": {""insertions"": 4, ""deletions"": 4, ""lines"": 8}, ""src/option.c"": {""insertions"": 2, ""deletions"": 2, ""lines"": 4}, ""src/optionstr.c"": {""insertions"": 1, ""deletions"": 1, ""lines"": 2}, ""src/structs.h"": {""insertions"": 1, ""deletions"": 1, ""lines"": 2}, ""src/version.c"": {""insertions"": 2, ""deletions"": 0, ""lines"": 2}}"
2021-10-16 19:52:05,4eeedc09fed0cbbb3ba48317e0a01e20cd0b4f80,Dusan Popovic,239,14,253,12,"{""runtime/doc/options.txt"": {""insertions"": 12, ""deletions"": 0, ""lines"": 12}, ""src/errors.h"": {""insertions"": 2, ""deletions"": 0, ""lines"": 2}, ""src/gui.c"": {""insertions"": 34, ""deletions"": 0, ""lines"": 34}, ""src/gui.h"": {""insertions"": 3, ""deletions"": 0, ""lines"": 3}, ""src/gui_gtk_x11.c"": {""insertions"": 136, ""deletions"": 14, ""lines"": 150}, ""src/option.h"": {""insertions"": 3, ""deletions"": 0, ""lines"": 3}, ""src/optiondefs.h"": {""insertions"": 13, ""deletions"": 0, ""lines"": 13}, ""src/optionstr.c"": {""insertions"": 7, ""deletions"": 0, ""lines"": 7}, ""src/proto/gui.pro"": {""insertions"": 1, ""deletions"": 0, ""lines"": 1}, ""src/proto/gui_gtk_x11.pro"": {""insertions"": 1, ""deletions"": 0, ""lines"": 1}, ""src/testdir/test_gui.vim"": {""insertions"": 25, ""deletions"": 0, ""lines"": 25}, ""src/version.c"": {""insertions"": 2, ""deletions"": 0, ""lines"": 2}}"
2021-10-16 18:07:46,c89c91cafd91fbf17f431d800bbf4cafcffffe7a,DungSaga,6,8,14,2,"{""src/version.c"": {""insertions"": 2, ""deletions"": 0, ""lines"": 2}, ""src/xxd/xxd.c"": {""insertions"": 4, ""deletions"": 8, ""lines"": 12}}"
2021-10-16 16:51:40,93ff6720fe4427341bc426b6d46e6324f226c270,Bram Moolenaar,47,8,55,5,"{""runtime/doc/options.txt"": {""insertions"": 7, ""deletions"": 0, ""lines"": 7}, ""src/charset.c"": {""insertions"": 0, ""deletions"": 3, ""lines"": 3}, ""src/screen.c"": {""insertions"": 34, ""deletions"": 5, ""lines"": 39}, ""src/testdir/test_listchars.vim"": {""insertions"": 4, ""deletions"": 0, ""lines"": 4}, ""src/version.c"": {""insertions"": 2, ""deletions"": 0, ""lines"": 2}}"
2021-10-16 15:48:27,abdcfd1c837e244065d4fe04c7a78abae5af3f7e,Bram Moolenaar,3,1,4,2,"{""src/testdir/test_options.vim"": {""insertions"": 1, ""deletions"": 1, ""lines"": 2}, ""src/version.c"": {""insertions"": 2, ""deletions"": 0, ""lines"": 2}}"
2021-10-16 14:41:29,160e994d768d03a3c826b58115cde94df8fce607,Yegappan Lakshmanan,138,8,146,12,"{""runtime/doc/insert.txt"": {""insertions"": 7, ""deletions"": 1, ""lines"": 8}, ""runtime/doc/options.txt"": {""insertions"": 12, ""deletions"": 0, ""lines"": 12}, ""runtime/doc/quickref.txt"": {""insertions"": 1, ""deletions"": 0, ""lines"": 1}, ""src/buffer.c"": {""insertions"": 1, ""deletions"": 0, ""lines"": 1}, ""src/insexpand.c"": {""insertions"": 52, ""deletions"": 7, ""lines"": 59}, ""src/option.c"": {""insertions"": 3, ""deletions"": 0, ""lines"": 3}, ""src/option.h"": {""insertions"": 4, ""deletions"": 0, ""lines"": 4}, ""src/optiondefs.h"": {""insertions"": 12, ""deletions"": 0, ""lines"": 12}, ""src/optionstr.c"": {""insertions"": 1, ""deletions"": 0, ""lines"": 1}, ""src/structs.h"": {""insertions"": 1, ""deletions"": 0, ""lines"": 1}, ""src/testdir/test_edit.vim"": {""insertions"": 42, ""deletions"": 0, ""lines"": 42}, ""src/version.c"": {""insertions"": 2, ""deletions"": 0, ""lines"": 2}}"
2021-10-16 14:23:36,2286304cdbba53ceb52b3ba2ba4a521b0a2f8d0f,Bram Moolenaar,413,240,653,26,"{"".github/CODEOWNERS"": {""insertions"": 6, ""deletions"": 0, ""lines"": 6}, ""runtime/doc/autocmd.txt"": {""insertions"": 5, ""deletions"": 5, ""lines"": 10}, ""runtime/doc/change.txt"": {""insertions"": 3, ""deletions"": 3, ""lines"": 6}, ""runtime/doc/cmdline.txt"": {""insertions"": 1, ""deletions"": 1, ""lines"": 2}, ""runtime/doc/digraph.txt"": {""insertions"": 2, ""deletions"": 2, ""lines"": 4}, ""runtime/doc/editing.txt"": {""insertions"": 14, ""deletions"": 9, ""lines"": 23}, ""runtime/doc/eval.txt"": {""insertions"": 2, ""deletions"": 2, ""lines"": 4}, ""runtime/doc/help.txt"": {""insertions"": 1, ""deletions"": 0, ""lines"": 1}, ""runtime/doc/options.txt"": {""insertions"": 3, ""deletions"": 3, ""lines"": 6}, ""runtime/doc/pattern.txt"": {""insertions"": 8, ""deletions"": 9, ""lines"": 17}, ""runtime/doc/testing.txt"": {""insertions"": 4, ""deletions"": 4, ""lines"": 8}, ""runtime/doc/todo.txt"": {""insertions"": 26, ""deletions"": 22, ""lines"": 48}, ""runtime/doc/various.txt"": {""insertions"": 1, ""deletions"": 1, ""lines"": 2}, ""runtime/doc/vim9.txt"": {""insertions"": 10, ""deletions"": 10, ""lines"": 20}, ""runtime/ftplugin/context.vim"": {""insertions"": 41, ""deletions"": 26, ""lines"": 67}, ""runtime/ftplugin/csh.vim"": {""insertions"": 26, ""deletions"": 23, ""lines"": 49}, ""runtime/ftplugin/tcsh.vim"": {""insertions"": 8, ""deletions"": 13, ""lines"": 21}, ""runtime/ftplugin/tmux.vim"": {""insertions"": 3, ""deletions"": 0, ""lines"": 3}, ""runtime/ftplugin/toml.vim"": {""insertions"": 23, ""deletions"": 0, ""lines"": 23}, ""runtime/indent/hamster.vim"": {""insertions"": 18, ""deletions"": 3, ""lines"": 21}, ""runtime/indent/sqlanywhere.vim"": {""insertions"": 11, ""deletions"": 11, ""lines"": 22}, ""runtime/indent/tcsh.vim"": {""insertions"": 8, ""deletions"": 5, ""lines"": 13}, ""runtime/syntax/css.vim"": {""insertions"": 17, ""deletions"": 10, ""lines"": 27}, ""runtime/syntax/tcsh.vim"": {""insertions"": 36, ""deletions"": 30, ""lines"": 66}, ""runtime/syntax/tmux.vim"": {""insertions"": 55, ""deletions"": 48, ""lines"": 103}, ""runtime/syntax/toml.vim"": {""insertions"": 81, ""deletions"": 0, ""lines"": 81}}"
2021-10-16 12:44:04,28b6a3bef6d25d36c049bb731ced496155f7f9c0,Aman Verma,7,3,10,3,"{""runtime/filetype.vim"": {""insertions"": 3, ""deletions"": 1, ""lines"": 4}, ""src/testdir/test_filetype.vim"": {""insertions"": 2, ""deletions"": 2, ""lines"": 4}, ""src/version.c"": {""insertions"": 2, ""deletions"": 0, ""lines"": 2}}"
2021-10-16 12:00:14,f08b0eb8691ff09f98bc4beef986ece1c521655f,Bram Moolenaar,38,39,77,16,"{""src/testdir/runtest.vim"": {""insertions"": 1, ""deletions"": 38, ""lines"": 39}, ""src/testdir/test_autocmd.vim"": {""insertions"": 3, ""deletions"": 0, ""lines"": 3}, ""src/testdir/test_channel.vim"": {""insertions"": 7, ""deletions"": 0, ""lines"": 7}, ""src/testdir/test_clientserver.vim"": {""insertions"": 1, ""deletions"": 0, ""lines"": 1}, ""src/testdir/test_diffmode.vim"": {""insertions"": 1, ""deletions"": 0, ""lines"": 1}, ""src/testdir/test_functions.vim"": {""insertions"": 1, ""deletions"": 0, ""lines"": 1}, ""src/testdir/test_gui.vim"": {""insertions"": 1, ""deletions"": 0, ""lines"": 1}, ""src/testdir/test_mapping.vim"": {""insertions"": 2, ""deletions"": 1, ""lines"": 3}, ""src/testdir/test_paste.vim"": {""insertions"": 2, ""deletions"": 0, ""lines"": 2}, ""src/testdir/test_popup.vim"": {""insertions"": 1, ""deletions"": 0, ""lines"": 1}, ""src/testdir/test_quotestar.vim"": {""insertions"": 1, ""deletions"": 0, ""lines"": 1}, ""src/testdir/test_reltime.vim"": {""insertions"": 1, ""deletions"": 0, ""lines"": 1}, ""src/testdir/test_terminal.vim"": {""insertions"": 4, ""deletions"": 0, ""lines"": 4}, ""src/testdir/test_terminal2.vim"": {""insertions"": 2, ""deletions"": 0, ""lines"": 2}, ""src/testdir/test_timers.vim"": {""insertions"": 8, ""deletions"": 0, ""lines"": 8}, ""src/version.c"": {""insertions"": 2, ""deletions"": 0, ""lines"": 2}}"
2021-10-16 10:58:55,db3b44640d69ab27270691a3cab8d83cc93a0861,Christian Brabandt,52,11,63,6,"{""src/buffer.c"": {""insertions"": 1, ""deletions"": 0, ""lines"": 1}, ""src/bufwrite.c"": {""insertions"": 2, ""deletions"": 2, ""lines"": 4}, ""src/edit.c"": {""insertions"": 6, ""deletions"": 6, ""lines"": 12}, ""src/structs.h"": {""insertions"": 3, ""deletions"": 3, ""lines"": 6}, ""src/testdir/test_autocmd.vim"": {""insertions"": 38, ""deletions"": 0, ""lines"": 38}, ""src/version.c"": {""insertions"": 2, ""deletions"": 0, ""lines"": 2}}"
2021-10-15 21:25:43,7b5f45be2197403d631b5a3d633f6a20afdf806e,Milly,44,100,144,5,"{""runtime/doc/terminal.txt"": {""insertions"": 0, ""deletions"": 3, ""lines"": 3}, ""src/highlight.c"": {""insertions"": 0, ""deletions"": 12, ""lines"": 12}, ""src/proto/terminal.pro"": {""insertions"": 0, ""deletions"": 1, ""lines"": 1}, ""src/terminal.c"": {""insertions"": 42, ""deletions"": 84, ""lines"": 126}, ""src/version.c"": {""insertions"": 2, ""deletions"": 0, ""lines"": 2}}"
2021-10-15 16:23:12,def69dffb3d09a69629b071c89b7893a1783ba53,ichizok,12,9,21,2,"{""src/fileio.c"": {""insertions"": 10, ""deletions"": 9, ""lines"": 19}, ""src/version.c"": {""insertions"": 2, ""deletions"": 0, ""lines"": 2}}"
2021-10-15 16:09:50,eaa006dae3d5730e3b6dead27905444998b2cf8e,Bram Moolenaar,7,3,10,2,"{""src/testdir/test_stat.vim"": {""insertions"": 5, ""deletions"": 3, ""lines"": 8}, ""src/version.c"": {""insertions"": 2, ""deletions"": 0, ""lines"": 2}}"
2021-10-15 11:51:29,a2cff1dbc9c58758977eba3034603e6fe459031b,Bram Moolenaar,15,32,47,2,"{""src/search.c"": {""insertions"": 13, ""deletions"": 32, ""lines"": 45}, ""src/version.c"": {""insertions"": 2, ""deletions"": 0, ""lines"": 2}}"
2021-10-14 23:38:02,accf4ed352c07ffe59022377c42d36e12dd6d461,Bram Moolenaar,3,0,3,2,"{""src/testdir/test_stat.vim"": {""insertions"": 1, ""deletions"": 0, ""lines"": 1}, ""src/version.c"": {""insertions"": 2, ""deletions"": 0, ""lines"": 2}}"
2021-10-14 23:18:37,a06758dd38851f022d270dd5102efbe1049d4712,Bram Moolenaar,8,4,12,3,"{""src/evalvars.c"": {""insertions"": 3, ""deletions"": 2, ""lines"": 5}, ""src/version.c"": {""insertions"": 2, ""deletions"": 0, ""lines"": 2}, ""src/vim9script.c"": {""insertions"": 3, ""deletions"": 2, ""lines"": 5}}"
2021-10-14 20:27:55,0a7984af5601323fae7b3398f05a48087db7b767,Leah Neukirchen,151,6,157,13,"{""runtime/doc/eval.txt"": {""insertions"": 1, ""deletions"": 0, ""lines"": 1}, ""src/auto/configure"": {""insertions"": 46, ""deletions"": 0, ""lines"": 46}, ""src/bufwrite.c"": {""insertions"": 2, ""deletions"": 1, ""lines"": 3}, ""src/config.h.in"": {""insertions"": 3, ""deletions"": 0, ""lines"": 3}, ""src/configure.ac"": {""insertions"": 25, ""deletions"": 0, ""lines"": 25}, ""src/evalfunc.c"": {""insertions"": 7, ""deletions"": 0, ""lines"": 7}, ""src/fileio.c"": {""insertions"": 20, ""deletions"": 4, ""lines"": 24}, ""src/memline.c"": {""insertions"": 6, ""deletions"": 0, ""lines"": 6}, ""src/netbeans.c"": {""insertions"": 3, ""deletions"": 0, ""lines"": 3}, ""src/proto/fileio.pro"": {""insertions"": 1, ""deletions"": 1, ""lines"": 2}, ""src/structs.h"": {""insertions"": 2, ""deletions"": 0, ""lines"": 2}, ""src/testdir/test_stat.vim"": {""insertions"": 33, ""deletions"": 0, ""lines"": 33}, ""src/version.c"": {""insertions"": 2, ""deletions"": 0, ""lines"": 2}}"
2021-10-14 16:52:23,340dd0fbe462a15a9678cfba02085b4adcc45f02,Bram Moolenaar,9,2,11,3,"{""runtime/doc/options.txt"": {""insertions"": 2, ""deletions"": 2, ""lines"": 4}, ""src/undo.c"": {""insertions"": 5, ""deletions"": 0, ""lines"": 5}, ""src/version.c"": {""insertions"": 2, ""deletions"": 0, ""lines"": 2}}"
2021-10-14 15:53:42,051a8a375f8fb6a931fbc5ccca714a200d9b327f,Bram Moolenaar,10,0,10,2,"{""src/testdir/test_vim9_cmd.vim"": {""insertions"": 8, ""deletions"": 0, ""lines"": 8}, ""src/version.c"": {""insertions"": 2, ""deletions"": 0, ""lines"": 2}}"
2021-10-14 15:27:19,75aa92a16264e3511ba41aa306ffc1ffbbd2fe3a,Bram Moolenaar,10,8,18,2,"{""src/Makefile"": {""insertions"": 8, ""deletions"": 8, ""lines"": 16}, ""src/version.c"": {""insertions"": 2, ""deletions"": 0, ""lines"": 2}}"
2021-10-13 20:17:05,c0abac67d7a9cccf836bbda002ec72914e3cb3d7,Bram Moolenaar,26,0,26,2,"{""src/testdir/test_vim9_cmd.vim"": {""insertions"": 24, ""deletions"": 0, ""lines"": 24}, ""src/version.c"": {""insertions"": 2, ""deletions"": 0, ""lines"": 2}}"
2021-10-13 14:37:15,3be69bf539f3026369d20f1667e53d390d386a9f,Bram Moolenaar,6,0,6,2,"{""src/ex_cmds.c"": {""insertions"": 4, ""deletions"": 0, ""lines"": 4}, ""src/version.c"": {""insertions"": 2, ""deletions"": 0, ""lines"": 2}}"
2021-10-13 14:28:28,7f32092b9127a71d243bacd31ebb303f2c78a8f1,Bram Moolenaar,3,1,4,2,"{""src/version.c"": {""insertions"": 2, ""deletions"": 0, ""lines"": 2}, ""src/vim9compile.c"": {""insertions"": 1, ""deletions"": 1, ""lines"": 2}}"
2021-10-13 14:04:34,7b829268921e8fc1c63c34d245063c1c4e7d21af,Bram Moolenaar,111,1,112,8,"{""runtime/doc/vim9.txt"": {""insertions"": 14, ""deletions"": 1, ""lines"": 15}, ""src/errors.h"": {""insertions"": 4, ""deletions"": 0, ""lines"": 4}, ""src/ex_cmds.c"": {""insertions"": 6, ""deletions"": 0, ""lines"": 6}, ""src/ex_docmd.c"": {""insertions"": 9, ""deletions"": 0, ""lines"": 9}, ""src/proto/vim9compile.pro"": {""insertions"": 1, ""deletions"": 0, ""lines"": 1}, ""src/testdir/test_vim9_cmd.vim"": {""insertions"": 49, ""deletions"": 0, ""lines"": 49}, ""src/version.c"": {""insertions"": 2, ""deletions"": 0, ""lines"": 2}, ""src/vim9compile.c"": {""insertions"": 26, ""deletions"": 0, ""lines"": 26}}"
2021-10-13 09:05:30,fff10d9a76099aa9b944f3c33a911127ca1a0c72,Bram Moolenaar,7,0,7,2,"{""src/os_unix.c"": {""insertions"": 5, ""deletions"": 0, ""lines"": 5}, ""src/version.c"": {""insertions"": 2, ""deletions"": 0, ""lines"": 2}}"
2021-10-12 12:58:23,e519eb41c1c12836b2d12aeb703bb04c7618a724,Eric Pruitt,6,1,7,3,"{""runtime/filetype.vim"": {""insertions"": 3, ""deletions"": 0, ""lines"": 3}, ""src/testdir/test_filetype.vim"": {""insertions"": 1, ""deletions"": 1, ""lines"": 2}, ""src/version.c"": {""insertions"": 2, ""deletions"": 0, ""lines"": 2}}"
2021-10-12 11:02:49,3a724290c5dd8e4b7c9a1fa8941b81f6f80db00a,Christian Brabandt,3,1,4,2,"{"".github/workflows/ci.yml"": {""insertions"": 1, ""deletions"": 1, ""lines"": 2}, ""src/version.c"": {""insertions"": 2, ""deletions"": 0, ""lines"": 2}}"
2021-10-11 21:57:34,3d031a0ae791f901c0c2dedd5d8b9de137c23acc,Bram Moolenaar,7,5,12,2,"{""src/testdir/test_startup.vim"": {""insertions"": 5, ""deletions"": 5, ""lines"": 10}, ""src/version.c"": {""insertions"": 2, ""deletions"": 0, ""lines"": 2}}"
2021-10-11 20:04:37,37f341d7236ff8a1e886bbb0f0ba0700ad589373,James McCoy,7,3,10,2,"{""src/testdir/test_recover.vim"": {""insertions"": 5, ""deletions"": 3, ""lines"": 8}, ""src/version.c"": {""insertions"": 2, ""deletions"": 0, ""lines"": 2}}"
2021-10-11 19:26:55,a9173d06f7ca320fc84f4ffa993861d21710bc41,Dominique Pelle,4,0,4,2,"{""src/testdir/test_put.vim"": {""insertions"": 2, ""deletions"": 0, ""lines"": 2}, ""src/version.c"": {""insertions"": 2, ""deletions"": 0, ""lines"": 2}}"
2021-10-11 15:27:03,a5d4f3b09d25006f7bc988d618152bd34177a579,James McCoy,13,1,14,2,"{""src/testdir/test_crypt.vim"": {""insertions"": 11, ""deletions"": 1, ""lines"": 12}, ""src/version.c"": {""insertions"": 2, ""deletions"": 0, ""lines"": 2}}"
2021-10-11 15:08:32,b376aa2da4211fee7eaf16450bb8b37674e45bb0,Bram Moolenaar,10,1,11,2,"{""src/testdir/test_startup.vim"": {""insertions"": 8, ""deletions"": 1, ""lines"": 9}, ""src/version.c"": {""insertions"": 2, ""deletions"": 0, ""lines"": 2}}"
2021-10-11 14:40:43,b07626d4afa73dd2af0f03c0d59eed25ee159ef9,Bram Moolenaar,23,2,25,3,"{""src/normal.c"": {""insertions"": 1, ""deletions"": 2, ""lines"": 3}, ""src/testdir/test_visual.vim"": {""insertions"": 20, ""deletions"": 0, ""lines"": 20}, ""src/version.c"": {""insertions"": 2, ""deletions"": 0, ""lines"": 2}}"
2021-10-10 12:54:01,cddd5ac911707034ca27f10037c4b1b523188c47,Bram Moolenaar,6,1,7,2,"{""src/testdir/test_put.vim"": {""insertions"": 4, ""deletions"": 1, ""lines"": 5}, ""src/version.c"": {""insertions"": 2, ""deletions"": 0, ""lines"": 2}}"
2021-10-10 11:35:17,eeed1c7ae090c17f4df51cf97b2a9e4d8b4f4dc7,Bram Moolenaar,21,2,23,4,"{""src/errors.h"": {""insertions"": 2, ""deletions"": 0, ""lines"": 2}, ""src/register.c"": {""insertions"": 9, ""deletions"": 2, ""lines"": 11}, ""src/testdir/test_put.vim"": {""insertions"": 8, ""deletions"": 0, ""lines"": 8}, ""src/version.c"": {""insertions"": 2, ""deletions"": 0, ""lines"": 2}}"
2021-10-09 15:29:43,6e77b88df6371356cce9d6e08daf0f7cb1e7878a,Bram Moolenaar,16,1,17,2,"{""src/testdir/test_filetype.vim"": {""insertions"": 14, ""deletions"": 1, ""lines"": 15}, ""src/version.c"": {""insertions"": 2, ""deletions"": 0, ""lines"": 2}}"
2021-10-09 14:39:25,3826c0513bc9370583be550c864358c7eeb5605a,=?UTF-8?q?Dundar=20G=C3=B6c?=,2,8,10,6,"{""src/buffer.c"": {""insertions"": 0, ""deletions"": 2, ""lines"": 2}, ""src/getchar.c"": {""insertions"": 0, ""deletions"": 1, ""lines"": 1}, ""src/memline.c"": {""insertions"": 0, ""deletions"": 2, ""lines"": 2}, ""src/move.c"": {""insertions"": 0, ""deletions"": 1, ""lines"": 1}, ""src/option.c"": {""insertions"": 0, ""deletions"": 2, ""lines"": 2}, ""src/version.c"": {""insertions"": 2, ""deletions"": 0, ""lines"": 2}}"
2021-10-09 12:58:55,35a319b77f897744eec1155b736e9372c9c5575f,Bram Moolenaar,20,2,22,3,"{""src/ex_docmd.c"": {""insertions"": 4, ""deletions"": 2, ""lines"": 6}, ""src/testdir/test_search.vim"": {""insertions"": 14, ""deletions"": 0, ""lines"": 14}, ""src/version.c"": {""insertions"": 2, ""deletions"": 0, ""lines"": 2}}"
2021-10-09 11:50:20,26190b27011c25caedf3b9308e47005722b3f946,snxx,49,34,83,3,"{"".github/ISSUE_TEMPLATE/bug_report.md"": {""insertions"": 0, ""deletions"": 34, ""lines"": 34}, "".github/ISSUE_TEMPLATE/bug_report.yml"": {""insertions"": 47, ""deletions"": 0, ""lines"": 47}, ""src/version.c"": {""insertions"": 2, ""deletions"": 0, ""lines"": 2}}"
2021-10-08 17:39:28,826bfe4bbd7594188e3d74d2539d9707b1c6a14b,Bram Moolenaar,17,5,22,3,"{""src/drawscreen.c"": {""insertions"": 5, ""deletions"": 5, ""lines"": 10}, ""src/testdir/test_statusline.vim"": {""insertions"": 10, ""deletions"": 0, ""lines"": 10}, ""src/version.c"": {""insertions"": 2, ""deletions"": 0, ""lines"": 2}}"
2021-10-06 21:08:11,cce81e9673fe8d056e8eef310d9919620eccb2f2,Bram Moolenaar,30,2,32,3,"{""src/ex_eval.c"": {""insertions"": 8, ""deletions"": 2, ""lines"": 10}, ""src/testdir/test_trycatch.vim"": {""insertions"": 20, ""deletions"": 0, ""lines"": 20}, ""src/version.c"": {""insertions"": 2, ""deletions"": 0, ""lines"": 2}}"
2021-10-06 18:39:16,edd7a476fbcba199dc0b026461917912c574c629,Zdenek Dohnal,3,1,4,2,"{""src/testdir/test_python3.vim"": {""insertions"": 1, ""deletions"": 1, ""lines"": 2}, ""src/version.c"": {""insertions"": 2, ""deletions"": 0, ""lines"": 2}}"
2021-10-06 12:41:07,e275ba4fc994474155fbafe8b87a6d3b477456ba,Bram Moolenaar,25,1,26,4,"{""src/clipboard.c"": {""insertions"": 2, ""deletions"": 1, ""lines"": 3}, ""src/spellsuggest.c"": {""insertions"": 5, ""deletions"": 0, ""lines"": 5}, ""src/testdir/test_spell_utf8.vim"": {""insertions"": 16, ""deletions"": 0, ""lines"": 16}, ""src/version.c"": {""insertions"": 2, ""deletions"": 0, ""lines"": 2}}"
2021-10-06 10:27:21,e2982d691186c8a9b16ecc8d831d2472088c8ed8,Bram Moolenaar,9,5,14,4,"{""src/auto/configure"": {""insertions"": 3, ""deletions"": 2, ""lines"": 5}, ""src/configure.ac"": {""insertions"": 3, ""deletions"": 2, ""lines"": 5}, ""src/memline.c"": {""insertions"": 1, ""deletions"": 1, ""lines"": 2}, ""src/version.c"": {""insertions"": 2, ""deletions"": 0, ""lines"": 2}}"
2021-10-05 20:58:53,78e0fa4cf4fcd563c0bc8c87afa54d4f5dc22020,Bram Moolenaar,11,2,13,3,"{""src/cindent.c"": {""insertions"": 2, ""deletions"": 2, ""lines"": 4}, ""src/testdir/test_cindent.vim"": {""insertions"": 7, ""deletions"": 0, ""lines"": 7}, ""src/version.c"": {""insertions"": 2, ""deletions"": 0, ""lines"": 2}}"
2021-10-05 18:44:04,2e258bd79f403bcccb1336bea70803957a83808f,James McCoy,11,3,14,3,"{"".github/workflows/ci.yml"": {""insertions"": 7, ""deletions"": 1, ""lines"": 8}, ""src/structs.h"": {""insertions"": 2, ""deletions"": 2, ""lines"": 4}, ""src/version.c"": {""insertions"": 2, ""deletions"": 0, ""lines"": 2}}"
2021-10-05 18:28:01,949de97da32d4fff28c569387e2ba8b3e311e64d,Dominique Pelle,18,7,25,2,"{""src/testdir/test_trycatch.vim"": {""insertions"": 16, ""deletions"": 7, ""lines"": 23}, ""src/version.c"": {""insertions"": 2, ""deletions"": 0, ""lines"": 2}}"
2021-10-05 18:19:35,7c25a7c0a129300d0632e5b99ccefdca9bf3ffa2,Bram Moolenaar,7,0,7,3,"{""src/misc2.c"": {""insertions"": 1, ""deletions"": 0, ""lines"": 1}, ""src/testdir/test_channel.vim"": {""insertions"": 4, ""deletions"": 0, ""lines"": 4}, ""src/version.c"": {""insertions"": 2, ""deletions"": 0, ""lines"": 2}}"
2021-10-05 10:22:27,f67d3fb7363ebc9454f9bb582de3978609a4fd6b,Bram Moolenaar,11,4,15,3,"{""src/ex_eval.c"": {""insertions"": 5, ""deletions"": 1, ""lines"": 6}, ""src/structs.h"": {""insertions"": 4, ""deletions"": 3, ""lines"": 7}, ""src/version.c"": {""insertions"": 2, ""deletions"": 0, ""lines"": 2}}"
2021-10-05 00:19:53,6d197987745427801a2195836ef89e48537afbeb,Bram Moolenaar,4,0,4,2,"{""src/testdir/test_startup.vim"": {""insertions"": 2, ""deletions"": 0, ""lines"": 2}, ""src/version.c"": {""insertions"": 2, ""deletions"": 0, ""lines"": 2}}"
2021-10-04 22:13:13,d3710cf01ef6ab1b2f233866ff01dab76686f642,Bram Moolenaar,27,1,28,3,"{""src/buffer.c"": {""insertions"": 11, ""deletions"": 1, ""lines"": 12}, ""src/testdir/test_startup.vim"": {""insertions"": 14, ""deletions"": 0, ""lines"": 14}, ""src/version.c"": {""insertions"": 2, ""deletions"": 0, ""lines"": 2}}"
2021-10-04 21:17:36,08d7b1c82866a61b61a55e55b6c190dba04e54ea,kuuote,15,2,17,3,"{""src/ex_docmd.c"": {""insertions"": 5, ""deletions"": 2, ""lines"": 7}, ""src/testdir/test_excmd.vim"": {""insertions"": 8, ""deletions"": 0, ""lines"": 8}, ""src/version.c"": {""insertions"": 2, ""deletions"": 0, ""lines"": 2}}"
2021-10-04 20:51:57,965d2edbce1a8ccba96925be5ac4575981f68949,h-east,8,6,14,4,"{""runtime/doc/if_lua.txt"": {""insertions"": 4, ""deletions"": 4, ""lines"": 8}, ""src/getchar.c"": {""insertions"": 1, ""deletions"": 1, ""lines"": 2}, ""src/if_lua.c"": {""insertions"": 1, ""deletions"": 1, ""lines"": 2}, ""src/version.c"": {""insertions"": 2, ""deletions"": 0, ""lines"": 2}}"
2021-10-04 20:32:54,6e649224926bbc1df6a4fdfa7a96b4acb1f8bee0,Bram Moolenaar,2852,369,3221,50,"{"".github/CODEOWNERS"": {""insertions"": 21, ""deletions"": 0, ""lines"": 21}, ""runtime/autoload/netrw.vim"": {""insertions"": 2, ""deletions"": 1, ""lines"": 3}, ""runtime/doc/autocmd.txt"": {""insertions"": 9, ""deletions"": 2, ""lines"": 11}, ""runtime/doc/editing.txt"": {""insertions"": 4, ""deletions"": 2, ""lines"": 6}, ""runtime/doc/eval.txt"": {""insertions"": 21, ""deletions"": 21, ""lines"": 42}, ""runtime/doc/filetype.txt"": {""insertions"": 2, ""deletions"": 2, ""lines"": 4}, ""runtime/doc/intro.txt"": {""insertions"": 1, ""deletions"": 2, ""lines"": 3}, ""runtime/doc/mbyte.txt"": {""insertions"": 16, ""deletions"": 16, ""lines"": 32}, ""runtime/doc/print.txt"": {""insertions"": 2, ""deletions"": 2, ""lines"": 4}, ""runtime/doc/tags"": {""insertions"": 2, ""deletions"": 1, ""lines"": 3}, ""runtime/doc/todo.txt"": {""insertions"": 4, ""deletions"": 1, ""lines"": 5}, ""runtime/filetype.vim"": {""insertions"": 5, ""deletions"": 4, ""lines"": 9}, ""runtime/ftplugin/man.vim"": {""insertions"": 1, ""deletions"": 1, ""lines"": 2}, ""runtime/ftplugin/nginx.vim"": {""insertions"": 6, ""deletions"": 0, ""lines"": 6}, ""runtime/ftplugin/spec.vim"": {""insertions"": 2, ""deletions"": 2, ""lines"": 4}, ""runtime/indent/cdl.vim"": {""insertions"": 2, ""deletions"": 1, ""lines"": 3}, ""runtime/indent/cobol.vim"": {""insertions"": 3, ""deletions"": 0, ""lines"": 3}, ""runtime/indent/config.vim"": {""insertions"": 8, ""deletions"": 5, ""lines"": 13}, ""runtime/indent/css.vim"": {""insertions"": 7, ""deletions"": 5, ""lines"": 12}, ""runtime/indent/d.vim"": {""insertions"": 2, ""deletions"": 2, ""lines"": 4}, ""runtime/indent/dtd.vim"": {""insertions"": 6, ""deletions"": 3, ""lines"": 9}, ""runtime/indent/dylan.vim"": {""insertions"": 2, ""deletions"": 1, ""lines"": 3}, ""runtime/indent/elm.vim"": {""insertions"": 3, ""deletions"": 1, ""lines"": 4}, ""runtime/indent/eterm.vim"": {""insertions"": 6, ""deletions"": 3, ""lines"": 9}, ""runtime/indent/framescript.vim"": {""insertions"": 6, ""deletions"": 3, ""lines"": 9}, ""runtime/indent/idlang.vim"": {""insertions"": 3, ""deletions"": 2, ""lines"": 5}, ""runtime/indent/ld.vim"": {""insertions"": 6, ""deletions"": 3, ""lines"": 9}, ""runtime/indent/mail.vim"": {""insertions"": 3, ""deletions"": 1, ""lines"": 4}, ""runtime/indent/make.vim"": {""insertions"": 6, ""deletions"": 3, ""lines"": 9}, ""runtime/indent/matlab.vim"": {""insertions"": 2, ""deletions"": 0, ""lines"": 2}, ""runtime/indent/mma.vim"": {""insertions"": 6, ""deletions"": 5, ""lines"": 11}, ""runtime/indent/nginx.vim"": {""insertions"": 17, ""deletions"": 0, ""lines"": 17}, ""runtime/indent/occam.vim"": {""insertions"": 2, ""deletions"": 1, ""lines"": 3}, ""runtime/indent/pascal.vim"": {""insertions"": 7, ""deletions"": 8, ""lines"": 15}, ""runtime/indent/postscr.vim"": {""insertions"": 4, ""deletions"": 3, ""lines"": 7}, ""runtime/indent/prolog.vim"": {""insertions"": 4, ""deletions"": 3, ""lines"": 7}, ""runtime/indent/python.vim"": {""insertions"": 3, ""deletions"": 1, ""lines"": 4}, ""runtime/indent/readline.vim"": {""insertions"": 6, ""deletions"": 3, ""lines"": 9}, ""runtime/indent/sdl.vim"": {""insertions"": 3, ""deletions"": 1, ""lines"": 4}, ""runtime/indent/tcl.vim"": {""insertions"": 5, ""deletions"": 3, ""lines"": 8}, ""runtime/indent/tcsh.vim"": {""insertions"": 3, ""deletions"": 2, ""lines"": 5}, ""runtime/indent/zimbu.vim"": {""insertions"": 2, ""deletions"": 2, ""lines"": 4}, ""runtime/syntax/8th.vim"": {""insertions"": 302, ""deletions"": 233, ""lines"": 535}, ""runtime/syntax/chicken.vim"": {""insertions"": 2, ""deletions"": 2, ""lines"": 4}, ""runtime/syntax/nginx.vim"": {""insertions"": 2307, ""deletions"": 0, ""lines"": 2307}, ""runtime/syntax/sml.vim"": {""insertions"": 3, ""deletions"": 4, ""lines"": 7}, ""runtime/syntax/tcl.vim"": {""insertions"": 2, ""deletions"": 2, ""lines"": 4}, ""runtime/syntax/tcsh.vim"": {""insertions"": 3, ""deletions"": 2, ""lines"": 5}, ""runtime/syntax/typescriptcommon.vim"": {""insertions"": 3, ""deletions"": 2, ""lines"": 5}, ""runtime/syntax/xpm.vim"": {""insertions"": 5, ""deletions"": 2, ""lines"": 7}}"
2021-10-04 19:41:45,78aa5ffe314f40d33666f03b833f66b11c3d0f67,Bram Moolenaar,7,2,9,3,"{""runtime/filetype.vim"": {""insertions"": 4, ""deletions"": 1, ""lines"": 5}, ""src/testdir/test_filetype.vim"": {""insertions"": 1, ""deletions"": 1, ""lines"": 2}, ""src/version.c"": {""insertions"": 2, ""deletions"": 0, ""lines"": 2}}"
2021-10-04 19:09:19,9af9fd6ab637ea507dd9015fa5a84a408c36c1e0,Bram Moolenaar,7,2,9,2,"{""src/testdir/test_search.vim"": {""insertions"": 5, ""deletions"": 2, ""lines"": 7}, ""src/version.c"": {""insertions"": 2, ""deletions"": 0, ""lines"": 2}}"
2021-10-04 18:47:35,d8d957de86f218de9124ca1209548f8c6f61b69b,Bram Moolenaar,19,1,20,3,"{""src/ex_getln.c"": {""insertions"": 7, ""deletions"": 1, ""lines"": 8}, ""src/testdir/test_search.vim"": {""insertions"": 10, ""deletions"": 0, ""lines"": 10}, ""src/version.c"": {""insertions"": 2, ""deletions"": 0, ""lines"": 2}}"
2021-10-04 17:52:19,a684a684096ecef3fbaee39c573b47423235d6b1,Bram Moolenaar,16,1,17,3,"{""src/ex_eval.c"": {""insertions"": 2, ""deletions"": 1, ""lines"": 3}, ""src/testdir/test_trycatch.vim"": {""insertions"": 12, ""deletions"": 0, ""lines"": 12}, ""src/version.c"": {""insertions"": 2, ""deletions"": 0, ""lines"": 2}}"
2021-10-03 19:11:20,50c56893423eb6ad2154a4151e67f7097f52efb6,Bram Moolenaar,6,1,7,3,"{""runtime/filetype.vim"": {""insertions"": 3, ""deletions"": 0, ""lines"": 3}, ""src/testdir/test_filetype.vim"": {""insertions"": 1, ""deletions"": 1, ""lines"": 2}, ""src/version.c"": {""insertions"": 2, ""deletions"": 0, ""lines"": 2}}"
2021-10-03 18:29:48,c6376c798433bcb9ee38a8664299d11454546950,Bram Moolenaar,28,1,29,3,"{""src/os_unix.c"": {""insertions"": 9, ""deletions"": 1, ""lines"": 10}, ""src/testdir/test_cd.vim"": {""insertions"": 17, ""deletions"": 0, ""lines"": 17}, ""src/version.c"": {""insertions"": 2, ""deletions"": 0, ""lines"": 2}}"
2021-10-03 15:22:05,5a9357d0bff9059f547906d8d03b31bca7215af1,Bram Moolenaar,21,0,21,3,"{""src/edit.c"": {""insertions"": 3, ""deletions"": 0, ""lines"": 3}, ""src/testdir/test_autocmd.vim"": {""insertions"": 16, ""deletions"": 0, ""lines"": 16}, ""src/version.c"": {""insertions"": 2, ""deletions"": 0, ""lines"": 2}}"
2021-10-03 14:19:14,cc8cd4453332276d55b4a1109eace5785a4f319d,zeertzjq,53,5,58,4,"{""runtime/doc/eval.txt"": {""insertions"": 7, ""deletions"": 5, ""lines"": 12}, ""src/misc1.c"": {""insertions"": 6, ""deletions"": 0, ""lines"": 6}, ""src/testdir/test_functions.vim"": {""insertions"": 38, ""deletions"": 0, ""lines"": 38}, ""src/version.c"": {""insertions"": 2, ""deletions"": 0, ""lines"": 2}}"
2021-10-03 11:01:27,27fef59dd1dd75f50c366f7f616ffa4451560452,zeertzjq,11,2,13,4,"{""runtime/doc/eval.txt"": {""insertions"": 2, ""deletions"": 0, ""lines"": 2}, ""src/insexpand.c"": {""insertions"": 3, ""deletions"": 2, ""lines"": 5}, ""src/testdir/test_popup.vim"": {""insertions"": 4, ""deletions"": 0, ""lines"": 4}, ""src/version.c"": {""insertions"": 2, ""deletions"": 0, ""lines"": 2}}"
2021-10-03 10:46:09,8b8c0ed657fabd88e610401ca8a12366f987db94,Chris Aumann,6,0,6,3,"{""runtime/filetype.vim"": {""insertions"": 3, ""deletions"": 0, ""lines"": 3}, ""src/testdir/test_filetype.vim"": {""insertions"": 1, ""deletions"": 0, ""lines"": 1}, ""src/version.c"": {""insertions"": 2, ""deletions"": 0, ""lines"": 2}}"
2021-10-02 20:48:15,72d2fa69e56dd0e61eac87a9c3b79cd89d47cdd9,Bram Moolenaar,23,0,23,2,"{""src/testdir/test_edit.vim"": {""insertions"": 21, ""deletions"": 0, ""lines"": 21}, ""src/version.c"": {""insertions"": 2, ""deletions"": 0, ""lines"": 2}}"
2021-10-02 15:55:39,d85931e67316e824878000d0ead122553ccef3a4,Bram Moolenaar,12,4,16,3,"{""src/misc1.c"": {""insertions"": 5, ""deletions"": 3, ""lines"": 8}, ""src/testdir/test_edit.vim"": {""insertions"": 5, ""deletions"": 1, ""lines"": 6}, ""src/version.c"": {""insertions"": 2, ""deletions"": 0, ""lines"": 2}}"
2021-10-02 15:34:55,72406a4bd2896915b6f541e26d41521a59b1f846,Bram Moolenaar,16,1,17,4,"{""runtime/doc/eval.txt"": {""insertions"": 2, ""deletions"": 1, ""lines"": 3}, ""src/misc1.c"": {""insertions"": 4, ""deletions"": 0, ""lines"": 4}, ""src/testdir/test_functions.vim"": {""insertions"": 8, ""deletions"": 0, ""lines"": 8}, ""src/version.c"": {""insertions"": 2, ""deletions"": 0, ""lines"": 2}}"
2021-10-02 10:26:51,dfa5e464d459f84200a73d178f1ecefe75bbe511,=?UTF-8?q?Dundar=20G=C3=B6c?=,20,18,38,9,"{""src/autocmd.c"": {""insertions"": 5, ""deletions"": 5, ""lines"": 10}, ""src/buffer.c"": {""insertions"": 1, ""deletions"": 1, ""lines"": 2}, ""src/debugger.c"": {""insertions"": 1, ""deletions"": 1, ""lines"": 2}, ""src/getchar.c"": {""insertions"": 3, ""deletions"": 3, ""lines"": 6}, ""src/hardcopy.c"": {""insertions"": 2, ""deletions"": 2, ""lines"": 4}, ""src/if_cscope.c"": {""insertions"": 2, ""deletions"": 2, ""lines"": 4}, ""src/move.c"": {""insertions"": 1, ""deletions"": 1, ""lines"": 2}, ""src/tag.c"": {""insertions"": 1, ""deletions"": 1, ""lines"": 2}, ""src/version.c"": {""insertions"": 4, ""deletions"": 2, ""lines"": 6}}"
2021-09-30 18:00:00,51491adfa86fd66a857cd7ec50d0b57dbdf3da59,Yegappan Lakshmanan,65,4,69,5,"{""runtime/doc/eval.txt"": {""insertions"": 16, ""deletions"": 1, ""lines"": 17}, ""src/menu.c"": {""insertions"": 21, ""deletions"": 3, ""lines"": 24}, ""src/testdir/test_menu.vim"": {""insertions"": 3, ""deletions"": 0, ""lines"": 3}, ""src/testdir/test_vim9_builtin.vim"": {""insertions"": 23, ""deletions"": 0, ""lines"": 23}, ""src/version.c"": {""insertions"": 2, ""deletions"": 0, ""lines"": 2}}"
2021-09-26 21:11:52,be01090efad242e30728275dea05420db6f96257,Bram Moolenaar,4,2,6,3,"{""runtime/filetype.vim"": {""insertions"": 1, ""deletions"": 1, ""lines"": 2}, ""src/testdir/test_filetype.vim"": {""insertions"": 1, ""deletions"": 1, ""lines"": 2}, ""src/version.c"": {""insertions"": 2, ""deletions"": 0, ""lines"": 2}}"
2021-09-26 19:14:39,b16ff292ad5f07ed5a7e36a2236b2f82c943c982,Bram Moolenaar,6,0,6,2,"{""src/testdir/test_vim9_script.vim"": {""insertions"": 4, ""deletions"": 0, ""lines"": 4}, ""src/version.c"": {""insertions"": 2, ""deletions"": 0, ""lines"": 2}}"
2021-09-26 18:04:05,f8dbd586660c35e44276151b731eeedeace9b53e,Yegappan Lakshmanan,81,5,86,3,"{""src/evalfunc.c"": {""insertions"": 2, ""deletions"": 3, ""lines"": 5}, ""src/testdir/test_vim9_builtin.vim"": {""insertions"": 77, ""deletions"": 2, ""lines"": 79}, ""src/version.c"": {""insertions"": 2, ""deletions"": 0, ""lines"": 2}}"
2021-09-22 14:43:59,56858e4ed4e338e15821767b8303b06099e40384,Bram Moolenaar,9,2,11,3,"{""src/register.c"": {""insertions"": 3, ""deletions"": 0, ""lines"": 3}, ""src/testdir/test_put.vim"": {""insertions"": 4, ""deletions"": 2, ""lines"": 6}, ""src/version.c"": {""insertions"": 2, ""deletions"": 0, ""lines"": 2}}"
2021-09-22 14:37:07,23003e51e18371afda4420d9e171a3dcba5a31cc,Bram Moolenaar,23,3,26,3,"{""src/register.c"": {""insertions"": 11, ""deletions"": 3, ""lines"": 14}, ""src/testdir/test_put.vim"": {""insertions"": 10, ""deletions"": 0, ""lines"": 10}, ""src/version.c"": {""insertions"": 2, ""deletions"": 0, ""lines"": 2}}"
2021-09-22 12:18:13,40fa12aea352474d229f2f750e954a4318aead4e,Bram Moolenaar,16,1,17,3,"{""src/fileio.c"": {""insertions"": 1, ""deletions"": 1, ""lines"": 2}, ""src/testdir/test_autocmd.vim"": {""insertions"": 13, ""deletions"": 0, ""lines"": 13}, ""src/version.c"": {""insertions"": 2, ""deletions"": 0, ""lines"": 2}}"
2021-09-21 19:04:01,da0b497c6e4e01447669773a931b0eaa5ca757f3,Bram Moolenaar,2,1,3,1,"{""src/po/es.po"": {""insertions"": 2, ""deletions"": 1, ""lines"": 3}}"
2021-09-21 18:09:51,34cc7d8c034f2bc5b57455577051db8d72e2b87c,Bram Moolenaar,378,113,491,20,"{""runtime/autoload/csscomplete.vim"": {""insertions"": 3, ""deletions"": 3, ""lines"": 6}, ""runtime/doc/eval.txt"": {""insertions"": 8, ""deletions"": 4, ""lines"": 12}, ""runtime/doc/filetype.txt"": {""insertions"": 8, ""deletions"": 0, ""lines"": 8}, ""runtime/doc/map.txt"": {""insertions"": 1, ""deletions"": 1, ""lines"": 2}, ""runtime/doc/options.txt"": {""insertions"": 5, ""deletions"": 3, ""lines"": 8}, ""runtime/doc/tags"": {""insertions"": 8, ""deletions"": 0, ""lines"": 8}, ""runtime/doc/todo.txt"": {""insertions"": 6, ""deletions"": 9, ""lines"": 15}, ""runtime/doc/usr_41.txt"": {""insertions"": 1, ""deletions"": 1, ""lines"": 2}, ""runtime/doc/vim9.txt"": {""insertions"": 10, ""deletions"": 1, ""lines"": 11}, ""runtime/filetype.vim"": {""insertions"": 1, ""deletions"": 1, ""lines"": 2}, ""runtime/ftplugin/8th.vim"": {""insertions"": 6, ""deletions"": 4, ""lines"": 10}, ""runtime/ftplugin/c.vim"": {""insertions"": 7, ""deletions"": 3, ""lines"": 10}, ""runtime/ftplugin/gprof.vim"": {""insertions"": 13, ""deletions"": 9, ""lines"": 22}, ""runtime/syntax/go.vim"": {""insertions"": 3, ""deletions"": 3, ""lines"": 6}, ""runtime/syntax/gprof.vim"": {""insertions"": 3, ""deletions"": 2, ""lines"": 5}, ""runtime/syntax/php.vim"": {""insertions"": 251, ""deletions"": 16, ""lines"": 267}, ""runtime/syntax/vim.vim"": {""insertions"": 8, ""deletions"": 8, ""lines"": 16}, ""runtime/tutor/tutor"": {""insertions"": 10, ""deletions"": 10, ""lines"": 20}, ""runtime/tutor/tutor.utf-8"": {""insertions"": 10, ""deletions"": 10, ""lines"": 20}, ""src/po/es.po"": {""insertions"": 16, ""deletions"": 25, ""lines"": 41}}"
2021-09-21 17:37:01,690c524ce6629f9ff67728541ba211f831caf0ee,Steven Penny,6,1,7,3,"{""runtime/filetype.vim"": {""insertions"": 3, ""deletions"": 0, ""lines"": 3}, ""src/testdir/test_filetype.vim"": {""insertions"": 1, ""deletions"": 1, ""lines"": 2}, ""src/version.c"": {""insertions"": 2, ""deletions"": 0, ""lines"": 2}}"
2021-09-20 18:57:31,770ddbe1595f6dab836304203d5ca2e0b069266f,Zdenek Dohnal,4,2,6,3,"{""runtime/filetype.vim"": {""insertions"": 1, ""deletions"": 1, ""lines"": 2}, ""src/testdir/test_filetype.vim"": {""insertions"": 1, ""deletions"": 1, ""lines"": 2}, ""src/version.c"": {""insertions"": 2, ""deletions"": 0, ""lines"": 2}}"
2021-09-19 15:55:16,18fefddcb023db3c8461953892650b0c5f0cc9fe,Bram Moolenaar,26,24,50,2,"{"".github/workflows/ci.yml"": {""insertions"": 24, ""deletions"": 24, ""lines"": 48}, ""src/version.c"": {""insertions"": 2, ""deletions"": 0, ""lines"": 2}}"
2021-09-19 15:01:39,c04f62346bfd6b92151908239a3c5ab1a7d18f2a,Yasuhiro Matsumoto,9,0,9,3,"{""src/list.c"": {""insertions"": 6, ""deletions"": 0, ""lines"": 6}, ""src/testdir/test_sort.vim"": {""insertions"": 1, ""deletions"": 0, ""lines"": 1}, ""src/version.c"": {""insertions"": 2, ""deletions"": 0, ""lines"": 2}}"
2021-09-18 13:25:52,1d34189ecb99fa76363c06e1aa815c1075675a1c,Bram Moolenaar,34,4,38,3,"{""src/testdir/test_trycatch.vim"": {""insertions"": 27, ""deletions"": 1, ""lines"": 28}, ""src/userfunc.c"": {""insertions"": 5, ""deletions"": 3, ""lines"": 8}, ""src/version.c"": {""insertions"": 2, ""deletions"": 0, ""lines"": 2}}"
2021-09-18 10:15:08,d2b98ab4ecf168514ae622948e3749dea7671946,Yegappan Lakshmanan,4,2,6,2,"{""src/os_unix.h"": {""insertions"": 2, ""deletions"": 2, ""lines"": 4}, ""src/version.c"": {""insertions"": 2, ""deletions"": 0, ""lines"": 2}}"
2021-09-17 19:07:35,820d5525cae707f39571c6abc2aa6a9e66ed171e,Yegappan Lakshmanan,66,17,83,6,"{""runtime/doc/sign.txt"": {""insertions"": 1, ""deletions"": 0, ""lines"": 1}, ""runtime/doc/textprop.txt"": {""insertions"": 1, ""deletions"": 1, ""lines"": 2}, ""src/sign.c"": {""insertions"": 0, ""deletions"": 4, ""lines"": 4}, ""src/testdir/test_blob.vim"": {""insertions"": 2, ""deletions"": 1, ""lines"": 3}, ""src/testdir/test_vim9_builtin.vim"": {""insertions"": 60, ""deletions"": 11, ""lines"": 71}, ""src/version.c"": {""insertions"": 2, ""deletions"": 0, ""lines"": 2}}"
2021-09-17 18:45:30,542ffe16a1b6961e9262a3c4c6ddb86e6149a1cd,Bram Moolenaar,6,2,8,2,"{""src/globals.h"": {""insertions"": 1, ""deletions"": 1, ""lines"": 2}, ""src/version.c"": {""insertions"": 5, ""deletions"": 1, ""lines"": 6}}"
2021-09-16 20:32:15,644b49fa0fb90143e8dbe90a7c14c9498d17b266,Bram Moolenaar,36,2,38,4,"{""src/edit.c"": {""insertions"": 10, ""deletions"": 0, ""lines"": 10}, ""src/testdir/dumps/Test_conceal_two_windows_07in.dump"": {""insertions"": 20, ""deletions"": 0, ""lines"": 20}, ""src/testdir/test_conceal.vim"": {""insertions"": 4, ""deletions"": 2, ""lines"": 6}, ""src/version.c"": {""insertions"": 2, ""deletions"": 0, ""lines"": 2}}"
2021-09-16 18:14:51,3dfe2e0fb8768914a019fa04b1ed9581e33c9b26,Bram Moolenaar,4,1,5,2,"{""src/version.c"": {""insertions"": 2, ""deletions"": 0, ""lines"": 2}, ""src/vim9compile.c"": {""insertions"": 2, ""deletions"": 1, ""lines"": 3}}"
2021-09-16 14:15:07,1a7ee4dd115329052670d7af176341bd09c9dc5a,Bram Moolenaar,137,38,175,5,"{""src/testdir/test_vim9_disassemble.vim"": {""insertions"": 50, ""deletions"": 12, ""lines"": 62}, ""src/version.c"": {""insertions"": 2, ""deletions"": 0, ""lines"": 2}, ""src/vim9.h"": {""insertions"": 1, ""deletions"": 0, ""lines"": 1}, ""src/vim9compile.c"": {""insertions"": 81, ""deletions"": 26, ""lines"": 107}, ""src/vim9execute.c"": {""insertions"": 3, ""deletions"": 0, ""lines"": 3}}"
2021-09-15 10:53:40,ee2cbcd99c54d7c4a3ccfaf0cd5ddeb1369a844e,Christian Brabandt,3,1,4,2,"{""src/version.c"": {""insertions"": 2, ""deletions"": 0, ""lines"": 2}, ""vimtutor.bat"": {""insertions"": 1, ""deletions"": 1, ""lines"": 2}}"
2021-09-14 20:58:23,f2a8bafa4b815e5b4e50a25c2b3a8a24fbe8aa11,Bram Moolenaar,8,0,8,2,"{""src/testdir/test_recover.vim"": {""insertions"": 6, ""deletions"": 0, ""lines"": 6}, ""src/version.c"": {""insertions"": 2, ""deletions"": 0, ""lines"": 2}}"
2021-09-14 16:55:51,78eb9cce911dcd662182443e0920649ec1596d41,Christian Brabandt,64,0,64,5,"{""src/ops.c"": {""insertions"": 2, ""deletions"": 0, ""lines"": 2}, ""src/proto/register.pro"": {""insertions"": 1, ""deletions"": 0, ""lines"": 1}, ""src/register.c"": {""insertions"": 7, ""deletions"": 0, ""lines"": 7}, ""src/testdir/test_registers.vim"": {""insertions"": 52, ""deletions"": 0, ""lines"": 52}, ""src/version.c"": {""insertions"": 2, ""deletions"": 0, ""lines"": 2}}"
2021-09-14 15:54:30,5dfe467432638fac2e0156a2f9cd0d9eb569fb39,Yegappan Lakshmanan,185,1,186,11,"{""runtime/doc/eval.txt"": {""insertions"": 27, ""deletions"": 1, ""lines"": 28}, ""runtime/doc/usr_41.txt"": {""insertions"": 6, ""deletions"": 0, ""lines"": 6}, ""src/blob.c"": {""insertions"": 61, ""deletions"": 0, ""lines"": 61}, ""src/errors.h"": {""insertions"": 4, ""deletions"": 0, ""lines"": 4}, ""src/evalfunc.c"": {""insertions"": 14, ""deletions"": 0, ""lines"": 14}, ""src/proto/blob.pro"": {""insertions"": 2, ""deletions"": 0, ""lines"": 2}, ""src/proto/typval.pro"": {""insertions"": 1, ""deletions"": 0, ""lines"": 1}, ""src/testdir/test_blob.vim"": {""insertions"": 39, ""deletions"": 0, ""lines"": 39}, ""src/testdir/test_vim9_builtin.vim"": {""insertions"": 12, ""deletions"": 0, ""lines"": 12}, ""src/typval.c"": {""insertions"": 17, ""deletions"": 0, ""lines"": 17}, ""src/version.c"": {""insertions"": 2, ""deletions"": 0, ""lines"": 2}}"
2021-09-13 20:17:38,f5785cf0592626ec17676e814d3ba58f5123bcda,Mike Williams,8,5,13,4,"{""src/screen.c"": {""insertions"": 4, ""deletions"": 3, ""lines"": 7}, ""src/version.c"": {""insertions"": 2, ""deletions"": 0, ""lines"": 2}, ""src/xdiff/xemit.c"": {""insertions"": 1, ""deletions"": 1, ""lines"": 2}, ""src/xdiff/xutils.c"": {""insertions"": 1, ""deletions"": 1, ""lines"": 2}}"
2021-09-13 19:36:27,a29856fcdc41541c607437629c1c1f45951100a4,Bram Moolenaar,7,3,10,2,"{""src/typval.c"": {""insertions"": 5, ""deletions"": 3, ""lines"": 8}, ""src/version.c"": {""insertions"": 2, ""deletions"": 0, ""lines"": 2}}"
2021-09-13 16:25:54,b1b6f4de2b0edc3b6622912132ddb8994ec52709,Bram Moolenaar,226,26,252,6,"{""src/testdir/test_vim9_disassemble.vim"": {""insertions"": 34, ""deletions"": 1, ""lines"": 35}, ""src/testdir/test_vim9_func.vim"": {""insertions"": 31, ""deletions"": 0, ""lines"": 31}, ""src/version.c"": {""insertions"": 2, ""deletions"": 0, ""lines"": 2}, ""src/vim9.h"": {""insertions"": 3, ""deletions"": 0, ""lines"": 3}, ""src/vim9compile.c"": {""insertions"": 33, ""deletions"": 6, ""lines"": 39}, ""src/vim9execute.c"": {""insertions"": 123, ""deletions"": 19, ""lines"": 142}}"
2021-09-12 19:00:14,28e591dd5080bbcd0f468f9d9597cedb716e28c9,Bram Moolenaar,3,1,4,2,"{""src/proto/misc1.pro"": {""insertions"": 1, ""deletions"": 1, ""lines"": 2}, ""src/version.c"": {""insertions"": 2, ""deletions"": 0, ""lines"": 2}}"
2021-09-12 18:58:02,bdcba24d8597abd5af509c2fb9206e64e713c711,Bram Moolenaar,47,6,53,5,"{""runtime/doc/map.txt"": {""insertions"": 4, ""deletions"": 0, ""lines"": 4}, ""src/errors.h"": {""insertions"": 4, ""deletions"": 0, ""lines"": 4}, ""src/testdir/test_usercommands.vim"": {""insertions"": 21, ""deletions"": 0, ""lines"": 21}, ""src/usercmd.c"": {""insertions"": 16, ""deletions"": 6, ""lines"": 22}, ""src/version.c"": {""insertions"": 2, ""deletions"": 0, ""lines"": 2}}"
2021-09-12 15:03:08,ca0627df69c29508f6f797bef27a1f5fa9a447d3,Bram Moolenaar,13,14,27,3,"{""runtime/autoload/dist/ft.vim"": {""insertions"": 3, ""deletions"": 3, ""lines"": 6}, ""src/testdir/test_filetype.vim"": {""insertions"": 8, ""deletions"": 11, ""lines"": 19}, ""src/version.c"": {""insertions"": 2, ""deletions"": 0, ""lines"": 2}}"
2021-09-12 13:45:10,dfe04dbff5863f6c089da8831d7ac2a3421a44b7,naohiro ono,9,1,10,3,"{""src/cmdexpand.c"": {""insertions"": 2, ""deletions"": 1, ""lines"": 3}, ""src/testdir/test_cmdline.vim"": {""insertions"": 5, ""deletions"": 0, ""lines"": 5}, ""src/version.c"": {""insertions"": 2, ""deletions"": 0, ""lines"": 2}}"
2021-09-12 11:39:55,f1e8876fa2359b572d262772747405d3616db670,=?UTF-8?q?Magnus=20Gro=C3=9F?=,135,4,139,13,"{""runtime/doc/autocmd.txt"": {""insertions"": 18, ""deletions"": 1, ""lines"": 19}, ""src/autocmd.c"": {""insertions"": 16, ""deletions"": 2, ""lines"": 18}, ""src/edit.c"": {""insertions"": 3, ""deletions"": 0, ""lines"": 3}, ""src/ex_docmd.c"": {""insertions"": 1, ""deletions"": 0, ""lines"": 1}, ""src/ex_getln.c"": {""insertions"": 10, ""deletions"": 0, ""lines"": 10}, ""src/globals.h"": {""insertions"": 3, ""deletions"": 0, ""lines"": 3}, ""src/misc1.c"": {""insertions"": 40, ""deletions"": 1, ""lines"": 41}, ""src/normal.c"": {""insertions"": 3, ""deletions"": 0, ""lines"": 3}, ""src/proto/autocmd.pro"": {""insertions"": 1, ""deletions"": 0, ""lines"": 1}, ""src/proto/misc1.pro"": {""insertions"": 1, ""deletions"": 0, ""lines"": 1}, ""src/testdir/test_edit.vim"": {""insertions"": 34, ""deletions"": 0, ""lines"": 34}, ""src/version.c"": {""insertions"": 2, ""deletions"": 0, ""lines"": 2}, ""src/vim.h"": {""insertions"": 3, ""deletions"": 0, ""lines"": 3}}"
2021-09-11 21:07:44,464393a6961d9b9de2bfe9c05f8e2ae5bdec0293,Bram Moolenaar,19,3,22,3,"{""src/evalvars.c"": {""insertions"": 14, ""deletions"": 2, ""lines"": 16}, ""src/version.c"": {""insertions"": 2, ""deletions"": 0, ""lines"": 2}, ""src/vim9type.c"": {""insertions"": 3, ""deletions"": 1, ""lines"": 4}}"
2021-09-11 19:14:20,35a9a00afcb20897d462a766793ff45534810dc3,Bram Moolenaar,21,3,24,3,"{""src/normal.c"": {""insertions"": 7, ""deletions"": 3, ""lines"": 10}, ""src/testdir/test_edit.vim"": {""insertions"": 12, ""deletions"": 0, ""lines"": 12}, ""src/version.c"": {""insertions"": 2, ""deletions"": 0, ""lines"": 2}}"
2021-09-11 18:20:38,b3bf33a7b227df871834e816c4ce4b2706b56bea,Bram Moolenaar,19,5,24,3,"{""src/list.c"": {""insertions"": 7, ""deletions"": 1, ""lines"": 8}, ""src/testdir/test_vim9_builtin.vim"": {""insertions"": 10, ""deletions"": 4, ""lines"": 14}, ""src/version.c"": {""insertions"": 2, ""deletions"": 0, ""lines"": 2}}"
2021-09-11 13:06:44,4b4b1b84eee70b74fa3bb57624533c65bafd8428,Bram Moolenaar,52,6,58,3,"{""src/change.c"": {""insertions"": 32, ""deletions"": 6, ""lines"": 38}, ""src/testdir/test_listener.vim"": {""insertions"": 18, ""deletions"": 0, ""lines"": 18}, ""src/version.c"": {""insertions"": 2, ""deletions"": 0, ""lines"": 2}}"
2021-09-11 10:15:09,56e14698b45a9c4ef8fa65c55c9bfe86fbb3d6bf,Bram Moolenaar,4,2,6,2,"{""src/screen.c"": {""insertions"": 2, ""deletions"": 2, ""lines"": 4}, ""src/version.c"": {""insertions"": 2, ""deletions"": 0, ""lines"": 2}}"
2021-09-10 14:58:30,f14b8ba1373f569705cb80419248054100b02360,zeertzjq,264,29,293,7,"{""runtime/doc/options.txt"": {""insertions"": 14, ""deletions"": 5, ""lines"": 19}, ""src/drawline.c"": {""insertions"": 20, ""deletions"": 3, ""lines"": 23}, ""src/message.c"": {""insertions"": 30, ""deletions"": 13, ""lines"": 43}, ""src/screen.c"": {""insertions"": 58, ""deletions"": 5, ""lines"": 63}, ""src/structs.h"": {""insertions"": 1, ""deletions"": 0, ""lines"": 1}, ""src/testdir/test_listchars.vim"": {""insertions"": 139, ""deletions"": 3, ""lines"": 142}, ""src/version.c"": {""insertions"": 2, ""deletions"": 0, ""lines"": 2}}"
2021-09-09 21:01:14,07802044b90b2cbcc64b2dfe235f019d7c37589c,Bram Moolenaar,36,12,48,5,"{""src/structs.h"": {""insertions"": 3, ""deletions"": 0, ""lines"": 3}, ""src/testdir/test_vim9_assign.vim"": {""insertions"": 8, ""deletions"": 7, ""lines"": 15}, ""src/version.c"": {""insertions"": 2, ""deletions"": 0, ""lines"": 2}, ""src/vim9compile.c"": {""insertions"": 15, ""deletions"": 4, ""lines"": 19}, ""src/vim9execute.c"": {""insertions"": 8, ""deletions"": 1, ""lines"": 9}}"
2021-09-09 20:30:52,efc084e3353d6854b6dac8b240f70cb0abb838ad,Bram Moolenaar,26,0,26,3,"{""src/list.c"": {""insertions"": 1, ""deletions"": 0, ""lines"": 1}, ""src/testdir/test_vim9_func.vim"": {""insertions"": 23, ""deletions"": 0, ""lines"": 23}, ""src/version.c"": {""insertions"": 2, ""deletions"": 0, ""lines"": 2}}"
2021-09-09 19:55:11,6c391a74fe90190796ca0b0c010112948a6e75d7,Bram Moolenaar,247,167,414,80,"{"".github/CODEOWNERS"": {""insertions"": 1, ""deletions"": 0, ""lines"": 1}, ""runtime/autoload/ada.vim"": {""insertions"": 3, ""deletions"": 3, ""lines"": 6}, ""runtime/autoload/adacomplete.vim"": {""insertions"": 1, ""deletions"": 1, ""lines"": 2}, ""runtime/autoload/csscomplete.vim"": {""insertions"": 1, ""deletions"": 1, ""lines"": 2}, ""runtime/autoload/decada.vim"": {""insertions"": 1, ""deletions"": 1, ""lines"": 2}, ""runtime/autoload/getscript.vim"": {""insertions"": 2, ""deletions"": 2, ""lines"": 4}, ""runtime/autoload/haskellcomplete.vim"": {""insertions"": 3, ""deletions"": 3, ""lines"": 6}, ""runtime/autoload/htmlcomplete.vim"": {""insertions"": 1, ""deletions"": 1, ""lines"": 2}, ""runtime/autoload/netrw.vim"": {""insertions"": 4, ""deletions"": 4, ""lines"": 8}, ""runtime/autoload/phpcomplete.vim"": {""insertions"": 21, ""deletions"": 21, ""lines"": 42}, ""runtime/autoload/python3complete.vim"": {""insertions"": 1, ""deletions"": 1, ""lines"": 2}, ""runtime/autoload/pythoncomplete.vim"": {""insertions"": 1, ""deletions"": 1, ""lines"": 2}, ""runtime/autoload/sqlcomplete.vim"": {""insertions"": 7, ""deletions"": 7, ""lines"": 14}, ""runtime/autoload/tar.vim"": {""insertions"": 1, ""deletions"": 1, ""lines"": 2}, ""runtime/autoload/tohtml.vim"": {""insertions"": 1, ""deletions"": 1, ""lines"": 2}, ""runtime/autoload/xmlcomplete.vim"": {""insertions"": 1, ""deletions"": 1, ""lines"": 2}, ""runtime/autoload/zip.vim"": {""insertions"": 1, ""deletions"": 1, ""lines"": 2}, ""runtime/compiler/fpc.vim"": {""insertions"": 1, ""deletions"": 1, ""lines"": 2}, ""runtime/compiler/tex.vim"": {""insertions"": 1, ""deletions"": 1, ""lines"": 2}, ""runtime/doc/eval.txt"": {""insertions"": 6, ""deletions"": 3, ""lines"": 9}, ""runtime/doc/index.txt"": {""insertions"": 1, ""deletions"": 1, ""lines"": 2}, ""runtime/doc/insert.txt"": {""insertions"": 1, ""deletions"": 1, ""lines"": 2}, ""runtime/doc/options.txt"": {""insertions"": 3, ""deletions"": 1, ""lines"": 4}, ""runtime/doc/repeat.txt"": {""insertions"": 6, ""deletions"": 2, ""lines"": 8}, ""runtime/doc/tags"": {""insertions"": 4, ""deletions"": 0, ""lines"": 4}, ""runtime/doc/todo.txt"": {""insertions"": 10, ""deletions"": 8, ""lines"": 18}, ""runtime/doc/various.txt"": {""insertions"": 2, ""deletions"": 2, ""lines"": 4}, ""runtime/doc/vim9.txt"": {""insertions"": 3, ""deletions"": 4, ""lines"": 7}, ""runtime/doc/windows.txt"": {""insertions"": 4, ""deletions"": 3, ""lines"": 7}, ""runtime/filetype.vim"": {""insertions"": 1, ""deletions"": 1, ""lines"": 2}, ""runtime/ftplugin/dosini.vim"": {""insertions"": 1, ""deletions"": 1, ""lines"": 2}, ""runtime/ftplugin/matlab.vim"": {""insertions"": 4, ""deletions"": 3, ""lines"": 7}, ""runtime/ftplugin/ocaml.vim"": {""insertions"": 4, ""deletions"": 4, ""lines"": 8}, ""runtime/ftplugin/octave.vim"": {""insertions"": 63, ""deletions"": 0, ""lines"": 63}, ""runtime/ftplugin/systemverilog.vim"": {""insertions"": 1, ""deletions"": 1, ""lines"": 2}, ""runtime/ftplugin/tex.vim"": {""insertions"": 1, ""deletions"": 1, ""lines"": 2}, ""runtime/indent/ada.vim"": {""insertions"": 1, ""deletions"": 1, ""lines"": 2}, ""runtime/indent/cdl.vim"": {""insertions"": 6, ""deletions"": 6, ""lines"": 12}, ""runtime/indent/config.vim"": {""insertions"": 2, ""deletions"": 2, ""lines"": 4}, ""runtime/indent/dtd.vim"": {""insertions"": 3, ""deletions"": 3, ""lines"": 6}, ""runtime/indent/erlang.vim"": {""insertions"": 4, ""deletions"": 4, ""lines"": 8}, ""runtime/indent/json.vim"": {""insertions"": 1, ""deletions"": 1, ""lines"": 2}, ""runtime/indent/lifelines.vim"": {""insertions"": 1, ""deletions"": 1, ""lines"": 2}, ""runtime/indent/objc.vim"": {""insertions"": 1, ""deletions"": 1, ""lines"": 2}, ""runtime/indent/pov.vim"": {""insertions"": 1, ""deletions"": 1, ""lines"": 2}, ""runtime/indent/ruby.vim"": {""insertions"": 1, ""deletions"": 1, ""lines"": 2}, ""runtime/indent/sqlanywhere.vim"": {""insertions"": 1, ""deletions"": 1, ""lines"": 2}, ""runtime/indent/systemverilog.vim"": {""insertions"": 2, ""deletions"": 2, ""lines"": 4}, ""runtime/indent/tex.vim"": {""insertions"": 1, ""deletions"": 1, ""lines"": 2}, ""runtime/indent/treetop.vim"": {""insertions"": 1, ""deletions"": 1, ""lines"": 2}, ""runtime/indent/typescript.vim"": {""insertions"": 1, ""deletions"": 1, ""lines"": 2}, ""runtime/indent/verilog.vim"": {""insertions"": 2, ""deletions"": 2, ""lines"": 4}, ""runtime/keymap/kana.vim"": {""insertions"": 2, ""deletions"": 2, ""lines"": 4}, ""runtime/keymap/korean.vim"": {""insertions"": 1, ""deletions"": 1, ""lines"": 2}, ""runtime/keymap/russian-jcukenwintype.vim"": {""insertions"": 1, ""deletions"": 1, ""lines"": 2}, ""runtime/keymap/russian-typograph.vim"": {""insertions"": 2, ""deletions"": 2, ""lines"": 4}, ""runtime/plugin/tohtml.vim"": {""insertions"": 1, ""deletions"": 1, ""lines"": 2}, ""runtime/syntax/2html.vim"": {""insertions"": 2, ""deletions"": 2, ""lines"": 4}, ""runtime/syntax/abel.vim"": {""insertions"": 1, ""deletions"": 1, ""lines"": 2}, ""runtime/syntax/ada.vim"": {""insertions"": 1, ""deletions"": 1, ""lines"": 2}, ""runtime/syntax/ahdl.vim"": {""insertions"": 1, ""deletions"": 1, ""lines"": 2}, ""runtime/syntax/aspvbs.vim"": {""insertions"": 5, ""deletions"": 5, ""lines"": 10}, ""runtime/syntax/cfg.vim"": {""insertions"": 1, ""deletions"": 1, ""lines"": 2}, ""runtime/syntax/csc.vim"": {""insertions"": 1, ""deletions"": 1, ""lines"": 2}, ""runtime/syntax/cupl.vim"": {""insertions"": 1, ""deletions"": 1, ""lines"": 2}, ""runtime/syntax/dosbatch.vim"": {""insertions"": 1, ""deletions"": 1, ""lines"": 2}, ""runtime/syntax/doxygen.vim"": {""insertions"": 4, ""deletions"": 4, ""lines"": 8}, ""runtime/syntax/focexec.vim"": {""insertions"": 1, ""deletions"": 1, ""lines"": 2}, ""runtime/syntax/forth.vim"": {""insertions"": 1, ""deletions"": 1, ""lines"": 2}, ""runtime/syntax/hamster.vim"": {""insertions"": 1, ""deletions"": 1, ""lines"": 2}, ""runtime/syntax/idl.vim"": {""insertions"": 1, ""deletions"": 1, ""lines"": 2}, ""runtime/syntax/iss.vim"": {""insertions"": 2, ""deletions"": 2, ""lines"": 4}, ""runtime/syntax/mma.vim"": {""insertions"": 2, ""deletions"": 2, ""lines"": 4}, ""runtime/syntax/objc.vim"": {""insertions"": 1, ""deletions"": 1, ""lines"": 2}, ""runtime/syntax/postscr.vim"": {""insertions"": 6, ""deletions"": 6, ""lines"": 12}, ""runtime/syntax/sgml.vim"": {""insertions"": 3, ""deletions"": 3, ""lines"": 6}, ""runtime/syntax/spup.vim"": {""insertions"": 3, ""deletions"": 3, ""lines"": 6}, ""runtime/syntax/st.vim"": {""insertions"": 2, ""deletions"": 2, ""lines"": 4}, ""runtime/syntax/tcl.vim"": {""insertions"": 1, ""deletions"": 1, ""lines"": 2}, ""runtime/syntax/tmux.vim"": {""insertions"": 1, ""deletions"": 1, ""lines"": 2}}"
2021-09-09 18:45:34,d176ca3dde47c11aae0376c31b7e1ba0939c8c6c,Dominique Pelle,21,2,23,4,"{""src/testdir/test_functions.vim"": {""insertions"": 1, ""deletions"": 0, ""lines"": 1}, ""src/testdir/test_history.vim"": {""insertions"": 16, ""deletions"": 0, ""lines"": 16}, ""src/testdir/test_startup.vim"": {""insertions"": 2, ""deletions"": 2, ""lines"": 4}, ""src/version.c"": {""insertions"": 2, ""deletions"": 0, ""lines"": 2}}"
2021-09-09 15:14:50,6b9efdde7828b3317b64f38bd90fb5a784a654c0,Christian Brabandt,9,3,12,3,"{""src/auto/configure"": {""insertions"": 4, ""deletions"": 2, ""lines"": 6}, ""src/configure.ac"": {""insertions"": 3, ""deletions"": 1, ""lines"": 4}, ""src/version.c"": {""insertions"": 2, ""deletions"": 0, ""lines"": 2}}"
2021-09-09 10:34:19,0325d3967ce7d0fd35bc1472fd476b911b895b76,Bram Moolenaar,11,17,28,3,"{""src/debugger.c"": {""insertions"": 8, ""deletions"": 14, ""lines"": 22}, ""src/testdir/test_debugger.vim"": {""insertions"": 1, ""deletions"": 3, ""lines"": 4}, ""src/version.c"": {""insertions"": 2, ""deletions"": 0, ""lines"": 2}}"
2021-09-09 10:12:03,070ac3433b0ebefd6dc6cd49707fcfa1421b9e67,Christian Brabandt,5,0,5,2,"{""src/eval.c"": {""insertions"": 3, ""deletions"": 0, ""lines"": 3}, ""src/version.c"": {""insertions"": 2, ""deletions"": 0, ""lines"": 2}}"
2021-09-08 18:40:34,072f1c68884a1e2d468a0f39e27fc28168fb4b03,Bram Moolenaar,57,8,65,3,"{""src/debugger.c"": {""insertions"": 26, ""deletions"": 8, ""lines"": 34}, ""src/testdir/test_debugger.vim"": {""insertions"": 29, ""deletions"": 0, ""lines"": 29}, ""src/version.c"": {""insertions"": 2, ""deletions"": 0, ""lines"": 2}}"
2021-09-08 13:33:30,36f691f5f1d0676f080cc97d697d742ed5cc8251,Bram Moolenaar,27,1,28,3,"{""src/testdir/test_trycatch.vim"": {""insertions"": 24, ""deletions"": 0, ""lines"": 24}, ""src/userfunc.c"": {""insertions"": 1, ""deletions"": 1, ""lines"": 2}, ""src/version.c"": {""insertions"": 2, ""deletions"": 0, ""lines"": 2}}"
2021-09-08 12:57:42,fc3b775055c2361e507a1a44008d5a7d37eecf14,Yegappan Lakshmanan,115,13,128,7,"{""src/channel.c"": {""insertions"": 1, ""deletions"": 1, ""lines"": 2}, ""src/digraph.c"": {""insertions"": 2, ""deletions"": 2, ""lines"": 4}, ""src/evalfunc.c"": {""insertions"": 2, ""deletions"": 6, ""lines"": 8}, ""src/terminal.c"": {""insertions"": 1, ""deletions"": 1, ""lines"": 2}, ""src/testdir/test_digraph.vim"": {""insertions"": 11, ""deletions"": 1, ""lines"": 12}, ""src/testdir/test_vim9_builtin.vim"": {""insertions"": 96, ""deletions"": 2, ""lines"": 98}, ""src/version.c"": {""insertions"": 2, ""deletions"": 0, ""lines"": 2}}"
2021-09-08 12:29:46,80c88eac5a81dd9f1a96fc80cb8aab6c84fe7b86,Bram Moolenaar,41,5,46,5,"{""src/ex_docmd.c"": {""insertions"": 3, ""deletions"": 3, ""lines"": 6}, ""src/proto/usercmd.pro"": {""insertions"": 2, ""deletions"": 1, ""lines"": 3}, ""src/testdir/test_cmdline.vim"": {""insertions"": 7, ""deletions"": 0, ""lines"": 7}, ""src/usercmd.c"": {""insertions"": 27, ""deletions"": 1, ""lines"": 28}, ""src/version.c"": {""insertions"": 2, ""deletions"": 0, ""lines"": 2}}"
2021-09-08 10:31:35,a9e3d560877489acf751f99e045ab1d78e13249c,Bram Moolenaar,31,5,36,4,"{""src/errors.h"": {""insertions"": 2, ""deletions"": 2, ""lines"": 4}, ""src/testdir/test_vim9_script.vim"": {""insertions"": 17, ""deletions"": 0, ""lines"": 17}, ""src/version.c"": {""insertions"": 2, ""deletions"": 0, ""lines"": 2}, ""src/vim9script.c"": {""insertions"": 10, ""deletions"": 3, ""lines"": 13}}"
2021-09-07 20:35:34,af2d5d2ce26029a47547c05be964e749bb0310d0,Bram Moolenaar,5,2,7,2,"{""src/testdir/test_vim9_script.vim"": {""insertions"": 3, ""deletions"": 2, ""lines"": 5}, ""src/version.c"": {""insertions"": 2, ""deletions"": 0, ""lines"": 2}}"
2021-09-07 20:12:19,6853c38b78fe5333f95470e1ff3ca6741247e600,Bram Moolenaar,25,0,25,4,"{""src/errors.h"": {""insertions"": 2, ""deletions"": 0, ""lines"": 2}, ""src/evalvars.c"": {""insertions"": 6, ""deletions"": 0, ""lines"": 6}, ""src/testdir/test_vim9_script.vim"": {""insertions"": 15, ""deletions"": 0, ""lines"": 15}, ""src/version.c"": {""insertions"": 2, ""deletions"": 0, ""lines"": 2}}"
2021-09-07 18:45:31,89a54b413a8c96206ce7e038dde81a6eff6cd6b8,Bram Moolenaar,48,31,79,3,"{""src/drawline.c"": {""insertions"": 36, ""deletions"": 31, ""lines"": 67}, ""src/testdir/test_listlbr_utf8.vim"": {""insertions"": 10, ""deletions"": 0, ""lines"": 10}, ""src/version.c"": {""insertions"": 2, ""deletions"": 0, ""lines"": 2}}"
2021-09-07 17:26:53,65b605665997fad54ef39a93199e305af2fe4d7f,Bram Moolenaar,12,1,13,3,"{""src/regexp_nfa.c"": {""insertions"": 2, ""deletions"": 1, ""lines"": 3}, ""src/testdir/test_regexp_utf8.vim"": {""insertions"": 8, ""deletions"": 0, ""lines"": 8}, ""src/version.c"": {""insertions"": 2, ""deletions"": 0, ""lines"": 2}}"
2021-09-06 18:56:56,ddfc05100a29263a682dd96bb924dfde4354a654,Bram Moolenaar,14,0,14,3,"{""src/testdir/test_user_func.vim"": {""insertions"": 5, ""deletions"": 0, ""lines"": 5}, ""src/userfunc.c"": {""insertions"": 7, ""deletions"": 0, ""lines"": 7}, ""src/version.c"": {""insertions"": 2, ""deletions"": 0, ""lines"": 2}}"
2021-09-06 17:19:45,3b318513561b5862944769188ae4af6b70311838,Bram Moolenaar,3,0,3,2,"{""src/dict.c"": {""insertions"": 1, ""deletions"": 0, ""lines"": 1}, ""src/version.c"": {""insertions"": 2, ""deletions"": 0, ""lines"": 2}}"
2021-09-06 16:57:30,3ae5fc9a6a881e0be381e4cc70080ac5908d7520,Bram Moolenaar,12,0,12,3,"{""src/auto/configure"": {""insertions"": 4, ""deletions"": 0, ""lines"": 4}, ""src/configure.ac"": {""insertions"": 6, ""deletions"": 0, ""lines"": 6}, ""src/version.c"": {""insertions"": 2, ""deletions"": 0, ""lines"": 2}}"
2021-09-06 15:10:59,ec1b0968aa90d408a79b5b5dca465f65e69753a1,Bram Moolenaar,13,1,14,3,"{""src/ex_docmd.c"": {""insertions"": 9, ""deletions"": 0, ""lines"": 9}, ""src/testdir/test_usercommands.vim"": {""insertions"": 2, ""deletions"": 1, ""lines"": 3}, ""src/version.c"": {""insertions"": 2, ""deletions"": 0, ""lines"": 2}}"
2021-09-05 14:36:23,01dd6c3732a2f352d598e36336a65049614d7508,Bram Moolenaar,12,2,14,3,"{""src/testdir/test_vim9_func.vim"": {""insertions"": 4, ""deletions"": 0, ""lines"": 4}, ""src/userfunc.c"": {""insertions"": 6, ""deletions"": 2, ""lines"": 8}, ""src/version.c"": {""insertions"": 2, ""deletions"": 0, ""lines"": 2}}"
2021-09-04 19:20:41,2ddb89f8a94425cda1e5491efc80c1ccccb6e08e,Bram Moolenaar,13,2,15,2,"{""src/indent.c"": {""insertions"": 11, ""deletions"": 2, ""lines"": 13}, ""src/version.c"": {""insertions"": 2, ""deletions"": 0, ""lines"": 2}}"
2021-09-04 16:47:28,b7081e135a16091c93f6f5f7525a5c58fb7ca9f9,Bram Moolenaar,34,21,55,5,"{""src/indent.c"": {""insertions"": 21, ""deletions"": 13, ""lines"": 34}, ""src/option.c"": {""insertions"": 6, ""deletions"": 6, ""lines"": 12}, ""src/optionstr.c"": {""insertions"": 2, ""deletions"": 2, ""lines"": 4}, ""src/testdir/test_retab.vim"": {""insertions"": 3, ""deletions"": 0, ""lines"": 3}, ""src/version.c"": {""insertions"": 2, ""deletions"": 0, ""lines"": 2}}"
2021-09-04 12:49:56,10c83dde554b57ab4db71b96a0a02a5b6d1798e9,Bram Moolenaar,18,2,20,3,"{""src/evalfunc.c"": {""insertions"": 2, ""deletions"": 2, ""lines"": 4}, ""src/testdir/test_vim9_builtin.vim"": {""insertions"": 14, ""deletions"": 0, ""lines"": 14}, ""src/version.c"": {""insertions"": 2, ""deletions"": 0, ""lines"": 2}}"
2021-09-04 11:44:01,7f2dd1e90c1d4a30c791fae20014594641769a1e,Dominique Pelle,45,8,53,5,"{""runtime/doc/various.txt"": {""insertions"": 8, ""deletions"": 3, ""lines"": 11}, ""src/ex_cmds.c"": {""insertions"": 1, ""deletions"": 1, ""lines"": 2}, ""src/ex_cmds.h"": {""insertions"": 1, ""deletions"": 1, ""lines"": 2}, ""src/testdir/test_ex_z.vim"": {""insertions"": 33, ""deletions"": 3, ""lines"": 36}, ""src/version.c"": {""insertions"": 2, ""deletions"": 0, ""lines"": 2}}"
2021-09-03 17:21:36,deba5eb195d6ac70171d4973091fa884809fa3fa,Bram Moolenaar,116,5,121,5,"{""runtime/autoload/dist/ft.vim"": {""insertions"": 15, ""deletions"": 4, ""lines"": 19}, ""runtime/doc/filetype.txt"": {""insertions"": 1, ""deletions"": 0, ""lines"": 1}, ""runtime/filetype.vim"": {""insertions"": 4, ""deletions"": 1, ""lines"": 5}, ""src/testdir/test_filetype.vim"": {""insertions"": 94, ""deletions"": 0, ""lines"": 94}, ""src/version.c"": {""insertions"": 2, ""deletions"": 0, ""lines"": 2}}"
2021-09-03 14:50:16,af631f61bc42d0dddafe1bc0c06872cf3aaeb239,Dominique Pelle,116,94,210,2,"{""src/testdir/test_textobjects.vim"": {""insertions"": 114, ""deletions"": 94, ""lines"": 208}, ""src/version.c"": {""insertions"": 2, ""deletions"": 0, ""lines"": 2}}"
2021-09-02 18:05:26,03d257998b6343fc91f9dfd5ffc92eebe98d4d24,Yegappan Lakshmanan,20,0,20,2,"{""src/testdir/test_breakindent.vim"": {""insertions"": 18, ""deletions"": 0, ""lines"": 18}, ""src/version.c"": {""insertions"": 2, ""deletions"": 0, ""lines"": 2}}"
2021-09-02 17:53:07,87e1587b8add93e40340170e4261cdadc4c8940e,Bram Moolenaar,7,0,7,2,"{""src/evalfunc.c"": {""insertions"": 5, ""deletions"": 0, ""lines"": 5}, ""src/version.c"": {""insertions"": 2, ""deletions"": 0, ""lines"": 2}}"
2021-09-02 16:49:06,26a4484da20039b61f18d3565a4b4339c4d1f7e3,Bram Moolenaar,75,5,80,8,"{""src/debugger.c"": {""insertions"": 28, ""deletions"": 0, ""lines"": 28}, ""src/proto/debugger.pro"": {""insertions"": 1, ""deletions"": 0, ""lines"": 1}, ""src/proto/vim9execute.pro"": {""insertions"": 1, ""deletions"": 0, ""lines"": 1}, ""src/testdir/test_debugger.vim"": {""insertions"": 21, ""deletions"": 0, ""lines"": 21}, ""src/version.c"": {""insertions"": 2, ""deletions"": 0, ""lines"": 2}, ""src/vim.h"": {""insertions"": 9, ""deletions"": 2, ""lines"": 11}, ""src/vim9.h"": {""insertions"": 2, ""deletions"": 2, ""lines"": 4}, ""src/vim9execute.c"": {""insertions"": 11, ""deletions"": 1, ""lines"": 12}}"
2021-09-01 14:02:07,04626c243c47af91c2580eaf23e12286180e0e81,Bram Moolenaar,86,1,87,6,"{""src/diff.c"": {""insertions"": 13, ""deletions"": 0, ""lines"": 13}, ""src/move.c"": {""insertions"": 7, ""deletions"": 1, ""lines"": 8}, ""src/testdir/dumps/Test_diff_scroll_change_01.dump"": {""insertions"": 20, ""deletions"": 0, ""lines"": 20}, ""src/testdir/dumps/Test_diff_scroll_change_02.dump"": {""insertions"": 20, ""deletions"": 0, ""lines"": 20}, ""src/testdir/test_diffmode.vim"": {""insertions"": 24, ""deletions"": 0, ""lines"": 24}, ""src/version.c"": {""insertions"": 2, ""deletions"": 0, ""lines"": 2}}"
2021-09-01 12:31:51,6631597452d4644f485a09e4036d117e5f91de70,Bram Moolenaar,13,10,23,3,"{""src/strings.c"": {""insertions"": 1, ""deletions"": 0, ""lines"": 1}, ""src/testdir/test_shell.vim"": {""insertions"": 10, ""deletions"": 10, ""lines"": 20}, ""src/version.c"": {""insertions"": 2, ""deletions"": 0, ""lines"": 2}}"
2021-09-01 11:03:39,b4d82e2a8d610c00139a74970df772eece2daf1c,Bram Moolenaar,9,5,14,3,"{""src/cmdexpand.c"": {""insertions"": 2, ""deletions"": 2, ""lines"": 4}, ""src/testdir/test_cmdline.vim"": {""insertions"": 5, ""deletions"": 3, ""lines"": 8}, ""src/version.c"": {""insertions"": 2, ""deletions"": 0, ""lines"": 2}}"
2021-08-31 18:57:55,20e0c3d27bda770542c1c0e4c81fd6443c12f3a6,Bram Moolenaar,10,3,13,2,"{""src/drawline.c"": {""insertions"": 8, ""deletions"": 3, ""lines"": 11}, ""src/version.c"": {""insertions"": 2, ""deletions"": 0, ""lines"": 2}}"
2021-08-31 18:46:39,ba02e4720f863fdb456e7023520f0a354eec0dcf,Christian Brabandt,239,144,383,16,"{""src/diff.c"": {""insertions"": 1, ""deletions"": 1, ""lines"": 2}, ""src/version.c"": {""insertions"": 2, ""deletions"": 0, ""lines"": 2}, ""src/xdiff/README.txt"": {""insertions"": 1, ""deletions"": 1, ""lines"": 2}, ""src/xdiff/xdiff.h"": {""insertions"": 24, ""deletions"": 13, ""lines"": 37}, ""src/xdiff/xdiffi.c"": {""insertions"": 117, ""deletions"": 59, ""lines"": 176}, ""src/xdiff/xdiffi.h"": {""insertions"": 1, ""deletions"": 1, ""lines"": 2}, ""src/xdiff/xemit.c"": {""insertions"": 26, ""deletions"": 10, ""lines"": 36}, ""src/xdiff/xemit.h"": {""insertions"": 1, ""deletions"": 1, ""lines"": 2}, ""src/xdiff/xhistogram.c"": {""insertions"": 8, ""deletions"": 8, ""lines"": 16}, ""src/xdiff/xinclude.h"": {""insertions"": 8, ""deletions"": 2, ""lines"": 10}, ""src/xdiff/xmacros.h"": {""insertions"": 1, ""deletions"": 1, ""lines"": 2}, ""src/xdiff/xpatience.c"": {""insertions"": 23, ""deletions"": 30, ""lines"": 53}, ""src/xdiff/xprepare.h"": {""insertions"": 1, ""deletions"": 1, ""lines"": 2}, ""src/xdiff/xtypes.h"": {""insertions"": 1, ""deletions"": 1, ""lines"": 2}, ""src/xdiff/xutils.c"": {""insertions"": 23, ""deletions"": 14, ""lines"": 37}, ""src/xdiff/xutils.h"": {""insertions"": 1, ""deletions"": 1, ""lines"": 2}}"
2021-08-31 17:12:51,dca29d9cf46cd1d4d4519211c7af78b6b1c56960,zeertzjq,119,7,126,5,"{""runtime/doc/index.txt"": {""insertions"": 1, ""deletions"": 0, ""lines"": 1}, ""runtime/doc/insert.txt"": {""insertions"": 8, ""deletions"": 0, ""lines"": 8}, ""src/insexpand.c"": {""insertions"": 48, ""deletions"": 7, ""lines"": 55}, ""src/testdir/test_ins_complete.vim"": {""insertions"": 60, ""deletions"": 0, ""lines"": 60}, ""src/version.c"": {""insertions"": 2, ""deletions"": 0, ""lines"": 2}}"
2021-08-30 19:26:16,4eaef9979fc5032606897963f1af37674ee0d422,Bram Moolenaar,11,1,12,3,"{""src/os_unix.c"": {""insertions"": 7, ""deletions"": 1, ""lines"": 8}, ""src/testdir/test_fnamemodify.vim"": {""insertions"": 2, ""deletions"": 0, ""lines"": 2}, ""src/version.c"": {""insertions"": 2, ""deletions"": 0, ""lines"": 2}}"
2021-08-30 17:57:34,de05ae71589f46c5d27642c33fe5eb21b22aaf5d,Dominique Pelle,3,1,4,2,"{""src/strings.c"": {""insertions"": 1, ""deletions"": 1, ""lines"": 2}, ""src/version.c"": {""insertions"": 2, ""deletions"": 0, ""lines"": 2}}"
2021-08-29 20:12:56,a91871262670f9d3a4e5d1c5c6dbc02f85625f7d,Dominique Pelle,3,0,3,2,"{""src/indent.c"": {""insertions"": 1, ""deletions"": 0, ""lines"": 1}, ""src/version.c"": {""insertions"": 2, ""deletions"": 0, ""lines"": 2}}"
2021-08-29 19:55:35,89a9c159f23fb7b3e24e6d09068adfc24a73afcb,Bram Moolenaar,649,242,891,39,"{"".github/workflows/codeql-analysis.yml"": {""insertions"": 1, ""deletions"": 1, ""lines"": 2}, ""CONTRIBUTING.md"": {""insertions"": 1, ""deletions"": 1, ""lines"": 2}, ""README.md"": {""insertions"": 7, ""deletions"": 7, ""lines"": 14}, ""README.txt"": {""insertions"": 6, ""deletions"": 6, ""lines"": 12}, ""README_VIM9.md"": {""insertions"": 1, ""deletions"": 1, ""lines"": 2}, ""nsis/lang/turkish.nsi"": {""insertions"": 7, ""deletions"": 7, ""lines"": 14}, ""pixmaps/gen-inline-pixbufs.sh"": {""insertions"": 2, ""deletions"": 4, ""lines"": 6}, ""runtime/autoload/netrw.vim"": {""insertions"": 213, ""deletions"": 80, ""lines"": 293}, ""runtime/autoload/netrwSettings.vim"": {""insertions"": 4, ""deletions"": 4, ""lines"": 8}, ""runtime/doc/eval.txt"": {""insertions"": 16, ""deletions"": 16, ""lines"": 32}, ""runtime/doc/index.txt"": {""insertions"": 1, ""deletions"": 1, ""lines"": 2}, ""runtime/doc/insert.txt"": {""insertions"": 1, ""deletions"": 1, ""lines"": 2}, ""runtime/doc/options.txt"": {""insertions"": 11, ""deletions"": 4, ""lines"": 15}, ""runtime/doc/pi_netrw.txt"": {""insertions"": 72, ""deletions"": 12, ""lines"": 84}, ""runtime/doc/popup.txt"": {""insertions"": 18, ""deletions"": 7, ""lines"": 25}, ""runtime/doc/syntax.txt"": {""insertions"": 6, ""deletions"": 5, ""lines"": 11}, ""runtime/doc/tags"": {""insertions"": 5, ""deletions"": 0, ""lines"": 5}, ""runtime/doc/term.txt"": {""insertions"": 37, ""deletions"": 1, ""lines"": 38}, ""runtime/doc/terminal.txt"": {""insertions"": 15, ""deletions"": 13, ""lines"": 28}, ""runtime/doc/testing.txt"": {""insertions"": 16, ""deletions"": 8, ""lines"": 24}, ""runtime/doc/textprop.txt"": {""insertions"": 1, ""deletions"": 1, ""lines"": 2}, ""runtime/doc/todo.txt"": {""insertions"": 5, ""deletions"": 1, ""lines"": 6}, ""runtime/doc/version6.txt"": {""insertions"": 1, ""deletions"": 1, ""lines"": 2}, ""runtime/doc/vim9.txt"": {""insertions"": 9, ""deletions"": 6, ""lines"": 15}, ""runtime/filetype.vim"": {""insertions"": 1, ""deletions"": 1, ""lines"": 2}, ""runtime/ftplugin/scala.vim"": {""insertions"": 3, ""deletions"": 3, ""lines"": 6}, ""runtime/indent/scala.vim"": {""insertions"": 6, ""deletions"": 3, ""lines"": 9}, ""runtime/pack/dist/opt/termdebug/plugin/termdebug.vim"": {""insertions"": 5, ""deletions"": 1, ""lines"": 6}, ""runtime/plugin/netrwPlugin.vim"": {""insertions"": 21, ""deletions"": 7, ""lines"": 28}, ""runtime/syntax/cpp.vim"": {""insertions"": 19, ""deletions"": 2, ""lines"": 21}, ""runtime/syntax/gemtext.vim"": {""insertions"": 24, ""deletions"": 0, ""lines"": 24}, ""runtime/syntax/scala.vim"": {""insertions"": 12, ""deletions"": 12, ""lines"": 24}, ""runtime/syntax/structurizr.vim"": {""insertions"": 76, ""deletions"": 0, ""lines"": 76}, ""runtime/tutor/tutor"": {""insertions"": 5, ""deletions"": 5, ""lines"": 10}, ""runtime/tutor/tutor.utf-8"": {""insertions"": 5, ""deletions"": 5, ""lines"": 10}, ""src/INSTALL"": {""insertions"": 1, ""deletions"": 0, ""lines"": 1}, ""src/gvimtutor"": {""insertions"": 1, ""deletions"": 1, ""lines"": 2}, ""src/vimtutor"": {""insertions"": 13, ""deletions"": 13, ""lines"": 26}, ""vimtutor.bat"": {""insertions"": 1, ""deletions"": 1, ""lines"": 2}}"
2021-08-29 10:36:49,6e82351130ddb8d13cf3748b47f07cae77886fc7,Jason Cox,38,8,46,4,"{""runtime/doc/eval.txt"": {""insertions"": 4, ""deletions"": 0, ""lines"": 4}, ""src/strings.c"": {""insertions"": 21, ""deletions"": 0, ""lines"": 21}, ""src/testdir/test_shell.vim"": {""insertions"": 11, ""deletions"": 8, ""lines"": 19}, ""src/version.c"": {""insertions"": 2, ""deletions"": 0, ""lines"": 2}}"
2021-08-28 18:42:50,9dcd349ca85e1df1abd1cbf1c29c0f1574b70bf8,Hu Jialun,21,2,23,4,"{""runtime/doc/options.txt"": {""insertions"": 9, ""deletions"": 0, ""lines"": 9}, ""src/buffer.c"": {""insertions"": 2, ""deletions"": 2, ""lines"": 4}, ""src/testdir/test_modeline.vim"": {""insertions"": 8, ""deletions"": 0, ""lines"": 8}, ""src/version.c"": {""insertions"": 2, ""deletions"": 0, ""lines"": 2}}"
2021-08-28 13:56:06,9aecf79c45da5593e4d8c0de1b2d212edc4765ce,naohiro ono,7,2,9,3,"{""src/testdir/test_cmdline.vim"": {""insertions"": 3, ""deletions"": 1, ""lines"": 4}, ""src/userfunc.c"": {""insertions"": 2, ""deletions"": 1, ""lines"": 3}, ""src/version.c"": {""insertions"": 2, ""deletions"": 0, ""lines"": 2}}"
2021-08-28 12:58:44,c8103b4c2547ce2044469bcd49e3d55907bd33d1,Bram Moolenaar,14,2,16,3,"{""src/testdir/test_vim9_builtin.vim"": {""insertions"": 9, ""deletions"": 0, ""lines"": 9}, ""src/version.c"": {""insertions"": 2, ""deletions"": 0, ""lines"": 2}, ""src/vim9type.c"": {""insertions"": 3, ""deletions"": 2, ""lines"": 5}}"
2021-08-28 12:42:25,5c56da4de8398566ef96122db44ec93e6c2d483a,Bram Moolenaar,10,1,11,3,"{""src/globals.h"": {""insertions"": 1, ""deletions"": 1, ""lines"": 2}, ""src/testdir/test_signs.vim"": {""insertions"": 7, ""deletions"": 0, ""lines"": 7}, ""src/version.c"": {""insertions"": 2, ""deletions"": 0, ""lines"": 2}}"
2021-08-28 10:49:27,60b6e6f6cc60ac99253e1c13bd0cae4ef0e43201,Bram Moolenaar,8,0,8,3,"{""src/evalfunc.c"": {""insertions"": 5, ""deletions"": 0, ""lines"": 5}, ""src/testdir/test_expr.vim"": {""insertions"": 1, ""deletions"": 0, ""lines"": 1}, ""src/version.c"": {""insertions"": 2, ""deletions"": 0, ""lines"": 2}}"
2021-08-28 10:30:12,271906bc067a8f25422016665001d2e44cf618e2,Bram Moolenaar,10,1,11,3,"{""src/job.c"": {""insertions"": 4, ""deletions"": 1, ""lines"": 5}, ""src/testdir/test_channel.vim"": {""insertions"": 4, ""deletions"": 0, ""lines"": 4}, ""src/version.c"": {""insertions"": 2, ""deletions"": 0, ""lines"": 2}}"
2021-08-27 18:59:35,6024c0427ce1196344439997d5e41a6f8546368c,Albert Liu,9,7,16,3,"{""src/cmdexpand.c"": {""insertions"": 3, ""deletions"": 7, ""lines"": 10}, ""src/testdir/test_cmdline.vim"": {""insertions"": 4, ""deletions"": 0, ""lines"": 4}, ""src/version.c"": {""insertions"": 2, ""deletions"": 0, ""lines"": 2}}"
