date,hexsha,author,insertions,deletions,lines,files,files_json
2022-01-02 14:08:18,2b4ecc2c31c00df6e1c8ad46a3e4eabb1f1f84e3,Bram Moolenaar,61,16,77,3,"{""src/testdir/test_vim9_disassemble.vim"": {""insertions"": 37, ""deletions"": 0, ""lines"": 37}, ""src/version.c"": {""insertions"": 2, ""deletions"": 0, ""lines"": 2}, ""src/vim9cmds.c"": {""insertions"": 22, ""deletions"": 16, ""lines"": 38}}"
2022-01-02 13:05:45,b3bd1d39e68e2d697c014b9f85482c2c12a3f909,Bram Moolenaar,58,27,85,3,"{""src/ops.c"": {""insertions"": 42, ""deletions"": 27, ""lines"": 69}, ""src/testdir/test_normal.vim"": {""insertions"": 14, ""deletions"": 0, ""lines"": 14}, ""src/version.c"": {""insertions"": 2, ""deletions"": 0, ""lines"": 2}}"
2022-01-02 12:06:33,a6feb163f0295dfefb829d93ba3fa659b9c262b6,Bram Moolenaar,9,4,13,3,"{""runtime/doc/builtin.txt"": {""insertions"": 1, ""deletions"": 0, ""lines"": 1}, ""runtime/doc/various.txt"": {""insertions"": 2, ""deletions"": 1, ""lines"": 3}, ""src/version.c"": {""insertions"": 6, ""deletions"": 3, ""lines"": 9}}"
2022-01-02 01:04:09,6b1a99dfe33cf5a1d7f82febd81face85ac1b8a6,Bram Moolenaar,3,1,4,2,"{""src/errors.h"": {""insertions"": 1, ""deletions"": 1, ""lines"": 2}, ""src/version.c"": {""insertions"": 2, ""deletions"": 0, ""lines"": 2}}"
2022-01-01 21:59:18,9a846fbaa569b3690d70606f2a86e97f77a05496,Bram Moolenaar,147,43,190,20,"{""src/change.c"": {""insertions"": 1, ""deletions"": 1, ""lines"": 2}, ""src/clientserver.c"": {""insertions"": 1, ""deletions"": 1, ""lines"": 2}, ""src/errors.h"": {""insertions"": 107, ""deletions"": 1, ""lines"": 108}, ""src/eval.c"": {""insertions"": 1, ""deletions"": 1, ""lines"": 2}, ""src/gui_xim.c"": {""insertions"": 6, ""deletions"": 10, ""lines"": 16}, ""src/if_cscope.c"": {""insertions"": 2, ""deletions"": 2, ""lines"": 4}, ""src/if_py_both.h"": {""insertions"": 1, ""deletions"": 1, ""lines"": 2}, ""src/if_python.c"": {""insertions"": 1, ""deletions"": 1, ""lines"": 2}, ""src/if_python3.c"": {""insertions"": 1, ""deletions"": 1, ""lines"": 2}, ""src/if_ruby.c"": {""insertions"": 9, ""deletions"": 9, ""lines"": 18}, ""src/if_tcl.c"": {""insertions"": 1, ""deletions"": 1, ""lines"": 2}, ""src/main.c"": {""insertions"": 1, ""deletions"": 1, ""lines"": 2}, ""src/mark.c"": {""insertions"": 1, ""deletions"": 1, ""lines"": 2}, ""src/match.c"": {""insertions"": 1, ""deletions"": 1, ""lines"": 2}, ""src/memfile.c"": {""insertions"": 5, ""deletions"": 5, ""lines"": 10}, ""src/memline.c"": {""insertions"": 3, ""deletions"": 3, ""lines"": 6}, ""src/terminal.c"": {""insertions"": 1, ""deletions"": 1, ""lines"": 2}, ""src/textprop.c"": {""insertions"": 1, ""deletions"": 1, ""lines"": 2}, ""src/userfunc.c"": {""insertions"": 1, ""deletions"": 1, ""lines"": 2}, ""src/version.c"": {""insertions"": 2, ""deletions"": 0, ""lines"": 2}}"
2022-01-01 19:42:16,b34689010a587e85ff724051f276513a15c634d0,Bram Moolenaar,3,9,12,2,"{""src/evalfunc.c"": {""insertions"": 1, ""deletions"": 9, ""lines"": 10}, ""src/version.c"": {""insertions"": 2, ""deletions"": 0, ""lines"": 2}}"
2022-01-01 19:33:50,cbadefe25a27ded93548eaa7a325d2a04bf55d7c,Bram Moolenaar,104,34,138,14,"{""src/clientserver.c"": {""insertions"": 3, ""deletions"": 3, ""lines"": 6}, ""src/errors.h"": {""insertions"": 73, ""deletions"": 8, ""lines"": 81}, ""src/fileio.c"": {""insertions"": 1, ""deletions"": 1, ""lines"": 2}, ""src/gui.c"": {""insertions"": 2, ""deletions"": 2, ""lines"": 4}, ""src/gui_beval.c"": {""insertions"": 1, ""deletions"": 1, ""lines"": 2}, ""src/gui_w32.c"": {""insertions"": 2, ""deletions"": 3, ""lines"": 5}, ""src/gui_x11.c"": {""insertions"": 4, ""deletions"": 4, ""lines"": 8}, ""src/if_cscope.c"": {""insertions"": 3, ""deletions"": 2, ""lines"": 5}, ""src/if_xcmdsrv.c"": {""insertions"": 2, ""deletions"": 2, ""lines"": 4}, ""src/os_mswin.c"": {""insertions"": 8, ""deletions"": 5, ""lines"": 13}, ""src/sign.c"": {""insertions"": 1, ""deletions"": 1, ""lines"": 2}, ""src/version.c"": {""insertions"": 2, ""deletions"": 0, ""lines"": 2}, ""src/viminfo.c"": {""insertions"": 1, ""deletions"": 1, ""lines"": 2}, ""src/window.c"": {""insertions"": 1, ""deletions"": 1, ""lines"": 2}}"
2022-01-01 18:29:21,1f4a3457a3e55cdacd70ab0d5be587c248fb1ce8,Bram Moolenaar,16,1,17,3,"{""src/testdir/test_vim9_builtin.vim"": {""insertions"": 11, ""deletions"": 0, ""lines"": 11}, ""src/version.c"": {""insertions"": 2, ""deletions"": 0, ""lines"": 2}, ""src/vim9execute.c"": {""insertions"": 3, ""deletions"": 1, ""lines"": 4}}"
2022-01-01 16:31:48,0f7a5e758c5d8be2d8f1ab4a145d1636a36d18b2,Bram Moolenaar,4,0,4,2,"{""src/errors.h"": {""insertions"": 2, ""deletions"": 0, ""lines"": 2}, ""src/version.c"": {""insertions"": 2, ""deletions"": 0, ""lines"": 2}}"
2022-01-01 16:21:00,3a846e6bca25bd3d0addcd9ed3bdd9a6774adbe5,Bram Moolenaar,61,49,110,15,"{""src/errors.h"": {""insertions"": 30, ""deletions"": 0, ""lines"": 30}, ""src/eval.c"": {""insertions"": 4, ""deletions"": 4, ""lines"": 8}, ""src/evalfunc.c"": {""insertions"": 2, ""deletions"": 2, ""lines"": 4}, ""src/evalvars.c"": {""insertions"": 2, ""deletions"": 2, ""lines"": 4}, ""src/evalwindow.c"": {""insertions"": 1, ""deletions"": 1, ""lines"": 2}, ""src/ex_eval.c"": {""insertions"": 2, ""deletions"": 2, ""lines"": 4}, ""src/globals.h"": {""insertions"": 5, ""deletions"": 26, ""lines"": 31}, ""src/list.c"": {""insertions"": 2, ""deletions"": 2, ""lines"": 4}, ""src/match.c"": {""insertions"": 2, ""deletions"": 2, ""lines"": 4}, ""src/menu.c"": {""insertions"": 2, ""deletions"": 2, ""lines"": 4}, ""src/popupmenu.c"": {""insertions"": 1, ""deletions"": 1, ""lines"": 2}, ""src/search.c"": {""insertions"": 2, ""deletions"": 1, ""lines"": 3}, ""src/version.c"": {""insertions"": 2, ""deletions"": 0, ""lines"": 2}, ""src/vim9cmds.c"": {""insertions"": 3, ""deletions"": 3, ""lines"": 6}, ""src/vim9expr.c"": {""insertions"": 1, ""deletions"": 1, ""lines"": 2}}"
2022-01-01 16:01:23,0699b040e6794d27ffdca241a4358d7c31876385,Bram Moolenaar,3,1,4,2,"{""src/typval.c"": {""insertions"": 1, ""deletions"": 1, ""lines"": 2}, ""src/version.c"": {""insertions"": 2, ""deletions"": 0, ""lines"": 2}}"
2022-01-01 15:58:22,74409f62790a93daf0965c71da01ff76aa0fa5a5,Bram Moolenaar,161,131,292,39,"{""src/buffer.c"": {""insertions"": 1, ""deletions"": 1, ""lines"": 2}, ""src/bufwrite.c"": {""insertions"": 1, ""deletions"": 1, ""lines"": 2}, ""src/clientserver.c"": {""insertions"": 1, ""deletions"": 1, ""lines"": 2}, ""src/cmdhist.c"": {""insertions"": 2, ""deletions"": 2, ""lines"": 4}, ""src/dict.c"": {""insertions"": 3, ""deletions"": 3, ""lines"": 6}, ""src/edit.c"": {""insertions"": 1, ""deletions"": 1, ""lines"": 2}, ""src/errors.h"": {""insertions"": 72, ""deletions"": 0, ""lines"": 72}, ""src/eval.c"": {""insertions"": 3, ""deletions"": 3, ""lines"": 6}, ""src/evalfunc.c"": {""insertions"": 2, ""deletions"": 2, ""lines"": 4}, ""src/evalvars.c"": {""insertions"": 5, ""deletions"": 5, ""lines"": 10}, ""src/ex_cmds.c"": {""insertions"": 2, ""deletions"": 2, ""lines"": 4}, ""src/ex_docmd.c"": {""insertions"": 12, ""deletions"": 12, ""lines"": 24}, ""src/ex_eval.c"": {""insertions"": 1, ""deletions"": 1, ""lines"": 2}, ""src/ex_getln.c"": {""insertions"": 2, ""deletions"": 2, ""lines"": 4}, ""src/globals.h"": {""insertions"": 0, ""deletions"": 44, ""lines"": 44}, ""src/gui_w32.c"": {""insertions"": 1, ""deletions"": 1, ""lines"": 2}, ""src/gui_x11.c"": {""insertions"": 1, ""deletions"": 1, ""lines"": 2}, ""src/if_xcmdsrv.c"": {""insertions"": 1, ""deletions"": 1, ""lines"": 2}, ""src/insexpand.c"": {""insertions"": 1, ""deletions"": 1, ""lines"": 2}, ""src/json.c"": {""insertions"": 2, ""deletions"": 2, ""lines"": 4}, ""src/match.c"": {""insertions"": 1, ""deletions"": 1, ""lines"": 2}, ""src/menu.c"": {""insertions"": 1, ""deletions"": 1, ""lines"": 2}, ""src/option.c"": {""insertions"": 9, ""deletions"": 9, ""lines"": 18}, ""src/optionstr.c"": {""insertions"": 1, ""deletions"": 1, ""lines"": 2}, ""src/os_mswin.c"": {""insertions"": 1, ""deletions"": 1, ""lines"": 2}, ""src/quickfix.c"": {""insertions"": 3, ""deletions"": 3, ""lines"": 6}, ""src/regexp_bt.c"": {""insertions"": 4, ""deletions"": 4, ""lines"": 8}, ""src/regexp_nfa.c"": {""insertions"": 2, ""deletions"": 2, ""lines"": 4}, ""src/scriptfile.c"": {""insertions"": 1, ""deletions"": 1, ""lines"": 2}, ""src/sign.c"": {""insertions"": 1, ""deletions"": 1, ""lines"": 2}, ""src/spellfile.c"": {""insertions"": 1, ""deletions"": 1, ""lines"": 2}, ""src/undo.c"": {""insertions"": 3, ""deletions"": 3, ""lines"": 6}, ""src/userfunc.c"": {""insertions"": 5, ""deletions"": 5, ""lines"": 10}, ""src/version.c"": {""insertions"": 2, ""deletions"": 0, ""lines"": 2}, ""src/vim9cmds.c"": {""insertions"": 4, ""deletions"": 4, ""lines"": 8}, ""src/vim9compile.c"": {""insertions"": 1, ""deletions"": 1, ""lines"": 2}, ""src/vim9execute.c"": {""insertions"": 1, ""deletions"": 1, ""lines"": 2}, ""src/vim9expr.c"": {""insertions"": 5, ""deletions"": 5, ""lines"": 10}, ""src/window.c"": {""insertions"": 1, ""deletions"": 1, ""lines"": 2}}"
2022-01-01 14:59:44,56200eed62e59ad831f6564dcafe346e6f97ac20,naohiro ono,40,15,55,8,"{""runtime/doc/builtin.txt"": {""insertions"": 14, ""deletions"": 9, ""lines"": 23}, ""runtime/doc/eval.txt"": {""insertions"": 3, ""deletions"": 0, ""lines"": 3}, ""src/evalvars.c"": {""insertions"": 2, ""deletions"": 0, ""lines"": 2}, ""src/testdir/test_cursor_func.vim"": {""insertions"": 12, ""deletions"": 0, ""lines"": 12}, ""src/testdir/test_normal.vim"": {""insertions"": 4, ""deletions"": 4, ""lines"": 8}, ""src/testdir/test_put.vim"": {""insertions"": 1, ""deletions"": 1, ""lines"": 2}, ""src/version.c"": {""insertions"": 2, ""deletions"": 0, ""lines"": 2}, ""src/vim.h"": {""insertions"": 2, ""deletions"": 1, ""lines"": 3}}"
2022-01-01 14:25:55,e70cec976026ce72d09b6589ebba4677581063ac,Bram Moolenaar,5,3,8,3,"{""src/strings.c"": {""insertions"": 2, ""deletions"": 2, ""lines"": 4}, ""src/version.c"": {""insertions"": 2, ""deletions"": 0, ""lines"": 2}, ""src/vim9compile.c"": {""insertions"": 1, ""deletions"": 1, ""lines"": 2}}"
2022-01-01 14:19:49,460ae5dfca31fa627531c263184849976755cf6b,Bram Moolenaar,403,334,737,70,"{""src/arglist.c"": {""insertions"": 2, ""deletions"": 2, ""lines"": 4}, ""src/autocmd.c"": {""insertions"": 3, ""deletions"": 3, ""lines"": 6}, ""src/blob.c"": {""insertions"": 7, ""deletions"": 7, ""lines"": 14}, ""src/bufwrite.c"": {""insertions"": 1, ""deletions"": 1, ""lines"": 2}, ""src/channel.c"": {""insertions"": 1, ""deletions"": 1, ""lines"": 2}, ""src/cmdexpand.c"": {""insertions"": 2, ""deletions"": 2, ""lines"": 4}, ""src/dict.c"": {""insertions"": 3, ""deletions"": 3, ""lines"": 6}, ""src/diff.c"": {""insertions"": 1, ""deletions"": 1, ""lines"": 2}, ""src/errors.h"": {""insertions"": 130, ""deletions"": 1, ""lines"": 131}, ""src/eval.c"": {""insertions"": 9, ""deletions"": 9, ""lines"": 18}, ""src/evalfunc.c"": {""insertions"": 11, ""deletions"": 11, ""lines"": 22}, ""src/evalvars.c"": {""insertions"": 10, ""deletions"": 10, ""lines"": 20}, ""src/ex_cmds.c"": {""insertions"": 4, ""deletions"": 4, ""lines"": 8}, ""src/ex_docmd.c"": {""insertions"": 6, ""deletions"": 7, ""lines"": 13}, ""src/feature.h"": {""insertions"": 12, ""deletions"": 0, ""lines"": 12}, ""src/fileio.c"": {""insertions"": 2, ""deletions"": 2, ""lines"": 4}, ""src/filepath.c"": {""insertions"": 5, ""deletions"": 5, ""lines"": 10}, ""src/getchar.c"": {""insertions"": 1, ""deletions"": 1, ""lines"": 2}, ""src/globals.h"": {""insertions"": 0, ""deletions"": 74, ""lines"": 74}, ""src/gui_gtk_x11.c"": {""insertions"": 2, ""deletions"": 2, ""lines"": 4}, ""src/gui_x11.c"": {""insertions"": 1, ""deletions"": 1, ""lines"": 2}, ""src/hardcopy.c"": {""insertions"": 1, ""deletions"": 1, ""lines"": 2}, ""src/help.c"": {""insertions"": 1, ""deletions"": 1, ""lines"": 2}, ""src/highlight.c"": {""insertions"": 3, ""deletions"": 3, ""lines"": 6}, ""src/if_cscope.c"": {""insertions"": 1, ""deletions"": 1, ""lines"": 2}, ""src/if_lua.c"": {""insertions"": 2, ""deletions"": 2, ""lines"": 4}, ""src/if_mzsch.c"": {""insertions"": 4, ""deletions"": 4, ""lines"": 8}, ""src/if_perl.xs"": {""insertions"": 1, ""deletions"": 1, ""lines"": 2}, ""src/if_python.c"": {""insertions"": 3, ""deletions"": 3, ""lines"": 6}, ""src/if_python3.c"": {""insertions"": 3, ""deletions"": 3, ""lines"": 6}, ""src/if_ruby.c"": {""insertions"": 2, ""deletions"": 2, ""lines"": 4}, ""src/if_tcl.c"": {""insertions"": 2, ""deletions"": 2, ""lines"": 4}, ""src/if_xcmdsrv.c"": {""insertions"": 1, ""deletions"": 1, ""lines"": 2}, ""src/indent.c"": {""insertions"": 2, ""deletions"": 2, ""lines"": 4}, ""src/insexpand.c"": {""insertions"": 3, ""deletions"": 2, ""lines"": 5}, ""src/job.c"": {""insertions"": 1, ""deletions"": 1, ""lines"": 2}, ""src/list.c"": {""insertions"": 18, ""deletions"": 18, ""lines"": 36}, ""src/main.c"": {""insertions"": 1, ""deletions"": 1, ""lines"": 2}, ""src/map.c"": {""insertions"": 1, ""deletions"": 1, ""lines"": 2}, ""src/match.c"": {""insertions"": 2, ""deletions"": 2, ""lines"": 4}, ""src/mbyte.c"": {""insertions"": 3, ""deletions"": 3, ""lines"": 6}, ""src/message.c"": {""insertions"": 3, ""deletions"": 3, ""lines"": 6}, ""src/misc1.c"": {""insertions"": 6, ""deletions"": 6, ""lines"": 12}, ""src/option.c"": {""insertions"": 22, ""deletions"": 22, ""lines"": 44}, ""src/optionstr.c"": {""insertions"": 1, ""deletions"": 1, ""lines"": 2}, ""src/os_mswin.c"": {""insertions"": 2, ""deletions"": 2, ""lines"": 4}, ""src/os_unix.c"": {""insertions"": 7, ""deletions"": 7, ""lines"": 14}, ""src/os_win32.c"": {""insertions"": 5, ""deletions"": 5, ""lines"": 10}, ""src/popupwin.c"": {""insertions"": 9, ""deletions"": 9, ""lines"": 18}, ""src/profiler.c"": {""insertions"": 1, ""deletions"": 1, ""lines"": 2}, ""src/quickfix.c"": {""insertions"": 10, ""deletions"": 10, ""lines"": 20}, ""src/scriptfile.c"": {""insertions"": 1, ""deletions"": 1, ""lines"": 2}, ""src/search.c"": {""insertions"": 3, ""deletions"": 3, ""lines"": 6}, ""src/session.c"": {""insertions"": 1, ""deletions"": 1, ""lines"": 2}, ""src/sign.c"": {""insertions"": 9, ""deletions"": 9, ""lines"": 18}, ""src/spell.c"": {""insertions"": 1, ""deletions"": 1, ""lines"": 2}, ""src/spellfile.c"": {""insertions"": 8, ""deletions"": 8, ""lines"": 16}, ""src/spellsuggest.c"": {""insertions"": 2, ""deletions"": 2, ""lines"": 4}, ""src/syntax.c"": {""insertions"": 1, ""deletions"": 1, ""lines"": 2}, ""src/tag.c"": {""insertions"": 1, ""deletions"": 1, ""lines"": 2}, ""src/terminal.c"": {""insertions"": 10, ""deletions"": 10, ""lines"": 20}, ""src/testing.c"": {""insertions"": 2, ""deletions"": 2, ""lines"": 4}, ""src/textprop.c"": {""insertions"": 10, ""deletions"": 10, ""lines"": 20}, ""src/typval.c"": {""insertions"": 1, ""deletions"": 1, ""lines"": 2}, ""src/userfunc.c"": {""insertions"": 4, ""deletions"": 4, ""lines"": 8}, ""src/version.c"": {""insertions"": 2, ""deletions"": 0, ""lines"": 2}, ""src/vim9execute.c"": {""insertions"": 10, ""deletions"": 10, ""lines"": 20}, ""src/vim9expr.c"": {""insertions"": 1, ""deletions"": 1, ""lines"": 2}, ""src/vim9instr.c"": {""insertions"": 1, ""deletions"": 1, ""lines"": 2}, ""src/vim9script.c"": {""insertions"": 1, ""deletions"": 1, ""lines"": 2}}"
2022-01-01 12:42:56,b37a65e4bf08c4eec4fa5b81a5efc3945fca44de,Bram Moolenaar,15,0,15,3,"{""src/getchar.c"": {""insertions"": 3, ""deletions"": 0, ""lines"": 3}, ""src/testdir/test_feedkeys.vim"": {""insertions"": 10, ""deletions"": 0, ""lines"": 10}, ""src/version.c"": {""insertions"": 2, ""deletions"": 0, ""lines"": 2}}"
2022-01-01 12:17:00,b79ee0c299d786627784f7304ba84b80e78ece26,Bram Moolenaar,22,5,27,4,"{""runtime/doc/vim9.txt"": {""insertions"": 2, ""deletions"": 5, ""lines"": 7}, ""src/evalfunc.c"": {""insertions"": 1, ""deletions"": 0, ""lines"": 1}, ""src/testdir/test_vim9_script.vim"": {""insertions"": 17, ""deletions"": 0, ""lines"": 17}, ""src/version.c"": {""insertions"": 2, ""deletions"": 0, ""lines"": 2}}"
2022-01-01 11:38:42,654b729c4c9951f2a46c161d1e9fefdc223fc94e,Alex Vear,7,5,12,3,"{""runtime/filetype.vim"": {""insertions"": 3, ""deletions"": 3, ""lines"": 6}, ""src/testdir/test_filetype.vim"": {""insertions"": 2, ""deletions"": 2, ""lines"": 4}, ""src/version.c"": {""insertions"": 2, ""deletions"": 0, ""lines"": 2}}"
2022-01-01 00:55:28,096ca73dacd748a65d080197b842eef6f4423096,Bram Moolenaar,6,2,8,3,"{""src/errors.h"": {""insertions"": 3, ""deletions"": 1, ""lines"": 4}, ""src/message.c"": {""insertions"": 1, ""deletions"": 1, ""lines"": 2}, ""src/version.c"": {""insertions"": 2, ""deletions"": 0, ""lines"": 2}}"
2021-12-31 23:15:53,d0819d11ecdf3bca4b0800ef905091b5e175b6f4,Bram Moolenaar,4,1,5,2,"{""src/regexp_bt.c"": {""insertions"": 2, ""deletions"": 1, ""lines"": 3}, ""src/version.c"": {""insertions"": 2, ""deletions"": 0, ""lines"": 2}}"
2021-12-31 22:49:24,436b5adc9770a2568209dd5ab1f98bd1afc91898,Bram Moolenaar,427,403,830,62,"{""src/arglist.c"": {""insertions"": 1, ""deletions"": 1, ""lines"": 2}, ""src/autocmd.c"": {""insertions"": 1, ""deletions"": 1, ""lines"": 2}, ""src/blob.c"": {""insertions"": 2, ""deletions"": 2, ""lines"": 4}, ""src/bufwrite.c"": {""insertions"": 4, ""deletions"": 4, ""lines"": 8}, ""src/channel.c"": {""insertions"": 6, ""deletions"": 6, ""lines"": 12}, ""src/clipboard.c"": {""insertions"": 2, ""deletions"": 2, ""lines"": 4}, ""src/cmdexpand.c"": {""insertions"": 2, ""deletions"": 2, ""lines"": 4}, ""src/debugger.c"": {""insertions"": 2, ""deletions"": 2, ""lines"": 4}, ""src/dict.c"": {""insertions"": 2, ""deletions"": 2, ""lines"": 4}, ""src/errors.h"": {""insertions"": 48, ""deletions"": 1, ""lines"": 49}, ""src/eval.c"": {""insertions"": 1, ""deletions"": 1, ""lines"": 2}, ""src/evalfunc.c"": {""insertions"": 18, ""deletions"": 18, ""lines"": 36}, ""src/evalvars.c"": {""insertions"": 9, ""deletions"": 9, ""lines"": 18}, ""src/evalwindow.c"": {""insertions"": 2, ""deletions"": 2, ""lines"": 4}, ""src/ex_cmds.c"": {""insertions"": 8, ""deletions"": 8, ""lines"": 16}, ""src/ex_docmd.c"": {""insertions"": 19, ""deletions"": 19, ""lines"": 38}, ""src/ex_eval.c"": {""insertions"": 10, ""deletions"": 10, ""lines"": 20}, ""src/ex_getln.c"": {""insertions"": 1, ""deletions"": 1, ""lines"": 2}, ""src/fileio.c"": {""insertions"": 1, ""deletions"": 1, ""lines"": 2}, ""src/filepath.c"": {""insertions"": 2, ""deletions"": 2, ""lines"": 4}, ""src/globals.h"": {""insertions"": 2, ""deletions"": 30, ""lines"": 32}, ""src/gui_gtk_x11.c"": {""insertions"": 1, ""deletions"": 1, ""lines"": 2}, ""src/gui_haiku.cc"": {""insertions"": 2, ""deletions"": 2, ""lines"": 4}, ""src/gui_photon.c"": {""insertions"": 1, ""deletions"": 1, ""lines"": 2}, ""src/gui_w32.c"": {""insertions"": 1, ""deletions"": 1, ""lines"": 2}, ""src/gui_x11.c"": {""insertions"": 3, ""deletions"": 3, ""lines"": 6}, ""src/highlight.c"": {""insertions"": 1, ""deletions"": 1, ""lines"": 2}, ""src/indent.c"": {""insertions"": 8, ""deletions"": 5, ""lines"": 13}, ""src/insexpand.c"": {""insertions"": 1, ""deletions"": 1, ""lines"": 2}, ""src/job.c"": {""insertions"": 36, ""deletions"": 36, ""lines"": 72}, ""src/json.c"": {""insertions"": 2, ""deletions"": 2, ""lines"": 4}, ""src/list.c"": {""insertions"": 3, ""deletions"": 3, ""lines"": 6}, ""src/map.c"": {""insertions"": 2, ""deletions"": 2, ""lines"": 4}, ""src/mark.c"": {""insertions"": 4, ""deletions"": 4, ""lines"": 8}, ""src/match.c"": {""insertions"": 5, ""deletions"": 5, ""lines"": 10}, ""src/mbyte.c"": {""insertions"": 2, ""deletions"": 2, ""lines"": 4}, ""src/menu.c"": {""insertions"": 3, ""deletions"": 3, ""lines"": 6}, ""src/message.c"": {""insertions"": 1, ""deletions"": 1, ""lines"": 2}, ""src/misc2.c"": {""insertions"": 2, ""deletions"": 2, ""lines"": 4}, ""src/ops.c"": {""insertions"": 1, ""deletions"": 1, ""lines"": 2}, ""src/option.c"": {""insertions"": 13, ""deletions"": 13, ""lines"": 26}, ""src/optionstr.c"": {""insertions"": 83, ""deletions"": 83, ""lines"": 166}, ""src/popupwin.c"": {""insertions"": 8, ""deletions"": 8, ""lines"": 16}, ""src/quickfix.c"": {""insertions"": 2, ""deletions"": 2, ""lines"": 4}, ""src/screen.c"": {""insertions"": 7, ""deletions"": 7, ""lines"": 14}, ""src/scriptfile.c"": {""insertions"": 4, ""deletions"": 4, ""lines"": 8}, ""src/search.c"": {""insertions"": 7, ""deletions"": 7, ""lines"": 14}, ""src/sign.c"": {""insertions"": 13, ""deletions"": 13, ""lines"": 26}, ""src/spell.c"": {""insertions"": 2, ""deletions"": 2, ""lines"": 4}, ""src/spellfile.c"": {""insertions"": 1, ""deletions"": 1, ""lines"": 2}, ""src/strings.c"": {""insertions"": 5, ""deletions"": 5, ""lines"": 10}, ""src/syntax.c"": {""insertions"": 6, ""deletions"": 6, ""lines"": 12}, ""src/terminal.c"": {""insertions"": 9, ""deletions"": 9, ""lines"": 18}, ""src/testing.c"": {""insertions"": 12, ""deletions"": 12, ""lines"": 24}, ""src/textprop.c"": {""insertions"": 9, ""deletions"": 9, ""lines"": 18}, ""src/time.c"": {""insertions"": 5, ""deletions"": 5, ""lines"": 10}, ""src/userfunc.c"": {""insertions"": 4, ""deletions"": 4, ""lines"": 8}, ""src/version.c"": {""insertions"": 2, ""deletions"": 0, ""lines"": 2}, ""src/vim9cmds.c"": {""insertions"": 6, ""deletions"": 6, ""lines"": 12}, ""src/vim9execute.c"": {""insertions"": 1, ""deletions"": 1, ""lines"": 2}, ""src/vim9script.c"": {""insertions"": 2, ""deletions"": 2, ""lines"": 4}, ""src/window.c"": {""insertions"": 4, ""deletions"": 4, ""lines"": 8}}"
2021-12-31 19:59:55,f1474d801bbdb73406dd3d1f931f515f99e86dfa,Bram Moolenaar,145,47,192,9,"{""src/alloc.c"": {""insertions"": 2, ""deletions"": 2, ""lines"": 4}, ""src/arglist.c"": {""insertions"": 2, ""deletions"": 2, ""lines"": 4}, ""src/autocmd.c"": {""insertions"": 3, ""deletions"": 4, ""lines"": 7}, ""src/blob.c"": {""insertions"": 1, ""deletions"": 1, ""lines"": 2}, ""src/blowfish.c"": {""insertions"": 5, ""deletions"": 5, ""lines"": 10}, ""src/buffer.c"": {""insertions"": 9, ""deletions"": 11, ""lines"": 20}, ""src/bufwrite.c"": {""insertions"": 21, ""deletions"": 22, ""lines"": 43}, ""src/errors.h"": {""insertions"": 100, ""deletions"": 0, ""lines"": 100}, ""src/version.c"": {""insertions"": 2, ""deletions"": 0, ""lines"": 2}}"
2021-12-31 18:49:43,6d0570117ac86b7979bf249de5741088212d6e17,Bram Moolenaar,122,45,167,13,"{""src/autocmd.c"": {""insertions"": 5, ""deletions"": 5, ""lines"": 10}, ""src/bufwrite.c"": {""insertions"": 8, ""deletions"": 8, ""lines"": 16}, ""src/errors.h"": {""insertions"": 79, ""deletions"": 2, ""lines"": 81}, ""src/evalvars.c"": {""insertions"": 1, ""deletions"": 1, ""lines"": 2}, ""src/ex_docmd.c"": {""insertions"": 3, ""deletions"": 3, ""lines"": 6}, ""src/ex_eval.c"": {""insertions"": 3, ""deletions"": 3, ""lines"": 6}, ""src/ex_getln.c"": {""insertions"": 1, ""deletions"": 1, ""lines"": 2}, ""src/fileio.c"": {""insertions"": 9, ""deletions"": 9, ""lines"": 18}, ""src/getchar.c"": {""insertions"": 2, ""deletions"": 2, ""lines"": 4}, ""src/gui.c"": {""insertions"": 1, ""deletions"": 1, ""lines"": 2}, ""src/locale.c"": {""insertions"": 1, ""deletions"": 1, ""lines"": 2}, ""src/map.c"": {""insertions"": 7, ""deletions"": 9, ""lines"": 16}, ""src/version.c"": {""insertions"": 2, ""deletions"": 0, ""lines"": 2}}"
2021-12-31 17:33:47,ef089f50f9d6685c7a0ab94f9133576d7beec32b,Yegappan Lakshmanan,6,0,6,2,"{""src/version.c"": {""insertions"": 2, ""deletions"": 0, ""lines"": 2}, ""src/xxd/xxd.c"": {""insertions"": 4, ""deletions"": 0, ""lines"": 4}}"
2021-12-31 17:25:48,1a9922243a90f213894d5c58cd063465eea3350f,Bram Moolenaar,112,51,163,15,"{""src/arglist.c"": {""insertions"": 3, ""deletions"": 3, ""lines"": 6}, ""src/bufwrite.c"": {""insertions"": 2, ""deletions"": 1, ""lines"": 3}, ""src/errors.h"": {""insertions"": 64, ""deletions"": 3, ""lines"": 67}, ""src/evalvars.c"": {""insertions"": 1, ""deletions"": 1, ""lines"": 2}, ""src/ex_cmds2.c"": {""insertions"": 1, ""deletions"": 1, ""lines"": 2}, ""src/ex_docmd.c"": {""insertions"": 12, ""deletions"": 12, ""lines"": 24}, ""src/ex_eval.c"": {""insertions"": 4, ""deletions"": 4, ""lines"": 8}, ""src/globals.h"": {""insertions"": 0, ""deletions"": 3, ""lines"": 3}, ""src/help.c"": {""insertions"": 1, ""deletions"": 1, ""lines"": 2}, ""src/scriptfile.c"": {""insertions"": 2, ""deletions"": 2, ""lines"": 4}, ""src/usercmd.c"": {""insertions"": 11, ""deletions"": 11, ""lines"": 22}, ""src/userfunc.c"": {""insertions"": 3, ""deletions"": 3, ""lines"": 6}, ""src/version.c"": {""insertions"": 2, ""deletions"": 0, ""lines"": 2}, ""src/vim9cmds.c"": {""insertions"": 3, ""deletions"": 3, ""lines"": 6}, ""src/vim9compile.c"": {""insertions"": 3, ""deletions"": 3, ""lines"": 6}}"
2021-12-31 15:21:53,4b1478093eb8b8bebc94b1f596e0afc25db4d189,zeertzjq,2,1,3,2,"{""src/evalfunc.c"": {""insertions"": 0, ""deletions"": 1, ""lines"": 1}, ""src/version.c"": {""insertions"": 2, ""deletions"": 0, ""lines"": 2}}"
2021-12-31 15:09:27,eb822a280cf4706f7e67319ced1cdf3243b27e20,Bram Moolenaar,77,29,106,8,"{""src/debugger.c"": {""insertions"": 1, ""deletions"": 1, ""lines"": 2}, ""src/errors.h"": {""insertions"": 48, ""deletions"": 0, ""lines"": 48}, ""src/ex_cmds.c"": {""insertions"": 11, ""deletions"": 12, ""lines"": 23}, ""src/globals.h"": {""insertions"": 0, ""deletions"": 1, ""lines"": 1}, ""src/help.c"": {""insertions"": 6, ""deletions"": 6, ""lines"": 12}, ""src/sign.c"": {""insertions"": 8, ""deletions"": 8, ""lines"": 16}, ""src/spellfile.c"": {""insertions"": 1, ""deletions"": 1, ""lines"": 2}, ""src/version.c"": {""insertions"": 2, ""deletions"": 0, ""lines"": 2}}"
2021-12-31 14:06:45,9a015111a56d0011ced40d98f46a9841d1457b51,Bram Moolenaar,48,3,51,4,"{""src/testdir/test_vim9_assign.vim"": {""insertions"": 3, ""deletions"": 3, ""lines"": 6}, ""src/testdir/test_vim9_func.vim"": {""insertions"": 12, ""deletions"": 0, ""lines"": 12}, ""src/version.c"": {""insertions"": 2, ""deletions"": 0, ""lines"": 2}, ""src/vim9compile.c"": {""insertions"": 31, ""deletions"": 0, ""lines"": 31}}"
2021-12-31 12:59:53,6ad84ab3e48d9490e4139df04f2c55b136f5501d,Yegappan Lakshmanan,605,562,1167,2,"{""src/insexpand.c"": {""insertions"": 603, ""deletions"": 562, ""lines"": 1165}, ""src/version.c"": {""insertions"": 2, ""deletions"": 0, ""lines"": 2}}"
2021-12-31 12:19:22,1fa3de1ce806ba18ebcc00c6d9a0678a84735463,zeertzjq,51,1,52,3,"{""src/ex_cmds.c"": {""insertions"": 5, ""deletions"": 1, ""lines"": 6}, ""src/testdir/test_excmd.vim"": {""insertions"": 44, ""deletions"": 0, ""lines"": 44}, ""src/version.c"": {""insertions"": 2, ""deletions"": 0, ""lines"": 2}}"
2021-12-30 20:24:12,04fb916684829f6aa12f33f14d0d0023b458f200,Bram Moolenaar,798,822,1620,9,"{""runtime/doc/builtin.txt"": {""insertions"": 1, ""deletions"": 1, ""lines"": 2}, ""runtime/doc/change.txt"": {""insertions"": 3, ""deletions"": 2, ""lines"": 5}, ""runtime/doc/eval.txt"": {""insertions"": 8, ""deletions"": 6, ""lines"": 14}, ""runtime/doc/filetype.txt"": {""insertions"": 3, ""deletions"": 3, ""lines"": 6}, ""runtime/doc/insert.txt"": {""insertions"": 6, ""deletions"": 1, ""lines"": 7}, ""runtime/doc/tags"": {""insertions"": 4, ""deletions"": 2, ""lines"": 6}, ""runtime/doc/todo.txt"": {""insertions"": 1, ""deletions"": 4, ""lines"": 5}, ""runtime/doc/usr_41.txt"": {""insertions"": 764, ""deletions"": 795, ""lines"": 1559}, ""runtime/syntax/vim.vim"": {""insertions"": 8, ""deletions"": 8, ""lines"": 16}}"
2021-12-30 17:09:05,d293981d2b76b40013143fe2302b910585e50808,Bram Moolenaar,17,3,20,3,"{""src/testdir/test_vim9_func.vim"": {""insertions"": 14, ""deletions"": 3, ""lines"": 17}, ""src/version.c"": {""insertions"": 2, ""deletions"": 0, ""lines"": 2}, ""src/vim9compile.c"": {""insertions"": 1, ""deletions"": 0, ""lines"": 1}}"
2021-12-30 15:29:18,94f3192b03ed27474db80b4d3a409e107140738b,Bram Moolenaar,19,4,23,3,"{""src/charset.c"": {""insertions"": 9, ""deletions"": 4, ""lines"": 13}, ""src/testdir/test_regexp_latin.vim"": {""insertions"": 8, ""deletions"": 0, ""lines"": 8}, ""src/version.c"": {""insertions"": 2, ""deletions"": 0, ""lines"": 2}}"
2021-12-30 14:49:43,4c13e5e6763c6eb36a343a2b8235ea227202e952,Bram Moolenaar,17,2,19,3,"{""src/regexp.c"": {""insertions"": 7, ""deletions"": 2, ""lines"": 9}, ""src/testdir/test_regexp_latin.vim"": {""insertions"": 8, ""deletions"": 0, ""lines"": 8}, ""src/version.c"": {""insertions"": 2, ""deletions"": 0, ""lines"": 2}}"
2021-12-30 13:59:20,cfe3af284a26178f4838df7c7489b2a1edd4c3a1,Bram Moolenaar,14,9,23,2,"{""src/version.c"": {""insertions"": 2, ""deletions"": 0, ""lines"": 2}, ""src/vim9type.c"": {""insertions"": 12, ""deletions"": 9, ""lines"": 21}}"
2021-12-30 13:45:57,f38aad85cf8e4e930c96cb843bc136949c8dbd29,zeertzjq,4,2,6,2,"{""src/ex_docmd.c"": {""insertions"": 2, ""deletions"": 2, ""lines"": 4}, ""src/version.c"": {""insertions"": 2, ""deletions"": 0, ""lines"": 2}}"
2021-12-30 13:32:09,1c67f3a9779b99bed7aacb3108abbb649445d3ed,Bram Moolenaar,7,1,8,3,"{""src/message.c"": {""insertions"": 4, ""deletions"": 1, ""lines"": 5}, ""src/testdir/runtest.vim"": {""insertions"": 1, ""deletions"": 0, ""lines"": 1}, ""src/version.c"": {""insertions"": 2, ""deletions"": 0, ""lines"": 2}}"
2021-12-30 13:29:00,13789bf10338a0d049c78acfdc0870fc63e63f4f,Bram Moolenaar,53,0,53,4,"{""src/testdir/test_vim9_assign.vim"": {""insertions"": 30, ""deletions"": 0, ""lines"": 30}, ""src/userfunc.c"": {""insertions"": 6, ""deletions"": 0, ""lines"": 6}, ""src/version.c"": {""insertions"": 2, ""deletions"": 0, ""lines"": 2}, ""src/vim9type.c"": {""insertions"": 15, ""deletions"": 0, ""lines"": 15}}"
2021-12-30 11:40:53,5d2e007ccbfbd749a1f201d06965b8811ff50e6e,Yegappan Lakshmanan,757,594,1351,3,"{""src/insexpand.c"": {""insertions"": 736, ""deletions"": 594, ""lines"": 1330}, ""src/testdir/test_ins_complete.vim"": {""insertions"": 19, ""deletions"": 0, ""lines"": 19}, ""src/version.c"": {""insertions"": 2, ""deletions"": 0, ""lines"": 2}}"
2021-12-30 10:51:45,491669701c72578f273db53e579d8a03a9deac0c,Bram Moolenaar,3,4,7,2,"{""src/diff.c"": {""insertions"": 1, ""deletions"": 4, ""lines"": 5}, ""src/version.c"": {""insertions"": 2, ""deletions"": 0, ""lines"": 2}}"
2021-12-30 10:32:25,8e7cc6b920ddea37deaa5e6b7b3bdfff2222d137,Bram Moolenaar,4,0,4,2,"{""src/insexpand.c"": {""insertions"": 2, ""deletions"": 0, ""lines"": 2}, ""src/version.c"": {""insertions"": 2, ""deletions"": 0, ""lines"": 2}}"
2021-12-29 19:41:47,ab16ad33ba10dd12ff6660fa57b88f1a30ddd8ba,dbivolaru,94,7,101,6,"{""runtime/doc/autocmd.txt"": {""insertions"": 2, ""deletions"": 2, ""lines"": 4}, ""src/ex_docmd.c"": {""insertions"": 1, ""deletions"": 2, ""lines"": 3}, ""src/os_unix.c"": {""insertions"": 36, ""deletions"": 3, ""lines"": 39}, ""src/proto/ex_docmd.pro"": {""insertions"": 1, ""deletions"": 0, ""lines"": 1}, ""src/testdir/test_signals.vim"": {""insertions"": 52, ""deletions"": 0, ""lines"": 52}, ""src/version.c"": {""insertions"": 2, ""deletions"": 0, ""lines"": 2}}"
2021-12-29 19:22:44,94fb8274ca8c93a10102d41c8bcc848f75cb7334,Bram Moolenaar,36,1,37,5,"{""src/match.c"": {""insertions"": 1, ""deletions"": 1, ""lines"": 2}, ""src/testdir/dumps/Test_match_with_incsearch_1.dump"": {""insertions"": 6, ""deletions"": 0, ""lines"": 6}, ""src/testdir/dumps/Test_match_with_incsearch_2.dump"": {""insertions"": 6, ""deletions"": 0, ""lines"": 6}, ""src/testdir/test_match.vim"": {""insertions"": 21, ""deletions"": 0, ""lines"": 21}, ""src/version.c"": {""insertions"": 2, ""deletions"": 0, ""lines"": 2}}"
2021-12-29 18:16:21,5a664fe57fe7ba65a771bc95ef1c205e4db193b7,Yegappan Lakshmanan,4,1,5,3,"{""src/os_mswin.c"": {""insertions"": 1, ""deletions"": 1, ""lines"": 2}, ""src/testdir/test_fnamemodify.vim"": {""insertions"": 1, ""deletions"": 0, ""lines"": 1}, ""src/version.c"": {""insertions"": 2, ""deletions"": 0, ""lines"": 2}}"
2021-12-29 18:09:13,ba26367fea3b63df49d274f3d5cca0af38402add,Bram Moolenaar,42,19,61,5,"{""src/cindent.c"": {""insertions"": 17, ""deletions"": 14, ""lines"": 31}, ""src/proto/cindent.pro"": {""insertions"": 1, ""deletions"": 0, ""lines"": 1}, ""src/search.c"": {""insertions"": 7, ""deletions"": 5, ""lines"": 12}, ""src/testdir/test_textformat.vim"": {""insertions"": 15, ""deletions"": 0, ""lines"": 15}, ""src/version.c"": {""insertions"": 2, ""deletions"": 0, ""lines"": 2}}"
2021-12-29 17:38:46,edc6f103907a004b9e2265e232dc8be8bc594601,Yegappan Lakshmanan,552,346,898,3,"{""src/insexpand.c"": {""insertions"": 505, ""deletions"": 345, ""lines"": 850}, ""src/testdir/test_ins_complete.vim"": {""insertions"": 45, ""deletions"": 1, ""lines"": 46}, ""src/version.c"": {""insertions"": 2, ""deletions"": 0, ""lines"": 2}}"
2021-12-29 16:44:48,ccc1644f95e7833c23fa0d440e42293c1622fdcb,Sean Dewar,26,16,42,2,"{""src/testdir/test_diffmode.vim"": {""insertions"": 24, ""deletions"": 16, ""lines"": 40}, ""src/version.c"": {""insertions"": 2, ""deletions"": 0, ""lines"": 2}}"
2021-12-29 16:05:31,5d20fbf2e79b96a39abbdadc486b656cdcc67ed6,Bram Moolenaar,33,1,34,3,"{""src/edit.c"": {""insertions"": 15, ""deletions"": 0, ""lines"": 15}, ""src/testdir/test_textformat.vim"": {""insertions"": 16, ""deletions"": 1, ""lines"": 17}, ""src/version.c"": {""insertions"": 2, ""deletions"": 0, ""lines"": 2}}"
2021-12-29 15:15:47,5ea5f373729589acb38ce3f3ca338e8a6d398bdc,Bram Moolenaar,28,2,30,3,"{""src/change.c"": {""insertions"": 3, ""deletions"": 2, ""lines"": 5}, ""src/testdir/test_textformat.vim"": {""insertions"": 23, ""deletions"": 0, ""lines"": 23}, ""src/version.c"": {""insertions"": 2, ""deletions"": 0, ""lines"": 2}}"
2021-12-29 14:39:08,3d0abad5bf4fe125e219f1b56c4e8200cb900e2a,Richard Doty,25,14,39,3,"{""src/ex_docmd.c"": {""insertions"": 16, ""deletions"": 14, ""lines"": 30}, ""src/testdir/test_cd.vim"": {""insertions"": 7, ""deletions"": 0, ""lines"": 7}, ""src/version.c"": {""insertions"": 2, ""deletions"": 0, ""lines"": 2}}"
2021-12-29 14:09:32,264d3ddac0f9474816c20a0e92014d6f7f4b08ac,Bram Moolenaar,28,2,30,3,"{""src/testdir/test_textformat.vim"": {""insertions"": 15, ""deletions"": 0, ""lines"": 15}, ""src/textformat.c"": {""insertions"": 11, ""deletions"": 2, ""lines"": 13}, ""src/version.c"": {""insertions"": 2, ""deletions"": 0, ""lines"": 2}}"
2021-12-29 11:59:53,febb78fa1798e0f95983b3f7881419a754886df5,Bram Moolenaar,5,0,5,2,"{""src/diff.c"": {""insertions"": 3, ""deletions"": 0, ""lines"": 3}, ""src/version.c"": {""insertions"": 2, ""deletions"": 0, ""lines"": 2}}"
2021-12-28 20:59:56,c97f9a55bd020b94d92c392516d763ed5e43d872,Bram Moolenaar,11,9,20,7,"{""src/ex_docmd.c"": {""insertions"": 1, ""deletions"": 1, ""lines"": 2}, ""src/ex_getln.c"": {""insertions"": 4, ""deletions"": 4, ""lines"": 8}, ""src/normal.c"": {""insertions"": 1, ""deletions"": 1, ""lines"": 2}, ""src/proto/ex_getln.pro"": {""insertions"": 1, ""deletions"": 1, ""lines"": 2}, ""src/register.c"": {""insertions"": 1, ""deletions"": 1, ""lines"": 2}, ""src/userfunc.c"": {""insertions"": 1, ""deletions"": 1, ""lines"": 2}, ""src/version.c"": {""insertions"": 2, ""deletions"": 0, ""lines"": 2}}"
2021-12-28 20:53:30,10c75c4a09a604ea674a2700aacb55914750b86d,Bram Moolenaar,5,0,5,2,"{""src/option.c"": {""insertions"": 3, ""deletions"": 0, ""lines"": 3}, ""src/version.c"": {""insertions"": 2, ""deletions"": 0, ""lines"": 2}}"
2021-12-28 20:49:56,11ceb7d949e7c2fb36509a79dfe8df54fbdfa666,Bram Moolenaar,6,3,9,2,"{""src/userfunc.c"": {""insertions"": 4, ""deletions"": 3, ""lines"": 7}, ""src/version.c"": {""insertions"": 2, ""deletions"": 0, ""lines"": 2}}"
2021-12-28 20:18:50,8c697e3698e7dbe0a3c4524ac360b78ceb852b23,Bram Moolenaar,4,1,5,2,"{""src/userfunc.c"": {""insertions"": 2, ""deletions"": 1, ""lines"": 3}, ""src/version.c"": {""insertions"": 2, ""deletions"": 0, ""lines"": 2}}"
2021-12-28 20:03:43,92f246e4f9936f15471d5ee71b9afd5f3e6e0653,Bram Moolenaar,10,1,11,2,"{""src/evalwindow.c"": {""insertions"": 8, ""deletions"": 1, ""lines"": 9}, ""src/version.c"": {""insertions"": 2, ""deletions"": 0, ""lines"": 2}}"
2021-12-28 18:30:05,06f6095623cfcc72da08748c058d13b465652fd4,Bram Moolenaar,131,4,135,7,"{""src/diff.c"": {""insertions"": 12, ""deletions"": 4, ""lines"": 16}, ""src/testdir/dumps/Test_diff_bin_01.dump"": {""insertions"": 20, ""deletions"": 0, ""lines"": 20}, ""src/testdir/dumps/Test_diff_bin_02.dump"": {""insertions"": 20, ""deletions"": 0, ""lines"": 20}, ""src/testdir/dumps/Test_diff_bin_03.dump"": {""insertions"": 20, ""deletions"": 0, ""lines"": 20}, ""src/testdir/dumps/Test_diff_bin_04.dump"": {""insertions"": 20, ""deletions"": 0, ""lines"": 20}, ""src/testdir/test_diffmode.vim"": {""insertions"": 37, ""deletions"": 0, ""lines"": 37}, ""src/version.c"": {""insertions"": 2, ""deletions"": 0, ""lines"": 2}}"
2021-12-28 17:55:26,7473a84cf935f64ddd4ea7fe7eee0f9c51c50b60,Bram Moolenaar,56,22,78,5,"{""src/errors.h"": {""insertions"": 2, ""deletions"": 2, ""lines"": 4}, ""src/testdir/test_vim9_func.vim"": {""insertions"": 12, ""deletions"": 3, ""lines"": 15}, ""src/userfunc.c"": {""insertions"": 33, ""deletions"": 16, ""lines"": 49}, ""src/version.c"": {""insertions"": 2, ""deletions"": 0, ""lines"": 2}, ""src/vim9compile.c"": {""insertions"": 7, ""deletions"": 1, ""lines"": 8}}"
2021-12-28 17:23:12,4bf1006cae7e87259ccd5219128c3dba75774441,Bram Moolenaar,23,1,24,3,"{""src/testdir/test_vim9_func.vim"": {""insertions"": 19, ""deletions"": 1, ""lines"": 20}, ""src/userfunc.c"": {""insertions"": 2, ""deletions"": 0, ""lines"": 2}, ""src/version.c"": {""insertions"": 2, ""deletions"": 0, ""lines"": 2}}"
2021-12-28 15:51:45,8bb3fe4d4dcd27c02e903f6772fdc8fe2e9eba70,ichizok,98,31,129,10,"{""ci/config.mk.clang-12.sed"": {""insertions"": 2, ""deletions"": 2, ""lines"": 4}, ""ci/config.mk.clang.sed"": {""insertions"": 1, ""deletions"": 1, ""lines"": 2}, ""ci/config.mk.sed"": {""insertions"": 2, ""deletions"": 1, ""lines"": 3}, ""src/Makefile"": {""insertions"": 13, ""deletions"": 12, ""lines"": 25}, ""src/auto/configure"": {""insertions"": 12, ""deletions"": 0, ""lines"": 12}, ""src/config.mk.in"": {""insertions"": 6, ""deletions"": 0, ""lines"": 6}, ""src/configure.ac"": {""insertions"": 6, ""deletions"": 0, ""lines"": 6}, ""src/if_ruby.c"": {""insertions"": 47, ""deletions"": 10, ""lines"": 57}, ""src/version.c"": {""insertions"": 2, ""deletions"": 0, ""lines"": 2}, ""src/vim.h"": {""insertions"": 7, ""deletions"": 5, ""lines"": 12}}"
2021-12-28 13:54:41,d9da86e94ea8dbaa056270a666892945c40a6674,Lewis Russell,146,116,262,2,"{""src/diff.c"": {""insertions"": 144, ""deletions"": 116, ""lines"": 260}, ""src/version.c"": {""insertions"": 2, ""deletions"": 0, ""lines"": 2}}"
2021-12-28 13:15:05,90c317f2246a7fb4bd4e3feb0778b53627bc9fad,Bram Moolenaar,41,4,45,3,"{""src/evalwindow.c"": {""insertions"": 19, ""deletions"": 4, ""lines"": 23}, ""src/testdir/test_autochdir.vim"": {""insertions"": 20, ""deletions"": 0, ""lines"": 20}, ""src/version.c"": {""insertions"": 2, ""deletions"": 0, ""lines"": 2}}"
2021-12-28 11:24:49,8b6256f6ec075cca40341e61ebc9f538b4902dd1,Bram Moolenaar,39,14,53,5,"{""runtime/doc/builtin.txt"": {""insertions"": 4, ""deletions"": 3, ""lines"": 7}, ""src/evalbuffer.c"": {""insertions"": 18, ""deletions"": 9, ""lines"": 27}, ""src/testdir/test_vim9_builtin.vim"": {""insertions"": 12, ""deletions"": 1, ""lines"": 13}, ""src/typval.c"": {""insertions"": 3, ""deletions"": 1, ""lines"": 4}, ""src/version.c"": {""insertions"": 2, ""deletions"": 0, ""lines"": 2}}"
2021-12-27 21:42:57,be4e223eadaa765bf2957f196e4d4b6014057bd1,Bram Moolenaar,7,6,13,2,"{""src/testdir/test_function_lists.vim"": {""insertions"": 5, ""deletions"": 6, ""lines"": 11}, ""src/version.c"": {""insertions"": 2, ""deletions"": 0, ""lines"": 2}}"
2021-12-27 21:33:07,a4d131d11052cafcc5baad2273ef48e0dd4d09c5,Bram Moolenaar,1837,1549,3386,16,"{""runtime/autoload/ccomplete.vim"": {""insertions"": 484, ""deletions"": 425, ""lines"": 909}, ""runtime/doc/change.txt"": {""insertions"": 7, ""deletions"": 1, ""lines"": 8}, ""runtime/doc/cmdline.txt"": {""insertions"": 10, ""deletions"": 1, ""lines"": 11}, ""runtime/doc/editing.txt"": {""insertions"": 4, ""deletions"": 1, ""lines"": 5}, ""runtime/doc/fold.txt"": {""insertions"": 0, ""deletions"": 2, ""lines"": 2}, ""runtime/doc/help.txt"": {""insertions"": 1, ""deletions"": 1, ""lines"": 2}, ""runtime/doc/insert.txt"": {""insertions"": 7, ""deletions"": 1, ""lines"": 8}, ""runtime/doc/map.txt"": {""insertions"": 2, ""deletions"": 2, ""lines"": 4}, ""runtime/doc/motion.txt"": {""insertions"": 4, ""deletions"": 1, ""lines"": 5}, ""runtime/doc/options.txt"": {""insertions"": 1, ""deletions"": 1, ""lines"": 2}, ""runtime/doc/remote.txt"": {""insertions"": 1, ""deletions"": 1, ""lines"": 2}, ""runtime/doc/repeat.txt"": {""insertions"": 4, ""deletions"": 1, ""lines"": 5}, ""runtime/doc/tags"": {""insertions"": 514, ""deletions"": 504, ""lines"": 1018}, ""runtime/doc/todo.txt"": {""insertions"": 6, ""deletions"": 29, ""lines"": 35}, ""runtime/filetype.vim"": {""insertions"": 1, ""deletions"": 1, ""lines"": 2}, ""src/po/tr.po"": {""insertions"": 791, ""deletions"": 577, ""lines"": 1368}}"
2021-12-27 21:28:34,1cae5a0a034d0545360387407a7a409310f1efe2,Bram Moolenaar,10137,10092,20229,6,"{""runtime/doc/Makefile"": {""insertions"": 2, ""deletions"": 0, ""lines"": 2}, ""runtime/doc/builtin.txt"": {""insertions"": 10125, ""deletions"": 0, ""lines"": 10125}, ""runtime/doc/eval.txt"": {""insertions"": 6, ""deletions"": 10091, ""lines"": 10097}, ""runtime/doc/help.txt"": {""insertions"": 1, ""deletions"": 0, ""lines"": 1}, ""runtime/doc/remote.txt"": {""insertions"": 1, ""deletions"": 1, ""lines"": 2}, ""src/version.c"": {""insertions"": 2, ""deletions"": 0, ""lines"": 2}}"
2021-12-27 20:57:06,8dac2acd6a79d571ff5409d9c90b4c9e73237eb4,Bram Moolenaar,31,8,39,7,"{""src/errors.h"": {""insertions"": 4, ""deletions"": 0, ""lines"": 4}, ""src/eval.c"": {""insertions"": 5, ""deletions"": 2, ""lines"": 7}, ""src/evalbuffer.c"": {""insertions"": 2, ""deletions"": 0, ""lines"": 2}, ""src/indent.c"": {""insertions"": 6, ""deletions"": 0, ""lines"": 6}, ""src/testdir/test_vim9_builtin.vim"": {""insertions"": 8, ""deletions"": 0, ""lines"": 8}, ""src/textprop.c"": {""insertions"": 4, ""deletions"": 6, ""lines"": 10}, ""src/version.c"": {""insertions"": 2, ""deletions"": 0, ""lines"": 2}}"
2021-12-27 19:28:37,4b28ba3245df8274303c79429972f9dc9438e4aa,Bram Moolenaar,21,1,22,3,"{""src/insexpand.c"": {""insertions"": 6, ""deletions"": 1, ""lines"": 7}, ""src/testdir/test_ins_complete.vim"": {""insertions"": 13, ""deletions"": 0, ""lines"": 13}, ""src/version.c"": {""insertions"": 2, ""deletions"": 0, ""lines"": 2}}"
2021-12-27 17:21:41,af4a61a85d6e8cacc35324f266934bc463a21673,Dominique Pelle,109,107,216,58,"{""src/alloc.c"": {""insertions"": 1, ""deletions"": 1, ""lines"": 2}, ""src/blowfish.c"": {""insertions"": 1, ""deletions"": 1, ""lines"": 2}, ""src/buffer.c"": {""insertions"": 2, ""deletions"": 2, ""lines"": 4}, ""src/cindent.c"": {""insertions"": 5, ""deletions"": 5, ""lines"": 10}, ""src/clipboard.c"": {""insertions"": 3, ""deletions"": 3, ""lines"": 6}, ""src/diff.c"": {""insertions"": 3, ""deletions"": 3, ""lines"": 6}, ""src/drawline.c"": {""insertions"": 2, ""deletions"": 2, ""lines"": 4}, ""src/edit.c"": {""insertions"": 2, ""deletions"": 2, ""lines"": 4}, ""src/ex_cmds.c"": {""insertions"": 1, ""deletions"": 1, ""lines"": 2}, ""src/ex_docmd.c"": {""insertions"": 2, ""deletions"": 2, ""lines"": 4}, ""src/findfile.c"": {""insertions"": 2, ""deletions"": 2, ""lines"": 4}, ""src/fold.c"": {""insertions"": 1, ""deletions"": 1, ""lines"": 2}, ""src/getchar.c"": {""insertions"": 3, ""deletions"": 3, ""lines"": 6}, ""src/gui.c"": {""insertions"": 8, ""deletions"": 8, ""lines"": 16}, ""src/gui_athena.c"": {""insertions"": 1, ""deletions"": 1, ""lines"": 2}, ""src/gui_gtk.c"": {""insertions"": 1, ""deletions"": 1, ""lines"": 2}, ""src/gui_motif.c"": {""insertions"": 1, ""deletions"": 1, ""lines"": 2}, ""src/gui_photon.c"": {""insertions"": 1, ""deletions"": 1, ""lines"": 2}, ""src/gui_w32.c"": {""insertions"": 5, ""deletions"": 5, ""lines"": 10}, ""src/gui_xmebw.c"": {""insertions"": 1, ""deletions"": 1, ""lines"": 2}, ""src/if_python.c"": {""insertions"": 2, ""deletions"": 2, ""lines"": 4}, ""src/if_python3.c"": {""insertions"": 1, ""deletions"": 1, ""lines"": 2}, ""src/if_xcmdsrv.c"": {""insertions"": 1, ""deletions"": 1, ""lines"": 2}, ""src/main.c"": {""insertions"": 1, ""deletions"": 1, ""lines"": 2}, ""src/memline.c"": {""insertions"": 1, ""deletions"": 1, ""lines"": 2}, ""src/menu.c"": {""insertions"": 3, ""deletions"": 3, ""lines"": 6}, ""src/message.c"": {""insertions"": 1, ""deletions"": 1, ""lines"": 2}, ""src/misc1.c"": {""insertions"": 1, ""deletions"": 1, ""lines"": 2}, ""src/move.c"": {""insertions"": 2, ""deletions"": 2, ""lines"": 4}, ""src/option.c"": {""insertions"": 2, ""deletions"": 2, ""lines"": 4}, ""src/os_amiga.c"": {""insertions"": 1, ""deletions"": 1, ""lines"": 2}, ""src/os_mac.h"": {""insertions"": 1, ""deletions"": 1, ""lines"": 2}, ""src/os_mac_conv.c"": {""insertions"": 1, ""deletions"": 1, ""lines"": 2}, ""src/os_mswin.c"": {""insertions"": 2, ""deletions"": 2, ""lines"": 4}, ""src/os_unix.c"": {""insertions"": 1, ""deletions"": 1, ""lines"": 2}, ""src/os_win32.c"": {""insertions"": 2, ""deletions"": 2, ""lines"": 4}, ""src/os_win32.h"": {""insertions"": 1, ""deletions"": 1, ""lines"": 2}, ""src/quickfix.c"": {""insertions"": 1, ""deletions"": 1, ""lines"": 2}, ""src/regexp_nfa.c"": {""insertions"": 2, ""deletions"": 2, ""lines"": 4}, ""src/screen.c"": {""insertions"": 11, ""deletions"": 11, ""lines"": 22}, ""src/scriptfile.c"": {""insertions"": 1, ""deletions"": 1, ""lines"": 2}, ""src/spell.c"": {""insertions"": 4, ""deletions"": 4, ""lines"": 8}, ""src/spellfile.c"": {""insertions"": 2, ""deletions"": 2, ""lines"": 4}, ""src/spellsuggest.c"": {""insertions"": 1, ""deletions"": 1, ""lines"": 2}, ""src/strings.c"": {""insertions"": 1, ""deletions"": 1, ""lines"": 2}, ""src/term.c"": {""insertions"": 1, ""deletions"": 1, ""lines"": 2}, ""src/terminal.c"": {""insertions"": 1, ""deletions"": 1, ""lines"": 2}, ""src/testdir/test_debugger.vim"": {""insertions"": 1, ""deletions"": 1, ""lines"": 2}, ""src/testdir/test_source.vim"": {""insertions"": 1, ""deletions"": 1, ""lines"": 2}, ""src/textformat.c"": {""insertions"": 1, ""deletions"": 1, ""lines"": 2}, ""src/userfunc.c"": {""insertions"": 1, ""deletions"": 1, ""lines"": 2}, ""src/version.c"": {""insertions"": 2, ""deletions"": 0, ""lines"": 2}, ""src/vim.h"": {""insertions"": 1, ""deletions"": 1, ""lines"": 2}, ""src/vim9.h"": {""insertions"": 1, ""deletions"": 1, ""lines"": 2}, ""src/vim9cmds.c"": {""insertions"": 1, ""deletions"": 1, ""lines"": 2}, ""src/vim9execute.c"": {""insertions"": 1, ""deletions"": 1, ""lines"": 2}, ""src/winclip.c"": {""insertions"": 2, ""deletions"": 2, ""lines"": 4}, ""src/window.c"": {""insertions"": 2, ""deletions"": 2, ""lines"": 4}}"
2021-12-27 15:39:57,5da36052a4bb0f3a9747ec3a8ab9d85e058e39fa,Bram Moolenaar,204,125,329,4,"{""runtime/doc/eval.txt"": {""insertions"": 186, ""deletions"": 109, ""lines"": 295}, ""runtime/doc/vim9.txt"": {""insertions"": 10, ""deletions"": 10, ""lines"": 20}, ""src/version.c"": {""insertions"": 2, ""deletions"": 0, ""lines"": 2}, ""src/vim9expr.c"": {""insertions"": 6, ""deletions"": 6, ""lines"": 12}}"
2021-12-27 12:52:07,bf7ff61af490a2fbc0d9c7d42f3bb7eb7d37127e,Bram Moolenaar,368,258,626,2,"{""src/insexpand.c"": {""insertions"": 366, ""deletions"": 258, ""lines"": 624}, ""src/version.c"": {""insertions"": 2, ""deletions"": 0, ""lines"": 2}}"
2021-12-27 12:29:19,ef8f04b1d1daf2e0be8fa38dedcae84ebfc5ffb4,Bram Moolenaar,9,0,9,3,"{""src/evalfunc.c"": {""insertions"": 1, ""deletions"": 0, ""lines"": 1}, ""src/testdir/test_vim9_builtin.vim"": {""insertions"": 6, ""deletions"": 0, ""lines"": 6}, ""src/version.c"": {""insertions"": 2, ""deletions"": 0, ""lines"": 2}}"
2021-12-27 11:54:37,23018f2d4b6f85512af117d346eee9b14a4637a6,Bram Moolenaar,15,1,16,3,"{""src/list.c"": {""insertions"": 2, ""deletions"": 1, ""lines"": 3}, ""src/testdir/test_vim9_builtin.vim"": {""insertions"": 11, ""deletions"": 0, ""lines"": 11}, ""src/version.c"": {""insertions"": 2, ""deletions"": 0, ""lines"": 2}}"
2021-12-27 10:35:52,bbdd3fb804bf69684f7b0f49d3c0a0b039daec02,Bram Moolenaar,4,2,6,3,"{""runtime/filetype.vim"": {""insertions"": 1, ""deletions"": 1, ""lines"": 2}, ""src/testdir/test_filetype.vim"": {""insertions"": 1, ""deletions"": 1, ""lines"": 2}, ""src/version.c"": {""insertions"": 2, ""deletions"": 0, ""lines"": 2}}"
2021-12-26 21:54:43,27708e6c7b6f444fd599f3dc5015336b002b874d,Yegappan Lakshmanan,60,4,64,9,"{""runtime/doc/fold.txt"": {""insertions"": 6, ""deletions"": 1, ""lines"": 7}, ""src/optionstr.c"": {""insertions"": 4, ""deletions"": 1, ""lines"": 5}, ""src/strings.c"": {""insertions"": 0, ""deletions"": 2, ""lines"": 2}, ""src/testdir/test_blob.vim"": {""insertions"": 14, ""deletions"": 0, ""lines"": 14}, ""src/testdir/test_expr.vim"": {""insertions"": 1, ""deletions"": 0, ""lines"": 1}, ""src/testdir/test_filter_map.vim"": {""insertions"": 1, ""deletions"": 0, ""lines"": 1}, ""src/testdir/test_fold.vim"": {""insertions"": 31, ""deletions"": 0, ""lines"": 31}, ""src/testdir/test_listdict.vim"": {""insertions"": 1, ""deletions"": 0, ""lines"": 1}, ""src/version.c"": {""insertions"": 2, ""deletions"": 0, ""lines"": 2}}"
2021-12-26 20:20:34,c553a21e189aa440515a19c5b25f8b6b50c5d53d,Bram Moolenaar,61,30,91,6,"{""src/errors.h"": {""insertions"": 35, ""deletions"": 1, ""lines"": 36}, ""src/ex_cmds.c"": {""insertions"": 2, ""deletions"": 2, ""lines"": 4}, ""src/testdir/test_user_func.vim"": {""insertions"": 1, ""deletions"": 1, ""lines"": 2}, ""src/userfunc.c"": {""insertions"": 18, ""deletions"": 23, ""lines"": 41}, ""src/version.c"": {""insertions"": 2, ""deletions"": 0, ""lines"": 2}, ""src/viminfo.c"": {""insertions"": 3, ""deletions"": 3, ""lines"": 6}}"
2021-12-26 18:09:31,1f318c6eac3d894a3fb9c68c53512cdd75e8f6b4,Bram Moolenaar,8,16,24,2,"{""runtime/doc/vim9.txt"": {""insertions"": 6, ""deletions"": 16, ""lines"": 22}, ""src/version.c"": {""insertions"": 2, ""deletions"": 0, ""lines"": 2}}"
2021-12-26 17:31:35,c88ac94a0bdc70012558813404821fe077f1de20,Bram Moolenaar,7,1,8,3,"{""runtime/filetype.vim"": {""insertions"": 4, ""deletions"": 0, ""lines"": 4}, ""src/testdir/test_filetype.vim"": {""insertions"": 1, ""deletions"": 1, ""lines"": 2}, ""src/version.c"": {""insertions"": 2, ""deletions"": 0, ""lines"": 2}}"
2021-12-26 17:18:14,7319981f21cbd51267c8cc80b37ed56d8ee78ea7,Bram Moolenaar,65,9,74,3,"{""src/evalfunc.c"": {""insertions"": 22, ""deletions"": 2, ""lines"": 24}, ""src/testdir/test_vim9_builtin.vim"": {""insertions"": 41, ""deletions"": 7, ""lines"": 48}, ""src/version.c"": {""insertions"": 2, ""deletions"": 0, ""lines"": 2}}"
2021-12-26 15:00:07,71c41255f6a074c4df4dc6f9e97d347e565253a1,Bram Moolenaar,11,6,17,3,"{""src/normal.c"": {""insertions"": 1, ""deletions"": 6, ""lines"": 7}, ""src/testdir/test_normal.vim"": {""insertions"": 8, ""deletions"": 0, ""lines"": 8}, ""src/version.c"": {""insertions"": 2, ""deletions"": 0, ""lines"": 2}}"
2021-12-26 14:23:22,9c23f9bb5fe435b28245ba8ac65aa0ca6b902c04,Bram Moolenaar,62,26,88,6,"{""src/proto/userfunc.pro"": {""insertions"": 1, ""deletions"": 1, ""lines"": 2}, ""src/testdir/test_vim9_func.vim"": {""insertions"": 20, ""deletions"": 0, ""lines"": 20}, ""src/userfunc.c"": {""insertions"": 16, ""deletions"": 10, ""lines"": 26}, ""src/version.c"": {""insertions"": 2, ""deletions"": 0, ""lines"": 2}, ""src/vim9compile.c"": {""insertions"": 20, ""deletions"": 14, ""lines"": 34}, ""src/vim9execute.c"": {""insertions"": 3, ""deletions"": 1, ""lines"": 4}}"
2021-12-26 12:07:30,71eb3ad5790ef3d16369e2fceb040980d75539cf,Bram Moolenaar,68,3,71,6,"{""runtime/doc/options.txt"": {""insertions"": 10, ""deletions"": 0, ""lines"": 10}, ""runtime/doc/vim9.txt"": {""insertions"": 1, ""deletions"": 0, ""lines"": 1}, ""src/scriptfile.c"": {""insertions"": 7, ""deletions"": 2, ""lines"": 9}, ""src/structs.h"": {""insertions"": 1, ""deletions"": 0, ""lines"": 1}, ""src/testdir/test_vim9_script.vim"": {""insertions"": 47, ""deletions"": 1, ""lines"": 48}, ""src/version.c"": {""insertions"": 2, ""deletions"": 0, ""lines"": 2}}"
2021-12-26 10:51:39,8bb65f230d3025037f34021a72616038da0601ee,Yegappan Lakshmanan,265,8,273,13,"{""runtime/doc/diff.txt"": {""insertions"": 10, ""deletions"": 0, ""lines"": 10}, ""runtime/doc/fold.txt"": {""insertions"": 7, ""deletions"": 0, ""lines"": 7}, ""runtime/doc/options.txt"": {""insertions"": 20, ""deletions"": 0, ""lines"": 20}, ""runtime/doc/print.txt"": {""insertions"": 5, ""deletions"": 0, ""lines"": 5}, ""src/optionstr.c"": {""insertions"": 83, ""deletions"": 8, ""lines"": 91}, ""src/testdir/test_diffmode.vim"": {""insertions"": 20, ""deletions"": 0, ""lines"": 20}, ""src/testdir/test_edit.vim"": {""insertions"": 10, ""deletions"": 0, ""lines"": 10}, ""src/testdir/test_fold.vim"": {""insertions"": 26, ""deletions"": 0, ""lines"": 26}, ""src/testdir/test_gf.vim"": {""insertions"": 26, ""deletions"": 0, ""lines"": 26}, ""src/testdir/test_gui.vim"": {""insertions"": 9, ""deletions"": 0, ""lines"": 9}, ""src/testdir/test_hardcopy.vim"": {""insertions"": 8, ""deletions"": 0, ""lines"": 8}, ""src/testdir/test_normal.vim"": {""insertions"": 39, ""deletions"": 0, ""lines"": 39}, ""src/version.c"": {""insertions"": 2, ""deletions"": 0, ""lines"": 2}}"
2021-12-25 22:10:42,ec86520f946a40d5c4a92d6a11d6928faa13abd4,Bram Moolenaar,5,2,7,2,"{""src/evalfunc.c"": {""insertions"": 3, ""deletions"": 2, ""lines"": 5}, ""src/version.c"": {""insertions"": 2, ""deletions"": 0, ""lines"": 2}}"
2021-12-25 22:00:49,fb9dcb080b5143d3021a8c1d6deaf143f2ca3a48,Bram Moolenaar,20,0,20,2,"{""src/testdir/test_vim9_disassemble.vim"": {""insertions"": 18, ""deletions"": 0, ""lines"": 18}, ""src/version.c"": {""insertions"": 2, ""deletions"": 0, ""lines"": 2}}"
2021-12-25 21:43:28,1802405d71da20dff510690bf14f6da085836125,Bram Moolenaar,80,12,92,7,"{""src/evalfunc.c"": {""insertions"": 52, ""deletions"": 4, ""lines"": 56}, ""src/globals.h"": {""insertions"": 1, ""deletions"": 0, ""lines"": 1}, ""src/list.c"": {""insertions"": 1, ""deletions"": 1, ""lines"": 2}, ""src/testdir/test_vim9_builtin.vim"": {""insertions"": 20, ""deletions"": 3, ""lines"": 23}, ""src/testdir/test_vim9_expr.vim"": {""insertions"": 3, ""deletions"": 3, ""lines"": 6}, ""src/testdir/test_vim9_script.vim"": {""insertions"": 1, ""deletions"": 1, ""lines"": 2}, ""src/version.c"": {""insertions"": 2, ""deletions"": 0, ""lines"": 2}}"
2021-12-25 19:58:22,db8e5c21b98c5998df4ab94e0b94bd9fdaf35c83,Bram Moolenaar,17,0,17,2,"{""src/testdir/test_vim9_func.vim"": {""insertions"": 15, ""deletions"": 0, ""lines"": 15}, ""src/version.c"": {""insertions"": 2, ""deletions"": 0, ""lines"": 2}}"
2021-12-25 19:43:44,ae1068afde6dfc6fd3e3f54512dbd089e1559053,Bram Moolenaar,6,1,7,3,"{""src/evalfunc.c"": {""insertions"": 2, ""deletions"": 1, ""lines"": 3}, ""src/testdir/test_vim9_builtin.vim"": {""insertions"": 2, ""deletions"": 0, ""lines"": 2}, ""src/version.c"": {""insertions"": 2, ""deletions"": 0, ""lines"": 2}}"
2021-12-25 19:29:21,223d0a6bc8dc68039ceb6660de9576fafe178d73,Bram Moolenaar,27,1,28,6,"{""src/errors.h"": {""insertions"": 2, ""deletions"": 0, ""lines"": 2}, ""src/evalfunc.c"": {""insertions"": 2, ""deletions"": 1, ""lines"": 3}, ""src/proto/typval.pro"": {""insertions"": 1, ""deletions"": 0, ""lines"": 1}, ""src/testdir/test_vim9_builtin.vim"": {""insertions"": 3, ""deletions"": 0, ""lines"": 3}, ""src/typval.c"": {""insertions"": 17, ""deletions"": 0, ""lines"": 17}, ""src/version.c"": {""insertions"": 2, ""deletions"": 0, ""lines"": 2}}"
2021-12-25 18:23:24,5cd647935d0834b3064aa36384b8f6730fadadd6,Bram Moolenaar,51,23,74,7,"{""src/proto/vim9instr.pro"": {""insertions"": 1, ""deletions"": 1, ""lines"": 2}, ""src/testdir/test_vim9_disassemble.vim"": {""insertions"": 12, ""deletions"": 11, ""lines"": 23}, ""src/version.c"": {""insertions"": 2, ""deletions"": 0, ""lines"": 2}, ""src/vim9cmds.c"": {""insertions"": 1, ""deletions"": 1, ""lines"": 2}, ""src/vim9compile.c"": {""insertions"": 9, ""deletions"": 2, ""lines"": 11}, ""src/vim9execute.c"": {""insertions"": 12, ""deletions"": 2, ""lines"": 14}, ""src/vim9instr.c"": {""insertions"": 14, ""deletions"": 6, ""lines"": 20}}"
2021-12-25 15:13:18,35cfd793aad7c4bfba4a9bedf5c435c44e4293d0,Bram Moolenaar,12,5,17,2,"{""src/ui.c"": {""insertions"": 10, ""deletions"": 5, ""lines"": 15}, ""src/version.c"": {""insertions"": 2, ""deletions"": 0, ""lines"": 2}}"
2021-12-25 11:20:30,7f4a628efefd893a3cad3a1fdde340c98360f705,Yegappan Lakshmanan,16,0,16,3,"{"".github/workflows/ci.yml"": {""insertions"": 7, ""deletions"": 0, ""lines"": 7}, "".github/workflows/codeql-analysis.yml"": {""insertions"": 7, ""deletions"": 0, ""lines"": 7}, ""src/version.c"": {""insertions"": 2, ""deletions"": 0, ""lines"": 2}}"
2021-12-24 21:36:12,d787e40fdbe6f4d8bf47d36186c1d9d51c29b853,Bram Moolenaar,141,117,258,5,"{""src/evalvars.c"": {""insertions"": 122, ""deletions"": 113, ""lines"": 235}, ""src/proto/evalvars.pro"": {""insertions"": 2, ""deletions"": 1, ""lines"": 3}, ""src/testdir/test_vim9_expr.vim"": {""insertions"": 14, ""deletions"": 1, ""lines"": 15}, ""src/version.c"": {""insertions"": 2, ""deletions"": 0, ""lines"": 2}, ""src/vim9instr.c"": {""insertions"": 1, ""deletions"": 2, ""lines"": 3}}"
2021-12-24 20:47:38,e7f4abd38b6e05100c699900c8f87281e363beb2,Yegappan Lakshmanan,84,39,123,8,"{""src/evalfunc.c"": {""insertions"": 1, ""deletions"": 12, ""lines"": 13}, ""src/evalvars.c"": {""insertions"": 12, ""deletions"": 1, ""lines"": 13}, ""src/option.c"": {""insertions"": 1, ""deletions"": 26, ""lines"": 27}, ""src/proto/userfunc.pro"": {""insertions"": 1, ""deletions"": 0, ""lines"": 1}, ""src/testdir/test_expr.vim"": {""insertions"": 15, ""deletions"": 0, ""lines"": 15}, ""src/testdir/test_normal.vim"": {""insertions"": 12, ""deletions"": 0, ""lines"": 12}, ""src/userfunc.c"": {""insertions"": 40, ""deletions"": 0, ""lines"": 40}, ""src/version.c"": {""insertions"": 2, ""deletions"": 0, ""lines"": 2}}"
2021-12-24 20:28:03,73a024209cbfbd5b39a2e974084d807c6131e2ed,Nir Lichtman,99,29,128,8,"{""runtime/doc/editing.txt"": {""insertions"": 9, ""deletions"": 2, ""lines"": 11}, ""runtime/doc/index.txt"": {""insertions"": 1, ""deletions"": 0, ""lines"": 1}, ""src/arglist.c"": {""insertions"": 27, ""deletions"": 0, ""lines"": 27}, ""src/ex_cmdidxs.h"": {""insertions"": 27, ""deletions"": 27, ""lines"": 54}, ""src/ex_cmds.h"": {""insertions"": 3, ""deletions"": 0, ""lines"": 3}, ""src/proto/arglist.pro"": {""insertions"": 1, ""deletions"": 0, ""lines"": 1}, ""src/testdir/test_arglist.vim"": {""insertions"": 29, ""deletions"": 0, ""lines"": 29}, ""src/version.c"": {""insertions"": 2, ""deletions"": 0, ""lines"": 2}}"
2021-12-24 19:54:52,806da5176e9e9ab011d927c4ca33a8dde1769539,Bram Moolenaar,6,4,10,3,"{""src/errors.h"": {""insertions"": 3, ""deletions"": 3, ""lines"": 6}, ""src/testdir/test_mapping.vim"": {""insertions"": 1, ""deletions"": 1, ""lines"": 2}, ""src/version.c"": {""insertions"": 2, ""deletions"": 0, ""lines"": 2}}"
2021-12-24 19:24:47,b6db1467622be046dbf00b2213fd9f49f4f3cccb,Bram Moolenaar,5,2,7,4,"{""src/autocmd.c"": {""insertions"": 1, ""deletions"": 1, ""lines"": 2}, ""src/testdir/test_arglist.vim"": {""insertions"": 1, ""deletions"": 1, ""lines"": 2}, ""src/testdir/test_autocmd.vim"": {""insertions"": 1, ""deletions"": 0, ""lines"": 1}, ""src/version.c"": {""insertions"": 2, ""deletions"": 0, ""lines"": 2}}"
2021-12-24 18:58:46,679140c56bbabf12a199d94f584b1b9dfc9809fd,Bram Moolenaar,8,10,18,2,"{""src/testdir/test_arglist.vim"": {""insertions"": 6, ""deletions"": 10, ""lines"": 16}, ""src/version.c"": {""insertions"": 2, ""deletions"": 0, ""lines"": 2}}"
2021-12-24 18:11:27,6f98371532fcff911b462d51bc64f2ce8a6ae682,Bram Moolenaar,12,0,12,3,"{""src/arglist.c"": {""insertions"": 3, ""deletions"": 0, ""lines"": 3}, ""src/testdir/test_arglist.vim"": {""insertions"": 7, ""deletions"": 0, ""lines"": 7}, ""src/version.c"": {""insertions"": 2, ""deletions"": 0, ""lines"": 2}}"
2021-12-24 16:46:14,5937c7505f444dd896f336fa0119a93a55ebe9a2,Bram Moolenaar,4,0,4,2,"{""src/ex_cmds.c"": {""insertions"": 2, ""deletions"": 0, ""lines"": 2}, ""src/version.c"": {""insertions"": 2, ""deletions"": 0, ""lines"": 2}}"
2021-12-24 13:18:38,fa3b72348d88343390fbe212cfc230fec1602fc2,Bram Moolenaar,1748,1285,3033,29,"{""runtime/autoload/dist/ft.vim"": {""insertions"": 1, ""deletions"": 1, ""lines"": 2}, ""runtime/doc/eval.txt"": {""insertions"": 7, ""deletions"": 4, ""lines"": 11}, ""runtime/doc/map.txt"": {""insertions"": 39, ""deletions"": 19, ""lines"": 58}, ""runtime/doc/options.txt"": {""insertions"": 3, ""deletions"": 3, ""lines"": 6}, ""runtime/doc/quickref.txt"": {""insertions"": 2, ""deletions"": 1, ""lines"": 3}, ""runtime/doc/syntax.txt"": {""insertions"": 1, ""deletions"": 1, ""lines"": 2}, ""runtime/doc/tags"": {""insertions"": 3, ""deletions"": 0, ""lines"": 3}, ""runtime/doc/term.txt"": {""insertions"": 1, ""deletions"": 1, ""lines"": 2}, ""runtime/doc/terminal.txt"": {""insertions"": 3, ""deletions"": 1, ""lines"": 4}, ""runtime/doc/todo.txt"": {""insertions"": 13, ""deletions"": 9, ""lines"": 22}, ""runtime/doc/various.txt"": {""insertions"": 11, ""deletions"": 8, ""lines"": 19}, ""runtime/doc/vim9.txt"": {""insertions"": 4, ""deletions"": 4, ""lines"": 8}, ""runtime/filetype.vim"": {""insertions"": 1, ""deletions"": 1, ""lines"": 2}, ""runtime/ftplugin/zsh.vim"": {""insertions"": 4, ""deletions"": 4, ""lines"": 8}, ""runtime/indent/sh.vim"": {""insertions"": 1, ""deletions"": 1, ""lines"": 2}, ""runtime/indent/xml.vim"": {""insertions"": 7, ""deletions"": 1, ""lines"": 8}, ""runtime/menu.vim"": {""insertions"": 6, ""deletions"": 1, ""lines"": 7}, ""runtime/optwin.vim"": {""insertions"": 1, ""deletions"": 1, ""lines"": 2}, ""runtime/pack/dist/opt/matchit/autoload/matchit.vim"": {""insertions"": 132, ""deletions"": 119, ""lines"": 251}, ""runtime/pack/dist/opt/matchit/doc/matchit.txt"": {""insertions"": 10, ""deletions"": 3, ""lines"": 13}, ""runtime/pack/dist/opt/matchit/plugin/matchit.vim"": {""insertions"": 24, ""deletions"": 18, ""lines"": 42}, ""runtime/pack/dist/opt/termdebug/plugin/termdebug.vim"": {""insertions"": 10, ""deletions"": 5, ""lines"": 15}, ""runtime/syntax/debcontrol.vim"": {""insertions"": 10, ""deletions"": 10, ""lines"": 20}, ""runtime/syntax/dep3patch.vim"": {""insertions"": 57, ""deletions"": 0, ""lines"": 57}, ""runtime/syntax/dtd.vim"": {""insertions"": 3, ""deletions"": 3, ""lines"": 6}, ""runtime/syntax/vim.vim"": {""insertions"": 16, ""deletions"": 16, ""lines"": 32}, ""runtime/syntax/xml.vim"": {""insertions"": 8, ""deletions"": 4, ""lines"": 12}, ""runtime/syntax/zsh.vim"": {""insertions"": 11, ""deletions"": 212, ""lines"": 223}, ""src/po/de.po"": {""insertions"": 1359, ""deletions"": 834, ""lines"": 2193}}"
2021-12-24 12:02:43,d3f00f54bf955bd01767db3a0af25866bc112ec7,zeertzjq,8,18,26,2,"{""src/evalfunc.c"": {""insertions"": 6, ""deletions"": 18, ""lines"": 24}, ""src/version.c"": {""insertions"": 2, ""deletions"": 0, ""lines"": 2}}"
2021-12-24 11:57:06,6073f13f557c53928a2a9071495178599c38e798,h-east,3,1,4,2,"{""src/main.c"": {""insertions"": 1, ""deletions"": 1, ""lines"": 2}, ""src/version.c"": {""insertions"": 2, ""deletions"": 0, ""lines"": 2}}"
2021-12-24 11:33:56,70a120b72b2b48800f881725c58241cd170893f8,Bram Moolenaar,4,1,5,3,"{""runtime/filetype.vim"": {""insertions"": 1, ""deletions"": 0, ""lines"": 1}, ""src/testdir/test_filetype.vim"": {""insertions"": 1, ""deletions"": 1, ""lines"": 2}, ""src/version.c"": {""insertions"": 2, ""deletions"": 0, ""lines"": 2}}"
2021-12-24 10:48:30,51e64b2789eb7e60f7c5892a43426ab4ec1a54aa,Bram Moolenaar,48,47,95,2,"{""src/evalfunc.c"": {""insertions"": 46, ""deletions"": 47, ""lines"": 93}, ""src/version.c"": {""insertions"": 2, ""deletions"": 0, ""lines"": 2}}"
2021-12-23 21:14:37,310091d20f26f6472fefc31e19004684f3d640bf,Bram Moolenaar,44,1,45,3,"{""src/testdir/test_vim9_script.vim"": {""insertions"": 40, ""deletions"": 0, ""lines"": 40}, ""src/version.c"": {""insertions"": 2, ""deletions"": 0, ""lines"": 2}, ""src/vim9execute.c"": {""insertions"": 2, ""deletions"": 1, ""lines"": 3}}"
2021-12-22 21:40:33,28fbbeac7046f33db350294908eecb380042d553,Bram Moolenaar,61,6,67,3,"{""src/testdir/test_vim9_expr.vim"": {""insertions"": 30, ""deletions"": 0, ""lines"": 30}, ""src/typval.c"": {""insertions"": 29, ""deletions"": 6, ""lines"": 35}, ""src/version.c"": {""insertions"": 2, ""deletions"": 0, ""lines"": 2}}"
2021-12-22 20:55:30,f2f0bddf303e37d4d532ca22e2d53179c20b1d19,zeertzjq,54,0,54,3,"{""src/cindent.c"": {""insertions"": 4, ""deletions"": 0, ""lines"": 4}, ""src/testdir/test_cindent.vim"": {""insertions"": 48, ""deletions"": 0, ""lines"": 48}, ""src/version.c"": {""insertions"": 2, ""deletions"": 0, ""lines"": 2}}"
2021-12-22 20:29:09,b4168fd917e869912e0649fe13c10e5e6a595199,Bram Moolenaar,5,2,7,2,"{""src/dict.c"": {""insertions"": 3, ""deletions"": 2, ""lines"": 5}, ""src/version.c"": {""insertions"": 2, ""deletions"": 0, ""lines"": 2}}"
2021-12-22 19:45:28,a80aad717464760a5a50ac2201ce35b24a0cf7a5,James McCoy,94,26,120,9,"{""runtime/doc/options.txt"": {""insertions"": 2, ""deletions"": 2, ""lines"": 4}, ""runtime/doc/sign.txt"": {""insertions"": 9, ""deletions"": 0, ""lines"": 9}, ""src/drawline.c"": {""insertions"": 7, ""deletions"": 0, ""lines"": 7}, ""src/popupwin.c"": {""insertions"": 1, ""deletions"": 1, ""lines"": 2}, ""src/proto/sign.pro"": {""insertions"": 1, ""deletions"": 1, ""lines"": 2}, ""src/sign.c"": {""insertions"": 47, ""deletions"": 5, ""lines"": 52}, ""src/structs.h"": {""insertions"": 1, ""deletions"": 0, ""lines"": 1}, ""src/testdir/test_signs.vim"": {""insertions"": 24, ""deletions"": 17, ""lines"": 41}, ""src/version.c"": {""insertions"": 2, ""deletions"": 0, ""lines"": 2}}"
2021-12-22 19:19:08,82b3b4c6cf2973fe767f8e2311482af0bd95267e,Bram Moolenaar,6,1,7,3,"{""runtime/filetype.vim"": {""insertions"": 3, ""deletions"": 1, ""lines"": 4}, ""src/testdir/test_filetype.vim"": {""insertions"": 1, ""deletions"": 0, ""lines"": 1}, ""src/version.c"": {""insertions"": 2, ""deletions"": 0, ""lines"": 2}}"
2021-12-22 18:45:37,080182216e605df3428cc699b9fd7e761368d12f,Bram Moolenaar,34,3,37,4,"{""src/evalfunc.c"": {""insertions"": 11, ""deletions"": 2, ""lines"": 13}, ""src/testdir/test_vim9_builtin.vim"": {""insertions"": 7, ""deletions"": 0, ""lines"": 7}, ""src/testdir/vim9.vim"": {""insertions"": 14, ""deletions"": 1, ""lines"": 15}, ""src/version.c"": {""insertions"": 2, ""deletions"": 0, ""lines"": 2}}"
2021-12-22 18:19:26,f973eeb4911de09258e84cb2248dc0f9392824b4,Yegappan Lakshmanan,975,872,1847,13,"{""src/blob.c"": {""insertions"": 276, ""deletions"": 48, ""lines"": 324}, ""src/dict.c"": {""insertions"": 250, ""deletions"": 39, ""lines"": 289}, ""src/list.c"": {""insertions"": 203, ""deletions"": 780, ""lines"": 983}, ""src/proto/blob.pro"": {""insertions"": 5, ""deletions"": 0, ""lines"": 5}, ""src/proto/dict.pro"": {""insertions"": 4, ""deletions"": 1, ""lines"": 5}, ""src/proto/list.pro"": {""insertions"": 1, ""deletions"": 0, ""lines"": 1}, ""src/proto/strings.pro"": {""insertions"": 3, ""deletions"": 0, ""lines"": 3}, ""src/strings.c"": {""insertions"": 180, ""deletions"": 4, ""lines"": 184}, ""src/structs.h"": {""insertions"": 8, ""deletions"": 0, ""lines"": 8}, ""src/testdir/test_filter_map.vim"": {""insertions"": 1, ""deletions"": 0, ""lines"": 1}, ""src/testdir/test_listdict.vim"": {""insertions"": 26, ""deletions"": 0, ""lines"": 26}, ""src/testdir/test_sort.vim"": {""insertions"": 16, ""deletions"": 0, ""lines"": 16}, ""src/version.c"": {""insertions"": 2, ""deletions"": 0, ""lines"": 2}}"
2021-12-22 15:21:15,1aeccdb464d81f0af047b399cbad160307a91f7c,Nir Lichtman,10,4,14,3,"{""src/GvimExt/gvimext.cpp"": {""insertions"": 7, ""deletions"": 3, ""lines"": 10}, ""src/GvimExt/gvimext.h"": {""insertions"": 1, ""deletions"": 1, ""lines"": 2}, ""src/version.c"": {""insertions"": 2, ""deletions"": 0, ""lines"": 2}}"
2021-12-22 13:18:39,fa46ead31abe66494da775921feefece02ce6d95,Bram Moolenaar,35,26,61,5,"{""src/testdir/test_vim9_func.vim"": {""insertions"": 3, ""deletions"": 13, ""lines"": 16}, ""src/version.c"": {""insertions"": 2, ""deletions"": 0, ""lines"": 2}, ""src/vim9compile.c"": {""insertions"": 8, ""deletions"": 6, ""lines"": 14}, ""src/vim9expr.c"": {""insertions"": 2, ""deletions"": 1, ""lines"": 3}, ""src/vim9type.c"": {""insertions"": 20, ""deletions"": 6, ""lines"": 26}}"
2021-12-21 13:30:42,1b5f7a6202406b7d7ac804960602350e42b8be80,Bram Moolenaar,33,12,45,3,"{""src/testdir/test_vim9_disassemble.vim"": {""insertions"": 26, ""deletions"": 10, ""lines"": 36}, ""src/version.c"": {""insertions"": 2, ""deletions"": 0, ""lines"": 2}, ""src/vim9type.c"": {""insertions"": 5, ""deletions"": 2, ""lines"": 7}}"
2021-12-21 13:19:42,d92813a59877c707e4b64bea6d786aad152acb45,Yegappan Lakshmanan,488,374,862,2,"{""src/list.c"": {""insertions"": 486, ""deletions"": 374, ""lines"": 860}, ""src/version.c"": {""insertions"": 2, ""deletions"": 0, ""lines"": 2}}"
2021-12-21 12:32:17,59618fed4ce118d12686c2e5c7c09601c8177817,Bram Moolenaar,121,36,157,7,"{""src/evalfunc.c"": {""insertions"": 55, ""deletions"": 24, ""lines"": 79}, ""src/globals.h"": {""insertions"": 7, ""deletions"": 0, ""lines"": 7}, ""src/testdir/test_vim9_func.vim"": {""insertions"": 33, ""deletions"": 0, ""lines"": 33}, ""src/version.c"": {""insertions"": 2, ""deletions"": 0, ""lines"": 2}, ""src/vim9cmds.c"": {""insertions"": 5, ""deletions"": 2, ""lines"": 7}, ""src/vim9expr.c"": {""insertions"": 10, ""deletions"": 6, ""lines"": 16}, ""src/vim9instr.c"": {""insertions"": 9, ""deletions"": 4, ""lines"": 13}}"
2021-12-21 09:42:09,0d807107b66e0d30d4f338c272962af5714c400e,Bram Moolenaar,20,18,38,5,"{""src/version.c"": {""insertions"": 2, ""deletions"": 0, ""lines"": 2}, ""src/vim9.h"": {""insertions"": 2, ""deletions"": 2, ""lines"": 4}, ""src/vim9cmds.c"": {""insertions"": 11, ""deletions"": 11, ""lines"": 22}, ""src/vim9execute.c"": {""insertions"": 4, ""deletions"": 4, ""lines"": 8}, ""src/vim9instr.c"": {""insertions"": 1, ""deletions"": 1, ""lines"": 2}}"
2021-12-21 09:12:23,6f79e614b25caebd35cf0d82b6f3b7e0733849ec,Bram Moolenaar,38,6,44,7,"{""runtime/doc/options.txt"": {""insertions"": 12, ""deletions"": 0, ""lines"": 12}, ""runtime/doc/term.txt"": {""insertions"": 9, ""deletions"": 2, ""lines"": 11}, ""runtime/optwin.vim"": {""insertions"": 8, ""deletions"": 0, ""lines"": 8}, ""src/option.h"": {""insertions"": 2, ""deletions"": 1, ""lines"": 3}, ""src/optiondefs.h"": {""insertions"": 3, ""deletions"": 0, ""lines"": 3}, ""src/term.c"": {""insertions"": 2, ""deletions"": 3, ""lines"": 5}, ""src/version.c"": {""insertions"": 2, ""deletions"": 0, ""lines"": 2}}"
2021-12-20 22:12:53,8d95d7091da08d0a236be4a16616e3dda388e58d,Bram Moolenaar,13,11,24,2,"{""src/Makefile"": {""insertions"": 11, ""deletions"": 11, ""lines"": 22}, ""src/version.c"": {""insertions"": 2, ""deletions"": 0, ""lines"": 2}}"
2021-12-20 21:35:59,dab17a0689a2f31f69f428975f84b0c3c7ba3030,Bram Moolenaar,28,0,28,3,"{""src/evalwindow.c"": {""insertions"": 4, ""deletions"": 0, ""lines"": 4}, ""src/testdir/test_execute_func.vim"": {""insertions"": 22, ""deletions"": 0, ""lines"": 22}, ""src/version.c"": {""insertions"": 2, ""deletions"": 0, ""lines"": 2}}"
2021-12-20 15:53:13,39713d3acbfb6673775158a0171c7389c07f25df,Bram Moolenaar,8,0,8,2,"{""Filelist"": {""insertions"": 6, ""deletions"": 0, ""lines"": 6}, ""src/version.c"": {""insertions"": 2, ""deletions"": 0, ""lines"": 2}}"
2021-12-20 15:04:29,dc7c366f3aae65ee691010b08f37acfb26e0742b,Bram Moolenaar,9356,9078,18434,18,"{""src/Make_ami.mak"": {""insertions"": 3, ""deletions"": 0, ""lines"": 3}, ""src/Make_cyg_ming.mak"": {""insertions"": 9, ""deletions"": 0, ""lines"": 9}, ""src/Make_mvc.mak"": {""insertions"": 12, ""deletions"": 0, ""lines"": 12}, ""src/Make_vms.mms"": {""insertions"": 19, ""deletions"": 1, ""lines"": 20}, ""src/Makefile"": {""insertions"": 41, ""deletions"": 11, ""lines"": 52}, ""src/proto.h"": {""insertions"": 5, ""deletions"": 0, ""lines"": 5}, ""src/proto/vim9cmds.pro"": {""insertions"": 33, ""deletions"": 0, ""lines"": 33}, ""src/proto/vim9compile.pro"": {""insertions"": 14, ""deletions"": 10, ""lines"": 24}, ""src/proto/vim9expr.pro"": {""insertions"": 17, ""deletions"": 0, ""lines"": 17}, ""src/proto/vim9instr.pro"": {""insertions"": 72, ""deletions"": 0, ""lines"": 72}, ""src/version.c"": {""insertions"": 2, ""deletions"": 0, ""lines"": 2}, ""src/vim9.h"": {""insertions"": 201, ""deletions"": 7, ""lines"": 208}, ""src/vim9cmds.c"": {""insertions"": 2274, ""deletions"": 0, ""lines"": 2274}, ""src/vim9compile.c"": {""insertions"": 1547, ""deletions"": 9044, ""lines"": 10591}, ""src/vim9execute.c"": {""insertions"": 4, ""deletions"": 4, ""lines"": 8}, ""src/vim9expr.c"": {""insertions"": 2893, ""deletions"": 0, ""lines"": 2893}, ""src/vim9instr.c"": {""insertions"": 2208, ""deletions"": 0, ""lines"": 2208}, ""src/vim9script.c"": {""insertions"": 2, ""deletions"": 1, ""lines"": 3}}"
2021-12-20 12:25:03,a99fb23842f055c511bfe1b62de7bbd14d5a99c0,Bram Moolenaar,16,8,24,5,"{""src/errors.h"": {""insertions"": 2, ""deletions"": 0, ""lines"": 2}, ""src/testdir/test_vim9_cmd.vim"": {""insertions"": 4, ""deletions"": 0, ""lines"": 4}, ""src/testdir/test_vim9_script.vim"": {""insertions"": 1, ""deletions"": 1, ""lines"": 2}, ""src/version.c"": {""insertions"": 2, ""deletions"": 0, ""lines"": 2}, ""src/vim9compile.c"": {""insertions"": 7, ""deletions"": 7, ""lines"": 14}}"
2021-12-20 10:55:35,003312b1d2ee2f4922f473b8bf50af6663c0efac,Bram Moolenaar,63,7,70,4,"{""src/testdir/test_vim9_cmd.vim"": {""insertions"": 17, ""deletions"": 0, ""lines"": 17}, ""src/testdir/test_vim9_script.vim"": {""insertions"": 37, ""deletions"": 3, ""lines"": 40}, ""src/version.c"": {""insertions"": 2, ""deletions"": 0, ""lines"": 2}, ""src/vim9compile.c"": {""insertions"": 7, ""deletions"": 4, ""lines"": 11}}"
2021-12-20 09:36:27,2f9f4ccfc8f1d4a56761dc1cc1e9e20190a72c74,Bram Moolenaar,68,14,82,3,"{""src/evalfunc.c"": {""insertions"": 7, ""deletions"": 13, ""lines"": 20}, ""src/testdir/test_vim9_builtin.vim"": {""insertions"": 59, ""deletions"": 1, ""lines"": 60}, ""src/version.c"": {""insertions"": 2, ""deletions"": 0, ""lines"": 2}}"
2021-12-19 21:34:05,fea43e44c008a7ca73b506ddab0f47b63b5d2126,Bram Moolenaar,598,508,1106,4,"{""src/testdir/test_expr.vim"": {""insertions"": 577, ""deletions"": 493, ""lines"": 1070}, ""src/testdir/vim9.vim"": {""insertions"": 17, ""deletions"": 14, ""lines"": 31}, ""src/version.c"": {""insertions"": 2, ""deletions"": 0, ""lines"": 2}, ""src/vim9compile.c"": {""insertions"": 2, ""deletions"": 1, ""lines"": 3}}"
2021-12-19 19:19:31,bc404bfb32cf2bef34050d2aeae0ea72ccf980cc,Yegappan Lakshmanan,14,4,18,5,"{""src/blob.c"": {""insertions"": 1, ""deletions"": 0, ""lines"": 1}, ""src/regexp_nfa.c"": {""insertions"": 3, ""deletions"": 3, ""lines"": 6}, ""src/testdir/test_blob.vim"": {""insertions"": 7, ""deletions"": 0, ""lines"": 7}, ""src/testdir/test_messages.vim"": {""insertions"": 1, ""deletions"": 1, ""lines"": 2}, ""src/version.c"": {""insertions"": 2, ""deletions"": 0, ""lines"": 2}}"
2021-12-19 18:33:23,86b3ab4fa0de3e8884ab6a6ced2a70592b937d0f,Bram Moolenaar,1009,997,2006,13,"{""src/testdir/test_execute_func.vim"": {""insertions"": 1, ""deletions"": 1, ""lines"": 2}, ""src/testdir/test_float_func.vim"": {""insertions"": 1, ""deletions"": 1, ""lines"": 2}, ""src/testdir/test_functions.vim"": {""insertions"": 3, ""deletions"": 3, ""lines"": 6}, ""src/testdir/test_glob2regpat.vim"": {""insertions"": 1, ""deletions"": 1, ""lines"": 2}, ""src/testdir/test_listdict.vim"": {""insertions"": 1, ""deletions"": 1, ""lines"": 2}, ""src/testdir/test_vim9_assign.vim"": {""insertions"": 12, ""deletions"": 12, ""lines"": 24}, ""src/testdir/test_vim9_builtin.vim"": {""insertions"": 833, ""deletions"": 833, ""lines"": 1666}, ""src/testdir/test_vim9_cmd.vim"": {""insertions"": 4, ""deletions"": 4, ""lines"": 8}, ""src/testdir/test_vim9_expr.vim"": {""insertions"": 104, ""deletions"": 104, ""lines"": 208}, ""src/testdir/test_vim9_func.vim"": {""insertions"": 1, ""deletions"": 1, ""lines"": 2}, ""src/testdir/test_vim9_script.vim"": {""insertions"": 10, ""deletions"": 10, ""lines"": 20}, ""src/testdir/vim9.vim"": {""insertions"": 36, ""deletions"": 26, ""lines"": 62}, ""src/version.c"": {""insertions"": 2, ""deletions"": 0, ""lines"": 2}}"
2021-12-19 17:27:06,700e6b166298ecfb53fe4bf593085b29ca78d556,Bram Moolenaar,17,17,34,2,"{""src/testdir/test_listdict.vim"": {""insertions"": 15, ""deletions"": 17, ""lines"": 32}, ""src/version.c"": {""insertions"": 2, ""deletions"": 0, ""lines"": 2}}"
2021-12-19 15:17:21,f47c5a8e2d8eda7c2c8a9cccf9568eb56c03a0cf,Bram Moolenaar,41,6,47,5,"{""src/errors.h"": {""insertions"": 2, ""deletions"": 0, ""lines"": 2}, ""src/eval.c"": {""insertions"": 8, ""deletions"": 2, ""lines"": 10}, ""src/testdir/test_listdict.vim"": {""insertions"": 10, ""deletions"": 3, ""lines"": 13}, ""src/version.c"": {""insertions"": 2, ""deletions"": 0, ""lines"": 2}, ""src/vim9compile.c"": {""insertions"": 19, ""deletions"": 1, ""lines"": 20}}"
2021-12-19 12:33:05,265f811f5a2dac81d9698f5202a661a04ed095f1,Bram Moolenaar,313,202,515,4,"{""src/proto/typval.pro"": {""insertions"": 7, ""deletions"": 2, ""lines"": 9}, ""src/typval.c"": {""insertions"": 269, ""deletions"": 161, ""lines"": 430}, ""src/version.c"": {""insertions"": 2, ""deletions"": 0, ""lines"": 2}, ""src/vim9execute.c"": {""insertions"": 35, ""deletions"": 39, ""lines"": 74}}"
2021-12-19 11:06:35,2de5371a755abd287dab6ff544924715a76d4abe,Bram Moolenaar,11,1,12,3,"{""src/eval.c"": {""insertions"": 2, ""deletions"": 1, ""lines"": 3}, ""src/testdir/test_messages.vim"": {""insertions"": 7, ""deletions"": 0, ""lines"": 7}, ""src/version.c"": {""insertions"": 2, ""deletions"": 0, ""lines"": 2}}"
2021-12-19 10:35:15,389b72196e6aaeafe3f907c73d271f2c6b931140,Yegappan Lakshmanan,582,473,1055,4,"{""runtime/doc/eval.txt"": {""insertions"": 7, ""deletions"": 5, ""lines"": 12}, ""src/list.c"": {""insertions"": 570, ""deletions"": 468, ""lines"": 1038}, ""src/testdir/test_listdict.vim"": {""insertions"": 3, ""deletions"": 0, ""lines"": 3}, ""src/version.c"": {""insertions"": 2, ""deletions"": 0, ""lines"": 2}}"
2021-12-18 18:33:46,0ccb5842f5fb103763d106c7aa364d758343c35a,rbtnn,149,40,189,9,"{""runtime/doc/eval.txt"": {""insertions"": 4, ""deletions"": 3, ""lines"": 7}, ""src/errors.h"": {""insertions"": 5, ""deletions"": 1, ""lines"": 6}, ""src/evalfunc.c"": {""insertions"": 16, ""deletions"": 1, ""lines"": 17}, ""src/list.c"": {""insertions"": 71, ""deletions"": 17, ""lines"": 88}, ""src/proto/typval.pro"": {""insertions"": 1, ""deletions"": 0, ""lines"": 1}, ""src/testdir/test_listdict.vim"": {""insertions"": 25, ""deletions"": 4, ""lines"": 29}, ""src/testdir/test_vim9_builtin.vim"": {""insertions"": 6, ""deletions"": 6, ""lines"": 12}, ""src/typval.c"": {""insertions"": 19, ""deletions"": 8, ""lines"": 27}, ""src/version.c"": {""insertions"": 2, ""deletions"": 0, ""lines"": 2}}"
2021-12-18 16:54:31,605ec91e5a7330d61be313637e495fa02a6dc264,Bram Moolenaar,9,2,11,3,"{""src/eval.c"": {""insertions"": 5, ""deletions"": 2, ""lines"": 7}, ""src/testdir/test_lambda.vim"": {""insertions"": 2, ""deletions"": 0, ""lines"": 2}, ""src/version.c"": {""insertions"": 2, ""deletions"": 0, ""lines"": 2}}"
2021-12-18 15:32:46,60618c8f1a7ea55452837a446525272142286471,zeertzjq,23,5,28,4,"{""src/screen.c"": {""insertions"": 4, ""deletions"": 4, ""lines"": 8}, ""src/testdir/test_display.vim"": {""insertions"": 2, ""deletions"": 0, ""lines"": 2}, ""src/testdir/test_listchars.vim"": {""insertions"": 15, ""deletions"": 1, ""lines"": 16}, ""src/version.c"": {""insertions"": 2, ""deletions"": 0, ""lines"": 2}}"
2021-12-18 12:40:52,0dc4d8eaecc3acc26c3bee906d98097f9faa90bd,Dominique Pelle,8,2,10,2,"{""src/testdir/test_vim9_builtin.vim"": {""insertions"": 6, ""deletions"": 2, ""lines"": 8}, ""src/version.c"": {""insertions"": 2, ""deletions"": 0, ""lines"": 2}}"
2021-12-18 12:31:33,44a8977de467241a2f9959253d06eff53a8baad9,Bram Moolenaar,69,9,78,5,"{""src/proto/vim9type.pro"": {""insertions"": 1, ""deletions"": 0, ""lines"": 1}, ""src/testdir/test_vim9_assign.vim"": {""insertions"": 17, ""deletions"": 0, ""lines"": 17}, ""src/version.c"": {""insertions"": 2, ""deletions"": 0, ""lines"": 2}, ""src/vim9compile.c"": {""insertions"": 6, ""deletions"": 3, ""lines"": 9}, ""src/vim9type.c"": {""insertions"": 43, ""deletions"": 6, ""lines"": 49}}"
2021-12-17 20:52:57,647ab4cede4dbf412d24748f8e0a64d1cb9239f4,James McCoy,62,0,62,4,"{""runtime/autoload/dist/ft.vim"": {""insertions"": 17, ""deletions"": 0, ""lines"": 17}, ""runtime/filetype.vim"": {""insertions"": 3, ""deletions"": 0, ""lines"": 3}, ""src/testdir/test_filetype.vim"": {""insertions"": 40, ""deletions"": 0, ""lines"": 40}, ""src/version.c"": {""insertions"": 2, ""deletions"": 0, ""lines"": 2}}"
2021-12-17 20:36:15,422085f1c87cb6bea879158b8b05c4a5cf7ab48b,Bram Moolenaar,31,9,40,3,"{""src/testdir/test_listdict.vim"": {""insertions"": 12, ""deletions"": 0, ""lines"": 12}, ""src/version.c"": {""insertions"": 2, ""deletions"": 0, ""lines"": 2}, ""src/vim9execute.c"": {""insertions"": 17, ""deletions"": 9, ""lines"": 26}}"
2021-12-17 20:15:38,71b768509250b12696e8cc90e5902029f1b5433d,Bram Moolenaar,93,35,128,7,"{""src/errors.h"": {""insertions"": 18, ""deletions"": 0, ""lines"": 18}, ""src/evalvars.c"": {""insertions"": 24, ""deletions"": 12, ""lines"": 36}, ""src/globals.h"": {""insertions"": 0, ""deletions"": 1, ""lines"": 1}, ""src/testdir/test_listdict.vim"": {""insertions"": 13, ""deletions"": 8, ""lines"": 21}, ""src/testdir/test_vim9_assign.vim"": {""insertions"": 16, ""deletions"": 0, ""lines"": 16}, ""src/version.c"": {""insertions"": 2, ""deletions"": 0, ""lines"": 2}, ""src/vim9execute.c"": {""insertions"": 20, ""deletions"": 14, ""lines"": 34}}"
2021-12-17 18:01:31,ddc80aff575dd60c04c79621a0358cf0abaac53a,rbtnn,19,72,91,2,"{""src/typval.c"": {""insertions"": 17, ""deletions"": 72, ""lines"": 89}, ""src/version.c"": {""insertions"": 2, ""deletions"": 0, ""lines"": 2}}"
2021-12-17 17:32:29,354b23a9f87fd8c5aec457d88320a0a5bce4b985,Dominique Pelle,20,0,20,2,"{""src/testdir/test_syntax.vim"": {""insertions"": 18, ""deletions"": 0, ""lines"": 18}, ""src/version.c"": {""insertions"": 2, ""deletions"": 0, ""lines"": 2}}"
2021-12-17 16:21:20,db1a410b610b2c1941311acc57dcc4afec20720e,Yegappan Lakshmanan,282,40,322,7,"{""src/option.c"": {""insertions"": 26, ""deletions"": 4, ""lines"": 30}, ""src/testdir/dumps/Test_set_tagfunc_on_cmdline.dump"": {""insertions"": 0, ""deletions"": 6, ""lines"": 6}, ""src/testdir/test_ins_complete.vim"": {""insertions"": 150, ""deletions"": 12, ""lines"": 162}, ""src/testdir/test_normal.vim"": {""insertions"": 34, ""deletions"": 1, ""lines"": 35}, ""src/testdir/test_quickfix.vim"": {""insertions"": 17, ""deletions"": 0, ""lines"": 17}, ""src/testdir/test_tagfunc.vim"": {""insertions"": 53, ""deletions"": 17, ""lines"": 70}, ""src/version.c"": {""insertions"": 2, ""deletions"": 0, ""lines"": 2}}"
2021-12-17 16:00:04,d2ff705af32862b4da49d213613233f93343874c,Bram Moolenaar,11,4,15,2,"{""src/autocmd.c"": {""insertions"": 9, ""deletions"": 4, ""lines"": 13}, ""src/version.c"": {""insertions"": 2, ""deletions"": 0, ""lines"": 2}}"
2021-12-17 14:46:12,02929a372e5e14db1b85abdc7d4515d6b2d81888,Bram Moolenaar,23,2,25,2,"{""src/eval.c"": {""insertions"": 21, ""deletions"": 2, ""lines"": 23}, ""src/version.c"": {""insertions"": 2, ""deletions"": 0, ""lines"": 2}}"
2021-12-17 12:45:22,259f443a934c6f2447a14bfe54403903416a9af0,Bram Moolenaar,18,4,22,4,"{""runtime/doc/vim9.txt"": {""insertions"": 6, ""deletions"": 3, ""lines"": 9}, ""src/ex_cmds.h"": {""insertions"": 1, ""deletions"": 1, ""lines"": 2}, ""src/testdir/test_vim9_expr.vim"": {""insertions"": 9, ""deletions"": 0, ""lines"": 9}, ""src/version.c"": {""insertions"": 2, ""deletions"": 0, ""lines"": 2}}"
2021-12-17 11:44:33,deda6441e457072df39cdc8744dcd685d77fa273,Bram Moolenaar,9,2,11,2,"{""src/testdir/test_channel.vim"": {""insertions"": 7, ""deletions"": 2, ""lines"": 9}, ""src/version.c"": {""insertions"": 2, ""deletions"": 0, ""lines"": 2}}"
2021-12-17 09:44:33,c3f91c0648f4b04a6a9ceb4ccec45ea767a63796,ichizok,27,0,27,3,"{""src/autocmd.c"": {""insertions"": 5, ""deletions"": 0, ""lines"": 5}, ""src/testdir/test_terminal3.vim"": {""insertions"": 20, ""deletions"": 0, ""lines"": 20}, ""src/version.c"": {""insertions"": 2, ""deletions"": 0, ""lines"": 2}}"
2021-12-16 21:11:26,994a0a298bfbdd03e2eaae64268739d617080644,Bram Moolenaar,4,2,6,2,"{""src/testdir/test_vimscript.vim"": {""insertions"": 2, ""deletions"": 2, ""lines"": 4}, ""src/version.c"": {""insertions"": 2, ""deletions"": 0, ""lines"": 2}}"
2021-12-16 21:07:35,23e72369ffa2c18e9fda1e5d77f4397dc4700764,Bram Moolenaar,3,7,10,3,"{""src/testdir/dumps/Test_opfunc_error.dump"": {""insertions"": 0, ""deletions"": 6, ""lines"": 6}, ""src/testdir/test_vim9_func.vim"": {""insertions"": 1, ""deletions"": 1, ""lines"": 2}, ""src/version.c"": {""insertions"": 2, ""deletions"": 0, ""lines"": 2}}"
2021-12-16 20:56:57,e124204c4f8ea8b4fe5357b7613092a7acb5feb8,Bram Moolenaar,137,74,211,19,"{""src/buffer.c"": {""insertions"": 4, ""deletions"": 4, ""lines"": 8}, ""src/dict.c"": {""insertions"": 1, ""deletions"": 1, ""lines"": 2}, ""src/diff.c"": {""insertions"": 8, ""deletions"": 8, ""lines"": 16}, ""src/digraph.c"": {""insertions"": 2, ""deletions"": 2, ""lines"": 4}, ""src/errors.h"": {""insertions"": 65, ""deletions"": 1, ""lines"": 66}, ""src/eval.c"": {""insertions"": 7, ""deletions"": 7, ""lines"": 14}, ""src/evalfunc.c"": {""insertions"": 5, ""deletions"": 4, ""lines"": 9}, ""src/evalvars.c"": {""insertions"": 1, ""deletions"": 1, ""lines"": 2}, ""src/globals.h"": {""insertions"": 0, ""deletions"": 9, ""lines"": 9}, ""src/misc2.c"": {""insertions"": 1, ""deletions"": 1, ""lines"": 2}, ""src/quickfix.c"": {""insertions"": 1, ""deletions"": 1, ""lines"": 2}, ""src/typval.c"": {""insertions"": 4, ""deletions"": 4, ""lines"": 8}, ""src/ui.c"": {""insertions"": 1, ""deletions"": 1, ""lines"": 2}, ""src/userfunc.c"": {""insertions"": 8, ""deletions"": 6, ""lines"": 14}, ""src/version.c"": {""insertions"": 2, ""deletions"": 0, ""lines"": 2}, ""src/vim9compile.c"": {""insertions"": 17, ""deletions"": 15, ""lines"": 32}, ""src/vim9execute.c"": {""insertions"": 6, ""deletions"": 5, ""lines"": 11}, ""src/vim9type.c"": {""insertions"": 3, ""deletions"": 3, ""lines"": 6}, ""src/window.c"": {""insertions"": 1, ""deletions"": 1, ""lines"": 2}}"
2021-12-16 19:45:47,94c785d235dccacf6cdf38c5903115b61ca8a981,Bram Moolenaar,22,0,22,4,"{""src/option.c"": {""insertions"": 3, ""deletions"": 0, ""lines"": 3}, ""src/testdir/dumps/Test_set_tagfunc_on_cmdline.dump"": {""insertions"": 6, ""deletions"": 0, ""lines"": 6}, ""src/testdir/test_tagfunc.vim"": {""insertions"": 11, ""deletions"": 0, ""lines"": 11}, ""src/version.c"": {""insertions"": 2, ""deletions"": 0, ""lines"": 2}}"
2021-12-16 18:02:07,8103527da7f12ff21c2566222748518ee093432c,Bram Moolenaar,52,2,54,4,"{""src/edit.c"": {""insertions"": 7, ""deletions"": 2, ""lines"": 9}, ""src/terminal.c"": {""insertions"": 17, ""deletions"": 0, ""lines"": 17}, ""src/testdir/test_terminal.vim"": {""insertions"": 26, ""deletions"": 0, ""lines"": 26}, ""src/version.c"": {""insertions"": 2, ""deletions"": 0, ""lines"": 2}}"
2021-12-16 16:14:11,f79cbf6512863c167bc794035df067e3a3e474f3,Bram Moolenaar,9,1,10,4,"{"".github/ISSUE_TEMPLATE/bug_report.yml"": {""insertions"": 5, ""deletions"": 0, ""lines"": 5}, ""Filelist"": {""insertions"": 1, ""deletions"": 0, ""lines"": 1}, ""README.md"": {""insertions"": 1, ""deletions"": 1, ""lines"": 2}, ""src/version.c"": {""insertions"": 2, ""deletions"": 0, ""lines"": 2}}"
2021-12-16 15:49:43,b15cf44c1d9c92a2ac07cff415071e31a9ad88fa,Bram Moolenaar,30,2,32,4,"{""src/testdir/test_vim9_disassemble.vim"": {""insertions"": 1, ""deletions"": 1, ""lines"": 2}, ""src/testdir/test_vim9_func.vim"": {""insertions"": 12, ""deletions"": 0, ""lines"": 12}, ""src/version.c"": {""insertions"": 2, ""deletions"": 0, ""lines"": 2}, ""src/vim9compile.c"": {""insertions"": 15, ""deletions"": 1, ""lines"": 16}}"
2021-12-16 14:45:13,52797bae1710621926c03a2611c40a692c96fb44,Bram Moolenaar,15,4,19,6,"{""src/getchar.c"": {""insertions"": 2, ""deletions"": 2, ""lines"": 4}, ""src/gui_motif.c"": {""insertions"": 1, ""deletions"": 1, ""lines"": 2}, ""src/mbyte.c"": {""insertions"": 6, ""deletions"": 0, ""lines"": 6}, ""src/regexp_nfa.c"": {""insertions"": 1, ""deletions"": 1, ""lines"": 2}, ""src/testdir/test_edit.vim"": {""insertions"": 3, ""deletions"": 0, ""lines"": 3}, ""src/version.c"": {""insertions"": 2, ""deletions"": 0, ""lines"": 2}}"
2021-12-16 14:41:10,0e6adf8a29d5c2c96c42cc7157f71bf22c2ad471,Bram Moolenaar,503,452,955,25,"{"".github/CODEOWNERS"": {""insertions"": 3, ""deletions"": 0, ""lines"": 3}, ""runtime/doc/editing.txt"": {""insertions"": 1, ""deletions"": 1, ""lines"": 2}, ""runtime/doc/eval.txt"": {""insertions"": 1, ""deletions"": 1, ""lines"": 2}, ""runtime/doc/helphelp.txt"": {""insertions"": 2, ""deletions"": 2, ""lines"": 4}, ""runtime/doc/map.txt"": {""insertions"": 18, ""deletions"": 11, ""lines"": 29}, ""runtime/doc/message.txt"": {""insertions"": 1, ""deletions"": 1, ""lines"": 2}, ""runtime/doc/motion.txt"": {""insertions"": 1, ""deletions"": 1, ""lines"": 2}, ""runtime/doc/tags"": {""insertions"": 5, ""deletions"": 0, ""lines"": 5}, ""runtime/doc/term.txt"": {""insertions"": 5, ""deletions"": 1, ""lines"": 6}, ""runtime/doc/testing.txt"": {""insertions"": 3, ""deletions"": 2, ""lines"": 5}, ""runtime/doc/todo.txt"": {""insertions"": 6, ""deletions"": 8, ""lines"": 14}, ""runtime/doc/various.txt"": {""insertions"": 2, ""deletions"": 2, ""lines"": 4}, ""runtime/doc/vim9.txt"": {""insertions"": 15, ""deletions"": 1, ""lines"": 16}, ""runtime/filetype.vim"": {""insertions"": 1, ""deletions"": 1, ""lines"": 2}, ""runtime/ftplugin/i3config.vim"": {""insertions"": 13, ""deletions"": 0, ""lines"": 13}, ""runtime/ftplugin/solution.vim"": {""insertions"": 37, ""deletions"": 0, ""lines"": 37}, ""runtime/optwin.vim"": {""insertions"": 3, ""deletions"": 5, ""lines"": 8}, ""runtime/pack/dist/opt/termdebug/plugin/termdebug.vim"": {""insertions"": 29, ""deletions"": 11, ""lines"": 40}, ""runtime/syntax/c.vim"": {""insertions"": 1, ""deletions"": 2, ""lines"": 3}, ""runtime/syntax/css.vim"": {""insertions"": 17, ""deletions"": 12, ""lines"": 29}, ""runtime/syntax/i3config.vim"": {""insertions"": 256, ""deletions"": 0, ""lines"": 256}, ""runtime/syntax/python.vim"": {""insertions"": 3, ""deletions"": 2, ""lines"": 5}, ""runtime/syntax/texinfo.vim"": {""insertions"": 28, ""deletions"": 378, ""lines"": 406}, ""runtime/syntax/vim.vim"": {""insertions"": 10, ""deletions"": 10, ""lines"": 20}, ""src/testdir/README.txt"": {""insertions"": 42, ""deletions"": 0, ""lines"": 42}}"
2021-12-16 13:06:10,6df0f2759d12ec0bc999b2963ecea4387a2bc516,Yegappan Lakshmanan,14,1,15,5,"{""src/Make_mvc.mak"": {""insertions"": 8, ""deletions"": 0, ""lines"": 8}, ""src/findfile.c"": {""insertions"": 1, ""deletions"": 1, ""lines"": 2}, ""src/os_mswin.c"": {""insertions"": 2, ""deletions"": 0, ""lines"": 2}, ""src/testdir/test_fnamemodify.vim"": {""insertions"": 1, ""deletions"": 0, ""lines"": 1}, ""src/version.c"": {""insertions"": 2, ""deletions"": 0, ""lines"": 2}}"
2021-12-16 10:05:41,6ecf58b0d7d9b8fbba780d19d2e6c0f227df715b,Bram Moolenaar,7,4,11,2,"{""src/testdir/test_visual.vim"": {""insertions"": 5, ""deletions"": 4, ""lines"": 9}, ""src/version.c"": {""insertions"": 2, ""deletions"": 0, ""lines"": 2}}"
2021-12-16 08:21:09,2d877599ee1cede063ef4abe3a2272e67c116238,Bram Moolenaar,130,64,194,8,"{""src/errors.h"": {""insertions"": 2, ""deletions"": 0, ""lines"": 2}, ""src/evalfunc.c"": {""insertions"": 17, ""deletions"": 1, ""lines"": 18}, ""src/list.c"": {""insertions"": 3, ""deletions"": 2, ""lines"": 5}, ""src/proto/typval.pro"": {""insertions"": 1, ""deletions"": 0, ""lines"": 1}, ""src/testdir/test_filter_map.vim"": {""insertions"": 78, ""deletions"": 56, ""lines"": 134}, ""src/testdir/test_vim9_builtin.vim"": {""insertions"": 5, ""deletions"": 5, ""lines"": 10}, ""src/typval.c"": {""insertions"": 22, ""deletions"": 0, ""lines"": 22}, ""src/version.c"": {""insertions"": 2, ""deletions"": 0, ""lines"": 2}}"
2021-12-15 21:29:19,19569ca6d805de7a2ac95ee7b0c52475a9d5d851,Bram Moolenaar,3,1,4,2,"{"".github/workflows/ci.yml"": {""insertions"": 1, ""deletions"": 1, ""lines"": 2}, ""src/version.c"": {""insertions"": 2, ""deletions"": 0, ""lines"": 2}}"
2021-12-15 21:08:50,8ee6028de3daa9af9e5f90fa9e583ff407bee04f,Bram Moolenaar,11,2,13,3,"{""src/ops.c"": {""insertions"": 5, ""deletions"": 2, ""lines"": 7}, ""src/testdir/test_visual.vim"": {""insertions"": 4, ""deletions"": 0, ""lines"": 4}, ""src/version.c"": {""insertions"": 2, ""deletions"": 0, ""lines"": 2}}"
2021-12-15 19:46:59,427f065a885629db430dd06ccda8b1318b8a5e92,Bram Moolenaar,4,2,6,3,"{""src/testdir/dumps/Test_popupwin_three_errors_1.dump"": {""insertions"": 1, ""deletions"": 1, ""lines"": 2}, ""src/testdir/dumps/Test_popupwin_three_errors_2.dump"": {""insertions"": 1, ""deletions"": 1, ""lines"": 2}, ""src/version.c"": {""insertions"": 2, ""deletions"": 0, ""lines"": 2}}"
2021-12-15 19:14:54,c479ce032f5d4d14bab9e479acbf42d758879893,rbtnn,169,27,196,5,"{""runtime/doc/eval.txt"": {""insertions"": 34, ""deletions"": 24, ""lines"": 58}, ""src/errors.h"": {""insertions"": 2, ""deletions"": 0, ""lines"": 2}, ""src/list.c"": {""insertions"": 67, ""deletions"": 1, ""lines"": 68}, ""src/testdir/test_filter_map.vim"": {""insertions"": 64, ""deletions"": 2, ""lines"": 66}, ""src/version.c"": {""insertions"": 2, ""deletions"": 0, ""lines"": 2}}"
2021-12-15 17:53:40,f87dac04c351583241ea1c4ec4228516431e6f22,Bram Moolenaar,38,24,62,4,"{""src/ex_cmds.h"": {""insertions"": 21, ""deletions"": 20, ""lines"": 41}, ""src/ex_docmd.c"": {""insertions"": 1, ""deletions"": 1, ""lines"": 2}, ""src/testdir/test_usercommands.vim"": {""insertions"": 14, ""deletions"": 3, ""lines"": 17}, ""src/version.c"": {""insertions"": 2, ""deletions"": 0, ""lines"": 2}}"
2021-12-15 16:38:33,1821d1498ca57dc3f7a21767c253a778d9b113fb,Mike Williams,3,1,4,2,"{""src/userfunc.c"": {""insertions"": 1, ""deletions"": 1, ""lines"": 2}, ""src/version.c"": {""insertions"": 2, ""deletions"": 0, ""lines"": 2}}"
2021-12-15 15:41:44,ce7eada12ea16c830332042f0021a9564bbb25af,Bram Moolenaar,34,4,38,6,"{""src/charset.c"": {""insertions"": 15, ""deletions"": 2, ""lines"": 17}, ""src/eval.c"": {""insertions"": 1, ""deletions"": 1, ""lines"": 2}, ""src/ex_docmd.c"": {""insertions"": 1, ""deletions"": 1, ""lines"": 2}, ""src/proto/charset.pro"": {""insertions"": 1, ""deletions"": 0, ""lines"": 1}, ""src/testdir/test_vim9_expr.vim"": {""insertions"": 14, ""deletions"": 0, ""lines"": 14}, ""src/version.c"": {""insertions"": 2, ""deletions"": 0, ""lines"": 2}}"
2021-12-15 13:30:43,cfabad9bcf45650dee1f1f41ec4047f82a12f323,Bram Moolenaar,8,2,10,3,"{""runtime/filetype.vim"": {""insertions"": 4, ""deletions"": 1, ""lines"": 5}, ""src/testdir/test_filetype.vim"": {""insertions"": 2, ""deletions"": 1, ""lines"": 3}, ""src/version.c"": {""insertions"": 2, ""deletions"": 0, ""lines"": 2}}"
2021-12-15 12:28:22,a5d78d1f1123d9ffccd5ba58f2d2dec44cc59e94,Bram Moolenaar,12,0,12,3,"{""src/ex_docmd.c"": {""insertions"": 4, ""deletions"": 0, ""lines"": 4}, ""src/testdir/test_quickfix.vim"": {""insertions"": 6, ""deletions"": 0, ""lines"": 6}, ""src/version.c"": {""insertions"": 2, ""deletions"": 0, ""lines"": 2}}"
2021-12-15 12:06:43,57bc2333b1d713bc54f8e33ef3ef7ac169af2ac4,Bram Moolenaar,45,20,65,2,"{""src/userfunc.c"": {""insertions"": 43, ""deletions"": 20, ""lines"": 63}, ""src/version.c"": {""insertions"": 2, ""deletions"": 0, ""lines"": 2}}"
2021-12-14 20:26:53,7c0fb800302c3bdd2dfa5ba10d0caa806e9500f6,Bram Moolenaar,3,0,3,2,"{""src/testdir/test_vim9_func.vim"": {""insertions"": 1, ""deletions"": 0, ""lines"": 1}, ""src/version.c"": {""insertions"": 2, ""deletions"": 0, ""lines"": 2}}"
2021-12-14 18:57:45,b334137acffd7a2b2ab8524e54d4c55ebf4518ea,Bram Moolenaar,13,3,16,3,"{""src/eval.c"": {""insertions"": 1, ""deletions"": 1, ""lines"": 2}, ""src/testdir/test_vim9_expr.vim"": {""insertions"": 10, ""deletions"": 2, ""lines"": 12}, ""src/version.c"": {""insertions"": 2, ""deletions"": 0, ""lines"": 2}}"
2021-12-14 18:14:37,7509ad8b0fad56f88288977decbeca3640406c82,Bram Moolenaar,100,12,112,6,"{""src/eval.c"": {""insertions"": 4, ""deletions"": 9, ""lines"": 13}, ""src/proto/vim9execute.pro"": {""insertions"": 1, ""deletions"": 0, ""lines"": 1}, ""src/structs.h"": {""insertions"": 7, ""deletions"": 2, ""lines"": 9}, ""src/testdir/test_vim9_func.vim"": {""insertions"": 35, ""deletions"": 0, ""lines"": 35}, ""src/version.c"": {""insertions"": 2, ""deletions"": 0, ""lines"": 2}, ""src/vim9execute.c"": {""insertions"": 51, ""deletions"": 1, ""lines"": 52}}"
2021-12-14 14:29:16,919c12c19a9785b856bc32dfe6cd8e9277178b62,Bram Moolenaar,5,3,8,2,"{""src/version.c"": {""insertions"": 2, ""deletions"": 0, ""lines"": 2}, ""src/vim9execute.c"": {""insertions"": 3, ""deletions"": 3, ""lines"": 6}}"
2021-12-14 12:06:16,f8a79fc3468645019532331bf8b36d1f7b403ef4,Bram Moolenaar,28,2,30,4,"{""src/eval.c"": {""insertions"": 1, ""deletions"": 1, ""lines"": 2}, ""src/testdir/test_vim9_script.vim"": {""insertions"": 15, ""deletions"": 0, ""lines"": 15}, ""src/userfunc.c"": {""insertions"": 10, ""deletions"": 1, ""lines"": 11}, ""src/version.c"": {""insertions"": 2, ""deletions"": 0, ""lines"": 2}}"
2021-12-14 11:16:31,c2958585f6c7ce4d822d3191ba501c0757b3ffff,Bram Moolenaar,4,3,7,2,"{""src/testdir/test_terminal.vim"": {""insertions"": 2, ""deletions"": 3, ""lines"": 5}, ""src/version.c"": {""insertions"": 2, ""deletions"": 0, ""lines"": 2}}"
2021-12-14 09:34:41,8176be159859deb9cf6455565bd7b24b3dcf17b9,Quentin Hibon,7,0,7,3,"{""runtime/filetype.vim"": {""insertions"": 4, ""deletions"": 0, ""lines"": 4}, ""src/testdir/test_filetype.vim"": {""insertions"": 1, ""deletions"": 0, ""lines"": 1}, ""src/version.c"": {""insertions"": 2, ""deletions"": 0, ""lines"": 2}}"
2021-12-14 09:01:38,6206877c511c636cbeb2a2b911451af316b62d00,Bram Moolenaar,4,1,5,2,"{""src/option.c"": {""insertions"": 2, ""deletions"": 1, ""lines"": 3}, ""src/version.c"": {""insertions"": 2, ""deletions"": 0, ""lines"": 2}}"
2021-12-14 08:41:38,829c8e87e2d99b9d87c9c745e74750177c0298df,Bram Moolenaar,5,3,8,2,"{""src/terminal.c"": {""insertions"": 3, ""deletions"": 3, ""lines"": 6}, ""src/version.c"": {""insertions"": 2, ""deletions"": 0, ""lines"": 2}}"
2021-12-13 22:17:44,0407d270342d363c6297a7556cd904b4c434df54,Bram Moolenaar,6,2,8,2,"{""src/testdir/test_terminal.vim"": {""insertions"": 4, ""deletions"": 2, ""lines"": 6}, ""src/version.c"": {""insertions"": 2, ""deletions"": 0, ""lines"": 2}}"
2021-12-13 21:59:09,3194e5bf87f8e08f519b947a03c46677616cd7e3,Bram Moolenaar,53,2,55,5,"{""src/drawscreen.c"": {""insertions"": 7, ""deletions"": 0, ""lines"": 7}, ""src/proto/terminal.pro"": {""insertions"": 1, ""deletions"": 0, ""lines"": 1}, ""src/terminal.c"": {""insertions"": 16, ""deletions"": 2, ""lines"": 18}, ""src/testdir/test_terminal.vim"": {""insertions"": 27, ""deletions"": 0, ""lines"": 27}, ""src/version.c"": {""insertions"": 2, ""deletions"": 0, ""lines"": 2}}"
2021-12-13 20:37:59,6840a0ffe8d27a8773a500ba17550cdf2ad12cbc,Bram Moolenaar,105,44,149,3,"{""src/auto/configure"": {""insertions"": 55, ""deletions"": 22, ""lines"": 77}, ""src/configure.ac"": {""insertions"": 48, ""deletions"": 22, ""lines"": 70}, ""src/version.c"": {""insertions"": 2, ""deletions"": 0, ""lines"": 2}}"
2021-12-13 19:14:52,80d60910ff493f7b8ea52156e4c7df7e70a348c6,Bram Moolenaar,3,1,4,2,"{""src/userfunc.c"": {""insertions"": 1, ""deletions"": 1, ""lines"": 2}, ""src/version.c"": {""insertions"": 2, ""deletions"": 0, ""lines"": 2}}"
2021-12-13 18:19:55,3b309f11db7904efcae0177c2825597042c07427,Bram Moolenaar,65,10,75,4,"{""src/testdir/dumps/Test_opfunc_error.dump"": {""insertions"": 6, ""deletions"": 0, ""lines"": 6}, ""src/testdir/test_vim9_func.vim"": {""insertions"": 48, ""deletions"": 10, ""lines"": 58}, ""src/userfunc.c"": {""insertions"": 9, ""deletions"": 0, ""lines"": 9}, ""src/version.c"": {""insertions"": 2, ""deletions"": 0, ""lines"": 2}}"
2021-12-13 14:40:53,1e78deb0779bc403a914712f0842a65d2949dfdf,Bram Moolenaar,6,9,15,3,"{""runtime/doc/message.txt"": {""insertions"": 1, ""deletions"": 2, ""lines"": 3}, ""src/feature.h"": {""insertions"": 3, ""deletions"": 7, ""lines"": 10}, ""src/version.c"": {""insertions"": 2, ""deletions"": 0, ""lines"": 2}}"
2021-12-13 14:26:44,851f86b951cdd67ad9cf3149e46169d1375c8d82,Bram Moolenaar,87,84,171,8,"{""src/eval.c"": {""insertions"": 18, ""deletions"": 18, ""lines"": 36}, ""src/list.c"": {""insertions"": 6, ""deletions"": 6, ""lines"": 12}, ""src/regexp.c"": {""insertions"": 3, ""deletions"": 3, ""lines"": 6}, ""src/structs.h"": {""insertions"": 9, ""deletions"": 9, ""lines"": 18}, ""src/terminal.c"": {""insertions"": 3, ""deletions"": 3, ""lines"": 6}, ""src/userfunc.c"": {""insertions"": 43, ""deletions"": 42, ""lines"": 85}, ""src/version.c"": {""insertions"": 2, ""deletions"": 0, ""lines"": 2}, ""src/vim9execute.c"": {""insertions"": 3, ""deletions"": 3, ""lines"": 6}}"
2021-12-13 13:12:53,739f13a55b4982efb37ebc9282e7f79975fff982,Bram Moolenaar,9,122,131,17,"{""runtime/doc/motion.txt"": {""insertions"": 0, ""deletions"": 7, ""lines"": 7}, ""runtime/doc/various.txt"": {""insertions"": 1, ""deletions"": 1, ""lines"": 2}, ""src/buffer.c"": {""insertions"": 0, ""deletions"": 2, ""lines"": 2}, ""src/change.c"": {""insertions"": 0, ""deletions"": 4, ""lines"": 4}, ""src/evalfunc.c"": {""insertions"": 1, ""deletions"": 15, ""lines"": 16}, ""src/ex_docmd.c"": {""insertions"": 0, ""deletions"": 6, ""lines"": 6}, ""src/feature.h"": {""insertions"": 1, ""deletions"": 7, ""lines"": 8}, ""src/mark.c"": {""insertions"": 1, ""deletions"": 25, ""lines"": 26}, ""src/normal.c"": {""insertions"": 2, ""deletions"": 8, ""lines"": 10}, ""src/structs.h"": {""insertions"": 0, ""deletions"": 4, ""lines"": 4}, ""src/testdir/test_changelist.vim"": {""insertions"": 0, ""deletions"": 4, ""lines"": 4}, ""src/testdir/test_jumplist.vim"": {""insertions"": 0, ""deletions"": 4, ""lines"": 4}, ""src/testdir/test_normal.vim"": {""insertions"": 0, ""deletions"": 2, ""lines"": 2}, ""src/undo.c"": {""insertions"": 1, ""deletions"": 3, ""lines"": 4}, ""src/version.c"": {""insertions"": 2, ""deletions"": 4, ""lines"": 6}, ""src/viminfo.c"": {""insertions"": 0, ""deletions"": 20, ""lines"": 20}, ""src/window.c"": {""insertions"": 0, ""deletions"": 6, ""lines"": 6}}"
2021-12-13 11:31:04,33b968dc60c5fa39451098e680c7559ebc65d1a7,Bram Moolenaar,18,3,21,3,"{""src/testdir/test_vim9_func.vim"": {""insertions"": 12, ""deletions"": 0, ""lines"": 12}, ""src/userfunc.c"": {""insertions"": 4, ""deletions"": 3, ""lines"": 7}, ""src/version.c"": {""insertions"": 2, ""deletions"": 0, ""lines"": 2}}"
2021-12-12 21:02:03,ef082e12df2cafe177b2ac9f6922393223ccf83b,Bram Moolenaar,28,2,30,3,"{""src/evalvars.c"": {""insertions"": 7, ""deletions"": 2, ""lines"": 9}, ""src/testdir/test_vim9_func.vim"": {""insertions"": 19, ""deletions"": 0, ""lines"": 19}, ""src/version.c"": {""insertions"": 2, ""deletions"": 0, ""lines"": 2}}"
2021-12-12 20:08:05,04ef1fb13d200f770952e670357dddadb6210dd4,Yegappan Lakshmanan,386,304,690,6,"{""src/testdir/test_iminsert.vim"": {""insertions"": 11, ""deletions"": 6, ""lines"": 17}, ""src/testdir/test_ins_complete.vim"": {""insertions"": 215, ""deletions"": 185, ""lines"": 400}, ""src/testdir/test_normal.vim"": {""insertions"": 71, ""deletions"": 61, ""lines"": 132}, ""src/testdir/test_quickfix.vim"": {""insertions"": 7, ""deletions"": 0, ""lines"": 7}, ""src/testdir/test_tagfunc.vim"": {""insertions"": 80, ""deletions"": 52, ""lines"": 132}, ""src/version.c"": {""insertions"": 2, ""deletions"": 0, ""lines"": 2}}"
2021-12-12 19:10:44,d2439e0443ee26931ab93874c05cc7f57e9af93d,Bram Moolenaar,5,3,8,2,"{""src/change.c"": {""insertions"": 3, ""deletions"": 3, ""lines"": 6}, ""src/version.c"": {""insertions"": 2, ""deletions"": 0, ""lines"": 2}}"
2021-12-12 18:50:19,3bb79dc191a1dec14606b1b94b968a6808906700,Bram Moolenaar,7,9,16,2,"{""src/testdir/test_terminal2.vim"": {""insertions"": 5, ""deletions"": 9, ""lines"": 14}, ""src/version.c"": {""insertions"": 2, ""deletions"": 0, ""lines"": 2}}"
2021-12-12 16:42:09,fa9a8e0fd1143d2b47611c6cc13e32f6283448a4,ichizok,9,3,12,2,"{""src/testdir/test_window_cmd.vim"": {""insertions"": 7, ""deletions"": 3, ""lines"": 10}, ""src/version.c"": {""insertions"": 2, ""deletions"": 0, ""lines"": 2}}"
2021-12-12 16:26:44,6ae8fae8696623b527c7fb22567f6a3705b2f0dd,Yegappan Lakshmanan,1091,898,1989,19,"{""src/eval.c"": {""insertions"": 28, ""deletions"": 0, ""lines"": 28}, ""src/evalbuffer.c"": {""insertions"": 15, ""deletions"": 21, ""lines"": 36}, ""src/evalvars.c"": {""insertions"": 0, ""deletions"": 1, ""lines"": 1}, ""src/gui_xim.c"": {""insertions"": 19, ""deletions"": 1, ""lines"": 20}, ""src/insexpand.c"": {""insertions"": 15, ""deletions"": 0, ""lines"": 15}, ""src/ops.c"": {""insertions"": 18, ""deletions"": 2, ""lines"": 20}, ""src/proto/eval.pro"": {""insertions"": 1, ""deletions"": 0, ""lines"": 1}, ""src/proto/gui_xim.pro"": {""insertions"": 1, ""deletions"": 0, ""lines"": 1}, ""src/proto/insexpand.pro"": {""insertions"": 1, ""deletions"": 0, ""lines"": 1}, ""src/proto/ops.pro"": {""insertions"": 1, ""deletions"": 0, ""lines"": 1}, ""src/proto/tag.pro"": {""insertions"": 1, ""deletions"": 0, ""lines"": 1}, ""src/quickfix.c"": {""insertions"": 11, ""deletions"": 2, ""lines"": 13}, ""src/tag.c"": {""insertions"": 20, ""deletions"": 4, ""lines"": 24}, ""src/testdir/test_iminsert.vim"": {""insertions"": 121, ""deletions"": 109, ""lines"": 230}, ""src/testdir/test_ins_complete.vim"": {""insertions"": 465, ""deletions"": 492, ""lines"": 957}, ""src/testdir/test_normal.vim"": {""insertions"": 119, ""deletions"": 129, ""lines"": 248}, ""src/testdir/test_quickfix.vim"": {""insertions"": 126, ""deletions"": 0, ""lines"": 126}, ""src/testdir/test_tagfunc.vim"": {""insertions"": 127, ""deletions"": 137, ""lines"": 264}, ""src/version.c"": {""insertions"": 2, ""deletions"": 0, ""lines"": 2}}"
2021-12-12 14:16:39,6e371ecb27227ff8fedd8561d0f3880a17576848,Bram Moolenaar,118,24,142,11,"{""src/change.c"": {""insertions"": 47, ""deletions"": 10, ""lines"": 57}, ""src/cindent.c"": {""insertions"": 23, ""deletions"": 6, ""lines"": 29}, ""src/edit.c"": {""insertions"": 2, ""deletions"": 1, ""lines"": 3}, ""src/normal.c"": {""insertions"": 1, ""deletions"": 1, ""lines"": 2}, ""src/proto/change.pro"": {""insertions"": 1, ""deletions"": 1, ""lines"": 2}, ""src/proto/search.pro"": {""insertions"": 1, ""deletions"": 0, ""lines"": 1}, ""src/search.c"": {""insertions"": 1, ""deletions"": 2, ""lines"": 3}, ""src/testdir/test_cindent.vim"": {""insertions"": 2, ""deletions"": 2, ""lines"": 4}, ""src/testdir/test_textformat.vim"": {""insertions"": 30, ""deletions"": 0, ""lines"": 30}, ""src/textformat.c"": {""insertions"": 8, ""deletions"": 1, ""lines"": 9}, ""src/version.c"": {""insertions"": 2, ""deletions"": 0, ""lines"": 2}}"
2021-12-12 11:44:11,9a4ec5a62632af040c278a189e256043740f5c7f,Bram Moolenaar,10,5,15,1,"{"".github/ISSUE_TEMPLATE/bug_report.yml"": {""insertions"": 10, ""deletions"": 5, ""lines"": 15}}"
2021-12-12 11:34:22,4e30b5c3bc83fe6a87f4d50720638e8bb4e16428,Bram Moolenaar,2,2,4,1,"{"".github/ISSUE_TEMPLATE/bug_report.yml"": {""insertions"": 2, ""deletions"": 2, ""lines"": 4}}"
2021-12-11 18:46:29,4f16e9de985c5178e9cf15d69facfec6f15a5e09,Bram Moolenaar,3,1,4,2,"{""src/testdir/test_functions.vim"": {""insertions"": 1, ""deletions"": 1, ""lines"": 2}, ""src/version.c"": {""insertions"": 2, ""deletions"": 0, ""lines"": 2}}"
2021-12-11 17:34:19,48c0196378a1fa408ebae4f578a62095d8a80c6f,ichizok,6,3,9,2,"{"".github/workflows/ci.yml"": {""insertions"": 4, ""deletions"": 3, ""lines"": 7}, ""src/version.c"": {""insertions"": 2, ""deletions"": 0, ""lines"": 2}}"
2021-12-11 17:24:39,7b1463bca36d16e70afd6779e4fbb30761048c91,Bram Moolenaar,18,2,20,2,"{""runtime/doc/options.txt"": {""insertions"": 16, ""deletions"": 2, ""lines"": 18}, ""src/version.c"": {""insertions"": 2, ""deletions"": 0, ""lines"": 2}}"
2021-12-11 16:14:07,2ef9156b4284e4a52613c36e3d4667245273a28d,Bram Moolenaar,51,19,70,9,"{""src/eval.c"": {""insertions"": 3, ""deletions"": 1, ""lines"": 4}, ""src/proto/userfunc.pro"": {""insertions"": 2, ""deletions"": 2, ""lines"": 4}, ""src/structs.h"": {""insertions"": 2, ""deletions"": 0, ""lines"": 2}, ""src/testdir/test_functions.vim"": {""insertions"": 6, ""deletions"": 0, ""lines"": 6}, ""src/testdir/test_vim9_func.vim"": {""insertions"": 1, ""deletions"": 1, ""lines"": 2}, ""src/testdir/test_vim9_script.vim"": {""insertions"": 9, ""deletions"": 0, ""lines"": 9}, ""src/userfunc.c"": {""insertions"": 16, ""deletions"": 7, ""lines"": 23}, ""src/version.c"": {""insertions"": 2, ""deletions"": 0, ""lines"": 2}, ""src/vim9execute.c"": {""insertions"": 10, ""deletions"": 8, ""lines"": 18}}"
2021-12-11 13:54:46,052ff291d72bc9c176f9562f021d7e8e030e74c0,Bram Moolenaar,46,10,56,5,"{""src/evalvars.c"": {""insertions"": 1, ""deletions"": 1, ""lines"": 2}, ""src/testdir/test_vim9_script.vim"": {""insertions"": 13, ""deletions"": 2, ""lines"": 15}, ""src/userfunc.c"": {""insertions"": 29, ""deletions"": 7, ""lines"": 36}, ""src/version.c"": {""insertions"": 2, ""deletions"": 0, ""lines"": 2}, ""src/vim.h"": {""insertions"": 1, ""deletions"": 0, ""lines"": 1}}"
2021-12-11 12:33:52,a416861c643b03fe5dec9f3bf8c1c9e054b5a9c7,Bram Moolenaar,3,1,4,2,"{""runtime/optwin.vim"": {""insertions"": 1, ""deletions"": 1, ""lines"": 2}, ""src/version.c"": {""insertions"": 2, ""deletions"": 0, ""lines"": 2}}"
2021-12-11 12:28:08,29f3a4591528130fded3fe1d63d74bcf22ab4f6c,Bakudankun,49,12,61,9,"{""runtime/doc/editing.txt"": {""insertions"": 6, ""deletions"": 5, ""lines"": 11}, ""runtime/doc/quickref.txt"": {""insertions"": 1, ""deletions"": 0, ""lines"": 1}, ""runtime/optwin.vim"": {""insertions"": 4, ""deletions"": 0, ""lines"": 4}, ""src/ex_docmd.c"": {""insertions"": 7, ""deletions"": 4, ""lines"": 11}, ""src/option.h"": {""insertions"": 1, ""deletions"": 0, ""lines"": 1}, ""src/optiondefs.h"": {""insertions"": 4, ""deletions"": 0, ""lines"": 4}, ""src/testdir/runtest.vim"": {""insertions"": 3, ""deletions"": 3, ""lines"": 6}, ""src/testdir/test_options.vim"": {""insertions"": 21, ""deletions"": 0, ""lines"": 21}, ""src/version.c"": {""insertions"": 2, ""deletions"": 0, ""lines"": 2}}"
2021-12-10 21:46:09,205f29c3e9b895dbaa4f738046da455a93c3812a,Bram Moolenaar,30,2,32,3,"{""src/testdir/test_usercommands.vim"": {""insertions"": 19, ""deletions"": 0, ""lines"": 19}, ""src/usercmd.c"": {""insertions"": 9, ""deletions"": 2, ""lines"": 11}, ""src/version.c"": {""insertions"": 2, ""deletions"": 0, ""lines"": 2}}"
2021-12-10 21:05:53,9537e37b1124a0584e5f2af10756baca78bc73a1,Bram Moolenaar,8,1,9,2,"{""src/testdir/test_vim9_script.vim"": {""insertions"": 6, ""deletions"": 1, ""lines"": 7}, ""src/version.c"": {""insertions"": 2, ""deletions"": 0, ""lines"": 2}}"
2021-12-10 20:39:17,1daedc838126bf6fe30221192cfe36aa1b56b454,=?UTF-8?q?Bj=C3=B6rn=20Linse?=,8,8,16,2,"{""src/spellfile.c"": {""insertions"": 6, ""deletions"": 8, ""lines"": 14}, ""src/version.c"": {""insertions"": 2, ""deletions"": 0, ""lines"": 2}}"
2021-12-10 20:15:15,f8e9eb8e173bf0ff9560192ae888941ef8302269,Bram Moolenaar,28,2,30,3,"{""src/tag.c"": {""insertions"": 7, ""deletions"": 2, ""lines"": 9}, ""src/testdir/test_taglist.vim"": {""insertions"": 19, ""deletions"": 0, ""lines"": 19}, ""src/version.c"": {""insertions"": 2, ""deletions"": 0, ""lines"": 2}}"
2021-12-10 16:55:58,9fffef9f3562e05755e4b3c46509b2eeeb623ff7,Bram Moolenaar,32,4,36,3,"{""src/testdir/test_vim9_script.vim"": {""insertions"": 23, ""deletions"": 0, ""lines"": 23}, ""src/version.c"": {""insertions"": 2, ""deletions"": 0, ""lines"": 2}, ""src/vim9compile.c"": {""insertions"": 7, ""deletions"": 4, ""lines"": 11}}"
2021-12-10 13:40:08,b711814cb64b60ec4918e3e1fb2ca5c50d6e9340,Bram Moolenaar,29,28,57,3,"{""src/structs.h"": {""insertions"": 2, ""deletions"": 1, ""lines"": 3}, ""src/version.c"": {""insertions"": 2, ""deletions"": 0, ""lines"": 2}, ""src/window.c"": {""insertions"": 25, ""deletions"": 27, ""lines"": 52}}"
2021-12-10 12:11:09,8a7374f8c4eb4c016270ad908a43af4ddedcbf56,Bram Moolenaar,26,13,39,2,"{""src/version.c"": {""insertions"": 2, ""deletions"": 0, ""lines"": 2}, ""src/window.c"": {""insertions"": 24, ""deletions"": 13, ""lines"": 37}}"
2021-12-10 10:57:08,ff39a650b2bd31e30d1bb8766e8560f9a14a7137,Bram Moolenaar,3,2,5,2,"{""src/testdir/test_timers.vim"": {""insertions"": 1, ""deletions"": 2, ""lines"": 3}, ""src/version.c"": {""insertions"": 2, ""deletions"": 0, ""lines"": 2}}"
2021-12-10 10:37:38,dd297bc11d2793ba61638972778c57f2da14e8b5,Bram Moolenaar,49,3,52,5,"{""src/evalvars.c"": {""insertions"": 3, ""deletions"": 2, ""lines"": 5}, ""src/structs.h"": {""insertions"": 1, ""deletions"": 0, ""lines"": 1}, ""src/testdir/test_vim9_func.vim"": {""insertions"": 19, ""deletions"": 0, ""lines"": 19}, ""src/version.c"": {""insertions"": 2, ""deletions"": 0, ""lines"": 2}, ""src/vim9script.c"": {""insertions"": 24, ""deletions"": 1, ""lines"": 25}}"
2021-12-09 21:08:01,dee78e1ce857985c06ff18e20daeadfe1622b8ae,ichizok,29,8,37,5,"{"".github/workflows/ci.yml"": {""insertions"": 14, ""deletions"": 6, ""lines"": 20}, ""ci/config.mk.clang-12.sed"": {""insertions"": 3, ""deletions"": 0, ""lines"": 3}, ""src/os_unix.c"": {""insertions"": 9, ""deletions"": 1, ""lines"": 10}, ""src/spellfile.c"": {""insertions"": 1, ""deletions"": 1, ""lines"": 2}, ""src/version.c"": {""insertions"": 2, ""deletions"": 0, ""lines"": 2}}"
2021-12-09 20:54:21,4c8c634365bc6d4d462635aed5e0f7ad2262d590,Gregory Anders,7,1,8,3,"{""runtime/filetype.vim"": {""insertions"": 3, ""deletions"": 0, ""lines"": 3}, ""src/testdir/test_filetype.vim"": {""insertions"": 2, ""deletions"": 1, ""lines"": 3}, ""src/version.c"": {""insertions"": 2, ""deletions"": 0, ""lines"": 2}}"
2021-12-09 18:42:57,95b2dd0c008f0977ebb3cbe233a5064001a332e1,Bram Moolenaar,11,1,12,3,"{""src/testdir/test_timers.vim"": {""insertions"": 7, ""deletions"": 0, ""lines"": 7}, ""src/time.c"": {""insertions"": 2, ""deletions"": 1, ""lines"": 3}, ""src/version.c"": {""insertions"": 2, ""deletions"": 0, ""lines"": 2}}"
2021-12-09 17:44:01,e8a92b6166e32f8e583e01c9f541cf81cf76f8e6,Bram Moolenaar,3,1,4,2,"{""src/eval.c"": {""insertions"": 1, ""deletions"": 1, ""lines"": 2}, ""src/version.c"": {""insertions"": 2, ""deletions"": 0, ""lines"": 2}}"
2021-12-09 16:40:18,c4ec338fb80ebfb5d631f0718fdd1a1c04d9ed82,Bram Moolenaar,16,1,17,3,"{""src/eval.c"": {""insertions"": 9, ""deletions"": 1, ""lines"": 10}, ""src/testdir/test_functions.vim"": {""insertions"": 5, ""deletions"": 0, ""lines"": 5}, ""src/version.c"": {""insertions"": 2, ""deletions"": 0, ""lines"": 2}}"
2021-12-09 14:23:43,dcb53be4418fe263a71c7738315241031df6c986,Bram Moolenaar,90,19,109,6,"{""src/testdir/test_vim9_disassemble.vim"": {""insertions"": 11, ""deletions"": 5, ""lines"": 16}, ""src/testdir/test_vim9_func.vim"": {""insertions"": 22, ""deletions"": 0, ""lines"": 22}, ""src/version.c"": {""insertions"": 2, ""deletions"": 0, ""lines"": 2}, ""src/vim9.h"": {""insertions"": 3, ""deletions"": 2, ""lines"": 5}, ""src/vim9compile.c"": {""insertions"": 30, ""deletions"": 9, ""lines"": 39}, ""src/vim9execute.c"": {""insertions"": 22, ""deletions"": 3, ""lines"": 25}}"
2021-12-09 11:57:22,d0fb907253a5c5a71b1f231f3ddec24098fb4e21,Bram Moolenaar,59,0,59,6,"{""src/edit.c"": {""insertions"": 5, ""deletions"": 0, ""lines"": 5}, ""src/normal.c"": {""insertions"": 5, ""deletions"": 0, ""lines"": 5}, ""src/proto/window.pro"": {""insertions"": 1, ""deletions"": 0, ""lines"": 1}, ""src/testdir/test_window_cmd.vim"": {""insertions"": 34, ""deletions"": 0, ""lines"": 34}, ""src/version.c"": {""insertions"": 2, ""deletions"": 0, ""lines"": 2}, ""src/window.c"": {""insertions"": 12, ""deletions"": 0, ""lines"": 12}}"
2021-12-09 10:51:05,e50507126f532a0b0ae65e201a6372b7ea5b0ccd,Bram Moolenaar,45,42,87,16,"{""src/beval.c"": {""insertions"": 1, ""deletions"": 1, ""lines"": 2}, ""src/channel.c"": {""insertions"": 2, ""deletions"": 2, ""lines"": 4}, ""src/drawscreen.c"": {""insertions"": 8, ""deletions"": 3, ""lines"": 11}, ""src/ex_getln.c"": {""insertions"": 4, ""deletions"": 0, ""lines"": 4}, ""src/job.c"": {""insertions"": 1, ""deletions"": 1, ""lines"": 2}, ""src/popupwin.c"": {""insertions"": 1, ""deletions"": 1, ""lines"": 2}, ""src/proto/drawscreen.pro"": {""insertions"": 1, ""deletions"": 1, ""lines"": 2}, ""src/sound.c"": {""insertions"": 2, ""deletions"": 2, ""lines"": 4}, ""src/terminal.c"": {""insertions"": 1, ""deletions"": 1, ""lines"": 2}, ""src/testdir/dumps/Test_terminal_focus_1.dump"": {""insertions"": 2, ""deletions"": 2, ""lines"": 4}, ""src/testdir/dumps/Test_terminal_focus_2.dump"": {""insertions"": 2, ""deletions"": 2, ""lines"": 4}, ""src/testdir/dumps/Test_terminal_focus_3.dump"": {""insertions"": 6, ""deletions"": 0, ""lines"": 6}, ""src/testdir/test_terminal.vim"": {""insertions"": 10, ""deletions"": 2, ""lines"": 12}, ""src/time.c"": {""insertions"": 1, ""deletions"": 1, ""lines"": 2}, ""src/ui.c"": {""insertions"": 1, ""deletions"": 23, ""lines"": 24}, ""src/version.c"": {""insertions"": 2, ""deletions"": 0, ""lines"": 2}}"
2021-12-09 09:27:06,56150da6879a96db1c84c7ec4ceedeb84969f606,Yegappan Lakshmanan,17,3,20,3,"{""src/quickfix.c"": {""insertions"": 8, ""deletions"": 3, ""lines"": 11}, ""src/testdir/test_quickfix.vim"": {""insertions"": 7, ""deletions"": 0, ""lines"": 7}, ""src/version.c"": {""insertions"": 2, ""deletions"": 0, ""lines"": 2}}"
2021-12-08 22:13:38,a48d4e44a24191f5495e17d7616771c20ae3e3c1,Bram Moolenaar,86,8,94,7,"{""src/proto/terminal.pro"": {""insertions"": 1, ""deletions"": 0, ""lines"": 1}, ""src/terminal.c"": {""insertions"": 33, ""deletions"": 8, ""lines"": 41}, ""src/testdir/dumps/Test_terminal_focus_1.dump"": {""insertions"": 6, ""deletions"": 0, ""lines"": 6}, ""src/testdir/dumps/Test_terminal_focus_2.dump"": {""insertions"": 6, ""deletions"": 0, ""lines"": 6}, ""src/testdir/test_terminal.vim"": {""insertions"": 34, ""deletions"": 0, ""lines"": 34}, ""src/ui.c"": {""insertions"": 4, ""deletions"": 0, ""lines"": 4}, ""src/version.c"": {""insertions"": 2, ""deletions"": 0, ""lines"": 2}}"
2021-12-08 21:00:24,48873aebc05608e9e5e56b8628ae6d2789ab7c48,Bram Moolenaar,3,0,3,2,"{""src/os_unix.c"": {""insertions"": 1, ""deletions"": 0, ""lines"": 1}, ""src/version.c"": {""insertions"": 2, ""deletions"": 0, ""lines"": 2}}"
2021-12-08 20:03:31,78a61068cf2c83e611d954a0fb413a09ad59dc07,Yegappan Lakshmanan,50,10,60,4,"{""src/quickfix.c"": {""insertions"": 8, ""deletions"": 8, ""lines"": 16}, ""src/testdir/test_quickfix.vim"": {""insertions"": 36, ""deletions"": 0, ""lines"": 36}, ""src/version.c"": {""insertions"": 2, ""deletions"": 0, ""lines"": 2}, ""src/window.c"": {""insertions"": 4, ""deletions"": 2, ""lines"": 6}}"
2021-12-08 10:46:21,2172bff36417ddd90653531edc65897411c83b3f,Yegappan Lakshmanan,483,400,883,4,"{""src/testdir/test_ins_complete.vim"": {""insertions"": 240, ""deletions"": 266, ""lines"": 506}, ""src/testdir/test_normal.vim"": {""insertions"": 177, ""deletions"": 64, ""lines"": 241}, ""src/testdir/test_tagfunc.vim"": {""insertions"": 64, ""deletions"": 70, ""lines"": 134}, ""src/version.c"": {""insertions"": 2, ""deletions"": 0, ""lines"": 2}}"
2021-12-07 21:29:20,f7f7aaf8aaad34a38d3f159e031c5bcf3394f8f1,erw7,14,2,16,4,"{""src/errors.h"": {""insertions"": 2, ""deletions"": 0, ""lines"": 2}, ""src/highlight.c"": {""insertions"": 9, ""deletions"": 2, ""lines"": 11}, ""src/testdir/test_highlight.vim"": {""insertions"": 1, ""deletions"": 0, ""lines"": 1}, ""src/version.c"": {""insertions"": 2, ""deletions"": 0, ""lines"": 2}}"
2021-12-07 12:23:57,4dc24eb5adbcc76838fae1e900936dd230209d96,Yegappan Lakshmanan,59,8,67,9,"{""src/insexpand.c"": {""insertions"": 0, ""deletions"": 2, ""lines"": 2}, ""src/job.c"": {""insertions"": 3, ""deletions"": 2, ""lines"": 5}, ""src/option.c"": {""insertions"": 1, ""deletions"": 1, ""lines"": 2}, ""src/tag.c"": {""insertions"": 2, ""deletions"": 1, ""lines"": 3}, ""src/testdir/test_iminsert.vim"": {""insertions"": 13, ""deletions"": 0, ""lines"": 13}, ""src/testdir/test_ins_complete.vim"": {""insertions"": 28, ""deletions"": 0, ""lines"": 28}, ""src/testdir/test_tagfunc.vim"": {""insertions"": 5, ""deletions"": 0, ""lines"": 5}, ""src/userfunc.c"": {""insertions"": 5, ""deletions"": 2, ""lines"": 7}, ""src/version.c"": {""insertions"": 2, ""deletions"": 0, ""lines"": 2}}"
2021-12-07 11:03:39,92c33eb2735045d25fceed3b607f44d7156c59c1,Bram Moolenaar,4,3,7,2,"{""src/evalvars.c"": {""insertions"": 2, ""deletions"": 3, ""lines"": 5}, ""src/version.c"": {""insertions"": 2, ""deletions"": 0, ""lines"": 2}}"
2021-12-06 19:51:01,ecabb511074b3f56cdd5067553c947a291d04e17,Bram Moolenaar,42,8,50,3,"{""src/testdir/test_indent.vim"": {""insertions"": 32, ""deletions"": 6, ""lines"": 38}, ""src/textformat.c"": {""insertions"": 8, ""deletions"": 2, ""lines"": 10}, ""src/version.c"": {""insertions"": 2, ""deletions"": 0, ""lines"": 2}}"
2021-12-06 15:13:31,3e55a973b5cab5823335e24b7e4885429c885921,Bram Moolenaar,1,1,2,1,"{""README.md"": {""insertions"": 1, ""deletions"": 1, ""lines"": 2}}"
2021-12-06 15:06:54,2336c376d5796446d44622b0dfa8fd3fd1a5d22b,Bram Moolenaar,7,3,10,4,"{""src/proto/userfunc.pro"": {""insertions"": 1, ""deletions"": 0, ""lines"": 1}, ""src/userfunc.c"": {""insertions"": 1, ""deletions"": 1, ""lines"": 2}, ""src/version.c"": {""insertions"": 2, ""deletions"": 0, ""lines"": 2}, ""src/vim9execute.c"": {""insertions"": 3, ""deletions"": 2, ""lines"": 5}}"
2021-12-06 11:24:09,8603be338ac810446f23c092f21bc6082f787519,h-east,6,4,10,2,"{""src/beval.c"": {""insertions"": 4, ""deletions"": 4, ""lines"": 8}, ""src/version.c"": {""insertions"": 2, ""deletions"": 0, ""lines"": 2}}"
2021-12-06 11:03:55,6409553b6e3b4de4e1d72b8ee5445595214581ff,Yegappan Lakshmanan,344,85,429,18,"{""runtime/doc/options.txt"": {""insertions"": 4, ""deletions"": 3, ""lines"": 7}, ""src/eval.c"": {""insertions"": 4, ""deletions"": 4, ""lines"": 8}, ""src/evalvars.c"": {""insertions"": 20, ""deletions"": 5, ""lines"": 25}, ""src/if_mzsch.c"": {""insertions"": 10, ""deletions"": 10, ""lines"": 20}, ""src/if_ruby.c"": {""insertions"": 2, ""deletions"": 2, ""lines"": 4}, ""src/if_tcl.c"": {""insertions"": 1, ""deletions"": 1, ""lines"": 2}, ""src/option.c"": {""insertions"": 19, ""deletions"": 11, ""lines"": 30}, ""src/option.h"": {""insertions"": 1, ""deletions"": 0, ""lines"": 1}, ""src/optiondefs.h"": {""insertions"": 8, ""deletions"": 8, ""lines"": 16}, ""src/proto/eval.pro"": {""insertions"": 1, ""deletions"": 1, ""lines"": 2}, ""src/proto/option.pro"": {""insertions"": 2, ""deletions"": 2, ""lines"": 4}, ""src/spell.c"": {""insertions"": 1, ""deletions"": 1, ""lines"": 2}, ""src/testdir/test_iminsert.vim"": {""insertions"": 32, ""deletions"": 12, ""lines"": 44}, ""src/testdir/test_ins_complete.vim"": {""insertions"": 177, ""deletions"": 15, ""lines"": 192}, ""src/testdir/test_tagfunc.vim"": {""insertions"": 53, ""deletions"": 3, ""lines"": 56}, ""src/typval.c"": {""insertions"": 3, ""deletions"": 3, ""lines"": 6}, ""src/version.c"": {""insertions"": 2, ""deletions"": 0, ""lines"": 2}, ""src/vim9compile.c"": {""insertions"": 4, ""deletions"": 4, ""lines"": 8}}"
2021-12-05 22:19:27,40bcec1bac34d34a3d4d7c5f6b2cc1f163acbd00,Bram Moolenaar,65,36,101,18,"{""src/blob.c"": {""insertions"": 1, ""deletions"": 1, ""lines"": 2}, ""src/buffer.c"": {""insertions"": 9, ""deletions"": 9, ""lines"": 18}, ""src/channel.c"": {""insertions"": 4, ""deletions"": 2, ""lines"": 6}, ""src/errors.h"": {""insertions"": 28, ""deletions"": 0, ""lines"": 28}, ""src/ex_docmd.c"": {""insertions"": 1, ""deletions"": 1, ""lines"": 2}, ""src/globals.h"": {""insertions"": 0, ""deletions"": 5, ""lines"": 5}, ""src/job.c"": {""insertions"": 5, ""deletions"": 3, ""lines"": 8}, ""src/list.c"": {""insertions"": 1, ""deletions"": 1, ""lines"": 2}, ""src/mark.c"": {""insertions"": 1, ""deletions"": 1, ""lines"": 2}, ""src/misc1.c"": {""insertions"": 1, ""deletions"": 1, ""lines"": 2}, ""src/os_unix.c"": {""insertions"": 2, ""deletions"": 2, ""lines"": 4}, ""src/popupwin.c"": {""insertions"": 1, ""deletions"": 1, ""lines"": 2}, ""src/register.c"": {""insertions"": 1, ""deletions"": 1, ""lines"": 2}, ""src/session.c"": {""insertions"": 1, ""deletions"": 1, ""lines"": 2}, ""src/spellfile.c"": {""insertions"": 5, ""deletions"": 5, ""lines"": 10}, ""src/term.c"": {""insertions"": 1, ""deletions"": 1, ""lines"": 2}, ""src/userfunc.c"": {""insertions"": 1, ""deletions"": 1, ""lines"": 2}, ""src/version.c"": {""insertions"": 2, ""deletions"": 0, ""lines"": 2}}"
2021-12-05 21:54:04,4700398e384f38f752b432e187462f404b96847d,Bram Moolenaar,223,113,336,27,"{""runtime/autoload/dist/ft.vim"": {""insertions"": 1, ""deletions"": 1, ""lines"": 2}, ""runtime/doc/channel.txt"": {""insertions"": 5, ""deletions"": 4, ""lines"": 9}, ""runtime/doc/cmdline.txt"": {""insertions"": 5, ""deletions"": 3, ""lines"": 8}, ""runtime/doc/filetype.txt"": {""insertions"": 0, ""deletions"": 8, ""lines"": 8}, ""runtime/doc/motion.txt"": {""insertions"": 5, ""deletions"": 1, ""lines"": 6}, ""runtime/doc/options.txt"": {""insertions"": 9, ""deletions"": 4, ""lines"": 13}, ""runtime/doc/popup.txt"": {""insertions"": 1, ""deletions"": 1, ""lines"": 2}, ""runtime/doc/quickfix.txt"": {""insertions"": 4, ""deletions"": 4, ""lines"": 8}, ""runtime/doc/sign.txt"": {""insertions"": 6, ""deletions"": 4, ""lines"": 10}, ""runtime/doc/syntax.txt"": {""insertions"": 8, ""deletions"": 0, ""lines"": 8}, ""runtime/doc/tags"": {""insertions"": 5, ""deletions"": 1, ""lines"": 6}, ""runtime/doc/term.txt"": {""insertions"": 15, ""deletions"": 3, ""lines"": 18}, ""runtime/doc/todo.txt"": {""insertions"": 5, ""deletions"": 11, ""lines"": 16}, ""runtime/doc/various.txt"": {""insertions"": 6, ""deletions"": 6, ""lines"": 12}, ""runtime/doc/vim9.txt"": {""insertions"": 12, ""deletions"": 5, ""lines"": 17}, ""runtime/doc/windows.txt"": {""insertions"": 3, ""deletions"": 1, ""lines"": 4}, ""runtime/doc/xxd-fr.1"": {""insertions"": 1, ""deletions"": 1, ""lines"": 2}, ""runtime/doc/xxd-fr.UTF-8.1"": {""insertions"": 1, ""deletions"": 1, ""lines"": 2}, ""runtime/filetype.vim"": {""insertions"": 1, ""deletions"": 1, ""lines"": 2}, ""runtime/indent/vim.vim"": {""insertions"": 2, ""deletions"": 1, ""lines"": 3}, ""runtime/pack/dist/opt/termdebug/plugin/termdebug.vim"": {""insertions"": 15, ""deletions"": 10, ""lines"": 25}, ""runtime/syntax/django.vim"": {""insertions"": 2, ""deletions"": 1, ""lines"": 3}, ""runtime/syntax/squirrel.vim"": {""insertions"": 50, ""deletions"": 0, ""lines"": 50}, ""runtime/syntax/vb.vim"": {""insertions"": 47, ""deletions"": 37, ""lines"": 84}, ""runtime/syntax/vim.vim"": {""insertions"": 3, ""deletions"": 3, ""lines"": 6}, ""runtime/tools/demoserver.py"": {""insertions"": 8, ""deletions"": 1, ""lines"": 9}, ""src/xdiff/README.txt"": {""insertions"": 3, ""deletions"": 0, ""lines"": 3}}"
2021-12-05 21:46:34,12f3c1b77fb39dc338304d5484cdbc99da27389a,Bram Moolenaar,57,33,90,11,"{""src/bufwrite.c"": {""insertions"": 1, ""deletions"": 1, ""lines"": 2}, ""src/cmdexpand.c"": {""insertions"": 1, ""deletions"": 1, ""lines"": 2}, ""src/errors.h"": {""insertions"": 34, ""deletions"": 0, ""lines"": 34}, ""src/getchar.c"": {""insertions"": 1, ""deletions"": 1, ""lines"": 2}, ""src/globals.h"": {""insertions"": 0, ""deletions"": 6, ""lines"": 6}, ""src/memfile.c"": {""insertions"": 2, ""deletions"": 2, ""lines"": 4}, ""src/regexp.c"": {""insertions"": 0, ""deletions"": 6, ""lines"": 6}, ""src/regexp_bt.c"": {""insertions"": 11, ""deletions"": 11, ""lines"": 22}, ""src/regexp_nfa.c"": {""insertions"": 4, ""deletions"": 4, ""lines"": 8}, ""src/tag.c"": {""insertions"": 1, ""deletions"": 1, ""lines"": 2}, ""src/version.c"": {""insertions"": 2, ""deletions"": 0, ""lines"": 2}}"
2021-12-05 19:10:04,e5710a02cb78c2a0a868ea55740835c78ddecbb4,Bram Moolenaar,2,37,39,4,"{""src/errors.h"": {""insertions"": 0, ""deletions"": 2, ""lines"": 2}, ""src/sign.c"": {""insertions"": 0, ""deletions"": 30, ""lines"": 30}, ""src/testdir/test_signs.vim"": {""insertions"": 0, ""deletions"": 5, ""lines"": 5}, ""src/version.c"": {""insertions"": 2, ""deletions"": 0, ""lines"": 2}}"
2021-12-05 17:45:49,0bac5fc5e125b7aa0f3b596c9b7f4381279e6688,Bram Moolenaar,56,10,66,3,"{""src/sign.c"": {""insertions"": 26, ""deletions"": 7, ""lines"": 33}, ""src/testdir/test_signs.vim"": {""insertions"": 28, ""deletions"": 3, ""lines"": 31}, ""src/version.c"": {""insertions"": 2, ""deletions"": 0, ""lines"": 2}}"
2021-12-05 17:20:24,c7d5fc8622f03cca8d1a9a54d4703e8f0c9941d0,Bram Moolenaar,39,2,41,3,"{""src/testdir/test_vim9_script.vim"": {""insertions"": 35, ""deletions"": 0, ""lines"": 35}, ""src/version.c"": {""insertions"": 2, ""deletions"": 0, ""lines"": 2}, ""src/vim9execute.c"": {""insertions"": 2, ""deletions"": 2, ""lines"": 4}}"
2021-12-05 13:40:01,f661cee847d2c17652b0ad0d703d2e3ac8610265,Dominique Pelle,2,1,3,2,"{""src/testdir/test_autochdir.vim"": {""insertions"": 0, ""deletions"": 1, ""lines"": 1}, ""src/version.c"": {""insertions"": 2, ""deletions"": 0, ""lines"": 2}}"
2021-12-05 13:21:18,f645ee47c85940d05f492a1b3932fbcdfd4204b3,Dominique Pelle,13,0,13,3,"{""src/testdir/test_options.vim"": {""insertions"": 6, ""deletions"": 0, ""lines"": 6}, ""src/testdir/test_spell.vim"": {""insertions"": 5, ""deletions"": 0, ""lines"": 5}, ""src/version.c"": {""insertions"": 2, ""deletions"": 0, ""lines"": 2}}"
2021-12-05 13:02:50,5e18ccc60bdddc4aa39ab039f1a7c918f29e67ce,Bram Moolenaar,34,0,34,4,"{""src/errors.h"": {""insertions"": 2, ""deletions"": 0, ""lines"": 2}, ""src/sign.c"": {""insertions"": 26, ""deletions"": 0, ""lines"": 26}, ""src/testdir/test_signs.vim"": {""insertions"": 4, ""deletions"": 0, ""lines"": 4}, ""src/version.c"": {""insertions"": 2, ""deletions"": 0, ""lines"": 2}}"
2021-12-05 12:39:21,f589fd3e1047cdf90566b68aaf9a13389e54d26a,Dominique Pelle,9,3,12,3,"{""src/testdir/test_autochdir.vim"": {""insertions"": 3, ""deletions"": 3, ""lines"": 6}, ""src/testdir/test_termcodes.vim"": {""insertions"": 4, ""deletions"": 0, ""lines"": 4}, ""src/version.c"": {""insertions"": 2, ""deletions"": 0, ""lines"": 2}}"
2021-12-05 12:06:24,e031fe90cf2e375ce861ff5e5e281e4ad229ebb9,Bram Moolenaar,22,3,25,3,"{""src/ex_docmd.c"": {""insertions"": 7, ""deletions"": 3, ""lines"": 10}, ""src/testdir/test_ex_mode.vim"": {""insertions"": 13, ""deletions"": 0, ""lines"": 13}, ""src/version.c"": {""insertions"": 2, ""deletions"": 0, ""lines"": 2}}"
2021-12-05 11:36:23,c7269f862748c3b0f56b5a651019e18c7d5190ee,Bram Moolenaar,14,0,14,4,"{""src/alloc.c"": {""insertions"": 3, ""deletions"": 0, ""lines"": 3}, ""src/if_tcl.c"": {""insertions"": 8, ""deletions"": 0, ""lines"": 8}, ""src/proto/if_tcl.pro"": {""insertions"": 1, ""deletions"": 0, ""lines"": 1}, ""src/version.c"": {""insertions"": 2, ""deletions"": 0, ""lines"": 2}}"
2021-12-04 22:03:34,dea4a616376c6500894c16e26057ce16d7ef9f0e,Bram Moolenaar,36,0,36,3,"{""src/testdir/test_autochdir.vim"": {""insertions"": 29, ""deletions"": 0, ""lines"": 29}, ""src/version.c"": {""insertions"": 2, ""deletions"": 0, ""lines"": 2}, ""src/window.c"": {""insertions"": 5, ""deletions"": 0, ""lines"": 5}}"
2021-12-04 17:20:27,23bdef2571b589414cd9744059abd507b043996b,Bram Moolenaar,4,1,5,2,"{""src/misc1.c"": {""insertions"": 2, ""deletions"": 1, ""lines"": 3}, ""src/version.c"": {""insertions"": 2, ""deletions"": 0, ""lines"": 2}}"
2021-12-04 15:12:40,8dea145e39a2569153cb63487d3403a46a882189,Dominique Pelle,4,0,4,2,"{""src/testdir/test_cd.vim"": {""insertions"": 2, ""deletions"": 0, ""lines"": 2}, ""src/version.c"": {""insertions"": 2, ""deletions"": 0, ""lines"": 2}}"
2021-12-04 15:00:23,853a7692d19deb6b7c2cabce989b57c8b9908596,Bram Moolenaar,7,1,8,2,"{""src/testdir/test_vim9_fails.vim"": {""insertions"": 5, ""deletions"": 1, ""lines"": 6}, ""src/version.c"": {""insertions"": 2, ""deletions"": 0, ""lines"": 2}}"
2021-12-04 14:02:30,7645da568c5e3b4ee339a2e99c3b3af790619787,Yegappan Lakshmanan,215,16,231,8,"{""runtime/doc/options.txt"": {""insertions"": 5, ""deletions"": 1, ""lines"": 6}, ""src/alloc.c"": {""insertions"": 1, ""deletions"": 0, ""lines"": 1}, ""src/gui_xim.c"": {""insertions"": 33, ""deletions"": 4, ""lines"": 37}, ""src/optionstr.c"": {""insertions"": 17, ""deletions"": 0, ""lines"": 17}, ""src/proto/gui_xim.pro"": {""insertions"": 3, ""deletions"": 0, ""lines"": 3}, ""src/testdir/test_iminsert.vim"": {""insertions"": 140, ""deletions"": 0, ""lines"": 140}, ""src/testdir/test_ins_complete.vim"": {""insertions"": 14, ""deletions"": 11, ""lines"": 25}, ""src/version.c"": {""insertions"": 2, ""deletions"": 0, ""lines"": 2}}"
2021-12-04 13:15:10,01a4dcbceefa99696bd1ef8631c3f7ce9f6e0cc2,Bram Moolenaar,4,0,4,2,"{""src/version.c"": {""insertions"": 2, ""deletions"": 0, ""lines"": 2}, ""src/vim9execute.c"": {""insertions"": 2, ""deletions"": 0, ""lines"": 2}}"
2021-12-04 11:57:00,b579f6ebbfa826d228abec1e1b24c05894517c27,Bram Moolenaar,12,7,19,4,"{""src/testdir/test_vim9_cmd.vim"": {""insertions"": 5, ""deletions"": 0, ""lines"": 5}, ""src/usercmd.c"": {""insertions"": 1, ""deletions"": 0, ""lines"": 1}, ""src/version.c"": {""insertions"": 2, ""deletions"": 0, ""lines"": 2}, ""src/vim9compile.c"": {""insertions"": 4, ""deletions"": 7, ""lines"": 11}}"
2021-12-03 21:18:14,cd2f8f0e0007bb77fc2035e6ad6227bb6661c612,Bram Moolenaar,3,1,4,2,"{""src/testdir/test_set.vim"": {""insertions"": 1, ""deletions"": 1, ""lines"": 2}, ""src/version.c"": {""insertions"": 2, ""deletions"": 0, ""lines"": 2}}"
2021-12-03 20:43:24,15a24f08987e3831be255333bb84b7bc9c00db24,Bram Moolenaar,48,12,60,5,"{""src/option.c"": {""insertions"": 7, ""deletions"": 6, ""lines"": 13}, ""src/proto/term.pro"": {""insertions"": 1, ""deletions"": 1, ""lines"": 2}, ""src/term.c"": {""insertions"": 8, ""deletions"": 5, ""lines"": 13}, ""src/testdir/test_set.vim"": {""insertions"": 30, ""deletions"": 0, ""lines"": 30}, ""src/version.c"": {""insertions"": 2, ""deletions"": 0, ""lines"": 2}}"
2021-12-03 19:24:41,800b01b0c8a5983e23d8caa2be6c73d195448193,Bram Moolenaar,12,6,18,3,"{""runtime/filetype.vim"": {""insertions"": 8, ""deletions"": 4, ""lines"": 12}, ""src/testdir/test_filetype.vim"": {""insertions"": 2, ""deletions"": 2, ""lines"": 4}, ""src/version.c"": {""insertions"": 2, ""deletions"": 0, ""lines"": 2}}"
2021-12-03 17:44:26,6f42cb6e5159b323814a53bbc82def4f2cfb17ad,Matt Dunford,6,0,6,3,"{""runtime/filetype.vim"": {""insertions"": 3, ""deletions"": 0, ""lines"": 3}, ""src/testdir/test_filetype.vim"": {""insertions"": 1, ""deletions"": 0, ""lines"": 1}, ""src/version.c"": {""insertions"": 2, ""deletions"": 0, ""lines"": 2}}"
2021-12-03 13:57:00,04b7b4bf7fe57375bf3c4ed3fd087fc0bb0147ba,kuuote,6,0,6,3,"{""src/blob.c"": {""insertions"": 1, ""deletions"": 0, ""lines"": 1}, ""src/testdir/test_blob.vim"": {""insertions"": 3, ""deletions"": 0, ""lines"": 3}, ""src/version.c"": {""insertions"": 2, ""deletions"": 0, ""lines"": 2}}"
2021-12-03 13:20:29,c14b57c0795671bafca14433bc376acfe6135a3a,Bram Moolenaar,65,6,71,3,"{""src/term.c"": {""insertions"": 41, ""deletions"": 6, ""lines"": 47}, ""src/testdir/test_termcodes.vim"": {""insertions"": 22, ""deletions"": 0, ""lines"": 22}, ""src/version.c"": {""insertions"": 2, ""deletions"": 0, ""lines"": 2}}"
2021-12-03 11:44:03,c903695be54189fd7199121e9cd669e722fbc9c2,Bram Moolenaar,13,6,19,3,"{""runtime/filetype.vim"": {""insertions"": 10, ""deletions"": 5, ""lines"": 15}, ""src/testdir/test_filetype.vim"": {""insertions"": 1, ""deletions"": 1, ""lines"": 2}, ""src/version.c"": {""insertions"": 2, ""deletions"": 0, ""lines"": 2}}"
2021-12-03 11:09:29,8658c759f05b317707d56e3b65a5ef63930c7498,Yegappan Lakshmanan,740,17,757,14,"{""runtime/doc/options.txt"": {""insertions"": 10, ""deletions"": 4, ""lines"": 14}, ""src/buffer.c"": {""insertions"": 3, ""deletions"": 0, ""lines"": 3}, ""src/insexpand.c"": {""insertions"": 135, ""deletions"": 2, ""lines"": 137}, ""src/option.c"": {""insertions"": 3, ""deletions"": 1, ""lines"": 4}, ""src/optionstr.c"": {""insertions"": 23, ""deletions"": 0, ""lines"": 23}, ""src/proto/insexpand.pro"": {""insertions"": 6, ""deletions"": 0, ""lines"": 6}, ""src/proto/tag.pro"": {""insertions"": 1, ""deletions"": 1, ""lines"": 2}, ""src/proto/userfunc.pro"": {""insertions"": 1, ""deletions"": 0, ""lines"": 1}, ""src/structs.h"": {""insertions"": 3, ""deletions"": 0, ""lines"": 3}, ""src/tag.c"": {""insertions"": 2, ""deletions"": 2, ""lines"": 4}, ""src/testdir/test_ins_complete.vim"": {""insertions"": 500, ""deletions"": 0, ""lines"": 500}, ""src/testdir/test_tagfunc.vim"": {""insertions"": 28, ""deletions"": 7, ""lines"": 35}, ""src/userfunc.c"": {""insertions"": 23, ""deletions"": 0, ""lines"": 23}, ""src/version.c"": {""insertions"": 2, ""deletions"": 0, ""lines"": 2}}"
2021-12-02 20:44:42,021ef351c2127cf8aa5668a881435a0a12774644,Bram Moolenaar,4,0,4,2,"{""src/errors.h"": {""insertions"": 2, ""deletions"": 0, ""lines"": 2}, ""src/version.c"": {""insertions"": 2, ""deletions"": 0, ""lines"": 2}}"
2021-12-02 19:46:57,acdc911e4e1120ef29d86fce8e890c72cdd1bf30,Bram Moolenaar,35,0,35,4,"{""src/drawline.c"": {""insertions"": 5, ""deletions"": 0, ""lines"": 5}, ""src/testdir/dumps/Test_prop_after_linebreak.dump"": {""insertions"": 10, ""deletions"": 0, ""lines"": 10}, ""src/testdir/test_textprop.vim"": {""insertions"": 18, ""deletions"": 0, ""lines"": 18}, ""src/version.c"": {""insertions"": 2, ""deletions"": 0, ""lines"": 2}}"
2021-12-02 18:55:16,5e86964bf48ddbfa20261bda84db391c80a36dca,Bram Moolenaar,2,18,20,2,"{""src/register.c"": {""insertions"": 0, ""deletions"": 18, ""lines"": 18}, ""src/version.c"": {""insertions"": 2, ""deletions"": 0, ""lines"": 2}}"
2021-12-02 18:42:33,9ac38129b6d409f73e29b1d51a5d459cf050410f,Bram Moolenaar,14,1,15,3,"{""src/errors.h"": {""insertions"": 2, ""deletions"": 1, ""lines"": 3}, ""src/register.c"": {""insertions"": 10, ""deletions"": 0, ""lines"": 10}, ""src/version.c"": {""insertions"": 2, ""deletions"": 0, ""lines"": 2}}"
2021-12-02 16:38:52,69c76171f1a78b829196f72d7010fbe1d9ad2944,Bram Moolenaar,26,1,27,4,"{""src/errors.h"": {""insertions"": 2, ""deletions"": 0, ""lines"": 2}, ""src/testdir/test_vim9_func.vim"": {""insertions"": 15, ""deletions"": 0, ""lines"": 15}, ""src/version.c"": {""insertions"": 2, ""deletions"": 0, ""lines"": 2}, ""src/vim9execute.c"": {""insertions"": 7, ""deletions"": 1, ""lines"": 8}}"
2021-12-02 12:30:22,f8bc0ce2671d7f7f73760f665b52e4f00a1bbcac,Bram Moolenaar,8,6,14,2,"{""src/testdir/test_buffer.vim"": {""insertions"": 6, ""deletions"": 6, ""lines"": 12}, ""src/version.c"": {""insertions"": 2, ""deletions"": 0, ""lines"": 2}}"
2021-12-02 11:34:21,3569c0de67bc9c723621297ae827d5e3353793a1,Bram Moolenaar,8,3,11,2,"{""src/drawline.c"": {""insertions"": 6, ""deletions"": 3, ""lines"": 9}, ""src/version.c"": {""insertions"": 2, ""deletions"": 0, ""lines"": 2}}"
2021-12-01 17:38:01,db9ff9ab5d7ce1fcc2c4106e7ad49151a323996c,Bram Moolenaar,49,6,55,5,"{""src/testdir/test_vim9_assign.vim"": {""insertions"": 21, ""deletions"": 0, ""lines"": 21}, ""src/testdir/test_vim9_disassemble.vim"": {""insertions"": 0, ""deletions"": 1, ""lines"": 1}, ""src/testdir/test_vim9_script.vim"": {""insertions"": 4, ""deletions"": 2, ""lines"": 6}, ""src/version.c"": {""insertions"": 2, ""deletions"": 0, ""lines"": 2}, ""src/vim9compile.c"": {""insertions"": 22, ""deletions"": 3, ""lines"": 25}}"
2021-12-01 15:22:56,e4eed8c6db693a9183b776032570ce2f89dcffb6,Bram Moolenaar,136,45,181,7,"{""src/ex_docmd.c"": {""insertions"": 50, ""deletions"": 37, ""lines"": 87}, ""src/proto/ex_docmd.pro"": {""insertions"": 2, ""deletions"": 1, ""lines"": 3}, ""src/testdir/test_vim9_disassemble.vim"": {""insertions"": 19, ""deletions"": 0, ""lines"": 19}, ""src/version.c"": {""insertions"": 2, ""deletions"": 0, ""lines"": 2}, ""src/vim9.h"": {""insertions"": 1, ""deletions"": 0, ""lines"": 1}, ""src/vim9compile.c"": {""insertions"": 37, ""deletions"": 7, ""lines"": 44}, ""src/vim9execute.c"": {""insertions"": 25, ""deletions"": 0, ""lines"": 25}}"
2021-12-01 12:41:31,f0e496a85a89fb1fd21b6af6363dcfc276331110,Bram Moolenaar,17,11,28,3,"{""src/testdir/test_vim9_builtin.vim"": {""insertions"": 1, ""deletions"": 11, ""lines"": 12}, ""src/testdir/test_vim9_fails.vim"": {""insertions"": 14, ""deletions"": 0, ""lines"": 14}, ""src/version.c"": {""insertions"": 2, ""deletions"": 0, ""lines"": 2}}"
2021-12-01 11:24:52,7e5503c17a3f142e6b28f344d899c9ab9e75a844,DungSaga,14,18,32,2,"{""src/version.c"": {""insertions"": 2, ""deletions"": 0, ""lines"": 2}, ""src/xxd/xxd.c"": {""insertions"": 12, ""deletions"": 18, ""lines"": 30}}"
2021-12-01 10:54:24,0b226f60be5c30c32fb01fc0b6dc11286e7e2313,Christian Brabandt,19,3,22,3,"{""src/quickfix.c"": {""insertions"": 2, ""deletions"": 3, ""lines"": 5}, ""src/testdir/test_quickfix.vim"": {""insertions"": 15, ""deletions"": 0, ""lines"": 15}, ""src/version.c"": {""insertions"": 2, ""deletions"": 0, ""lines"": 2}}"
2021-12-01 10:30:07,05e59e3a9ffddbf93c7af02cd2ba1d0f822d4625,Yegappan Lakshmanan,114,18,132,5,"{""runtime/doc/options.txt"": {""insertions"": 9, ""deletions"": 1, ""lines"": 10}, ""src/insexpand.c"": {""insertions"": 4, ""deletions"": 5, ""lines"": 9}, ""src/option.c"": {""insertions"": 1, ""deletions"": 1, ""lines"": 2}, ""src/testdir/test_tagfunc.vim"": {""insertions"": 98, ""deletions"": 11, ""lines"": 109}, ""src/version.c"": {""insertions"": 2, ""deletions"": 0, ""lines"": 2}}"
2021-12-01 10:10:22,56a8ffdb6e903615ed824a503f5fa6382b5b3df5,Bram Moolenaar,17,2,19,3,"{""src/testdir/test_vim9_cmd.vim"": {""insertions"": 11, ""deletions"": 2, ""lines"": 13}, ""src/version.c"": {""insertions"": 2, ""deletions"": 0, ""lines"": 2}, ""src/vim9compile.c"": {""insertions"": 4, ""deletions"": 0, ""lines"": 4}}"
2021-12-01 09:27:20,3d2e031d4f0e1559e4a4f99de5eb2330f38f8eb5,Bram Moolenaar,24,20,44,4,"{""runtime/doc/vim9.txt"": {""insertions"": 4, ""deletions"": 10, ""lines"": 14}, ""src/testdir/test_vim9_cmd.vim"": {""insertions"": 11, ""deletions"": 4, ""lines"": 15}, ""src/version.c"": {""insertions"": 2, ""deletions"": 0, ""lines"": 2}, ""src/vim9compile.c"": {""insertions"": 7, ""deletions"": 6, ""lines"": 13}}"
2021-11-30 21:58:19,fad2742d538123abb9b384a053fd581f2acf6bb0,Bram Moolenaar,27,12,39,3,"{""src/testdir/test_vim9_cmd.vim"": {""insertions"": 9, ""deletions"": 0, ""lines"": 9}, ""src/version.c"": {""insertions"": 2, ""deletions"": 0, ""lines"": 2}, ""src/vim9compile.c"": {""insertions"": 16, ""deletions"": 12, ""lines"": 28}}"
2021-11-30 21:39:39,69535d8a0a1ba09047fc1b5bed86a8965302a4fa,Bram Moolenaar,3,2,5,2,"{""src/testdir/test_vim9_cmd.vim"": {""insertions"": 1, ""deletions"": 2, ""lines"": 3}, ""src/version.c"": {""insertions"": 2, ""deletions"": 0, ""lines"": 2}}"
2021-11-30 20:57:38,90770b746ea2e72954c536d8acf41d241ca2f37e,Bram Moolenaar,37,7,44,3,"{""src/testdir/test_vim9_disassemble.vim"": {""insertions"": 32, ""deletions"": 0, ""lines"": 32}, ""src/version.c"": {""insertions"": 2, ""deletions"": 0, ""lines"": 2}, ""src/vim9compile.c"": {""insertions"": 3, ""deletions"": 7, ""lines"": 10}}"
2021-11-30 20:22:49,42eba04522d6be04393f59a9eab47833e7594650,Bram Moolenaar,31,1,32,4,"{""src/drawline.c"": {""insertions"": 1, ""deletions"": 1, ""lines"": 2}, ""src/testdir/dumps/Test_prop_after_tab.dump"": {""insertions"": 10, ""deletions"": 0, ""lines"": 10}, ""src/testdir/test_textprop.vim"": {""insertions"": 18, ""deletions"": 0, ""lines"": 18}, ""src/version.c"": {""insertions"": 2, ""deletions"": 0, ""lines"": 2}}"
2021-11-30 18:25:08,eba3b7f6645c8f856132b4c06a009a3b0a44e21c,Bram Moolenaar,44,13,57,5,"{""src/evalfunc.c"": {""insertions"": 2, ""deletions"": 3, ""lines"": 5}, ""src/proto/userfunc.pro"": {""insertions"": 1, ""deletions"": 0, ""lines"": 1}, ""src/testdir/test_expr.vim"": {""insertions"": 7, ""deletions"": 0, ""lines"": 7}, ""src/userfunc.c"": {""insertions"": 32, ""deletions"": 10, ""lines"": 42}, ""src/version.c"": {""insertions"": 2, ""deletions"": 0, ""lines"": 2}}"
2021-11-30 16:14:49,ab36e6ae7b87b0295fb19270e4339a734875c6b1,Bram Moolenaar,66,17,83,5,"{""runtime/doc/vim9.txt"": {""insertions"": 4, ""deletions"": 5, ""lines"": 9}, ""src/errors.h"": {""insertions"": 1, ""deletions"": 2, ""lines"": 3}, ""src/testdir/test_vim9_assign.vim"": {""insertions"": 54, ""deletions"": 1, ""lines"": 55}, ""src/version.c"": {""insertions"": 2, ""deletions"": 0, ""lines"": 2}, ""src/vim9compile.c"": {""insertions"": 5, ""deletions"": 9, ""lines"": 14}}"
2021-11-30 13:02:58,53ba95e4f0a82f6dab1791bb01f6cddc9b3f61b3,Bram Moolenaar,11,6,17,4,"{""runtime/autoload/dist/ft.vim"": {""insertions"": 1, ""deletions"": 1, ""lines"": 2}, ""runtime/filetype.vim"": {""insertions"": 6, ""deletions"": 3, ""lines"": 9}, ""src/testdir/test_filetype.vim"": {""insertions"": 2, ""deletions"": 2, ""lines"": 4}, ""src/version.c"": {""insertions"": 2, ""deletions"": 0, ""lines"": 2}}"
2021-11-30 11:56:22,98cb90ef865089a5ddd20bc0303d449fb7d97fb2,Bram Moolenaar,13,9,22,4,"{""src/dict.c"": {""insertions"": 6, ""deletions"": 8, ""lines"": 14}, ""src/testdir/test_listdict.vim"": {""insertions"": 3, ""deletions"": 0, ""lines"": 3}, ""src/typval.c"": {""insertions"": 2, ""deletions"": 1, ""lines"": 3}, ""src/version.c"": {""insertions"": 2, ""deletions"": 0, ""lines"": 2}}"
2021-11-29 22:02:12,c750d91a07ace532e993349aa5c13dda5c888cc0,Bram Moolenaar,26,33,59,2,"{""src/version.c"": {""insertions"": 2, ""deletions"": 0, ""lines"": 2}, ""src/vim9compile.c"": {""insertions"": 24, ""deletions"": 33, ""lines"": 57}}"
2021-11-29 21:12:35,6b839ac77586f69a814d2940f59f0125f55c5f81,Bram Moolenaar,49,1,50,4,"{""src/drawline.c"": {""insertions"": 19, ""deletions"": 1, ""lines"": 20}, ""src/testdir/dumps/Test_prop_linebreak.dump"": {""insertions"": 10, ""deletions"": 0, ""lines"": 10}, ""src/testdir/test_textprop.vim"": {""insertions"": 18, ""deletions"": 0, ""lines"": 18}, ""src/version.c"": {""insertions"": 2, ""deletions"": 0, ""lines"": 2}}"
2021-11-29 20:39:38,651fca85c71a4c5807f8f828f9ded30fbd754325,Bram Moolenaar,56,244,300,34,"{""runtime/doc/options.txt"": {""insertions"": 0, ""deletions"": 12, ""lines"": 12}, ""runtime/doc/various.txt"": {""insertions"": 1, ""deletions"": 1, ""lines"": 2}, ""src/alloc.c"": {""insertions"": 0, ""deletions"": 2, ""lines"": 2}, ""src/arglist.c"": {""insertions"": 0, ""deletions"": 6, ""lines"": 6}, ""src/autocmd.c"": {""insertions"": 0, ""deletions"": 2, ""lines"": 2}, ""src/buffer.c"": {""insertions"": 0, ""deletions"": 8, ""lines"": 8}, ""src/bufwrite.c"": {""insertions"": 0, ""deletions"": 2, ""lines"": 2}, ""src/change.c"": {""insertions"": 0, ""deletions"": 4, ""lines"": 4}, ""src/drawscreen.c"": {""insertions"": 3, ""deletions"": 4, ""lines"": 7}, ""src/evalfunc.c"": {""insertions"": 1, ""deletions"": 7, ""lines"": 8}, ""src/ex_cmds.c"": {""insertions"": 0, ""deletions"": 2, ""lines"": 2}, ""src/ex_docmd.c"": {""insertions"": 0, ""deletions"": 10, ""lines"": 10}, ""src/feature.h"": {""insertions"": 6, ""deletions"": 8, ""lines"": 14}, ""src/globals.h"": {""insertions"": 11, ""deletions"": 4, ""lines"": 15}, ""src/gui.c"": {""insertions"": 2, ""deletions"": 9, ""lines"": 11}, ""src/gui_gtk_x11.c"": {""insertions"": 0, ""deletions"": 2, ""lines"": 2}, ""src/if_xcmdsrv.c"": {""insertions"": 0, ""deletions"": 2, ""lines"": 2}, ""src/locale.c"": {""insertions"": 0, ""deletions"": 2, ""lines"": 2}, ""src/main.c"": {""insertions"": 1, ""deletions"": 3, ""lines"": 4}, ""src/misc2.c"": {""insertions"": 0, ""deletions"": 2, ""lines"": 2}, ""src/netbeans.c"": {""insertions"": 0, ""deletions"": 4, ""lines"": 4}, ""src/option.c"": {""insertions"": 0, ""deletions"": 24, ""lines"": 24}, ""src/option.h"": {""insertions"": 0, ""deletions"": 4, ""lines"": 4}, ""src/optiondefs.h"": {""insertions"": 0, ""deletions"": 25, ""lines"": 25}, ""src/optionstr.c"": {""insertions"": 2, ""deletions"": 12, ""lines"": 14}, ""src/os_amiga.c"": {""insertions"": 0, ""deletions"": 6, ""lines"": 6}, ""src/os_mswin.c"": {""insertions"": 11, ""deletions"": 19, ""lines"": 30}, ""src/os_unix.c"": {""insertions"": 5, ""deletions"": 21, ""lines"": 26}, ""src/os_win32.c"": {""insertions"": 7, ""deletions"": 21, ""lines"": 28}, ""src/regexp.c"": {""insertions"": 1, ""deletions"": 2, ""lines"": 3}, ""src/term.c"": {""insertions"": 2, ""deletions"": 6, ""lines"": 8}, ""src/ui.c"": {""insertions"": 1, ""deletions"": 2, ""lines"": 3}, ""src/version.c"": {""insertions"": 2, ""deletions"": 4, ""lines"": 6}, ""src/window.c"": {""insertions"": 0, ""deletions"": 2, ""lines"": 2}}"
2021-11-29 19:18:57,0c359af5c0fd106d3f57cc0bb7cef1c89b5e1e10,Bram Moolenaar,44,3,47,6,"{""src/drawline.c"": {""insertions"": 7, ""deletions"": 1, ""lines"": 8}, ""src/match.c"": {""insertions"": 7, ""deletions"": 1, ""lines"": 8}, ""src/proto/match.pro"": {""insertions"": 1, ""deletions"": 1, ""lines"": 2}, ""src/testdir/dumps/Test_match_linebreak.dump"": {""insertions"": 10, ""deletions"": 0, ""lines"": 10}, ""src/testdir/test_match.vim"": {""insertions"": 17, ""deletions"": 0, ""lines"": 17}, ""src/version.c"": {""insertions"": 2, ""deletions"": 0, ""lines"": 2}}"
2021-11-29 17:38:02,0b74d00693f2ff5f45cb5808197df7d1aaa5cb41,Bram Moolenaar,70,18,88,8,"{""runtime/doc/popup.txt"": {""insertions"": 3, ""deletions"": 0, ""lines"": 3}, ""src/mouse.c"": {""insertions"": 2, ""deletions"": 1, ""lines"": 3}, ""src/popupwin.c"": {""insertions"": 12, ""deletions"": 2, ""lines"": 14}, ""src/testdir/dumps/Test_popupwin_drag_05.dump"": {""insertions"": 10, ""deletions"": 0, ""lines"": 10}, ""src/testdir/dumps/Test_popupwin_drag_06.dump"": {""insertions"": 10, ""deletions"": 0, ""lines"": 10}, ""src/testdir/test_popupwin.vim"": {""insertions"": 24, ""deletions"": 9, ""lines"": 33}, ""src/version.c"": {""insertions"": 2, ""deletions"": 0, ""lines"": 2}, ""src/vim.h"": {""insertions"": 7, ""deletions"": 6, ""lines"": 13}}"
2021-11-29 16:01:49,7f2c34166402740a661131d6341bbf874bdb3d48,Bram Moolenaar,9,1,10,3,"{""src/evalvars.c"": {""insertions"": 1, ""deletions"": 1, ""lines"": 2}, ""src/testdir/test_vim9_assign.vim"": {""insertions"": 6, ""deletions"": 0, ""lines"": 6}, ""src/version.c"": {""insertions"": 2, ""deletions"": 0, ""lines"": 2}}"
2021-11-29 13:44:55,5c1ec439f0a69e9aa7ece9bbb7d916f48f58be1e,Bram Moolenaar,30,3,33,3,"{""src/eval.c"": {""insertions"": 9, ""deletions"": 3, ""lines"": 12}, ""src/testdir/test_listdict.vim"": {""insertions"": 19, ""deletions"": 0, ""lines"": 19}, ""src/version.c"": {""insertions"": 2, ""deletions"": 0, ""lines"": 2}}"
2021-11-29 12:12:43,af377e34b01ba00f9520d2b9de1f911e72db0114,Bram Moolenaar,78,3,81,5,"{""src/charset.c"": {""insertions"": 33, ""deletions"": 1, ""lines"": 34}, ""src/ex_docmd.c"": {""insertions"": 14, ""deletions"": 2, ""lines"": 16}, ""src/proto/charset.pro"": {""insertions"": 1, ""deletions"": 0, ""lines"": 1}, ""src/testdir/test_usercommands.vim"": {""insertions"": 28, ""deletions"": 0, ""lines"": 28}, ""src/version.c"": {""insertions"": 2, ""deletions"": 0, ""lines"": 2}}"
2021-11-29 10:36:19,293eb9ba4669b1500370502397d399681e7098f0,Bram Moolenaar,10,1,11,3,"{""src/errors.h"": {""insertions"": 2, ""deletions"": 1, ""lines"": 3}, ""src/version.c"": {""insertions"": 2, ""deletions"": 0, ""lines"": 2}, ""src/vim9execute.c"": {""insertions"": 6, ""deletions"": 0, ""lines"": 6}}"
2021-11-28 22:00:12,38453528c3372293d70c8e85471a6188749ff331,Bram Moolenaar,83,29,112,8,"{""src/errors.h"": {""insertions"": 1, ""deletions"": 2, ""lines"": 3}, ""src/structs.h"": {""insertions"": 1, ""deletions"": 0, ""lines"": 1}, ""src/testdir/test_vim9_func.vim"": {""insertions"": 27, ""deletions"": 3, ""lines"": 30}, ""src/userfunc.c"": {""insertions"": 4, ""deletions"": 4, ""lines"": 8}, ""src/version.c"": {""insertions"": 2, ""deletions"": 0, ""lines"": 2}, ""src/vim9.h"": {""insertions"": 2, ""deletions"": 1, ""lines"": 3}, ""src/vim9compile.c"": {""insertions"": 22, ""deletions"": 12, ""lines"": 34}, ""src/vim9execute.c"": {""insertions"": 24, ""deletions"": 7, ""lines"": 31}}"
2021-11-28 21:33:36,f566666e888685b6442a0e7f34c73ba56f6db49a,Bram Moolenaar,4,0,4,2,"{""src/gui.c"": {""insertions"": 2, ""deletions"": 0, ""lines"": 2}, ""src/version.c"": {""insertions"": 2, ""deletions"": 0, ""lines"": 2}}"
2021-11-28 20:24:17,06bffe836c98a65d270579f08004503ffce9931c,Bram Moolenaar,20,1,21,3,"{""src/ex_docmd.c"": {""insertions"": 8, ""deletions"": 1, ""lines"": 9}, ""src/testdir/test_vim9_cmd.vim"": {""insertions"": 10, ""deletions"": 0, ""lines"": 10}, ""src/version.c"": {""insertions"": 2, ""deletions"": 0, ""lines"": 2}}"
2021-11-28 19:53:42,3ccb5795168793e1b119a028da4035f77cef9f69,Bram Moolenaar,235,179,414,2,"{""src/evalvars.c"": {""insertions"": 233, ""deletions"": 179, ""lines"": 412}, ""src/version.c"": {""insertions"": 2, ""deletions"": 0, ""lines"": 2}}"
2021-11-28 18:41:05,2e0f3ecb7046e6d7915327270f836c48ad033a67,Christian Brabandt,6,0,6,2,"{""src/gui.c"": {""insertions"": 4, ""deletions"": 0, ""lines"": 4}, ""src/version.c"": {""insertions"": 2, ""deletions"": 0, ""lines"": 2}}"
2021-11-27 22:47:43,59f4f9505ae7ca2499904b94100db103e5ada5a6,Bram Moolenaar,57,15,72,3,"{""src/ops.c"": {""insertions"": 30, ""deletions"": 15, ""lines"": 45}, ""src/testdir/test_blockedit.vim"": {""insertions"": 25, ""deletions"": 0, ""lines"": 25}, ""src/version.c"": {""insertions"": 2, ""deletions"": 0, ""lines"": 2}}"
2021-11-27 17:22:07,3d14c0f2b964195d08b34bb43f89ec5f99255194,Bram Moolenaar,105,7,112,7,"{""runtime/autoload/dist/ft.vim"": {""insertions"": 17, ""deletions"": 0, ""lines"": 17}, ""runtime/doc/filetype.txt"": {""insertions"": 14, ""deletions"": 5, ""lines"": 19}, ""runtime/doc/syntax.txt"": {""insertions"": 8, ""deletions"": 0, ""lines"": 8}, ""runtime/filetype.vim"": {""insertions"": 4, ""deletions"": 1, ""lines"": 5}, ""runtime/scripts.vim"": {""insertions"": 4, ""deletions"": 0, ""lines"": 4}, ""src/testdir/test_filetype.vim"": {""insertions"": 56, ""deletions"": 1, ""lines"": 57}, ""src/version.c"": {""insertions"": 2, ""deletions"": 0, ""lines"": 2}}"
2021-11-27 14:31:47,c07f11e42fc2eac5e750bf05aa3030f9b02a22ca,Bram Moolenaar,10,2,12,3,"{""runtime/filetype.vim"": {""insertions"": 7, ""deletions"": 1, ""lines"": 8}, ""src/testdir/test_filetype.vim"": {""insertions"": 1, ""deletions"": 1, ""lines"": 2}, ""src/version.c"": {""insertions"": 2, ""deletions"": 0, ""lines"": 2}}"
2021-11-27 13:28:24,e9b0b40b7978f683977922233b42dd439ef31920,Bram Moolenaar,33,0,33,3,"{""src/ops.c"": {""insertions"": 4, ""deletions"": 0, ""lines"": 4}, ""src/testdir/test_blockedit.vim"": {""insertions"": 27, ""deletions"": 0, ""lines"": 27}, ""src/version.c"": {""insertions"": 2, ""deletions"": 0, ""lines"": 2}}"
2021-11-27 11:42:50,279d733dfb838cbabe88c8b8d3549d1493a49bbe,Bram Moolenaar,27,8,35,3,"{""src/ex_cmds.h"": {""insertions"": 8, ""deletions"": 8, ""lines"": 16}, ""src/testdir/test_vim9_cmd.vim"": {""insertions"": 17, ""deletions"": 0, ""lines"": 17}, ""src/version.c"": {""insertions"": 2, ""deletions"": 0, ""lines"": 2}}"
2021-11-27 10:57:26,6304be625ce44dcfedc6735164d0b853578581c8,Bram Moolenaar,171,131,302,12,"{""runtime/colors/tools/check_colors.vim"": {""insertions"": 10, ""deletions"": 4, ""lines"": 14}, ""runtime/doc/cmdline.txt"": {""insertions"": 6, ""deletions"": 4, ""lines"": 10}, ""runtime/doc/eval.txt"": {""insertions"": 1, ""deletions"": 0, ""lines"": 1}, ""runtime/doc/options.txt"": {""insertions"": 1, ""deletions"": 1, ""lines"": 2}, ""runtime/doc/repeat.txt"": {""insertions"": 5, ""deletions"": 1, ""lines"": 6}, ""runtime/doc/sign.txt"": {""insertions"": 4, ""deletions"": 7, ""lines"": 11}, ""runtime/doc/tags"": {""insertions"": 3, ""deletions"": 0, ""lines"": 3}, ""runtime/doc/todo.txt"": {""insertions"": 4, ""deletions"": 6, ""lines"": 10}, ""runtime/doc/vim9.txt"": {""insertions"": 5, ""deletions"": 1, ""lines"": 6}, ""runtime/ftplugin/jsonc.vim"": {""insertions"": 2, ""deletions"": 8, ""lines"": 10}, ""runtime/pack/dist/opt/termdebug/plugin/termdebug.vim"": {""insertions"": 116, ""deletions"": 85, ""lines"": 201}, ""runtime/syntax/vim.vim"": {""insertions"": 14, ""deletions"": 14, ""lines"": 28}}"
2021-11-26 17:36:51,7824fc80f675b8098e6483ce082e287aad14b6da,Bram Moolenaar,40,28,68,5,"{""src/evalvars.c"": {""insertions"": 13, ""deletions"": 7, ""lines"": 20}, ""src/proto/vim9script.pro"": {""insertions"": 1, ""deletions"": 1, ""lines"": 2}, ""src/testdir/test_vim9_assign.vim"": {""insertions"": 10, ""deletions"": 0, ""lines"": 10}, ""src/version.c"": {""insertions"": 2, ""deletions"": 0, ""lines"": 2}, ""src/vim9script.c"": {""insertions"": 14, ""deletions"": 20, ""lines"": 34}}"
2021-11-26 15:57:40,bfc5786a61693aaadc3e45f80a2f147c3a6711a3,Bram Moolenaar,24,0,24,4,"{""src/mouse.c"": {""insertions"": 1, ""deletions"": 0, ""lines"": 1}, ""src/testdir/dumps/Test_popupwin_drag_04.dump"": {""insertions"": 10, ""deletions"": 0, ""lines"": 10}, ""src/testdir/test_popupwin.vim"": {""insertions"": 11, ""deletions"": 0, ""lines"": 11}, ""src/version.c"": {""insertions"": 2, ""deletions"": 0, ""lines"": 2}}"
2021-11-26 13:59:27,d1d8a595bd03bf9ff6ba1440101daa98b19249fd,DungSaga,13,14,27,2,"{""src/version.c"": {""insertions"": 2, ""deletions"": 0, ""lines"": 2}, ""src/xxd/xxd.c"": {""insertions"": 11, ""deletions"": 14, ""lines"": 25}}"
2021-11-26 13:01:41,7329cfab36356c48edab7ed68f6244eb9e20a5b1,Doug Kearns,15,1,16,3,"{""runtime/autoload/dist/ft.vim"": {""insertions"": 3, ""deletions"": 1, ""lines"": 4}, ""src/testdir/test_filetype.vim"": {""insertions"": 10, ""deletions"": 0, ""lines"": 10}, ""src/version.c"": {""insertions"": 2, ""deletions"": 0, ""lines"": 2}}"
2021-11-25 20:40:11,85be8563fe5aff686e9e30d6afff401ccd976f2a,Bram Moolenaar,6,2,8,2,"{""src/register.c"": {""insertions"": 4, ""deletions"": 2, ""lines"": 6}, ""src/version.c"": {""insertions"": 2, ""deletions"": 0, ""lines"": 2}}"
2021-11-25 19:31:15,4d07253a485819b3a9fd923d263e722ea2109c12,Bram Moolenaar,30,3,33,3,"{""src/register.c"": {""insertions"": 15, ""deletions"": 3, ""lines"": 18}, ""src/testdir/test_put.vim"": {""insertions"": 13, ""deletions"": 0, ""lines"": 13}, ""src/version.c"": {""insertions"": 2, ""deletions"": 0, ""lines"": 2}}"
2021-11-25 15:11:03,309ce251897512d42da2b0df0ff100dc303e688a,Bram Moolenaar,2,782,784,2,"{""runtime/rgb.txt"": {""insertions"": 0, ""deletions"": 782, ""lines"": 782}, ""src/version.c"": {""insertions"": 2, ""deletions"": 0, ""lines"": 2}}"
2021-11-25 14:43:18,ba8c92687d53c91bbc20c867a49e0988819ea2d5,Bram Moolenaar,12,4,16,2,"{""src/message.c"": {""insertions"": 10, ""deletions"": 4, ""lines"": 14}, ""src/version.c"": {""insertions"": 2, ""deletions"": 0, ""lines"": 2}}"
2021-11-25 13:52:37,96e7a5928e1e7a350cd6c6d0b9376305190046e7,Bram Moolenaar,5,2,7,2,"{""src/memline.c"": {""insertions"": 3, ""deletions"": 2, ""lines"": 5}, ""src/version.c"": {""insertions"": 2, ""deletions"": 0, ""lines"": 2}}"
2021-11-25 13:39:28,0bd8d0563853ab821a018fb9cdd85f674684fe57,Bram Moolenaar,5,2,7,3,"{""src/globals.h"": {""insertions"": 1, ""deletions"": 0, ""lines"": 1}, ""src/message.c"": {""insertions"": 2, ""deletions"": 2, ""lines"": 4}, ""src/version.c"": {""insertions"": 2, ""deletions"": 0, ""lines"": 2}}"
2021-11-25 13:26:19,71b36206be14c3b6334765d44a38d413eca751c7,Bram Moolenaar,4,2,6,2,"{""src/version.c"": {""insertions"": 2, ""deletions"": 0, ""lines"": 2}, ""src/xxd/xxd.c"": {""insertions"": 2, ""deletions"": 2, ""lines"": 4}}"
2021-11-25 13:04:48,34c20ff85b87be587ea5d0398812441b502ee6a5,Bram Moolenaar,30,2,32,3,"{""src/testdir/test_prompt_buffer.vim"": {""insertions"": 25, ""deletions"": 0, ""lines"": 25}, ""src/version.c"": {""insertions"": 2, ""deletions"": 0, ""lines"": 2}, ""src/window.c"": {""insertions"": 3, ""deletions"": 2, ""lines"": 5}}"
2021-11-25 11:16:50,8af87bd6b1808ffcafdd73b1d7501dd50b9d15bc,Bram Moolenaar,70,69,139,2,"{""src/version.c"": {""insertions"": 2, ""deletions"": 0, ""lines"": 2}, ""src/xxd/xxd.c"": {""insertions"": 68, ""deletions"": 69, ""lines"": 137}}"
2021-11-25 10:50:12,bd228fd097b41a798f90944b5d1245eddd484142,Bram Moolenaar,12,2,14,3,"{""src/help.c"": {""insertions"": 1, ""deletions"": 2, ""lines"": 3}, ""src/testdir/test_help.vim"": {""insertions"": 9, ""deletions"": 0, ""lines"": 9}, ""src/version.c"": {""insertions"": 2, ""deletions"": 0, ""lines"": 2}}"
2021-11-24 20:28:31,bb277fd89fd7c665d51be2a08993732d46c208ef,Yegappan Lakshmanan,89,46,135,3,"{""src/highlight.c"": {""insertions"": 72, ""deletions"": 46, ""lines"": 118}, ""src/testdir/test_highlight.vim"": {""insertions"": 15, ""deletions"": 0, ""lines"": 15}, ""src/version.c"": {""insertions"": 2, ""deletions"": 0, ""lines"": 2}}"
2021-11-24 19:55:46,510d8e6056d89d903511c4498afec23f76b4f2a4,Bram Moolenaar,10,6,16,2,"{""src/libvterm/src/state.c"": {""insertions"": 8, ""deletions"": 6, ""lines"": 14}, ""src/version.c"": {""insertions"": 2, ""deletions"": 0, ""lines"": 2}}"
2021-11-24 19:30:55,7da341560ec8db7e81cd80092b046b60a482fbbe,Bram Moolenaar,971,256,1227,18,"{""Filelist"": {""insertions"": 1, ""deletions"": 0, ""lines"": 1}, ""src/libvterm/Makefile"": {""insertions"": 2, ""deletions"": 2, ""lines"": 4}, ""src/libvterm/doc/seqs.txt"": {""insertions"": 265, ""deletions"": 218, ""lines"": 483}, ""src/libvterm/include/vterm.h"": {""insertions"": 26, ""deletions"": 1, ""lines"": 27}, ""src/libvterm/src/mouse.c"": {""insertions"": 3, ""deletions"": 0, ""lines"": 3}, ""src/libvterm/src/parser.c"": {""insertions"": 51, ""deletions"": 4, ""lines"": 55}, ""src/libvterm/src/state.c"": {""insertions"": 321, ""deletions"": 5, ""lines"": 326}, ""src/libvterm/src/vterm.c"": {""insertions"": 20, ""deletions"": 12, ""lines"": 32}, ""src/libvterm/src/vterm_internal.h"": {""insertions"": 23, ""deletions"": 1, ""lines"": 24}, ""src/libvterm/t/02parser.test"": {""insertions"": 52, ""deletions"": 4, ""lines"": 56}, ""src/libvterm/t/17state_mouse.test"": {""insertions"": 9, ""deletions"": 0, ""lines"": 9}, ""src/libvterm/t/29state_fallback.test"": {""insertions"": 12, ""deletions"": 0, ""lines"": 12}, ""src/libvterm/t/40state_selection.test"": {""insertions"": 55, ""deletions"": 0, ""lines"": 55}, ""src/libvterm/t/harness.c"": {""insertions"": 113, ""deletions"": 3, ""lines"": 116}, ""src/libvterm/t/run-test.pl"": {""insertions"": 11, ""deletions"": 3, ""lines"": 14}, ""src/libvterm/vterm.pc.in"": {""insertions"": 1, ""deletions"": 2, ""lines"": 3}, ""src/terminal.c"": {""insertions"": 4, ""deletions"": 1, ""lines"": 5}, ""src/version.c"": {""insertions"": 2, ""deletions"": 0, ""lines"": 2}}"
2021-11-24 16:32:55,19916a8c8920b6a1fd737ffa6d4e363fc7a96319,Yegappan Lakshmanan,125,6,131,9,"{""runtime/doc/options.txt"": {""insertions"": 6, ""deletions"": 4, ""lines"": 10}, ""src/buffer.c"": {""insertions"": 1, ""deletions"": 0, ""lines"": 1}, ""src/option.c"": {""insertions"": 2, ""deletions"": 0, ""lines"": 2}, ""src/optionstr.c"": {""insertions"": 9, ""deletions"": 0, ""lines"": 9}, ""src/proto/tag.pro"": {""insertions"": 3, ""deletions"": 0, ""lines"": 3}, ""src/structs.h"": {""insertions"": 2, ""deletions"": 1, ""lines"": 3}, ""src/tag.c"": {""insertions"": 50, ""deletions"": 1, ""lines"": 51}, ""src/testdir/test_tagfunc.vim"": {""insertions"": 50, ""deletions"": 0, ""lines"": 50}, ""src/version.c"": {""insertions"": 2, ""deletions"": 0, ""lines"": 2}}"
2021-11-24 16:20:13,e413ea04b716effb28eb49dbc98ad3f9f761545a,Bram Moolenaar,104,18,122,12,"{""runtime/doc/sign.txt"": {""insertions"": 15, ""deletions"": 0, ""lines"": 15}, ""runtime/doc/syntax.txt"": {""insertions"": 4, ""deletions"": 0, ""lines"": 4}, ""src/drawline.c"": {""insertions"": 27, ""deletions"": 4, ""lines"": 31}, ""src/highlight.c"": {""insertions"": 2, ""deletions"": 0, ""lines"": 2}, ""src/optiondefs.h"": {""insertions"": 1, ""deletions"": 1, ""lines"": 2}, ""src/popupwin.c"": {""insertions"": 1, ""deletions"": 1, ""lines"": 2}, ""src/proto/sign.pro"": {""insertions"": 1, ""deletions"": 1, ""lines"": 2}, ""src/sign.c"": {""insertions"": 38, ""deletions"": 3, ""lines"": 41}, ""src/structs.h"": {""insertions"": 1, ""deletions"": 0, ""lines"": 1}, ""src/testdir/test_signs.vim"": {""insertions"": 9, ""deletions"": 7, ""lines"": 16}, ""src/version.c"": {""insertions"": 2, ""deletions"": 0, ""lines"": 2}, ""src/vim.h"": {""insertions"": 3, ""deletions"": 1, ""lines"": 4}}"
2021-11-24 15:32:57,1f2453fec6f8f0f315f00ca7b562a02090cb1e37,presuku,74,17,91,3,"{""src/strings.c"": {""insertions"": 12, ""deletions"": 17, ""lines"": 29}, ""src/testdir/test_expr.vim"": {""insertions"": 60, ""deletions"": 0, ""lines"": 60}, ""src/version.c"": {""insertions"": 2, ""deletions"": 0, ""lines"": 2}}"
2021-11-24 15:13:26,cf1e0239ceec96396fa51f494e442c799ccd45fb,Bram Moolenaar,5,3,8,2,"{""src/fold.c"": {""insertions"": 3, ""deletions"": 3, ""lines"": 6}, ""src/version.c"": {""insertions"": 2, ""deletions"": 0, ""lines"": 2}}"
2021-11-24 14:59:17,8bc07e800c2af36686aadd4178cc2671f5c454d4,Bram Moolenaar,7,5,12,2,"{""src/testdir/test_put.vim"": {""insertions"": 5, ""deletions"": 5, ""lines"": 10}, ""src/version.c"": {""insertions"": 2, ""deletions"": 0, ""lines"": 2}}"
2021-11-24 13:40:29,9b0e82f35ed4e98414333e71b71ca56219683d16,Bram Moolenaar,3,1,4,2,"{""src/normal.c"": {""insertions"": 1, ""deletions"": 1, ""lines"": 2}, ""src/version.c"": {""insertions"": 2, ""deletions"": 0, ""lines"": 2}}"
2021-11-24 12:17:53,03725c5795ae5b8c14da4a39cd0ce723c6dd4304,Bram Moolenaar,64,6,70,6,"{""src/errors.h"": {""insertions"": 2, ""deletions"": 0, ""lines"": 2}, ""src/ex_docmd.c"": {""insertions"": 15, ""deletions"": 1, ""lines"": 16}, ""src/normal.c"": {""insertions"": 12, ""deletions"": 5, ""lines"": 17}, ""src/testdir/test_excmd.vim"": {""insertions"": 12, ""deletions"": 0, ""lines"": 12}, ""src/testdir/test_normal.vim"": {""insertions"": 21, ""deletions"": 0, ""lines"": 21}, ""src/version.c"": {""insertions"": 2, ""deletions"": 0, ""lines"": 2}}"
2021-11-24 11:18:07,48608b4a4bfab4b9c0c9199d57b7e876c56db74c,DungSaga,28,9,37,3,"{""src/testdir/test_xxd.vim"": {""insertions"": 14, ""deletions"": 0, ""lines"": 14}, ""src/version.c"": {""insertions"": 2, ""deletions"": 0, ""lines"": 2}, ""src/xxd/xxd.c"": {""insertions"": 12, ""deletions"": 9, ""lines"": 21}}"
2021-11-23 22:16:34,112bed0cbeac84f73dca2682c5c2d74fabe1114d,Bram Moolenaar,26,1,27,3,"{""src/testdir/test_debugger.vim"": {""insertions"": 23, ""deletions"": 0, ""lines"": 23}, ""src/version.c"": {""insertions"": 2, ""deletions"": 0, ""lines"": 2}, ""src/vim9execute.c"": {""insertions"": 1, ""deletions"": 1, ""lines"": 2}}"
2021-11-23 14:52:06,65259b5c6a8ad4edaf6eeb8dbb7b50342c64d403,Bram Moolenaar,13,1,14,3,"{""src/ex_eval.c"": {""insertions"": 4, ""deletions"": 1, ""lines"": 5}, ""src/testdir/test_vim9_cmd.vim"": {""insertions"": 7, ""deletions"": 0, ""lines"": 7}, ""src/version.c"": {""insertions"": 2, ""deletions"": 0, ""lines"": 2}}"
2021-11-23 12:35:57,cc9d725bbb515baf172c2be21de12d35a961e4ee,Mike Williams,3,1,4,2,"{""src/version.c"": {""insertions"": 2, ""deletions"": 0, ""lines"": 2}, ""src/vim9compile.c"": {""insertions"": 1, ""deletions"": 1, ""lines"": 2}}"
2021-11-23 12:27:48,ee93e327ba31e8efb1b7de6209bdc992778b809b,Chris Dalton,23,1,24,2,"{""src/gui_gtk_x11.c"": {""insertions"": 21, ""deletions"": 1, ""lines"": 22}, ""src/version.c"": {""insertions"": 2, ""deletions"": 0, ""lines"": 2}}"
2021-11-23 12:07:25,b771b6b5fe2ec36d23c21ab8229b15c80780468c,Milly,3,0,3,2,"{""src/terminal.c"": {""insertions"": 1, ""deletions"": 0, ""lines"": 1}, ""src/version.c"": {""insertions"": 2, ""deletions"": 0, ""lines"": 2}}"
2021-11-23 11:46:32,e021662f39b38ef7cf27e13850d0ce6890e48376,Yegappan Lakshmanan,425,31,456,4,"{""runtime/doc/textprop.txt"": {""insertions"": 41, ""deletions"": 5, ""lines"": 46}, ""src/testdir/test_textprop.vim"": {""insertions"": 150, ""deletions"": 1, ""lines"": 151}, ""src/textprop.c"": {""insertions"": 232, ""deletions"": 25, ""lines"": 257}, ""src/version.c"": {""insertions"": 2, ""deletions"": 0, ""lines"": 2}}"
2021-11-22 21:58:41,04b568b38f848293e1ae0e680685280151acb386,Bram Moolenaar,26,0,26,4,"{""src/errors.h"": {""insertions"": 2, ""deletions"": 0, ""lines"": 2}, ""src/evalvars.c"": {""insertions"": 5, ""deletions"": 0, ""lines"": 5}, ""src/testdir/test_vim9_cmd.vim"": {""insertions"": 17, ""deletions"": 0, ""lines"": 17}, ""src/version.c"": {""insertions"": 2, ""deletions"": 0, ""lines"": 2}}"
2021-11-22 20:10:18,3b3755fe19e9ded2a1c45f14b2c6fa065bcaf2c6,Bram Moolenaar,38,9,47,7,"{""src/dict.c"": {""insertions"": 1, ""deletions"": 1, ""lines"": 2}, ""src/eval.c"": {""insertions"": 1, ""deletions"": 1, ""lines"": 2}, ""src/evalvars.c"": {""insertions"": 4, ""deletions"": 3, ""lines"": 7}, ""src/proto/evalvars.pro"": {""insertions"": 1, ""deletions"": 1, ""lines"": 2}, ""src/testdir/test_vim9_script.vim"": {""insertions"": 25, ""deletions"": 1, ""lines"": 26}, ""src/version.c"": {""insertions"": 2, ""deletions"": 0, ""lines"": 2}, ""src/vim9compile.c"": {""insertions"": 4, ""deletions"": 2, ""lines"": 6}}"
2021-11-22 18:31:02,7a53f29c031f54ab67a803e5e3f8cb44e4edc4bc,Bram Moolenaar,21,3,24,3,"{""src/ex_eval.c"": {""insertions"": 4, ""deletions"": 3, ""lines"": 7}, ""src/testdir/test_vim9_script.vim"": {""insertions"": 15, ""deletions"": 0, ""lines"": 15}, ""src/version.c"": {""insertions"": 2, ""deletions"": 0, ""lines"": 2}}"
2021-11-22 17:21:48,4671e88d7d3ed12206d9cdd8892fe3b2cbc0d6ab,Bram Moolenaar,11,3,14,2,"{""src/gui.c"": {""insertions"": 9, ""deletions"": 3, ""lines"": 12}, ""src/version.c"": {""insertions"": 2, ""deletions"": 0, ""lines"": 2}}"
2021-11-22 17:18:44,ce59b9f29244d98e55e3ec6be341c4d521159e8f,Dusan Popovic,39,7,46,2,"{""src/gui.c"": {""insertions"": 37, ""deletions"": 7, ""lines"": 44}, ""src/version.c"": {""insertions"": 2, ""deletions"": 0, ""lines"": 2}}"
2021-11-22 15:37:15,c449271f4efa44725c40116a95b213813040312f,Bram Moolenaar,26,0,26,4,"{""src/errors.h"": {""insertions"": 2, ""deletions"": 0, ""lines"": 2}, ""src/scriptfile.c"": {""insertions"": 14, ""deletions"": 0, ""lines"": 14}, ""src/testdir/test_vim9_builtin.vim"": {""insertions"": 8, ""deletions"": 0, ""lines"": 8}, ""src/version.c"": {""insertions"": 2, ""deletions"": 0, ""lines"": 2}}"
2021-11-22 15:05:46,7d5b8becc342e49e491053ea842e59f82d072001,Bram Moolenaar,47,8,55,3,"{""src/ex_eval.c"": {""insertions"": 17, ""deletions"": 7, ""lines"": 24}, ""src/testdir/test_vim9_cmd.vim"": {""insertions"": 28, ""deletions"": 1, ""lines"": 29}, ""src/version.c"": {""insertions"": 2, ""deletions"": 0, ""lines"": 2}}"
2021-11-22 14:16:08,2228cd72cf7c6f326e4e41179e88d37595ca4abc,Bram Moolenaar,58,9,67,5,"{""src/normal.c"": {""insertions"": 23, ""deletions"": 3, ""lines"": 26}, ""src/ops.c"": {""insertions"": 10, ""deletions"": 4, ""lines"": 14}, ""src/proto/normal.pro"": {""insertions"": 1, ""deletions"": 0, ""lines"": 1}, ""src/testdir/test_normal.vim"": {""insertions"": 22, ""deletions"": 2, ""lines"": 24}, ""src/version.c"": {""insertions"": 2, ""deletions"": 0, ""lines"": 2}}"
2021-11-22 12:47:39,a3f83feb63eae5464a620ae793c002eb45f7a838,zeertzjq,9,11,20,3,"{""src/getchar.c"": {""insertions"": 3, ""deletions"": 7, ""lines"": 10}, ""src/map.c"": {""insertions"": 4, ""deletions"": 4, ""lines"": 8}, ""src/version.c"": {""insertions"": 2, ""deletions"": 0, ""lines"": 2}}"
2021-11-22 12:06:06,73448a27a8e13b9b26759abeb092fd13a0e93238,Bram Moolenaar,3,1,4,2,"{""Filelist"": {""insertions"": 1, ""deletions"": 1, ""lines"": 2}, ""src/version.c"": {""insertions"": 2, ""deletions"": 0, ""lines"": 2}}"
2021-11-22 11:57:31,581f41adb3ba1dc95bf4fc7c434427e1203be5e8,DungSaga,8,14,22,2,"{""src/version.c"": {""insertions"": 2, ""deletions"": 0, ""lines"": 2}, ""src/xxd/xxd.c"": {""insertions"": 6, ""deletions"": 14, ""lines"": 20}}"
2021-11-21 21:13:36,88a4205f1cfbdc328e987ab00521fc8a22447fc3,Bram Moolenaar,1634,949,2583,19,"{"".github/CODEOWNERS"": {""insertions"": 2, ""deletions"": 0, ""lines"": 2}, ""runtime/defaults.vim"": {""insertions"": 5, ""deletions"": 4, ""lines"": 9}, ""runtime/doc/autocmd.txt"": {""insertions"": 2, ""deletions"": 2, ""lines"": 4}, ""runtime/doc/eval.txt"": {""insertions"": 9, ""deletions"": 6, ""lines"": 15}, ""runtime/doc/helphelp.txt"": {""insertions"": 3, ""deletions"": 3, ""lines"": 6}, ""runtime/doc/map.txt"": {""insertions"": 6, ""deletions"": 1, ""lines"": 7}, ""runtime/doc/options.txt"": {""insertions"": 1, ""deletions"": 1, ""lines"": 2}, ""runtime/doc/syntax.txt"": {""insertions"": 6, ""deletions"": 6, ""lines"": 12}, ""runtime/doc/tags"": {""insertions"": 1, ""deletions"": 0, ""lines"": 1}, ""runtime/doc/usr_20.txt"": {""insertions"": 2, ""deletions"": 2, ""lines"": 4}, ""runtime/doc/visual.txt"": {""insertions"": 3, ""deletions"": 2, ""lines"": 5}, ""runtime/ftplugin/indent.vim"": {""insertions"": 4, ""deletions"": 3, ""lines"": 7}, ""runtime/ftplugin/vb.vim"": {""insertions"": 54, ""deletions"": 28, ""lines"": 82}, ""runtime/pack/dist/opt/termdebug/plugin/termdebug.vim"": {""insertions"": 98, ""deletions"": 51, ""lines"": 149}, ""runtime/syntax/indent.vim"": {""insertions"": 5, ""deletions"": 4, ""lines"": 9}, ""runtime/syntax/vim.vim"": {""insertions"": 4, ""deletions"": 4, ""lines"": 8}, ""src/po/cs.cp1250.po"": {""insertions"": 1, ""deletions"": 1, ""lines"": 2}, ""src/po/cs.po"": {""insertions"": 1, ""deletions"": 1, ""lines"": 2}, ""src/po/eo.po"": {""insertions"": 1427, ""deletions"": 830, ""lines"": 2257}}"
2021-11-21 14:51:13,eea32afdb83ae281a63152f7494f79ec7e45ff55,Bram Moolenaar,42,0,42,5,"{""src/channel.c"": {""insertions"": 4, ""deletions"": 0, ""lines"": 4}, ""src/proto/terminal.pro"": {""insertions"": 1, ""deletions"": 0, ""lines"": 1}, ""src/terminal.c"": {""insertions"": 18, ""deletions"": 0, ""lines"": 18}, ""src/testdir/test_terminal.vim"": {""insertions"": 17, ""deletions"": 0, ""lines"": 17}, ""src/version.c"": {""insertions"": 2, ""deletions"": 0, ""lines"": 2}}"
2021-11-21 12:27:13,7f0c4b418e01d6e056a74de2f22fcbad613b7591,Volodymyr Kot,3,1,4,2,"{""src/main.c"": {""insertions"": 1, ""deletions"": 1, ""lines"": 2}, ""src/version.c"": {""insertions"": 2, ""deletions"": 0, ""lines"": 2}}"
2021-11-21 12:13:56,4785fe02bba14c4e0aede0fa425ca790a1cb98d7,ii14,9,2,11,3,"{""src/cmdexpand.c"": {""insertions"": 4, ""deletions"": 2, ""lines"": 6}, ""src/testdir/test_cmdline.vim"": {""insertions"": 3, ""deletions"": 0, ""lines"": 3}, ""src/version.c"": {""insertions"": 2, ""deletions"": 0, ""lines"": 2}}"
2021-11-21 11:36:04,923dce2b07ff185c0ef661f3eca47bc17655f01b,Dominique Pelle,39,38,77,21,"{""src/testdir/runtest.vim"": {""insertions"": 1, ""deletions"": 1, ""lines"": 2}, ""src/testdir/test_debugger.vim"": {""insertions"": 5, ""deletions"": 5, ""lines"": 10}, ""src/testdir/test_diffmode.vim"": {""insertions"": 2, ""deletions"": 2, ""lines"": 4}, ""src/testdir/test_edit.vim"": {""insertions"": 3, ""deletions"": 3, ""lines"": 6}, ""src/testdir/test_excmd.vim"": {""insertions"": 1, ""deletions"": 1, ""lines"": 2}, ""src/testdir/test_flatten.vim"": {""insertions"": 1, ""deletions"": 1, ""lines"": 2}, ""src/testdir/test_ins_complete.vim"": {""insertions"": 1, ""deletions"": 1, ""lines"": 2}, ""src/testdir/test_normal.vim"": {""insertions"": 3, ""deletions"": 3, ""lines"": 6}, ""src/testdir/test_options.vim"": {""insertions"": 1, ""deletions"": 1, ""lines"": 2}, ""src/testdir/test_python2.vim"": {""insertions"": 1, ""deletions"": 1, ""lines"": 2}, ""src/testdir/test_python3.vim"": {""insertions"": 1, ""deletions"": 1, ""lines"": 2}, ""src/testdir/test_quickfix.vim"": {""insertions"": 4, ""deletions"": 4, ""lines"": 8}, ""src/testdir/test_recover.vim"": {""insertions"": 1, ""deletions"": 1, ""lines"": 2}, ""src/testdir/test_spellfile.vim"": {""insertions"": 1, ""deletions"": 1, ""lines"": 2}, ""src/testdir/test_syntax.vim"": {""insertions"": 1, ""deletions"": 2, ""lines"": 3}, ""src/testdir/test_termcodes.vim"": {""insertions"": 3, ""deletions"": 3, ""lines"": 6}, ""src/testdir/test_textobjects.vim"": {""insertions"": 1, ""deletions"": 1, ""lines"": 2}, ""src/testdir/test_trycatch.vim"": {""insertions"": 1, ""deletions"": 1, ""lines"": 2}, ""src/testdir/test_vim9_script.vim"": {""insertions"": 2, ""deletions"": 2, ""lines"": 4}, ""src/testdir/test_viminfo.vim"": {""insertions"": 3, ""deletions"": 3, ""lines"": 6}, ""src/version.c"": {""insertions"": 2, ""deletions"": 0, ""lines"": 2}}"
2021-11-21 11:15:49,2c23670300b18f2f799d0602ff5225caa55b0d67,Bram Moolenaar,3,5,8,2,"{""src/gui_gtk_x11.c"": {""insertions"": 1, ""deletions"": 5, ""lines"": 6}, ""src/version.c"": {""insertions"": 2, ""deletions"": 0, ""lines"": 2}}"
2021-11-20 22:03:30,3c19b5050040fb74e4e39048f17dce853fdafc08,Dusan Popovic,22,11,33,2,"{""src/gui_gtk_x11.c"": {""insertions"": 20, ""deletions"": 11, ""lines"": 31}, ""src/version.c"": {""insertions"": 2, ""deletions"": 0, ""lines"": 2}}"
2021-11-20 21:46:20,d604d78e7b2e63d118814d0fa0b4b702ec52aeed,Bram Moolenaar,15,1,16,3,"{""src/testdir/test_vim9_func.vim"": {""insertions"": 12, ""deletions"": 1, ""lines"": 13}, ""src/userfunc.c"": {""insertions"": 1, ""deletions"": 0, ""lines"": 1}, ""src/version.c"": {""insertions"": 2, ""deletions"": 0, ""lines"": 2}}"
2021-11-20 21:35:41,a755fdbe80bed4897e06028f0044c208e0f9d8cb,Bram Moolenaar,17,1,18,3,"{""src/testdir/test_vim9_func.vim"": {""insertions"": 14, ""deletions"": 0, ""lines"": 14}, ""src/userfunc.c"": {""insertions"": 1, ""deletions"": 1, ""lines"": 2}, ""src/version.c"": {""insertions"": 2, ""deletions"": 0, ""lines"": 2}}"
2021-11-20 20:42:29,9cd9385db7d1d2b2dc38a511d121e366a5dae511,Yamagi,4,1,5,2,"{""src/gui_gtk_x11.c"": {""insertions"": 2, ""deletions"": 1, ""lines"": 3}, ""src/version.c"": {""insertions"": 2, ""deletions"": 0, ""lines"": 2}}"
2021-11-20 19:50:59,c8a9fe541d3bee36d2760ed156997ddbb0142ee1,Bram Moolenaar,12,2,14,3,"{""src/syntax.c"": {""insertions"": 2, ""deletions"": 2, ""lines"": 4}, ""src/testdir/test_vim9_cmd.vim"": {""insertions"": 8, ""deletions"": 0, ""lines"": 8}, ""src/version.c"": {""insertions"": 2, ""deletions"": 0, ""lines"": 2}}"
2021-11-20 19:38:31,d85fccdfed58108c4e0958d0b17c64690b5f073f,presuku,16,4,20,3,"{""src/strings.c"": {""insertions"": 9, ""deletions"": 4, ""lines"": 13}, ""src/testdir/test_expr.vim"": {""insertions"": 5, ""deletions"": 0, ""lines"": 5}, ""src/version.c"": {""insertions"": 2, ""deletions"": 0, ""lines"": 2}}"
2021-11-20 19:13:39,a1198124370a366ff02811a43845a631b5c6e7f0,mityu,73,12,85,6,"{""src/evalvars.c"": {""insertions"": 2, ""deletions"": 4, ""lines"": 6}, ""src/ex_getln.c"": {""insertions"": 9, ""deletions"": 0, ""lines"": 9}, ""src/proto/ex_getln.pro"": {""insertions"": 1, ""deletions"": 0, ""lines"": 1}, ""src/testdir/test_ins_complete.vim"": {""insertions"": 49, ""deletions"": 0, ""lines"": 49}, ""src/usercmd.c"": {""insertions"": 10, ""deletions"": 8, ""lines"": 18}, ""src/version.c"": {""insertions"": 2, ""deletions"": 0, ""lines"": 2}}"
2021-11-20 13:47:45,87fd0924e2d85213cc111ee7a5122f92216a37c7,Bram Moolenaar,1041,197,1238,43,"{""src/highlight.c"": {""insertions"": 5, ""deletions"": 0, ""lines"": 5}, ""src/libvterm/include/vterm.h"": {""insertions"": 12, ""deletions"": 1, ""lines"": 13}, ""src/option.c"": {""insertions"": 4, ""deletions"": 0, ""lines"": 4}, ""src/optionstr.c"": {""insertions"": 1, ""deletions"": 4, ""lines"": 5}, ""src/popupwin.c"": {""insertions"": 5, ""deletions"": 0, ""lines"": 5}, ""src/proto/terminal.pro"": {""insertions"": 3, ""deletions"": 1, ""lines"": 4}, ""src/structs.h"": {""insertions"": 11, ""deletions"": 0, ""lines"": 11}, ""src/terminal.c"": {""insertions"": 202, ""deletions"": 181, ""lines"": 383}, ""src/testdir/dumps/Test_terminal_color_MyTermCol.dump"": {""insertions"": 15, ""deletions"": 0, ""lines"": 15}, ""src/testdir/dumps/Test_terminal_color_MyTermCol_over_Terminal.dump"": {""insertions"": 15, ""deletions"": 0, ""lines"": 15}, ""src/testdir/dumps/Test_terminal_color_MyWinCol.dump"": {""insertions"": 15, ""deletions"": 0, ""lines"": 15}, ""src/testdir/dumps/Test_terminal_color_MyWinCol_over_group.dump"": {""insertions"": 15, ""deletions"": 0, ""lines"": 15}, ""src/testdir/dumps/Test_terminal_color_Terminal.dump"": {""insertions"": 15, ""deletions"": 0, ""lines"": 15}, ""src/testdir/dumps/Test_terminal_color_gui_MyTermCol.dump"": {""insertions"": 15, ""deletions"": 0, ""lines"": 15}, ""src/testdir/dumps/Test_terminal_color_gui_MyWinCol.dump"": {""insertions"": 15, ""deletions"": 0, ""lines"": 15}, ""src/testdir/dumps/Test_terminal_color_gui_Terminal.dump"": {""insertions"": 15, ""deletions"": 0, ""lines"": 15}, ""src/testdir/dumps/Test_terminal_color_gui_transp_MyTermCol.dump"": {""insertions"": 15, ""deletions"": 0, ""lines"": 15}, ""src/testdir/dumps/Test_terminal_color_gui_transp_MyWinCol.dump"": {""insertions"": 15, ""deletions"": 0, ""lines"": 15}, ""src/testdir/dumps/Test_terminal_color_gui_transp_Terminal.dump"": {""insertions"": 15, ""deletions"": 0, ""lines"": 15}, ""src/testdir/dumps/Test_terminal_color_transp_MyTermCol.dump"": {""insertions"": 15, ""deletions"": 0, ""lines"": 15}, ""src/testdir/dumps/Test_terminal_color_transp_MyWinCol.dump"": {""insertions"": 15, ""deletions"": 0, ""lines"": 15}, ""src/testdir/dumps/Test_terminal_color_transp_Terminal.dump"": {""insertions"": 15, ""deletions"": 0, ""lines"": 15}, ""src/testdir/dumps/Test_terminal_popup_MyPopupHlCol.dump"": {""insertions"": 15, ""deletions"": 0, ""lines"": 15}, ""src/testdir/dumps/Test_terminal_popup_MyTermCol_over_Terminal.dump"": {""insertions"": 15, ""deletions"": 0, ""lines"": 15}, ""src/testdir/dumps/Test_terminal_popup_MyWinCol.dump"": {""insertions"": 15, ""deletions"": 0, ""lines"": 15}, ""src/testdir/dumps/Test_terminal_popup_MyWinCol_over_group.dump"": {""insertions"": 15, ""deletions"": 0, ""lines"": 15}, ""src/testdir/dumps/Test_terminal_popup_gui_MyPopupHlCol.dump"": {""insertions"": 15, ""deletions"": 0, ""lines"": 15}, ""src/testdir/dumps/Test_terminal_popup_gui_MyTermCol.dump"": {""insertions"": 15, ""deletions"": 0, ""lines"": 15}, ""src/testdir/dumps/Test_terminal_popup_gui_MyWinCol.dump"": {""insertions"": 15, ""deletions"": 0, ""lines"": 15}, ""src/testdir/dumps/Test_terminal_popup_gui_Terminal.dump"": {""insertions"": 15, ""deletions"": 0, ""lines"": 15}, ""src/testdir/dumps/Test_terminal_popup_gui_transp_MyPopupHlCol.dump"": {""insertions"": 15, ""deletions"": 0, ""lines"": 15}, ""src/testdir/dumps/Test_terminal_popup_gui_transp_MyTermCol.dump"": {""insertions"": 15, ""deletions"": 0, ""lines"": 15}, ""src/testdir/dumps/Test_terminal_popup_gui_transp_MyWinCol.dump"": {""insertions"": 15, ""deletions"": 0, ""lines"": 15}, ""src/testdir/dumps/Test_terminal_popup_gui_transp_Terminal.dump"": {""insertions"": 15, ""deletions"": 0, ""lines"": 15}, ""src/testdir/dumps/Test_terminal_popup_transp_MyPopupHlCol.dump"": {""insertions"": 15, ""deletions"": 0, ""lines"": 15}, ""src/testdir/dumps/Test_terminal_popup_transp_MyTermCol.dump"": {""insertions"": 15, ""deletions"": 0, ""lines"": 15}, ""src/testdir/dumps/Test_terminal_popup_transp_MyWinCol.dump"": {""insertions"": 15, ""deletions"": 0, ""lines"": 15}, ""src/testdir/dumps/Test_terminal_popup_transp_Terminal.dump"": {""insertions"": 15, ""deletions"": 0, ""lines"": 15}, ""src/testdir/dumps/Test_terminal_wincolor_split_MyWinCol.dump"": {""insertions"": 15, ""deletions"": 0, ""lines"": 15}, ""src/testdir/dumps/Test_terminal_wincolor_split_MyWinCol2.dump"": {""insertions"": 15, ""deletions"": 0, ""lines"": 15}, ""src/testdir/test_terminal3.vim"": {""insertions"": 310, ""deletions"": 10, ""lines"": 320}, ""src/version.c"": {""insertions"": 2, ""deletions"": 0, ""lines"": 2}, ""src/window.c"": {""insertions"": 6, ""deletions"": 0, ""lines"": 6}}"
2021-11-20 11:14:24,cdf5fdb2948ecdd24c6a1e27ed33dfa847c2b3e4,Bram Moolenaar,8,0,8,4,"{""runtime/doc/eval.txt"": {""insertions"": 3, ""deletions"": 0, ""lines"": 3}, ""src/evalwindow.c"": {""insertions"": 1, ""deletions"": 0, ""lines"": 1}, ""src/testdir/test_bufwintabinfo.vim"": {""insertions"": 2, ""deletions"": 0, ""lines"": 2}, ""src/version.c"": {""insertions"": 2, ""deletions"": 0, ""lines"": 2}}"
2021-11-20 10:38:25,b8e642f7ace5382b4dacb7a8effd86f22b828cc1,Bram Moolenaar,10,3,13,3,"{""src/autocmd.c"": {""insertions"": 2, ""deletions"": 0, ""lines"": 2}, ""src/testdir/test_autocmd.vim"": {""insertions"": 6, ""deletions"": 3, ""lines"": 9}, ""src/version.c"": {""insertions"": 2, ""deletions"": 0, ""lines"": 2}}"
2021-11-19 19:41:13,2de9b7c7c8791da8853a9a7ca9c467867465b655,Bram Moolenaar,19,5,24,3,"{""src/cindent.c"": {""insertions"": 5, ""deletions"": 5, ""lines"": 10}, ""src/testdir/test_cindent.vim"": {""insertions"": 12, ""deletions"": 0, ""lines"": 12}, ""src/version.c"": {""insertions"": 2, ""deletions"": 0, ""lines"": 2}}"
2021-11-19 17:01:08,3ad695328f94e0197e84454f125c7f3464091d0c,Bram Moolenaar,29,0,29,5,"{""src/buffer.c"": {""insertions"": 5, ""deletions"": 0, ""lines"": 5}, ""src/proto/terminal.pro"": {""insertions"": 1, ""deletions"": 0, ""lines"": 1}, ""src/terminal.c"": {""insertions"": 9, ""deletions"": 0, ""lines"": 9}, ""src/testdir/test_terminal.vim"": {""insertions"": 12, ""deletions"": 0, ""lines"": 12}, ""src/version.c"": {""insertions"": 2, ""deletions"": 0, ""lines"": 2}}"
2021-11-19 12:37:36,8b8d829faf04fe3706c04f7f7000054acd3254e7,Christian Brabandt,19,7,26,4,"{""runtime/doc/map.txt"": {""insertions"": 0, ""deletions"": 3, ""lines"": 3}, ""src/os_unix.c"": {""insertions"": 11, ""deletions"": 4, ""lines"": 15}, ""src/testdir/test_expand.vim"": {""insertions"": 6, ""deletions"": 0, ""lines"": 6}, ""src/version.c"": {""insertions"": 2, ""deletions"": 0, ""lines"": 2}}"
2021-11-19 11:59:08,64be6aa3a54ecfe355d4a03e1200650c301e7f29,zeertzjq,11,1,12,3,"{""src/ex_docmd.c"": {""insertions"": 1, ""deletions"": 1, ""lines"": 2}, ""src/testdir/test_autochdir.vim"": {""insertions"": 8, ""deletions"": 0, ""lines"": 8}, ""src/version.c"": {""insertions"": 2, ""deletions"": 0, ""lines"": 2}}"
2021-11-19 11:35:32,1d69ef410ab2adb0351d559ff9753d6cdd4befdf,Bram Moolenaar,3,1,4,2,"{""src/version.c"": {""insertions"": 2, ""deletions"": 0, ""lines"": 2}, ""src/vim.h"": {""insertions"": 1, ""deletions"": 1, ""lines"": 2}}"
2021-11-19 11:28:04,b3a29558eedac9979f5276ae914934b7b7cbe06b,Bram Moolenaar,338,270,608,12,"{""src/Make_cyg_ming.mak"": {""insertions"": 1, ""deletions"": 1, ""lines"": 2}, ""src/Make_mvc.mak"": {""insertions"": 1, ""deletions"": 1, ""lines"": 2}, ""src/Make_vms.mms"": {""insertions"": 122, ""deletions"": 122, ""lines"": 244}, ""src/Makefile"": {""insertions"": 146, ""deletions"": 146, ""lines"": 292}, ""src/alloc.c"": {""insertions"": 1, ""deletions"": 0, ""lines"": 1}, ""src/auto/configure"": {""insertions"": 29, ""deletions"": 0, ""lines"": 29}, ""src/config.h.in"": {""insertions"": 3, ""deletions"": 0, ""lines"": 3}, ""src/configure.ac"": {""insertions"": 10, ""deletions"": 0, ""lines"": 10}, ""src/proto/term.pro"": {""insertions"": 1, ""deletions"": 0, ""lines"": 1}, ""src/term.c"": {""insertions"": 22, ""deletions"": 0, ""lines"": 22}, ""src/{term.h => termdefs.h}"": {""insertions"": 0, ""deletions"": 0, ""lines"": 0}, ""src/version.c"": {""insertions"": 2, ""deletions"": 0, ""lines"": 2}}"
2021-11-18 22:08:57,777175b0df8c5ec3cd30d19a2e887e661ac209c8,Yegappan Lakshmanan,185,41,226,10,"{""runtime/doc/map.txt"": {""insertions"": 14, ""deletions"": 0, ""lines"": 14}, ""runtime/doc/options.txt"": {""insertions"": 17, ""deletions"": 3, ""lines"": 20}, ""src/ops.c"": {""insertions"": 26, ""deletions"": 1, ""lines"": 27}, ""src/option.c"": {""insertions"": 47, ""deletions"": 0, ""lines"": 47}, ""src/optionstr.c"": {""insertions"": 9, ""deletions"": 1, ""lines"": 10}, ""src/proto/ops.pro"": {""insertions"": 2, ""deletions"": 0, ""lines"": 2}, ""src/proto/option.pro"": {""insertions"": 2, ""deletions"": 1, ""lines"": 3}, ""src/quickfix.c"": {""insertions"": 2, ""deletions"": 35, ""lines"": 37}, ""src/testdir/test_normal.vim"": {""insertions"": 64, ""deletions"": 0, ""lines"": 64}, ""src/version.c"": {""insertions"": 2, ""deletions"": 0, ""lines"": 2}}"
2021-11-18 20:47:31,851c7a699ae00bdc14a4db874cf722b7b7393b53,Bram Moolenaar,29,6,35,4,"{""runtime/doc/eval.txt"": {""insertions"": 3, ""deletions"": 3, ""lines"": 6}, ""src/filepath.c"": {""insertions"": 5, ""deletions"": 3, ""lines"": 8}, ""src/testdir/test_cd.vim"": {""insertions"": 19, ""deletions"": 0, ""lines"": 19}, ""src/version.c"": {""insertions"": 2, ""deletions"": 0, ""lines"": 2}}"
2021-11-18 18:53:45,0526815c15170a5926e1008600ec29d42d8b64c2,Bram Moolenaar,51,4,55,9,"{""src/buffer.c"": {""insertions"": 3, ""deletions"": 0, ""lines"": 3}, ""src/ex_docmd.c"": {""insertions"": 4, ""deletions"": 1, ""lines"": 5}, ""src/globals.h"": {""insertions"": 1, ""deletions"": 0, ""lines"": 1}, ""src/main.c"": {""insertions"": 2, ""deletions"": 1, ""lines"": 3}, ""src/netbeans.c"": {""insertions"": 3, ""deletions"": 0, ""lines"": 3}, ""src/os_win32.c"": {""insertions"": 3, ""deletions"": 2, ""lines"": 5}, ""src/testdir/test_autochdir.vim"": {""insertions"": 29, ""deletions"": 0, ""lines"": 29}, ""src/version.c"": {""insertions"": 2, ""deletions"": 0, ""lines"": 2}, ""src/window.c"": {""insertions"": 4, ""deletions"": 0, ""lines"": 4}}"
2021-11-18 15:37:29,3cad47038547e694cfa26ba39c399f610d2054bd,Shougo Matsushita,11,10,21,2,"{""src/testdir/test_arglist.vim"": {""insertions"": 9, ""deletions"": 10, ""lines"": 19}, ""src/version.c"": {""insertions"": 2, ""deletions"": 0, ""lines"": 2}}"
2021-11-18 13:56:37,818ff25cd1aabf60b9cd239da2f1328a959954f7,Christian Brabandt,101,1,102,3,"{""src/testdir/test_indent.vim"": {""insertions"": 75, ""deletions"": 0, ""lines"": 75}, ""src/textformat.c"": {""insertions"": 24, ""deletions"": 1, ""lines"": 25}, ""src/version.c"": {""insertions"": 2, ""deletions"": 0, ""lines"": 2}}"
2021-11-17 20:40:16,6555500bcf280716187eea9dba22d4f69bc0a501,Bakudankun,88,5,93,8,"{""src/popupmenu.c"": {""insertions"": 2, ""deletions"": 2, ""lines"": 4}, ""src/popupwin.c"": {""insertions"": 5, ""deletions"": 1, ""lines"": 6}, ""src/proto/popupmenu.pro"": {""insertions"": 1, ""deletions"": 1, ""lines"": 2}, ""src/screen.c"": {""insertions"": 1, ""deletions"": 1, ""lines"": 2}, ""src/testdir/dumps/Test_popupwin_popupmenu_masking_1.dump"": {""insertions"": 14, ""deletions"": 0, ""lines"": 14}, ""src/testdir/dumps/Test_popupwin_popupmenu_masking_2.dump"": {""insertions"": 14, ""deletions"": 0, ""lines"": 14}, ""src/testdir/test_popupwin.vim"": {""insertions"": 49, ""deletions"": 0, ""lines"": 49}, ""src/version.c"": {""insertions"": 2, ""deletions"": 0, ""lines"": 2}}"
2021-11-17 19:01:53,e015d99abb4276f47ce97bad1ad5ff0c658b1c8a,Bram Moolenaar,5,3,8,2,"{""src/findfile.c"": {""insertions"": 3, ""deletions"": 3, ""lines"": 6}, ""src/version.c"": {""insertions"": 2, ""deletions"": 0, ""lines"": 2}}"
2021-11-17 18:22:56,64066b9acd9f8cffdf4840f797748f938a13f2d6,Bram Moolenaar,19,1,20,4,"{""src/regexp.c"": {""insertions"": 1, ""deletions"": 1, ""lines"": 2}, ""src/regexp_nfa.c"": {""insertions"": 8, ""deletions"": 0, ""lines"": 8}, ""src/testdir/test_regexp_latin.vim"": {""insertions"": 8, ""deletions"": 0, ""lines"": 8}, ""src/version.c"": {""insertions"": 2, ""deletions"": 0, ""lines"": 2}}"
2021-11-17 18:00:31,615ddd5342b50a6878a907062aa471740bd9a847,Bram Moolenaar,22,2,24,4,"{""src/findfile.c"": {""insertions"": 8, ""deletions"": 0, ""lines"": 8}, ""src/normal.c"": {""insertions"": 4, ""deletions"": 2, ""lines"": 6}, ""src/testdir/test_visual.vim"": {""insertions"": 8, ""deletions"": 0, ""lines"": 8}, ""src/version.c"": {""insertions"": 2, ""deletions"": 0, ""lines"": 2}}"
2021-11-17 16:52:40,a062006b9de0b2947ab5fb376c6e67ef92a8cd69,Bram Moolenaar,12,2,14,3,"{""src/normal.c"": {""insertions"": 1, ""deletions"": 1, ""lines"": 2}, ""src/testdir/test_edit.vim"": {""insertions"": 9, ""deletions"": 1, ""lines"": 10}, ""src/version.c"": {""insertions"": 2, ""deletions"": 0, ""lines"": 2}}"
2021-11-17 15:51:52,3075a45592fe76f2febb6321632a23e352efe949,Bram Moolenaar,65,17,82,7,"{""src/insexpand.c"": {""insertions"": 4, ""deletions"": 4, ""lines"": 8}, ""src/misc1.c"": {""insertions"": 37, ""deletions"": 4, ""lines"": 41}, ""src/proto/misc1.pro"": {""insertions"": 2, ""deletions"": 0, ""lines"": 2}, ""src/register.c"": {""insertions"": 9, ""deletions"": 9, ""lines"": 18}, ""src/structs.h"": {""insertions"": 5, ""deletions"": 0, ""lines"": 5}, ""src/testdir/test_edit.vim"": {""insertions"": 6, ""deletions"": 0, ""lines"": 6}, ""src/version.c"": {""insertions"": 2, ""deletions"": 0, ""lines"": 2}}"
2021-11-17 14:01:14,125ffd21f9601a90b845f1d50c24da0d3938bb59,Egor Zvorykin,15,0,15,4,"{""runtime/defaults.vim"": {""insertions"": 11, ""deletions"": 0, ""lines"": 11}, ""src/testdir/test_autocmd.vim"": {""insertions"": 1, ""deletions"": 0, ""lines"": 1}, ""src/testdir/test_cmdline.vim"": {""insertions"": 1, ""deletions"": 0, ""lines"": 1}, ""src/version.c"": {""insertions"": 2, ""deletions"": 0, ""lines"": 2}}"
2021-11-16 20:03:56,9459b8d461d6f8345bfa3fb9b3b4297a7950b0bc,presuku,30,145,175,3,"{""src/gui.h"": {""insertions"": 0, ""deletions"": 1, ""lines"": 1}, ""src/gui_gtk_x11.c"": {""insertions"": 28, ""deletions"": 144, ""lines"": 172}, ""src/version.c"": {""insertions"": 2, ""deletions"": 0, ""lines"": 2}}"
2021-11-16 19:20:56,d3682c5f28380695a53cbb927deb94ffa3261eca,Bram Moolenaar,3,0,3,2,"{""Filelist"": {""insertions"": 1, ""deletions"": 0, ""lines"": 1}, ""src/version.c"": {""insertions"": 2, ""deletions"": 0, ""lines"": 2}}"
2021-11-16 19:18:26,519cc559b08b800edc429688aece7ad6a00d41eb,Bram Moolenaar,365,141,506,29,"{"".github/CODEOWNERS"": {""insertions"": 3, ""deletions"": 0, ""lines"": 3}, ""runtime/autoload/zip.vim"": {""insertions"": 21, ""deletions"": 15, ""lines"": 36}, ""runtime/doc/eval.txt"": {""insertions"": 4, ""deletions"": 4, ""lines"": 8}, ""runtime/doc/helphelp.txt"": {""insertions"": 13, ""deletions"": 9, ""lines"": 22}, ""runtime/doc/if_pyth.txt"": {""insertions"": 6, ""deletions"": 1, ""lines"": 7}, ""runtime/doc/map.txt"": {""insertions"": 4, ""deletions"": 1, ""lines"": 5}, ""runtime/doc/options.txt"": {""insertions"": 1, ""deletions"": 1, ""lines"": 2}, ""runtime/doc/pi_zip.txt"": {""insertions"": 4, ""deletions"": 1, ""lines"": 5}, ""runtime/doc/syntax.txt"": {""insertions"": 1, ""deletions"": 1, ""lines"": 2}, ""runtime/doc/tags"": {""insertions"": 4, ""deletions"": 2, ""lines"": 6}, ""runtime/doc/terminal.txt"": {""insertions"": 2, ""deletions"": 2, ""lines"": 4}, ""runtime/doc/todo.txt"": {""insertions"": 4, ""deletions"": 9, ""lines"": 13}, ""runtime/doc/usr_20.txt"": {""insertions"": 5, ""deletions"": 5, ""lines"": 10}, ""runtime/filetype.vim"": {""insertions"": 1, ""deletions"": 1, ""lines"": 2}, ""runtime/ftplugin/aap.vim"": {""insertions"": 10, ""deletions"": 3, ""lines"": 13}, ""runtime/ftplugin/diff.vim"": {""insertions"": 8, ""deletions"": 3, ""lines"": 11}, ""runtime/ftplugin/lua.vim"": {""insertions"": 21, ""deletions"": 17, ""lines"": 38}, ""runtime/ftplugin/routeros.vim"": {""insertions"": 29, ""deletions"": 0, ""lines"": 29}, ""runtime/ftplugin/zimbu.vim"": {""insertions"": 57, ""deletions"": 4, ""lines"": 61}, ""runtime/pack/dist/opt/matchit/doc/matchit.txt"": {""insertions"": 2, ""deletions"": 2, ""lines"": 4}, ""runtime/pack/dist/opt/termdebug/plugin/termdebug.vim"": {""insertions"": 3, ""deletions"": 1, ""lines"": 4}, ""runtime/plugin/zipPlugin.vim"": {""insertions"": 1, ""deletions"": 1, ""lines"": 2}, ""runtime/syntax/autoit.vim"": {""insertions"": 2, ""deletions"": 1, ""lines"": 3}, ""runtime/syntax/gdb.vim"": {""insertions"": 7, ""deletions"": 6, ""lines"": 13}, ""runtime/syntax/gnuplot.vim"": {""insertions"": 23, ""deletions"": 18, ""lines"": 41}, ""runtime/syntax/lisp.vim"": {""insertions"": 14, ""deletions"": 12, ""lines"": 26}, ""runtime/syntax/routeros.vim"": {""insertions"": 91, ""deletions"": 0, ""lines"": 91}, ""runtime/syntax/tcl.vim"": {""insertions"": 10, ""deletions"": 10, ""lines"": 20}, ""runtime/syntax/vim.vim"": {""insertions"": 14, ""deletions"": 11, ""lines"": 25}}"
2021-11-16 17:50:34,728104da6cd561b8cb2c7142769f7526d725958e,Bram Moolenaar,2,0,2,1,"{""src/version.c"": {""insertions"": 2, ""deletions"": 0, ""lines"": 2}}"
2021-11-16 17:19:30,2a16dc6613368c54d526850bcbcd03c3fec1be67,Yegappan Lakshmanan,142,35,177,5,"{""runtime/doc/eval.txt"": {""insertions"": 16, ""deletions"": 1, ""lines"": 17}, ""src/highlight.c"": {""insertions"": 35, ""deletions"": 17, ""lines"": 52}, ""src/testdir/test_highlight.vim"": {""insertions"": 88, ""deletions"": 15, ""lines"": 103}, ""src/testdir/test_vim9_builtin.vim"": {""insertions"": 1, ""deletions"": 0, ""lines"": 1}, ""src/testdir/test_vim9_cmd.vim"": {""insertions"": 2, ""deletions"": 2, ""lines"": 4}}"
2021-11-16 16:38:42,c143fa0778fa0d8744867318bb7f7a2e63cf37d7,Bram Moolenaar,6,1,7,3,"{""runtime/filetype.vim"": {""insertions"": 3, ""deletions"": 0, ""lines"": 3}, ""src/testdir/test_filetype.vim"": {""insertions"": 1, ""deletions"": 1, ""lines"": 2}, ""src/version.c"": {""insertions"": 2, ""deletions"": 0, ""lines"": 2}}"
2021-11-16 15:28:10,b1b163efd7bb3ca68cce101d4e431559d2944a8e,Bram Moolenaar,11,0,11,4,"{""runtime/filetype.vim"": {""insertions"": 3, ""deletions"": 0, ""lines"": 3}, ""runtime/scripts.vim"": {""insertions"": 4, ""deletions"": 0, ""lines"": 4}, ""src/testdir/test_filetype.vim"": {""insertions"": 2, ""deletions"": 0, ""lines"": 2}, ""src/version.c"": {""insertions"": 2, ""deletions"": 0, ""lines"": 2}}"
2021-11-16 13:08:56,1be7e215830d6ec9aa6200aac4ef34ac0ae85af5,K.Takata,5,0,5,2,"{""src/testdir/test_python3.vim"": {""insertions"": 3, ""deletions"": 0, ""lines"": 3}, ""src/version.c"": {""insertions"": 2, ""deletions"": 0, ""lines"": 2}}"
2021-11-16 12:50:46,fa53722367c3793fda95dac665af74b8651065e9,ichizok,68,29,97,3,"{""src/register.c"": {""insertions"": 35, ""deletions"": 27, ""lines"": 62}, ""src/testdir/test_put.vim"": {""insertions"": 31, ""deletions"": 2, ""lines"": 33}, ""src/version.c"": {""insertions"": 2, ""deletions"": 0, ""lines"": 2}}"
2021-11-16 11:53:13,314b773abbb9b1ce0020d83482c6daf7ad6a42a2,Bram Moolenaar,10,0,10,2,"{""runtime/scripts.vim"": {""insertions"": 8, ""deletions"": 0, ""lines"": 8}, ""src/version.c"": {""insertions"": 2, ""deletions"": 0, ""lines"": 2}}"
2021-11-16 11:10:11,782b4bbc163e03ebe98d25bc62b9d82cba8f91a1,Bram Moolenaar,4,2,6,3,"{""runtime/filetype.vim"": {""insertions"": 1, ""deletions"": 1, ""lines"": 2}, ""src/testdir/test_filetype.vim"": {""insertions"": 1, ""deletions"": 1, ""lines"": 2}, ""src/version.c"": {""insertions"": 2, ""deletions"": 0, ""lines"": 2}}"
2021-11-15 21:44:11,0818ab82e7058145366ebbe759f0b3f74724bdfd,zainin,7,0,7,3,"{""runtime/filetype.vim"": {""insertions"": 3, ""deletions"": 0, ""lines"": 3}, ""src/testdir/test_filetype.vim"": {""insertions"": 2, ""deletions"": 0, ""lines"": 2}, ""src/version.c"": {""insertions"": 2, ""deletions"": 0, ""lines"": 2}}"
2021-11-15 17:13:11,36968af1558b295b5fdf56973d5dcc75fce85658,Bram Moolenaar,20,1,21,3,"{""runtime/doc/options.txt"": {""insertions"": 3, ""deletions"": 0, ""lines"": 3}, ""src/terminal.c"": {""insertions"": 15, ""deletions"": 1, ""lines"": 16}, ""src/version.c"": {""insertions"": 2, ""deletions"": 0, ""lines"": 2}}"
2021-11-15 11:22:09,733b124a9098d5e2f028fd2e12012b831c9e9024,Yegappan Lakshmanan,18,5,23,3,"{""src/popupwin.c"": {""insertions"": 5, ""deletions"": 5, ""lines"": 10}, ""src/testdir/test_vim9_cmd.vim"": {""insertions"": 11, ""deletions"": 0, ""lines"": 11}, ""src/version.c"": {""insertions"": 2, ""deletions"": 0, ""lines"": 2}}"
2021-11-14 14:05:18,0d5a12ea041c112b06b1aafde38846ae4cff8f4c,Bram Moolenaar,8,2,10,2,"{""src/getchar.c"": {""insertions"": 6, ""deletions"": 2, ""lines"": 8}, ""src/version.c"": {""insertions"": 2, ""deletions"": 0, ""lines"": 2}}"
2021-11-14 13:46:05,786e05beb5bf4a50cffacd0968f1409aa6af3c6b,Bram Moolenaar,44,29,73,2,"{""src/version.c"": {""insertions"": 2, ""deletions"": 0, ""lines"": 2}, ""src/xxd/xxd.c"": {""insertions"": 42, ""deletions"": 29, ""lines"": 71}}"
2021-11-14 11:41:31,7f13b24ab6aca808262e68680d8fe5f082670ebd,Bram Moolenaar,58,30,88,5,"{""src/evalwindow.c"": {""insertions"": 4, ""deletions"": 0, ""lines"": 4}, ""src/proto/window.pro"": {""insertions"": 1, ""deletions"": 0, ""lines"": 1}, ""src/testdir/test_execute_func.vim"": {""insertions"": 12, ""deletions"": 0, ""lines"": 12}, ""src/version.c"": {""insertions"": 2, ""deletions"": 0, ""lines"": 2}, ""src/window.c"": {""insertions"": 39, ""deletions"": 30, ""lines"": 69}}"
2021-11-13 18:44:37,6a950a6007f27d9d0ce32ef8dcaf5c9d0f1b5aab,Dominique Pelle,7,0,7,2,"{""src/testdir/test_highlight.vim"": {""insertions"": 5, ""deletions"": 0, ""lines"": 5}, ""src/version.c"": {""insertions"": 2, ""deletions"": 0, ""lines"": 2}}"
2021-11-13 12:38:49,23beefed73aadb243fb67cf944e3d60fe8c038bb,naohiro ono,84,4,88,6,"{""runtime/doc/autocmd.txt"": {""insertions"": 7, ""deletions"": 0, ""lines"": 7}, ""src/autocmd.c"": {""insertions"": 3, ""deletions"": 1, ""lines"": 4}, ""src/testdir/test_autocmd.vim"": {""insertions"": 43, ""deletions"": 3, ""lines"": 46}, ""src/version.c"": {""insertions"": 2, ""deletions"": 0, ""lines"": 2}, ""src/vim.h"": {""insertions"": 1, ""deletions"": 0, ""lines"": 1}, ""src/window.c"": {""insertions"": 28, ""deletions"": 0, ""lines"": 28}}"
2021-11-13 10:50:01,a0fca17251bf491db7b8d302ce22dee844597e82,Drew Vogel,24,35,59,5,"{""runtime/doc/eval.txt"": {""insertions"": 1, ""deletions"": 1, ""lines"": 2}, ""src/highlight.c"": {""insertions"": 0, ""deletions"": 33, ""lines"": 33}, ""src/proto/highlight.pro"": {""insertions"": 0, ""deletions"": 1, ""lines"": 1}, ""src/testdir/test_highlight.vim"": {""insertions"": 21, ""deletions"": 0, ""lines"": 21}, ""src/version.c"": {""insertions"": 2, ""deletions"": 0, ""lines"": 2}}"
2021-11-13 10:27:40,5300be620c77950caa5296019408ee02e60097e8,Bram Moolenaar,11,1,12,4,"{""runtime/doc/terminal.txt"": {""insertions"": 2, ""deletions"": 1, ""lines"": 3}, ""src/job.c"": {""insertions"": 5, ""deletions"": 0, ""lines"": 5}, ""src/testdir/test_terminal.vim"": {""insertions"": 2, ""deletions"": 0, ""lines"": 2}, ""src/version.c"": {""insertions"": 2, ""deletions"": 0, ""lines"": 2}}"
2021-11-12 19:52:47,606efc7df4c94104bbd24248106dd0e4ee6f7cfa,Bram Moolenaar,6,5,11,2,"{""src/optionstr.c"": {""insertions"": 4, ""deletions"": 5, ""lines"": 9}, ""src/version.c"": {""insertions"": 2, ""deletions"": 0, ""lines"": 2}}"
2021-11-12 16:09:54,0a15c7676bccb0c9483579106318e785c6e40a7f,Bram Moolenaar,3,1,4,2,"{""src/testdir/test_compiler.vim"": {""insertions"": 1, ""deletions"": 1, ""lines"": 2}, ""src/version.c"": {""insertions"": 2, ""deletions"": 0, ""lines"": 2}}"
2021-11-12 16:06:03,326e7da609a1b115b0ed535e89e970afebe99e35,Bram Moolenaar,4,2,6,2,"{""src/testdir/test_usercommands.vim"": {""insertions"": 2, ""deletions"": 2, ""lines"": 4}, ""src/version.c"": {""insertions"": 2, ""deletions"": 0, ""lines"": 2}}"
2021-11-12 16:01:15,88137396733896eb5e49c2b3b73d9a496d6ce49a,Bram Moolenaar,13,2,15,4,"{""src/job.c"": {""insertions"": 5, ""deletions"": 1, ""lines"": 6}, ""src/terminal.c"": {""insertions"": 2, ""deletions"": 1, ""lines"": 3}, ""src/testdir/test_terminal.vim"": {""insertions"": 4, ""deletions"": 0, ""lines"": 4}, ""src/version.c"": {""insertions"": 2, ""deletions"": 0, ""lines"": 2}}"
2021-11-12 11:25:11,58ef8a31d7087d495ab1582be5b7a22796ac2451,Bram Moolenaar,20,5,25,6,"{""runtime/doc/map.txt"": {""insertions"": 3, ""deletions"": 0, ""lines"": 3}, ""src/ex_cmds.h"": {""insertions"": 1, ""deletions"": 0, ""lines"": 1}, ""src/ex_cmds2.c"": {""insertions"": 1, ""deletions"": 1, ""lines"": 2}, ""src/testdir/test_compiler.vim"": {""insertions"": 3, ""deletions"": 0, ""lines"": 3}, ""src/usercmd.c"": {""insertions"": 10, ""deletions"": 4, ""lines"": 14}, ""src/version.c"": {""insertions"": 2, ""deletions"": 0, ""lines"": 2}}"
2021-11-12 10:30:04,0c71114aede81a209b7efc126b4bf19f11d58955,Bram Moolenaar,58,3,61,5,"{""src/normal.c"": {""insertions"": 11, ""deletions"": 3, ""lines"": 14}, ""src/testdir/dumps/Test_searchstatgd_1.dump"": {""insertions"": 10, ""deletions"": 0, ""lines"": 10}, ""src/testdir/dumps/Test_searchstatgd_2.dump"": {""insertions"": 10, ""deletions"": 0, ""lines"": 10}, ""src/testdir/test_search_stat.vim"": {""insertions"": 25, ""deletions"": 0, ""lines"": 25}, ""src/version.c"": {""insertions"": 2, ""deletions"": 0, ""lines"": 2}}"
2021-11-07 20:27:04,113cb513f76d8866cbb6dc85fa18aded753e01da,Bram Moolenaar,359,416,775,48,"{"".github/CODEOWNERS"": {""insertions"": 3, ""deletions"": 0, ""lines"": 3}, ""runtime/autoload/clojurecomplete.vim"": {""insertions"": 5, ""deletions"": 5, ""lines"": 10}, ""runtime/doc/eval.txt"": {""insertions"": 45, ""deletions"": 11, ""lines"": 56}, ""runtime/doc/gui_w32.txt"": {""insertions"": 1, ""deletions"": 1, ""lines"": 2}, ""runtime/doc/indent.txt"": {""insertions"": 24, ""deletions"": 35, ""lines"": 59}, ""runtime/doc/insert.txt"": {""insertions"": 21, ""deletions"": 25, ""lines"": 46}, ""runtime/doc/options.txt"": {""insertions"": 7, ""deletions"": 4, ""lines"": 11}, ""runtime/doc/syntax.txt"": {""insertions"": 51, ""deletions"": 33, ""lines"": 84}, ""runtime/doc/tags"": {""insertions"": 14, ""deletions"": 0, ""lines"": 14}, ""runtime/doc/tips.txt"": {""insertions"": 2, ""deletions"": 1, ""lines"": 3}, ""runtime/doc/todo.txt"": {""insertions"": 11, ""deletions"": 3, ""lines"": 14}, ""runtime/doc/usr_06.txt"": {""insertions"": 2, ""deletions"": 2, ""lines"": 4}, ""runtime/ftplugin/clojure.vim"": {""insertions"": 6, ""deletions"": 6, ""lines"": 12}, ""runtime/ftplugin/mail.vim"": {""insertions"": 9, ""deletions"": 1, ""lines"": 10}, ""runtime/ftplugin/meson.vim"": {""insertions"": 21, ""deletions"": 2, ""lines"": 23}, ""runtime/ftplugin/spec.vim"": {""insertions"": 2, ""deletions"": 2, ""lines"": 4}, ""runtime/indent/clojure.vim"": {""insertions"": 8, ""deletions"": 11, ""lines"": 19}, ""runtime/indent/meson.vim"": {""insertions"": 2, ""deletions"": 0, ""lines"": 2}, ""runtime/indent/vim.vim"": {""insertions"": 2, ""deletions"": 2, ""lines"": 4}, ""runtime/optwin.vim"": {""insertions"": 2, ""deletions"": 2, ""lines"": 4}, ""runtime/pack/dist/opt/termdebug/plugin/termdebug.vim"": {""insertions"": 22, ""deletions"": 7, ""lines"": 29}, ""runtime/syntax/arduino.vim"": {""insertions"": 1, ""deletions"": 1, ""lines"": 2}, ""runtime/syntax/clojure.vim"": {""insertions"": 34, ""deletions"": 35, ""lines"": 69}, ""runtime/syntax/help_ru.vim"": {""insertions"": 2, ""deletions"": 2, ""lines"": 4}, ""runtime/syntax/meson.vim"": {""insertions"": 11, ""deletions"": 7, ""lines"": 18}, ""runtime/syntax/sh.vim"": {""insertions"": 4, ""deletions"": 4, ""lines"": 8}, ""runtime/syntax/vim.vim"": {""insertions"": 28, ""deletions"": 29, ""lines"": 57}, ""runtime/tutor/tutor.da.utf-8"": {""insertions"": 1, ""deletions"": 1, ""lines"": 2}, ""src/po/ca.po"": {""insertions"": 0, ""deletions"": 3, ""lines"": 3}, ""src/po/da.po"": {""insertions"": 0, ""deletions"": 3, ""lines"": 3}, ""src/po/de.po"": {""insertions"": 0, ""deletions"": 3, ""lines"": 3}, ""src/po/eo.po"": {""insertions"": 0, ""deletions"": 3, ""lines"": 3}, ""src/po/fi.po"": {""insertions"": 0, ""deletions"": 3, ""lines"": 3}, ""src/po/fr.po"": {""insertions"": 0, ""deletions"": 3, ""lines"": 3}, ""src/po/ga.po"": {""insertions"": 0, ""deletions"": 3, ""lines"": 3}, ""src/po/it.po"": {""insertions"": 18, ""deletions"": 127, ""lines"": 145}, ""src/po/ja.euc-jp.po"": {""insertions"": 0, ""deletions"": 3, ""lines"": 3}, ""src/po/ja.po"": {""insertions"": 0, ""deletions"": 3, ""lines"": 3}, ""src/po/ja.sjis.po"": {""insertions"": 0, ""deletions"": 3, ""lines"": 3}, ""src/po/ko.UTF-8.po"": {""insertions"": 0, ""deletions"": 3, ""lines"": 3}, ""src/po/ko.po"": {""insertions"": 0, ""deletions"": 3, ""lines"": 3}, ""src/po/pt_BR.po"": {""insertions"": 0, ""deletions"": 3, ""lines"": 3}, ""src/po/ru.cp1251.po"": {""insertions"": 0, ""deletions"": 3, ""lines"": 3}, ""src/po/ru.po"": {""insertions"": 0, ""deletions"": 3, ""lines"": 3}, ""src/po/sr.po"": {""insertions"": 0, ""deletions"": 3, ""lines"": 3}, ""src/po/tr.po"": {""insertions"": 0, ""deletions"": 3, ""lines"": 3}, ""src/po/uk.cp1251.po"": {""insertions"": 0, ""deletions"": 3, ""lines"": 3}, ""src/po/uk.po"": {""insertions"": 0, ""deletions"": 3, ""lines"": 3}}"
2021-11-04 15:46:05,15d9890eee53afc61eb0a03b878a19cb5672f732,Bram Moolenaar,11,1,12,3,"{""src/spellsuggest.c"": {""insertions"": 1, ""deletions"": 1, ""lines"": 2}, ""src/testdir/test_spell.vim"": {""insertions"": 8, ""deletions"": 0, ""lines"": 8}, ""src/version.c"": {""insertions"": 2, ""deletions"": 0, ""lines"": 2}}"
2021-11-04 15:10:11,0b5b06cb4777d1401fdf83e7d48d287662236e7e,Bram Moolenaar,12,0,12,3,"{""src/ex_docmd.c"": {""insertions"": 1, ""deletions"": 0, ""lines"": 1}, ""src/testdir/test_put.vim"": {""insertions"": 9, ""deletions"": 0, ""lines"": 9}, ""src/version.c"": {""insertions"": 2, ""deletions"": 0, ""lines"": 2}}"
2021-11-04 13:28:29,aaec1d4fb12efb82b87ad322e95994de77b1a833,Christian Brabandt,22,1,23,3,"{""src/normal.c"": {""insertions"": 8, ""deletions"": 1, ""lines"": 9}, ""src/testdir/test_normal.vim"": {""insertions"": 12, ""deletions"": 0, ""lines"": 12}, ""src/version.c"": {""insertions"": 2, ""deletions"": 0, ""lines"": 2}}"
2021-11-03 22:31:44,4b2c8047679b737dcb0cd15c313ee51553aed617,Christian Brabandt,8,1,9,2,"{""src/testdir/runtest.vim"": {""insertions"": 6, ""deletions"": 1, ""lines"": 7}, ""src/version.c"": {""insertions"": 2, ""deletions"": 0, ""lines"": 2}}"
2021-11-03 22:25:06,b32aa8a6a10983836d5987f1e42035f88d47bf6e,Bram Moolenaar,2,0,2,1,"{""src/version.c"": {""insertions"": 2, ""deletions"": 0, ""lines"": 2}}"
2021-11-03 21:56:45,d1a8d658e1b16cf8579fc72cf7aa6a29a57ff5ef,Yegappan Lakshmanan,724,0,724,9,"{""runtime/doc/eval.txt"": {""insertions"": 89, ""deletions"": 0, ""lines"": 89}, ""runtime/doc/syntax.txt"": {""insertions"": 1, ""deletions"": 0, ""lines"": 1}, ""runtime/doc/usr_41.txt"": {""insertions"": 2, ""deletions"": 0, ""lines"": 2}, ""runtime/doc/windows.txt"": {""insertions"": 1, ""deletions"": 0, ""lines"": 1}, ""src/evalfunc.c"": {""insertions"": 4, ""deletions"": 0, ""lines"": 4}, ""src/highlight.c"": {""insertions"": 454, ""deletions"": 0, ""lines"": 454}, ""src/proto/highlight.pro"": {""insertions"": 2, ""deletions"": 0, ""lines"": 2}, ""src/testdir/test_highlight.vim"": {""insertions"": 161, ""deletions"": 0, ""lines"": 161}, ""src/testdir/test_vim9_builtin.vim"": {""insertions"": 10, ""deletions"": 0, ""lines"": 10}}"
2021-11-03 13:43:16,0f0044125c2a5dcde2c4605efc39d2e237eed024,Bram Moolenaar,6,0,6,2,"{""src/testdir/test_put.vim"": {""insertions"": 4, ""deletions"": 0, ""lines"": 4}, ""src/version.c"": {""insertions"": 2, ""deletions"": 0, ""lines"": 2}}"
2021-11-03 13:15:47,a63780b9770699bf8fda93affeab2c728bc76912,Sean Dewar,3,1,4,2,"{""src/evalfunc.c"": {""insertions"": 1, ""deletions"": 1, ""lines"": 2}, ""src/version.c"": {""insertions"": 2, ""deletions"": 0, ""lines"": 2}}"
2021-11-02 23:11:00,e551ccfb9311eea5252d1c3106ff7a53c762d994,Bram Moolenaar,11,3,14,2,"{""src/register.c"": {""insertions"": 9, ""deletions"": 3, ""lines"": 12}, ""src/version.c"": {""insertions"": 2, ""deletions"": 0, ""lines"": 2}}"
2021-11-02 22:48:49,8a1962d1355096af55e84b1ea2f0baf5f1c5a5bc,Bram Moolenaar,5,2,7,2,"{""src/register.c"": {""insertions"": 3, ""deletions"": 2, ""lines"": 5}, ""src/version.c"": {""insertions"": 2, ""deletions"": 0, ""lines"": 2}}"
2021-11-02 21:39:49,69b3072d984480935ec412b32b97fea974d2b689,Bram Moolenaar,14,9,23,5,"{""src/evalvars.c"": {""insertions"": 6, ""deletions"": 0, ""lines"": 6}, ""src/register.c"": {""insertions"": 2, ""deletions"": 1, ""lines"": 3}, ""src/testdir/test_put.vim"": {""insertions"": 0, ""deletions"": 7, ""lines"": 7}, ""src/version.c"": {""insertions"": 2, ""deletions"": 0, ""lines"": 2}, ""src/vim.h"": {""insertions"": 4, ""deletions"": 1, ""lines"": 5}}"
2021-11-02 20:56:07,7a33ebfc5b04353aa7674972087d581def8fdcc1,zeertzjq,15,5,20,3,"{""src/testdir/test_listchars.vim"": {""insertions"": 11, ""deletions"": 5, ""lines"": 16}, ""src/version.c"": {""insertions"": 2, ""deletions"": 0, ""lines"": 2}, ""src/window.c"": {""insertions"": 2, ""deletions"": 0, ""lines"": 2}}"
2021-11-02 20:24:38,e2f66064d1c643f0cf12c4791de04bb123705a0c,Bram Moolenaar,3,1,4,2,"{""src/mbyte.c"": {""insertions"": 1, ""deletions"": 1, ""lines"": 2}, ""src/version.c"": {""insertions"": 2, ""deletions"": 0, ""lines"": 2}}"
2021-11-01 22:58:43,ec6e63079dde24a1d74b4103775e74d00f9215ec,Bram Moolenaar,6,0,6,2,"{""src/testdir/test_put.vim"": {""insertions"": 4, ""deletions"": 0, ""lines"": 4}, ""src/version.c"": {""insertions"": 2, ""deletions"": 0, ""lines"": 2}}"
2021-11-01 22:44:33,fd916d654d9731b3515abf7bc1ac12bd3632b601,Christian Brabandt,9,4,13,2,"{""src/os_win32.c"": {""insertions"": 7, ""deletions"": 4, ""lines"": 11}, ""src/version.c"": {""insertions"": 2, ""deletions"": 0, ""lines"": 2}}"
2021-10-31 20:19:17,8753c1dd2c2a5c2c7ff63a9bfb14cd4b9bb9c87f,Dominique Pelle,7,1,8,2,"{""src/testdir/test_edit.vim"": {""insertions"": 5, ""deletions"": 1, ""lines"": 6}, ""src/version.c"": {""insertions"": 2, ""deletions"": 0, ""lines"": 2}}"
2021-10-28 20:06:05,9cd063e3195a4c250c8016fa340922ab21fda252,Dominique Pelle,19,0,19,2,"{""src/testdir/test_edit.vim"": {""insertions"": 17, ""deletions"": 0, ""lines"": 17}, ""src/version.c"": {""insertions"": 2, ""deletions"": 0, ""lines"": 2}}"
2021-10-28 19:49:06,44db603f691b58a8531e8ff528e0a7ce644257b2,Gary Johnson,17,0,17,2,"{""src/version.c"": {""insertions"": 2, ""deletions"": 0, ""lines"": 2}, ""src/vim.h"": {""insertions"": 15, ""deletions"": 0, ""lines"": 15}}"
2021-10-26 11:00:01,2446ec9b567ce2b72bd06d121f200f40bbdc8a84,Bram Moolenaar,217,199,416,2,"{""src/Makefile"": {""insertions"": 215, ""deletions"": 199, ""lines"": 414}, ""src/version.c"": {""insertions"": 2, ""deletions"": 0, ""lines"": 2}}"
2021-10-25 16:07:04,777e7c21b7627be80961848ac560cb0a9978ff43,Bram Moolenaar,21,4,25,3,"{""src/move.c"": {""insertions"": 0, ""deletions"": 1, ""lines"": 1}, ""src/testdir/test_normal.vim"": {""insertions"": 19, ""deletions"": 3, ""lines"": 22}, ""src/version.c"": {""insertions"": 2, ""deletions"": 0, ""lines"": 2}}"
2021-10-25 09:30:14,2a52196b78f3fcc0e9fad538984272c5fd8d85db,Bram Moolenaar,4,2,6,2,"{""src/highlight.c"": {""insertions"": 2, ""deletions"": 2, ""lines"": 4}, ""src/version.c"": {""insertions"": 2, ""deletions"": 0, ""lines"": 2}}"
2021-10-24 19:35:07,e30d10253fa634c4f60daa798d029245f4eed393,Drew Vogel,1364,398,1762,26,"{""Filelist"": {""insertions"": 1, ""deletions"": 1, ""lines"": 2}, ""READMEdir/README_extra.txt"": {""insertions"": 0, ""deletions"": 1, ""lines"": 1}, ""nsis/gvim.nsi"": {""insertions"": 2, ""deletions"": 1, ""lines"": 3}, ""runtime/colors/README.txt"": {""insertions"": 2, ""deletions"": 1, ""lines"": 3}, ""runtime/colors/lists/csscolors.vim"": {""insertions"": 166, ""deletions"": 0, ""lines"": 166}, ""runtime/colors/lists/default.vim"": {""insertions"": 801, ""deletions"": 0, ""lines"": 801}, ""runtime/doc/eval.txt"": {""insertions"": 37, ""deletions"": 0, ""lines"": 37}, ""runtime/doc/gui_w32.txt"": {""insertions"": 4, ""deletions"": 14, ""lines"": 18}, ""runtime/doc/message.txt"": {""insertions"": 5, ""deletions"": 0, ""lines"": 5}, ""runtime/doc/os_haiku.txt"": {""insertions"": 2, ""deletions"": 3, ""lines"": 5}, ""runtime/doc/syntax.txt"": {""insertions"": 28, ""deletions"": 1, ""lines"": 29}, ""runtime/doc/usr_06.txt"": {""insertions"": 24, ""deletions"": 1, ""lines"": 25}, ""src/Makefile"": {""insertions"": 1, ""deletions"": 10, ""lines"": 11}, ""src/errors.h"": {""insertions"": 6, ""deletions"": 0, ""lines"": 6}, ""src/evalvars.c"": {""insertions"": 3, ""deletions"": 0, ""lines"": 3}, ""src/globals.h"": {""insertions"": 0, ""deletions"": 3, ""lines"": 3}, ""src/gui.c"": {""insertions"": 1, ""deletions"": 1, ""lines"": 2}, ""src/gui_haiku.cc"": {""insertions"": 1, ""deletions"": 158, ""lines"": 159}, ""src/highlight.c"": {""insertions"": 232, ""deletions"": 1, ""lines"": 233}, ""src/job.c"": {""insertions"": 1, ""deletions"": 1, ""lines"": 2}, ""src/proto/highlight.pro"": {""insertions"": 6, ""deletions"": 0, ""lines"": 6}, ""src/proto/term.pro"": {""insertions"": 0, ""deletions"": 2, ""lines"": 2}, ""src/term.c"": {""insertions"": 1, ""deletions"": 198, ""lines"": 199}, ""src/testdir/test_highlight.vim"": {""insertions"": 36, ""deletions"": 0, ""lines"": 36}, ""src/version.c"": {""insertions"": 2, ""deletions"": 0, ""lines"": 2}, ""src/vim.h"": {""insertions"": 2, ""deletions"": 1, ""lines"": 3}}"
2021-10-24 13:50:07,3c5904d2a5d7861c227a4c3cd4ddcbc51014c838,James McCoy,7,39,46,2,"{""src/if_cscope.c"": {""insertions"": 5, ""deletions"": 39, ""lines"": 44}, ""src/version.c"": {""insertions"": 2, ""deletions"": 0, ""lines"": 2}}"
2021-10-23 12:32:30,844fb64a605d60131827503a001b2d1aa232b078,Bram Moolenaar,63,20,83,8,"{""src/eval.c"": {""insertions"": 16, ""deletions"": 7, ""lines"": 23}, ""src/globals.h"": {""insertions"": 2, ""deletions"": 2, ""lines"": 4}, ""src/proto/eval.pro"": {""insertions"": 1, ""deletions"": 0, ""lines"": 1}, ""src/structs.h"": {""insertions"": 5, ""deletions"": 2, ""lines"": 7}, ""src/testdir/test_vim9_func.vim"": {""insertions"": 20, ""deletions"": 0, ""lines"": 20}, ""src/userfunc.c"": {""insertions"": 8, ""deletions"": 3, ""lines"": 11}, ""src/version.c"": {""insertions"": 2, ""deletions"": 0, ""lines"": 2}, ""src/vim9compile.c"": {""insertions"": 9, ""deletions"": 6, ""lines"": 15}}"
2021-10-23 11:34:27,ee56f3f119c4378a5b62b4d504cff3373b363308,Bram Moolenaar,5,2,7,2,"{""src/ex_eval.c"": {""insertions"": 3, ""deletions"": 2, ""lines"": 5}, ""src/version.c"": {""insertions"": 2, ""deletions"": 0, ""lines"": 2}}"
2021-10-23 11:08:41,079ba76ae7a7d0ef404cb9b41dff2663ff41f51b,Bram Moolenaar,520,280,800,19,"{"".github/CODEOWNERS"": {""insertions"": 1, ""deletions"": 0, ""lines"": 1}, ""runtime/doc/eval.txt"": {""insertions"": 1, ""deletions"": 1, ""lines"": 2}, ""runtime/doc/insert.txt"": {""insertions"": 2, ""deletions"": 2, ""lines"": 4}, ""runtime/doc/map.txt"": {""insertions"": 4, ""deletions"": 1, ""lines"": 5}, ""runtime/doc/options.txt"": {""insertions"": 3, ""deletions"": 2, ""lines"": 5}, ""runtime/doc/quickref.txt"": {""insertions"": 2, ""deletions"": 1, ""lines"": 3}, ""runtime/doc/tags"": {""insertions"": 8, ""deletions"": 0, ""lines"": 8}, ""runtime/doc/todo.txt"": {""insertions"": 1, ""deletions"": 3, ""lines"": 4}, ""runtime/ftplugin/changelog.vim"": {""insertions"": 16, ""deletions"": 10, ""lines"": 26}, ""runtime/ftplugin/nsis.vim"": {""insertions"": 2, ""deletions"": 2, ""lines"": 4}, ""runtime/indent/dosbatch.vim"": {""insertions"": 3, ""deletions"": 1, ""lines"": 4}, ""runtime/indent/nsis.vim"": {""insertions"": 3, ""deletions"": 1, ""lines"": 4}, ""runtime/indent/teraterm.vim"": {""insertions"": 3, ""deletions"": 1, ""lines"": 4}, ""runtime/optwin.vim"": {""insertions"": 6, ""deletions"": 1, ""lines"": 7}, ""runtime/syntax/arduino.vim"": {""insertions"": 64, ""deletions"": 35, ""lines"": 99}, ""runtime/syntax/debchangelog.vim"": {""insertions"": 3, ""deletions"": 2, ""lines"": 5}, ""runtime/syntax/debsources.vim"": {""insertions"": 3, ""deletions"": 2, ""lines"": 5}, ""runtime/syntax/nsis.vim"": {""insertions"": 35, ""deletions"": 7, ""lines"": 42}, ""src/po/it.po"": {""insertions"": 360, ""deletions"": 208, ""lines"": 568}}"
2021-10-23 09:25:21,06ca48a40f049f20347c9630a180457d1f1aece5,Bram Moolenaar,3,1,4,2,"{""src/testdir/test_vim9_script.vim"": {""insertions"": 1, ""deletions"": 1, ""lines"": 2}, ""src/version.c"": {""insertions"": 2, ""deletions"": 0, ""lines"": 2}}"
2021-10-22 21:17:53,5fe07d2e08f05c6f3905fecdf07f4cfad4d6ed17,Bram Moolenaar,77,7,84,3,"{""src/testdir/test_vim9_script.vim"": {""insertions"": 27, ""deletions"": 0, ""lines"": 27}, ""src/userfunc.c"": {""insertions"": 48, ""deletions"": 7, ""lines"": 55}, ""src/version.c"": {""insertions"": 2, ""deletions"": 0, ""lines"": 2}}"
2021-10-22 19:56:55,841c225b9ef8c5bdf5e02968a0bd62521fff6ca8,Bram Moolenaar,41,6,47,4,"{""src/diff.c"": {""insertions"": 16, ""deletions"": 6, ""lines"": 22}, ""src/testdir/dumps/Test_diff_scroll_change_03.dump"": {""insertions"": 20, ""deletions"": 0, ""lines"": 20}, ""src/testdir/test_diffmode.vim"": {""insertions"": 3, ""deletions"": 0, ""lines"": 3}, ""src/version.c"": {""insertions"": 2, ""deletions"": 0, ""lines"": 2}}"
2021-10-22 17:56:39,25def2c8b8bd7b0c3d5f020207c717a880b05d50,=?UTF-8?q?Magnus=20Gro=C3=9F?=,82,22,104,8,"{""runtime/doc/autocmd.txt"": {""insertions"": 9, ""deletions"": 4, ""lines"": 13}, ""src/autocmd.c"": {""insertions"": 17, ""deletions"": 0, ""lines"": 17}, ""src/insexpand.c"": {""insertions"": 7, ""deletions"": 0, ""lines"": 7}, ""src/misc1.c"": {""insertions"": 8, ""deletions"": 3, ""lines"": 11}, ""src/normal.c"": {""insertions"": 6, ""deletions"": 1, ""lines"": 7}, ""src/terminal.c"": {""insertions"": 1, ""deletions"": 0, ""lines"": 1}, ""src/testdir/test_edit.vim"": {""insertions"": 32, ""deletions"": 14, ""lines"": 46}, ""src/version.c"": {""insertions"": 2, ""deletions"": 0, ""lines"": 2}}"
2021-10-22 14:55:31,a2ffb435209716dc7aeb4783333f6ea19f5d28a7,DungSaga,48,62,110,2,"{""src/version.c"": {""insertions"": 2, ""deletions"": 0, ""lines"": 2}, ""src/xxd/xxd.c"": {""insertions"": 46, ""deletions"": 62, ""lines"": 108}}"
2021-10-22 14:11:37,5a5c111e79d1ea4b24133eaf44deab42a8e78eed,Bram Moolenaar,16,7,23,2,"{""src/testdir/test_xxd.vim"": {""insertions"": 14, ""deletions"": 7, ""lines"": 21}, ""src/version.c"": {""insertions"": 2, ""deletions"": 0, ""lines"": 2}}"
2021-10-22 11:55:42,47810464aa4f9edbf222c02a860a3ec560b0b7a1,DungSaga,45,7,52,3,"{""src/testdir/test_xxd.vim"": {""insertions"": 33, ""deletions"": 0, ""lines"": 33}, ""src/version.c"": {""insertions"": 2, ""deletions"": 0, ""lines"": 2}, ""src/xxd/xxd.c"": {""insertions"": 10, ""deletions"": 7, ""lines"": 17}}"
2021-10-21 17:01:13,94e7d345c156a722bb161b73238c4ba1d27ec586,itchyny,3,1,4,2,"{""src/misc1.c"": {""insertions"": 1, ""deletions"": 1, ""lines"": 2}, ""src/version.c"": {""insertions"": 2, ""deletions"": 0, ""lines"": 2}}"
2021-10-21 10:39:53,ae38a9db7770b38889fbf06908cc69d42b463a73,Shougo Matsushita,19,1,20,3,"{""src/cmdexpand.c"": {""insertions"": 2, ""deletions"": 1, ""lines"": 3}, ""src/testdir/test_cmdline.vim"": {""insertions"": 15, ""deletions"": 0, ""lines"": 15}, ""src/version.c"": {""insertions"": 2, ""deletions"": 0, ""lines"": 2}}"
2021-10-21 09:50:44,b811de5d49a23b20df82a80533d0602cda49029e,zeertzjq,20,18,38,2,"{""src/testdir/test_autocmd.vim"": {""insertions"": 18, ""deletions"": 18, ""lines"": 36}, ""src/version.c"": {""insertions"": 2, ""deletions"": 0, ""lines"": 2}}"
2021-10-20 22:08:11,d68a0044858d00de6100def1e389a3a9c1cdbcdc,Bram Moolenaar,32,4,36,3,"{""src/gui_gtk_x11.c"": {""insertions"": 8, ""deletions"": 4, ""lines"": 12}, ""src/testdir/test_gui.vim"": {""insertions"": 22, ""deletions"": 0, ""lines"": 22}, ""src/version.c"": {""insertions"": 2, ""deletions"": 0, ""lines"": 2}}"
2021-10-20 20:58:42,1d30fde3c989a962e0e1af4cbcf90e1ea483f1f4,Bram Moolenaar,36,9,45,6,"{""src/buffer.c"": {""insertions"": 4, ""deletions"": 3, ""lines"": 7}, ""src/ex_cmds.c"": {""insertions"": 8, ""deletions"": 4, ""lines"": 12}, ""src/quickfix.c"": {""insertions"": 3, ""deletions"": 2, ""lines"": 5}, ""src/testdir/test_quickfix.vim"": {""insertions"": 17, ""deletions"": 0, ""lines"": 17}, ""src/version.c"": {""insertions"": 2, ""deletions"": 0, ""lines"": 2}, ""src/vim.h"": {""insertions"": 2, ""deletions"": 0, ""lines"": 2}}"
2021-10-20 16:21:24,09f7723d5a8694889350b13e3f6b4a9c3ed4c41f,zeertzjq,4,0,4,2,"{""src/errors.h"": {""insertions"": 2, ""deletions"": 0, ""lines"": 2}, ""src/version.c"": {""insertions"": 2, ""deletions"": 0, ""lines"": 2}}"
2021-10-20 10:01:15,94358a1e6e640ca5ebeb295efdddd4e92b700673,zeertzjq,56,3,59,6,"{""runtime/doc/eval.txt"": {""insertions"": 3, ""deletions"": 0, ""lines"": 3}, ""src/errors.h"": {""insertions"": 4, ""deletions"": 0, ""lines"": 4}, ""src/mbyte.c"": {""insertions"": 35, ""deletions"": 1, ""lines"": 36}, ""src/optionstr.c"": {""insertions"": 2, ""deletions"": 2, ""lines"": 4}, ""src/testdir/test_utf8.vim"": {""insertions"": 10, ""deletions"": 0, ""lines"": 10}, ""src/version.c"": {""insertions"": 2, ""deletions"": 0, ""lines"": 2}}"
2021-10-20 09:00:05,051a40c8d91d4595c69a27375f739367d806a475,itchyny,6,1,7,2,"{""src/os_unix.c"": {""insertions"": 4, ""deletions"": 1, ""lines"": 5}, ""src/version.c"": {""insertions"": 2, ""deletions"": 0, ""lines"": 2}}"
2021-10-19 21:12:25,8b0e62c93b6dad5ec5b2c7558d4f7b78c46216d2,Bram Moolenaar,8,2,10,3,"{""src/memline.c"": {""insertions"": 5, ""deletions"": 1, ""lines"": 6}, ""src/testdir/test_swap.vim"": {""insertions"": 1, ""deletions"": 1, ""lines"": 2}, ""src/version.c"": {""insertions"": 2, ""deletions"": 0, ""lines"": 2}}"
2021-10-19 19:48:52,c5935a859ee31d56a565878d7a231fc59b7ddc01,Bram Moolenaar,63,102,165,2,"{""src/buffer.c"": {""insertions"": 61, ""deletions"": 102, ""lines"": 163}, ""src/version.c"": {""insertions"": 2, ""deletions"": 0, ""lines"": 2}}"
2021-10-19 19:24:34,731fba1081079d5c0251fca2626043ce6e86b1f2,Bram Moolenaar,6,0,6,2,"{""src/highlight.c"": {""insertions"": 4, ""deletions"": 0, ""lines"": 4}, ""src/version.c"": {""insertions"": 2, ""deletions"": 0, ""lines"": 2}}"
2021-10-19 19:08:45,f47ebf1e1a0a6473b10fb4c92c9c6427aab4dc91,Bram Moolenaar,15,1,16,3,"{""src/register.c"": {""insertions"": 1, ""deletions"": 1, ""lines"": 2}, ""src/testdir/test_put.vim"": {""insertions"": 12, ""deletions"": 0, ""lines"": 12}, ""src/version.c"": {""insertions"": 2, ""deletions"": 0, ""lines"": 2}}"
2021-10-19 13:22:03,604e207e277767a67cbf4a6a179080efb830b9e7,Bram Moolenaar,7,0,7,2,"{""src/gui_gtk.c"": {""insertions"": 5, ""deletions"": 0, ""lines"": 5}, ""src/version.c"": {""insertions"": 2, ""deletions"": 0, ""lines"": 2}}"
2021-10-19 12:44:52,d43d8e28db9afe693002a39e003ba1ece1a8319a,Yegappan Lakshmanan,8,4,12,2,"{""src/highlight.c"": {""insertions"": 6, ""deletions"": 4, ""lines"": 10}, ""src/version.c"": {""insertions"": 2, ""deletions"": 0, ""lines"": 2}}"
2021-10-19 10:15:41,75c30e96cf280a8cc01ac01c41a9252db3e503cc,naohiro ono,23,0,23,3,"{""src/ops.c"": {""insertions"": 5, ""deletions"": 0, ""lines"": 5}, ""src/testdir/test_functions.vim"": {""insertions"": 16, ""deletions"": 0, ""lines"": 16}, ""src/version.c"": {""insertions"": 2, ""deletions"": 0, ""lines"": 2}}"
2021-10-18 21:13:57,ad6b90c33cc239794a6694ef53e8baeee2ed97bd,Yegappan Lakshmanan,932,787,1719,2,"{""src/highlight.c"": {""insertions"": 930, ""deletions"": 787, ""lines"": 1717}, ""src/version.c"": {""insertions"": 2, ""deletions"": 0, ""lines"": 2}}"
2021-10-18 19:56:39,9b0b844d252ea84b3607f39603b4afa8cb002418,Dominique Pelle,7,3,10,2,"{""src/drawscreen.c"": {""insertions"": 5, ""deletions"": 3, ""lines"": 8}, ""src/version.c"": {""insertions"": 2, ""deletions"": 0, ""lines"": 2}}"
2021-10-18 13:37:13,944eeb44fb6e9d6d28474a1348d27c07873892f9,Bram Moolenaar,4,1,5,2,"{""src/testdir/test_stat.vim"": {""insertions"": 2, ""deletions"": 1, ""lines"": 3}, ""src/version.c"": {""insertions"": 2, ""deletions"": 0, ""lines"": 2}}"
2021-10-18 12:16:03,375c35a63fdb91e8db2a9965f94d56ae87135fff,DungSaga,8,11,19,2,"{""src/version.c"": {""insertions"": 2, ""deletions"": 0, ""lines"": 2}, ""src/xxd/xxd.c"": {""insertions"": 6, ""deletions"": 11, ""lines"": 17}}"
2021-10-17 20:53:58,e08aee60abc59f517d3e263fdb9ba4a0196d507c,Bram Moolenaar,13,3,16,3,"{""src/mark.c"": {""insertions"": 1, ""deletions"": 3, ""lines"": 4}, ""src/testdir/test_marks.vim"": {""insertions"": 10, ""deletions"": 0, ""lines"": 10}, ""src/version.c"": {""insertions"": 2, ""deletions"": 0, ""lines"": 2}}"
2021-10-17 17:05:26,39c47c310487b72bc78ff197b5a068a0bcf830de,Bram Moolenaar,9,4,13,2,"{""src/testdir/test_cmdline.vim"": {""insertions"": 7, ""deletions"": 4, ""lines"": 11}, ""src/version.c"": {""insertions"": 2, ""deletions"": 0, ""lines"": 2}}"
2021-10-17 16:20:23,21c1a0c2f10575dbb72fa873d33f0c1f6e170aa7,Bram Moolenaar,38,15,53,11,"{""src/cmdexpand.c"": {""insertions"": 5, ""deletions"": 2, ""lines"": 7}, ""src/evalfunc.c"": {""insertions"": 1, ""deletions"": 1, ""lines"": 2}, ""src/ex_getln.c"": {""insertions"": 12, ""deletions"": 7, ""lines"": 19}, ""src/normal.c"": {""insertions"": 1, ""deletions"": 1, ""lines"": 2}, ""src/proto/ex_getln.pro"": {""insertions"": 1, ""deletions"": 1, ""lines"": 2}, ""src/session.c"": {""insertions"": 1, ""deletions"": 1, ""lines"": 2}, ""src/terminal.c"": {""insertions"": 1, ""deletions"": 1, ""lines"": 2}, ""src/testdir/test_cmdline.vim"": {""insertions"": 6, ""deletions"": 0, ""lines"": 6}, ""src/version.c"": {""insertions"": 2, ""deletions"": 0, ""lines"": 2}, ""src/vim.h"": {""insertions"": 6, ""deletions"": 0, ""lines"": 6}, ""src/vim9execute.c"": {""insertions"": 2, ""deletions"": 1, ""lines"": 3}}"
2021-10-17 15:09:08,34a364877f0c726cdc0779e6999fded9ba959ebe,Atsushi SUGAWARA,3,1,4,2,"{""src/version.c"": {""insertions"": 2, ""deletions"": 0, ""lines"": 2}, ""src/xxd/xxd.c"": {""insertions"": 1, ""deletions"": 1, ""lines"": 2}}"
2021-10-17 13:13:09,f4d8b76d304dabc39c06d2344cd4c7b28484811b,Bram Moolenaar,109,51,160,9,"{""runtime/doc/insert.txt"": {""insertions"": 58, ""deletions"": 16, ""lines"": 74}, ""runtime/doc/options.txt"": {""insertions"": 12, ""deletions"": 19, ""lines"": 31}, ""src/insexpand.c"": {""insertions"": 4, ""deletions"": 5, ""lines"": 9}, ""src/option.c"": {""insertions"": 15, ""deletions"": 3, ""lines"": 18}, ""src/option.h"": {""insertions"": 2, ""deletions"": 2, ""lines"": 4}, ""src/optiondefs.h"": {""insertions"": 2, ""deletions"": 2, ""lines"": 4}, ""src/structs.h"": {""insertions"": 3, ""deletions"": 1, ""lines"": 4}, ""src/testdir/test_edit.vim"": {""insertions"": 11, ""deletions"": 3, ""lines"": 14}, ""src/version.c"": {""insertions"": 2, ""deletions"": 0, ""lines"": 2}}"
2021-10-17 10:33:47,9d4b8caf9eddb2db09395587c621309f4513befa,Bram Moolenaar,4,1,5,2,"{""src/gui_gtk_x11.c"": {""insertions"": 2, ""deletions"": 1, ""lines"": 3}, ""src/version.c"": {""insertions"": 2, ""deletions"": 0, ""lines"": 2}}"
2021-10-16 20:58:27,40bd5a15405206b130d487af0ca61b5d9b5859f8,Bram Moolenaar,99,150,249,5,"{""src/testdir/check.vim"": {""insertions"": 8, ""deletions"": 0, ""lines"": 8}, ""src/testdir/setup_gui.vim"": {""insertions"": 0, ""deletions"": 1, ""lines"": 1}, ""src/testdir/test_gui.vim"": {""insertions"": 79, ""deletions"": 123, ""lines"": 202}, ""src/testdir/test_gui_init.vim"": {""insertions"": 10, ""deletions"": 26, ""lines"": 36}, ""src/version.c"": {""insertions"": 2, ""deletions"": 0, ""lines"": 2}}"
2021-10-16 20:14:11,d4c4bfa0078a959ff90ef30288fd31d9d38f23d7,Bram Moolenaar,11,9,20,6,"{""src/buffer.c"": {""insertions"": 1, ""deletions"": 1, ""lines"": 2}, ""src/insexpand.c"": {""insertions"": 4, ""deletions"": 4, ""lines"": 8}, ""src/option.c"": {""insertions"": 2, ""deletions"": 2, ""lines"": 4}, ""src/optionstr.c"": {""insertions"": 1, ""deletions"": 1, ""lines"": 2}, ""src/structs.h"": {""insertions"": 1, ""deletions"": 1, ""lines"": 2}, ""src/version.c"": {""insertions"": 2, ""deletions"": 0, ""lines"": 2}}"
2021-10-16 19:52:05,4eeedc09fed0cbbb3ba48317e0a01e20cd0b4f80,Dusan Popovic,239,14,253,12,"{""runtime/doc/options.txt"": {""insertions"": 12, ""deletions"": 0, ""lines"": 12}, ""src/errors.h"": {""insertions"": 2, ""deletions"": 0, ""lines"": 2}, ""src/gui.c"": {""insertions"": 34, ""deletions"": 0, ""lines"": 34}, ""src/gui.h"": {""insertions"": 3, ""deletions"": 0, ""lines"": 3}, ""src/gui_gtk_x11.c"": {""insertions"": 136, ""deletions"": 14, ""lines"": 150}, ""src/option.h"": {""insertions"": 3, ""deletions"": 0, ""lines"": 3}, ""src/optiondefs.h"": {""insertions"": 13, ""deletions"": 0, ""lines"": 13}, ""src/optionstr.c"": {""insertions"": 7, ""deletions"": 0, ""lines"": 7}, ""src/proto/gui.pro"": {""insertions"": 1, ""deletions"": 0, ""lines"": 1}, ""src/proto/gui_gtk_x11.pro"": {""insertions"": 1, ""deletions"": 0, ""lines"": 1}, ""src/testdir/test_gui.vim"": {""insertions"": 25, ""deletions"": 0, ""lines"": 25}, ""src/version.c"": {""insertions"": 2, ""deletions"": 0, ""lines"": 2}}"
2021-10-16 18:07:46,c89c91cafd91fbf17f431d800bbf4cafcffffe7a,DungSaga,6,8,14,2,"{""src/version.c"": {""insertions"": 2, ""deletions"": 0, ""lines"": 2}, ""src/xxd/xxd.c"": {""insertions"": 4, ""deletions"": 8, ""lines"": 12}}"
2021-10-16 16:51:40,93ff6720fe4427341bc426b6d46e6324f226c270,Bram Moolenaar,47,8,55,5,"{""runtime/doc/options.txt"": {""insertions"": 7, ""deletions"": 0, ""lines"": 7}, ""src/charset.c"": {""insertions"": 0, ""deletions"": 3, ""lines"": 3}, ""src/screen.c"": {""insertions"": 34, ""deletions"": 5, ""lines"": 39}, ""src/testdir/test_listchars.vim"": {""insertions"": 4, ""deletions"": 0, ""lines"": 4}, ""src/version.c"": {""insertions"": 2, ""deletions"": 0, ""lines"": 2}}"
2021-10-16 15:48:27,abdcfd1c837e244065d4fe04c7a78abae5af3f7e,Bram Moolenaar,3,1,4,2,"{""src/testdir/test_options.vim"": {""insertions"": 1, ""deletions"": 1, ""lines"": 2}, ""src/version.c"": {""insertions"": 2, ""deletions"": 0, ""lines"": 2}}"
2021-10-16 14:41:29,160e994d768d03a3c826b58115cde94df8fce607,Yegappan Lakshmanan,138,8,146,12,"{""runtime/doc/insert.txt"": {""insertions"": 7, ""deletions"": 1, ""lines"": 8}, ""runtime/doc/options.txt"": {""insertions"": 12, ""deletions"": 0, ""lines"": 12}, ""runtime/doc/quickref.txt"": {""insertions"": 1, ""deletions"": 0, ""lines"": 1}, ""src/buffer.c"": {""insertions"": 1, ""deletions"": 0, ""lines"": 1}, ""src/insexpand.c"": {""insertions"": 52, ""deletions"": 7, ""lines"": 59}, ""src/option.c"": {""insertions"": 3, ""deletions"": 0, ""lines"": 3}, ""src/option.h"": {""insertions"": 4, ""deletions"": 0, ""lines"": 4}, ""src/optiondefs.h"": {""insertions"": 12, ""deletions"": 0, ""lines"": 12}, ""src/optionstr.c"": {""insertions"": 1, ""deletions"": 0, ""lines"": 1}, ""src/structs.h"": {""insertions"": 1, ""deletions"": 0, ""lines"": 1}, ""src/testdir/test_edit.vim"": {""insertions"": 42, ""deletions"": 0, ""lines"": 42}, ""src/version.c"": {""insertions"": 2, ""deletions"": 0, ""lines"": 2}}"
2021-10-16 14:23:36,2286304cdbba53ceb52b3ba2ba4a521b0a2f8d0f,Bram Moolenaar,413,240,653,26,"{"".github/CODEOWNERS"": {""insertions"": 6, ""deletions"": 0, ""lines"": 6}, ""runtime/doc/autocmd.txt"": {""insertions"": 5, ""deletions"": 5, ""lines"": 10}, ""runtime/doc/change.txt"": {""insertions"": 3, ""deletions"": 3, ""lines"": 6}, ""runtime/doc/cmdline.txt"": {""insertions"": 1, ""deletions"": 1, ""lines"": 2}, ""runtime/doc/digraph.txt"": {""insertions"": 2, ""deletions"": 2, ""lines"": 4}, ""runtime/doc/editing.txt"": {""insertions"": 14, ""deletions"": 9, ""lines"": 23}, ""runtime/doc/eval.txt"": {""insertions"": 2, ""deletions"": 2, ""lines"": 4}, ""runtime/doc/help.txt"": {""insertions"": 1, ""deletions"": 0, ""lines"": 1}, ""runtime/doc/options.txt"": {""insertions"": 3, ""deletions"": 3, ""lines"": 6}, ""runtime/doc/pattern.txt"": {""insertions"": 8, ""deletions"": 9, ""lines"": 17}, ""runtime/doc/testing.txt"": {""insertions"": 4, ""deletions"": 4, ""lines"": 8}, ""runtime/doc/todo.txt"": {""insertions"": 26, ""deletions"": 22, ""lines"": 48}, ""runtime/doc/various.txt"": {""insertions"": 1, ""deletions"": 1, ""lines"": 2}, ""runtime/doc/vim9.txt"": {""insertions"": 10, ""deletions"": 10, ""lines"": 20}, ""runtime/ftplugin/context.vim"": {""insertions"": 41, ""deletions"": 26, ""lines"": 67}, ""runtime/ftplugin/csh.vim"": {""insertions"": 26, ""deletions"": 23, ""lines"": 49}, ""runtime/ftplugin/tcsh.vim"": {""insertions"": 8, ""deletions"": 13, ""lines"": 21}, ""runtime/ftplugin/tmux.vim"": {""insertions"": 3, ""deletions"": 0, ""lines"": 3}, ""runtime/ftplugin/toml.vim"": {""insertions"": 23, ""deletions"": 0, ""lines"": 23}, ""runtime/indent/hamster.vim"": {""insertions"": 18, ""deletions"": 3, ""lines"": 21}, ""runtime/indent/sqlanywhere.vim"": {""insertions"": 11, ""deletions"": 11, ""lines"": 22}, ""runtime/indent/tcsh.vim"": {""insertions"": 8, ""deletions"": 5, ""lines"": 13}, ""runtime/syntax/css.vim"": {""insertions"": 17, ""deletions"": 10, ""lines"": 27}, ""runtime/syntax/tcsh.vim"": {""insertions"": 36, ""deletions"": 30, ""lines"": 66}, ""runtime/syntax/tmux.vim"": {""insertions"": 55, ""deletions"": 48, ""lines"": 103}, ""runtime/syntax/toml.vim"": {""insertions"": 81, ""deletions"": 0, ""lines"": 81}}"
2021-10-16 12:44:04,28b6a3bef6d25d36c049bb731ced496155f7f9c0,Aman Verma,7,3,10,3,"{""runtime/filetype.vim"": {""insertions"": 3, ""deletions"": 1, ""lines"": 4}, ""src/testdir/test_filetype.vim"": {""insertions"": 2, ""deletions"": 2, ""lines"": 4}, ""src/version.c"": {""insertions"": 2, ""deletions"": 0, ""lines"": 2}}"
2021-10-16 12:00:14,f08b0eb8691ff09f98bc4beef986ece1c521655f,Bram Moolenaar,38,39,77,16,"{""src/testdir/runtest.vim"": {""insertions"": 1, ""deletions"": 38, ""lines"": 39}, ""src/testdir/test_autocmd.vim"": {""insertions"": 3, ""deletions"": 0, ""lines"": 3}, ""src/testdir/test_channel.vim"": {""insertions"": 7, ""deletions"": 0, ""lines"": 7}, ""src/testdir/test_clientserver.vim"": {""insertions"": 1, ""deletions"": 0, ""lines"": 1}, ""src/testdir/test_diffmode.vim"": {""insertions"": 1, ""deletions"": 0, ""lines"": 1}, ""src/testdir/test_functions.vim"": {""insertions"": 1, ""deletions"": 0, ""lines"": 1}, ""src/testdir/test_gui.vim"": {""insertions"": 1, ""deletions"": 0, ""lines"": 1}, ""src/testdir/test_mapping.vim"": {""insertions"": 2, ""deletions"": 1, ""lines"": 3}, ""src/testdir/test_paste.vim"": {""insertions"": 2, ""deletions"": 0, ""lines"": 2}, ""src/testdir/test_popup.vim"": {""insertions"": 1, ""deletions"": 0, ""lines"": 1}, ""src/testdir/test_quotestar.vim"": {""insertions"": 1, ""deletions"": 0, ""lines"": 1}, ""src/testdir/test_reltime.vim"": {""insertions"": 1, ""deletions"": 0, ""lines"": 1}, ""src/testdir/test_terminal.vim"": {""insertions"": 4, ""deletions"": 0, ""lines"": 4}, ""src/testdir/test_terminal2.vim"": {""insertions"": 2, ""deletions"": 0, ""lines"": 2}, ""src/testdir/test_timers.vim"": {""insertions"": 8, ""deletions"": 0, ""lines"": 8}, ""src/version.c"": {""insertions"": 2, ""deletions"": 0, ""lines"": 2}}"
2021-10-16 10:58:55,db3b44640d69ab27270691a3cab8d83cc93a0861,Christian Brabandt,52,11,63,6,"{""src/buffer.c"": {""insertions"": 1, ""deletions"": 0, ""lines"": 1}, ""src/bufwrite.c"": {""insertions"": 2, ""deletions"": 2, ""lines"": 4}, ""src/edit.c"": {""insertions"": 6, ""deletions"": 6, ""lines"": 12}, ""src/structs.h"": {""insertions"": 3, ""deletions"": 3, ""lines"": 6}, ""src/testdir/test_autocmd.vim"": {""insertions"": 38, ""deletions"": 0, ""lines"": 38}, ""src/version.c"": {""insertions"": 2, ""deletions"": 0, ""lines"": 2}}"
2021-10-15 21:25:43,7b5f45be2197403d631b5a3d633f6a20afdf806e,Milly,44,100,144,5,"{""runtime/doc/terminal.txt"": {""insertions"": 0, ""deletions"": 3, ""lines"": 3}, ""src/highlight.c"": {""insertions"": 0, ""deletions"": 12, ""lines"": 12}, ""src/proto/terminal.pro"": {""insertions"": 0, ""deletions"": 1, ""lines"": 1}, ""src/terminal.c"": {""insertions"": 42, ""deletions"": 84, ""lines"": 126}, ""src/version.c"": {""insertions"": 2, ""deletions"": 0, ""lines"": 2}}"
2021-10-15 16:23:12,def69dffb3d09a69629b071c89b7893a1783ba53,ichizok,12,9,21,2,"{""src/fileio.c"": {""insertions"": 10, ""deletions"": 9, ""lines"": 19}, ""src/version.c"": {""insertions"": 2, ""deletions"": 0, ""lines"": 2}}"
2021-10-15 16:09:50,eaa006dae3d5730e3b6dead27905444998b2cf8e,Bram Moolenaar,7,3,10,2,"{""src/testdir/test_stat.vim"": {""insertions"": 5, ""deletions"": 3, ""lines"": 8}, ""src/version.c"": {""insertions"": 2, ""deletions"": 0, ""lines"": 2}}"
2021-10-15 11:51:29,a2cff1dbc9c58758977eba3034603e6fe459031b,Bram Moolenaar,15,32,47,2,"{""src/search.c"": {""insertions"": 13, ""deletions"": 32, ""lines"": 45}, ""src/version.c"": {""insertions"": 2, ""deletions"": 0, ""lines"": 2}}"
2021-10-14 23:38:02,accf4ed352c07ffe59022377c42d36e12dd6d461,Bram Moolenaar,3,0,3,2,"{""src/testdir/test_stat.vim"": {""insertions"": 1, ""deletions"": 0, ""lines"": 1}, ""src/version.c"": {""insertions"": 2, ""deletions"": 0, ""lines"": 2}}"
2021-10-14 23:18:37,a06758dd38851f022d270dd5102efbe1049d4712,Bram Moolenaar,8,4,12,3,"{""src/evalvars.c"": {""insertions"": 3, ""deletions"": 2, ""lines"": 5}, ""src/version.c"": {""insertions"": 2, ""deletions"": 0, ""lines"": 2}, ""src/vim9script.c"": {""insertions"": 3, ""deletions"": 2, ""lines"": 5}}"
2021-10-14 20:27:55,0a7984af5601323fae7b3398f05a48087db7b767,Leah Neukirchen,151,6,157,13,"{""runtime/doc/eval.txt"": {""insertions"": 1, ""deletions"": 0, ""lines"": 1}, ""src/auto/configure"": {""insertions"": 46, ""deletions"": 0, ""lines"": 46}, ""src/bufwrite.c"": {""insertions"": 2, ""deletions"": 1, ""lines"": 3}, ""src/config.h.in"": {""insertions"": 3, ""deletions"": 0, ""lines"": 3}, ""src/configure.ac"": {""insertions"": 25, ""deletions"": 0, ""lines"": 25}, ""src/evalfunc.c"": {""insertions"": 7, ""deletions"": 0, ""lines"": 7}, ""src/fileio.c"": {""insertions"": 20, ""deletions"": 4, ""lines"": 24}, ""src/memline.c"": {""insertions"": 6, ""deletions"": 0, ""lines"": 6}, ""src/netbeans.c"": {""insertions"": 3, ""deletions"": 0, ""lines"": 3}, ""src/proto/fileio.pro"": {""insertions"": 1, ""deletions"": 1, ""lines"": 2}, ""src/structs.h"": {""insertions"": 2, ""deletions"": 0, ""lines"": 2}, ""src/testdir/test_stat.vim"": {""insertions"": 33, ""deletions"": 0, ""lines"": 33}, ""src/version.c"": {""insertions"": 2, ""deletions"": 0, ""lines"": 2}}"
2021-10-14 16:52:23,340dd0fbe462a15a9678cfba02085b4adcc45f02,Bram Moolenaar,9,2,11,3,"{""runtime/doc/options.txt"": {""insertions"": 2, ""deletions"": 2, ""lines"": 4}, ""src/undo.c"": {""insertions"": 5, ""deletions"": 0, ""lines"": 5}, ""src/version.c"": {""insertions"": 2, ""deletions"": 0, ""lines"": 2}}"
2021-10-14 15:53:42,051a8a375f8fb6a931fbc5ccca714a200d9b327f,Bram Moolenaar,10,0,10,2,"{""src/testdir/test_vim9_cmd.vim"": {""insertions"": 8, ""deletions"": 0, ""lines"": 8}, ""src/version.c"": {""insertions"": 2, ""deletions"": 0, ""lines"": 2}}"
2021-10-14 15:27:19,75aa92a16264e3511ba41aa306ffc1ffbbd2fe3a,Bram Moolenaar,10,8,18,2,"{""src/Makefile"": {""insertions"": 8, ""deletions"": 8, ""lines"": 16}, ""src/version.c"": {""insertions"": 2, ""deletions"": 0, ""lines"": 2}}"
2021-10-13 20:17:05,c0abac67d7a9cccf836bbda002ec72914e3cb3d7,Bram Moolenaar,26,0,26,2,"{""src/testdir/test_vim9_cmd.vim"": {""insertions"": 24, ""deletions"": 0, ""lines"": 24}, ""src/version.c"": {""insertions"": 2, ""deletions"": 0, ""lines"": 2}}"
2021-10-13 14:37:15,3be69bf539f3026369d20f1667e53d390d386a9f,Bram Moolenaar,6,0,6,2,"{""src/ex_cmds.c"": {""insertions"": 4, ""deletions"": 0, ""lines"": 4}, ""src/version.c"": {""insertions"": 2, ""deletions"": 0, ""lines"": 2}}"
2021-10-13 14:28:28,7f32092b9127a71d243bacd31ebb303f2c78a8f1,Bram Moolenaar,3,1,4,2,"{""src/version.c"": {""insertions"": 2, ""deletions"": 0, ""lines"": 2}, ""src/vim9compile.c"": {""insertions"": 1, ""deletions"": 1, ""lines"": 2}}"
2021-10-13 14:04:34,7b829268921e8fc1c63c34d245063c1c4e7d21af,Bram Moolenaar,111,1,112,8,"{""runtime/doc/vim9.txt"": {""insertions"": 14, ""deletions"": 1, ""lines"": 15}, ""src/errors.h"": {""insertions"": 4, ""deletions"": 0, ""lines"": 4}, ""src/ex_cmds.c"": {""insertions"": 6, ""deletions"": 0, ""lines"": 6}, ""src/ex_docmd.c"": {""insertions"": 9, ""deletions"": 0, ""lines"": 9}, ""src/proto/vim9compile.pro"": {""insertions"": 1, ""deletions"": 0, ""lines"": 1}, ""src/testdir/test_vim9_cmd.vim"": {""insertions"": 49, ""deletions"": 0, ""lines"": 49}, ""src/version.c"": {""insertions"": 2, ""deletions"": 0, ""lines"": 2}, ""src/vim9compile.c"": {""insertions"": 26, ""deletions"": 0, ""lines"": 26}}"
2021-10-13 09:05:30,fff10d9a76099aa9b944f3c33a911127ca1a0c72,Bram Moolenaar,7,0,7,2,"{""src/os_unix.c"": {""insertions"": 5, ""deletions"": 0, ""lines"": 5}, ""src/version.c"": {""insertions"": 2, ""deletions"": 0, ""lines"": 2}}"
2021-10-12 12:58:23,e519eb41c1c12836b2d12aeb703bb04c7618a724,Eric Pruitt,6,1,7,3,"{""runtime/filetype.vim"": {""insertions"": 3, ""deletions"": 0, ""lines"": 3}, ""src/testdir/test_filetype.vim"": {""insertions"": 1, ""deletions"": 1, ""lines"": 2}, ""src/version.c"": {""insertions"": 2, ""deletions"": 0, ""lines"": 2}}"
2021-10-12 11:02:49,3a724290c5dd8e4b7c9a1fa8941b81f6f80db00a,Christian Brabandt,3,1,4,2,"{"".github/workflows/ci.yml"": {""insertions"": 1, ""deletions"": 1, ""lines"": 2}, ""src/version.c"": {""insertions"": 2, ""deletions"": 0, ""lines"": 2}}"
2021-10-11 21:57:34,3d031a0ae791f901c0c2dedd5d8b9de137c23acc,Bram Moolenaar,7,5,12,2,"{""src/testdir/test_startup.vim"": {""insertions"": 5, ""deletions"": 5, ""lines"": 10}, ""src/version.c"": {""insertions"": 2, ""deletions"": 0, ""lines"": 2}}"
2021-10-11 20:04:37,37f341d7236ff8a1e886bbb0f0ba0700ad589373,James McCoy,7,3,10,2,"{""src/testdir/test_recover.vim"": {""insertions"": 5, ""deletions"": 3, ""lines"": 8}, ""src/version.c"": {""insertions"": 2, ""deletions"": 0, ""lines"": 2}}"
2021-10-11 19:26:55,a9173d06f7ca320fc84f4ffa993861d21710bc41,Dominique Pelle,4,0,4,2,"{""src/testdir/test_put.vim"": {""insertions"": 2, ""deletions"": 0, ""lines"": 2}, ""src/version.c"": {""insertions"": 2, ""deletions"": 0, ""lines"": 2}}"
2021-10-11 15:27:03,a5d4f3b09d25006f7bc988d618152bd34177a579,James McCoy,13,1,14,2,"{""src/testdir/test_crypt.vim"": {""insertions"": 11, ""deletions"": 1, ""lines"": 12}, ""src/version.c"": {""insertions"": 2, ""deletions"": 0, ""lines"": 2}}"
2021-10-11 15:08:32,b376aa2da4211fee7eaf16450bb8b37674e45bb0,Bram Moolenaar,10,1,11,2,"{""src/testdir/test_startup.vim"": {""insertions"": 8, ""deletions"": 1, ""lines"": 9}, ""src/version.c"": {""insertions"": 2, ""deletions"": 0, ""lines"": 2}}"
2021-10-11 14:40:43,b07626d4afa73dd2af0f03c0d59eed25ee159ef9,Bram Moolenaar,23,2,25,3,"{""src/normal.c"": {""insertions"": 1, ""deletions"": 2, ""lines"": 3}, ""src/testdir/test_visual.vim"": {""insertions"": 20, ""deletions"": 0, ""lines"": 20}, ""src/version.c"": {""insertions"": 2, ""deletions"": 0, ""lines"": 2}}"
2021-10-10 12:54:01,cddd5ac911707034ca27f10037c4b1b523188c47,Bram Moolenaar,6,1,7,2,"{""src/testdir/test_put.vim"": {""insertions"": 4, ""deletions"": 1, ""lines"": 5}, ""src/version.c"": {""insertions"": 2, ""deletions"": 0, ""lines"": 2}}"
2021-10-10 11:35:17,eeed1c7ae090c17f4df51cf97b2a9e4d8b4f4dc7,Bram Moolenaar,21,2,23,4,"{""src/errors.h"": {""insertions"": 2, ""deletions"": 0, ""lines"": 2}, ""src/register.c"": {""insertions"": 9, ""deletions"": 2, ""lines"": 11}, ""src/testdir/test_put.vim"": {""insertions"": 8, ""deletions"": 0, ""lines"": 8}, ""src/version.c"": {""insertions"": 2, ""deletions"": 0, ""lines"": 2}}"
2021-10-09 15:29:43,6e77b88df6371356cce9d6e08daf0f7cb1e7878a,Bram Moolenaar,16,1,17,2,"{""src/testdir/test_filetype.vim"": {""insertions"": 14, ""deletions"": 1, ""lines"": 15}, ""src/version.c"": {""insertions"": 2, ""deletions"": 0, ""lines"": 2}}"
2021-10-09 14:39:25,3826c0513bc9370583be550c864358c7eeb5605a,=?UTF-8?q?Dundar=20G=C3=B6c?=,2,8,10,6,"{""src/buffer.c"": {""insertions"": 0, ""deletions"": 2, ""lines"": 2}, ""src/getchar.c"": {""insertions"": 0, ""deletions"": 1, ""lines"": 1}, ""src/memline.c"": {""insertions"": 0, ""deletions"": 2, ""lines"": 2}, ""src/move.c"": {""insertions"": 0, ""deletions"": 1, ""lines"": 1}, ""src/option.c"": {""insertions"": 0, ""deletions"": 2, ""lines"": 2}, ""src/version.c"": {""insertions"": 2, ""deletions"": 0, ""lines"": 2}}"
2021-10-09 12:58:55,35a319b77f897744eec1155b736e9372c9c5575f,Bram Moolenaar,20,2,22,3,"{""src/ex_docmd.c"": {""insertions"": 4, ""deletions"": 2, ""lines"": 6}, ""src/testdir/test_search.vim"": {""insertions"": 14, ""deletions"": 0, ""lines"": 14}, ""src/version.c"": {""insertions"": 2, ""deletions"": 0, ""lines"": 2}}"
2021-10-09 11:50:20,26190b27011c25caedf3b9308e47005722b3f946,snxx,49,34,83,3,"{"".github/ISSUE_TEMPLATE/bug_report.md"": {""insertions"": 0, ""deletions"": 34, ""lines"": 34}, "".github/ISSUE_TEMPLATE/bug_report.yml"": {""insertions"": 47, ""deletions"": 0, ""lines"": 47}, ""src/version.c"": {""insertions"": 2, ""deletions"": 0, ""lines"": 2}}"
2021-10-08 17:39:28,826bfe4bbd7594188e3d74d2539d9707b1c6a14b,Bram Moolenaar,17,5,22,3,"{""src/drawscreen.c"": {""insertions"": 5, ""deletions"": 5, ""lines"": 10}, ""src/testdir/test_statusline.vim"": {""insertions"": 10, ""deletions"": 0, ""lines"": 10}, ""src/version.c"": {""insertions"": 2, ""deletions"": 0, ""lines"": 2}}"
2021-10-06 21:08:11,cce81e9673fe8d056e8eef310d9919620eccb2f2,Bram Moolenaar,30,2,32,3,"{""src/ex_eval.c"": {""insertions"": 8, ""deletions"": 2, ""lines"": 10}, ""src/testdir/test_trycatch.vim"": {""insertions"": 20, ""deletions"": 0, ""lines"": 20}, ""src/version.c"": {""insertions"": 2, ""deletions"": 0, ""lines"": 2}}"
2021-10-06 18:39:16,edd7a476fbcba199dc0b026461917912c574c629,Zdenek Dohnal,3,1,4,2,"{""src/testdir/test_python3.vim"": {""insertions"": 1, ""deletions"": 1, ""lines"": 2}, ""src/version.c"": {""insertions"": 2, ""deletions"": 0, ""lines"": 2}}"
2021-10-06 12:41:07,e275ba4fc994474155fbafe8b87a6d3b477456ba,Bram Moolenaar,25,1,26,4,"{""src/clipboard.c"": {""insertions"": 2, ""deletions"": 1, ""lines"": 3}, ""src/spellsuggest.c"": {""insertions"": 5, ""deletions"": 0, ""lines"": 5}, ""src/testdir/test_spell_utf8.vim"": {""insertions"": 16, ""deletions"": 0, ""lines"": 16}, ""src/version.c"": {""insertions"": 2, ""deletions"": 0, ""lines"": 2}}"
2021-10-06 10:27:21,e2982d691186c8a9b16ecc8d831d2472088c8ed8,Bram Moolenaar,9,5,14,4,"{""src/auto/configure"": {""insertions"": 3, ""deletions"": 2, ""lines"": 5}, ""src/configure.ac"": {""insertions"": 3, ""deletions"": 2, ""lines"": 5}, ""src/memline.c"": {""insertions"": 1, ""deletions"": 1, ""lines"": 2}, ""src/version.c"": {""insertions"": 2, ""deletions"": 0, ""lines"": 2}}"
2021-10-05 20:58:53,78e0fa4cf4fcd563c0bc8c87afa54d4f5dc22020,Bram Moolenaar,11,2,13,3,"{""src/cindent.c"": {""insertions"": 2, ""deletions"": 2, ""lines"": 4}, ""src/testdir/test_cindent.vim"": {""insertions"": 7, ""deletions"": 0, ""lines"": 7}, ""src/version.c"": {""insertions"": 2, ""deletions"": 0, ""lines"": 2}}"
2021-10-05 18:44:04,2e258bd79f403bcccb1336bea70803957a83808f,James McCoy,11,3,14,3,"{"".github/workflows/ci.yml"": {""insertions"": 7, ""deletions"": 1, ""lines"": 8}, ""src/structs.h"": {""insertions"": 2, ""deletions"": 2, ""lines"": 4}, ""src/version.c"": {""insertions"": 2, ""deletions"": 0, ""lines"": 2}}"
2021-10-05 18:28:01,949de97da32d4fff28c569387e2ba8b3e311e64d,Dominique Pelle,18,7,25,2,"{""src/testdir/test_trycatch.vim"": {""insertions"": 16, ""deletions"": 7, ""lines"": 23}, ""src/version.c"": {""insertions"": 2, ""deletions"": 0, ""lines"": 2}}"
2021-10-05 18:19:35,7c25a7c0a129300d0632e5b99ccefdca9bf3ffa2,Bram Moolenaar,7,0,7,3,"{""src/misc2.c"": {""insertions"": 1, ""deletions"": 0, ""lines"": 1}, ""src/testdir/test_channel.vim"": {""insertions"": 4, ""deletions"": 0, ""lines"": 4}, ""src/version.c"": {""insertions"": 2, ""deletions"": 0, ""lines"": 2}}"
2021-10-05 10:22:27,f67d3fb7363ebc9454f9bb582de3978609a4fd6b,Bram Moolenaar,11,4,15,3,"{""src/ex_eval.c"": {""insertions"": 5, ""deletions"": 1, ""lines"": 6}, ""src/structs.h"": {""insertions"": 4, ""deletions"": 3, ""lines"": 7}, ""src/version.c"": {""insertions"": 2, ""deletions"": 0, ""lines"": 2}}"
2021-10-05 00:19:53,6d197987745427801a2195836ef89e48537afbeb,Bram Moolenaar,4,0,4,2,"{""src/testdir/test_startup.vim"": {""insertions"": 2, ""deletions"": 0, ""lines"": 2}, ""src/version.c"": {""insertions"": 2, ""deletions"": 0, ""lines"": 2}}"
2021-10-04 22:13:13,d3710cf01ef6ab1b2f233866ff01dab76686f642,Bram Moolenaar,27,1,28,3,"{""src/buffer.c"": {""insertions"": 11, ""deletions"": 1, ""lines"": 12}, ""src/testdir/test_startup.vim"": {""insertions"": 14, ""deletions"": 0, ""lines"": 14}, ""src/version.c"": {""insertions"": 2, ""deletions"": 0, ""lines"": 2}}"
2021-10-04 21:17:36,08d7b1c82866a61b61a55e55b6c190dba04e54ea,kuuote,15,2,17,3,"{""src/ex_docmd.c"": {""insertions"": 5, ""deletions"": 2, ""lines"": 7}, ""src/testdir/test_excmd.vim"": {""insertions"": 8, ""deletions"": 0, ""lines"": 8}, ""src/version.c"": {""insertions"": 2, ""deletions"": 0, ""lines"": 2}}"
2021-10-04 20:51:57,965d2edbce1a8ccba96925be5ac4575981f68949,h-east,8,6,14,4,"{""runtime/doc/if_lua.txt"": {""insertions"": 4, ""deletions"": 4, ""lines"": 8}, ""src/getchar.c"": {""insertions"": 1, ""deletions"": 1, ""lines"": 2}, ""src/if_lua.c"": {""insertions"": 1, ""deletions"": 1, ""lines"": 2}, ""src/version.c"": {""insertions"": 2, ""deletions"": 0, ""lines"": 2}}"
2021-10-04 20:32:54,6e649224926bbc1df6a4fdfa7a96b4acb1f8bee0,Bram Moolenaar,2852,369,3221,50,"{"".github/CODEOWNERS"": {""insertions"": 21, ""deletions"": 0, ""lines"": 21}, ""runtime/autoload/netrw.vim"": {""insertions"": 2, ""deletions"": 1, ""lines"": 3}, ""runtime/doc/autocmd.txt"": {""insertions"": 9, ""deletions"": 2, ""lines"": 11}, ""runtime/doc/editing.txt"": {""insertions"": 4, ""deletions"": 2, ""lines"": 6}, ""runtime/doc/eval.txt"": {""insertions"": 21, ""deletions"": 21, ""lines"": 42}, ""runtime/doc/filetype.txt"": {""insertions"": 2, ""deletions"": 2, ""lines"": 4}, ""runtime/doc/intro.txt"": {""insertions"": 1, ""deletions"": 2, ""lines"": 3}, ""runtime/doc/mbyte.txt"": {""insertions"": 16, ""deletions"": 16, ""lines"": 32}, ""runtime/doc/print.txt"": {""insertions"": 2, ""deletions"": 2, ""lines"": 4}, ""runtime/doc/tags"": {""insertions"": 2, ""deletions"": 1, ""lines"": 3}, ""runtime/doc/todo.txt"": {""insertions"": 4, ""deletions"": 1, ""lines"": 5}, ""runtime/filetype.vim"": {""insertions"": 5, ""deletions"": 4, ""lines"": 9}, ""runtime/ftplugin/man.vim"": {""insertions"": 1, ""deletions"": 1, ""lines"": 2}, ""runtime/ftplugin/nginx.vim"": {""insertions"": 6, ""deletions"": 0, ""lines"": 6}, ""runtime/ftplugin/spec.vim"": {""insertions"": 2, ""deletions"": 2, ""lines"": 4}, ""runtime/indent/cdl.vim"": {""insertions"": 2, ""deletions"": 1, ""lines"": 3}, ""runtime/indent/cobol.vim"": {""insertions"": 3, ""deletions"": 0, ""lines"": 3}, ""runtime/indent/config.vim"": {""insertions"": 8, ""deletions"": 5, ""lines"": 13}, ""runtime/indent/css.vim"": {""insertions"": 7, ""deletions"": 5, ""lines"": 12}, ""runtime/indent/d.vim"": {""insertions"": 2, ""deletions"": 2, ""lines"": 4}, ""runtime/indent/dtd.vim"": {""insertions"": 6, ""deletions"": 3, ""lines"": 9}, ""runtime/indent/dylan.vim"": {""insertions"": 2, ""deletions"": 1, ""lines"": 3}, ""runtime/indent/elm.vim"": {""insertions"": 3, ""deletions"": 1, ""lines"": 4}, ""runtime/indent/eterm.vim"": {""insertions"": 6, ""deletions"": 3, ""lines"": 9}, ""runtime/indent/framescript.vim"": {""insertions"": 6, ""deletions"": 3, ""lines"": 9}, ""runtime/indent/idlang.vim"": {""insertions"": 3, ""deletions"": 2, ""lines"": 5}, ""runtime/indent/ld.vim"": {""insertions"": 6, ""deletions"": 3, ""lines"": 9}, ""runtime/indent/mail.vim"": {""insertions"": 3, ""deletions"": 1, ""lines"": 4}, ""runtime/indent/make.vim"": {""insertions"": 6, ""deletions"": 3, ""lines"": 9}, ""runtime/indent/matlab.vim"": {""insertions"": 2, ""deletions"": 0, ""lines"": 2}, ""runtime/indent/mma.vim"": {""insertions"": 6, ""deletions"": 5, ""lines"": 11}, ""runtime/indent/nginx.vim"": {""insertions"": 17, ""deletions"": 0, ""lines"": 17}, ""runtime/indent/occam.vim"": {""insertions"": 2, ""deletions"": 1, ""lines"": 3}, ""runtime/indent/pascal.vim"": {""insertions"": 7, ""deletions"": 8, ""lines"": 15}, ""runtime/indent/postscr.vim"": {""insertions"": 4, ""deletions"": 3, ""lines"": 7}, ""runtime/indent/prolog.vim"": {""insertions"": 4, ""deletions"": 3, ""lines"": 7}, ""runtime/indent/python.vim"": {""insertions"": 3, ""deletions"": 1, ""lines"": 4}, ""runtime/indent/readline.vim"": {""insertions"": 6, ""deletions"": 3, ""lines"": 9}, ""runtime/indent/sdl.vim"": {""insertions"": 3, ""deletions"": 1, ""lines"": 4}, ""runtime/indent/tcl.vim"": {""insertions"": 5, ""deletions"": 3, ""lines"": 8}, ""runtime/indent/tcsh.vim"": {""insertions"": 3, ""deletions"": 2, ""lines"": 5}, ""runtime/indent/zimbu.vim"": {""insertions"": 2, ""deletions"": 2, ""lines"": 4}, ""runtime/syntax/8th.vim"": {""insertions"": 302, ""deletions"": 233, ""lines"": 535}, ""runtime/syntax/chicken.vim"": {""insertions"": 2, ""deletions"": 2, ""lines"": 4}, ""runtime/syntax/nginx.vim"": {""insertions"": 2307, ""deletions"": 0, ""lines"": 2307}, ""runtime/syntax/sml.vim"": {""insertions"": 3, ""deletions"": 4, ""lines"": 7}, ""runtime/syntax/tcl.vim"": {""insertions"": 2, ""deletions"": 2, ""lines"": 4}, ""runtime/syntax/tcsh.vim"": {""insertions"": 3, ""deletions"": 2, ""lines"": 5}, ""runtime/syntax/typescriptcommon.vim"": {""insertions"": 3, ""deletions"": 2, ""lines"": 5}, ""runtime/syntax/xpm.vim"": {""insertions"": 5, ""deletions"": 2, ""lines"": 7}}"
2021-10-04 19:41:45,78aa5ffe314f40d33666f03b833f66b11c3d0f67,Bram Moolenaar,7,2,9,3,"{""runtime/filetype.vim"": {""insertions"": 4, ""deletions"": 1, ""lines"": 5}, ""src/testdir/test_filetype.vim"": {""insertions"": 1, ""deletions"": 1, ""lines"": 2}, ""src/version.c"": {""insertions"": 2, ""deletions"": 0, ""lines"": 2}}"
2021-10-04 19:09:19,9af9fd6ab637ea507dd9015fa5a84a408c36c1e0,Bram Moolenaar,7,2,9,2,"{""src/testdir/test_search.vim"": {""insertions"": 5, ""deletions"": 2, ""lines"": 7}, ""src/version.c"": {""insertions"": 2, ""deletions"": 0, ""lines"": 2}}"
2021-10-04 18:47:35,d8d957de86f218de9124ca1209548f8c6f61b69b,Bram Moolenaar,19,1,20,3,"{""src/ex_getln.c"": {""insertions"": 7, ""deletions"": 1, ""lines"": 8}, ""src/testdir/test_search.vim"": {""insertions"": 10, ""deletions"": 0, ""lines"": 10}, ""src/version.c"": {""insertions"": 2, ""deletions"": 0, ""lines"": 2}}"
2021-10-04 17:52:19,a684a684096ecef3fbaee39c573b47423235d6b1,Bram Moolenaar,16,1,17,3,"{""src/ex_eval.c"": {""insertions"": 2, ""deletions"": 1, ""lines"": 3}, ""src/testdir/test_trycatch.vim"": {""insertions"": 12, ""deletions"": 0, ""lines"": 12}, ""src/version.c"": {""insertions"": 2, ""deletions"": 0, ""lines"": 2}}"
2021-10-03 19:11:20,50c56893423eb6ad2154a4151e67f7097f52efb6,Bram Moolenaar,6,1,7,3,"{""runtime/filetype.vim"": {""insertions"": 3, ""deletions"": 0, ""lines"": 3}, ""src/testdir/test_filetype.vim"": {""insertions"": 1, ""deletions"": 1, ""lines"": 2}, ""src/version.c"": {""insertions"": 2, ""deletions"": 0, ""lines"": 2}}"
2021-10-03 18:29:48,c6376c798433bcb9ee38a8664299d11454546950,Bram Moolenaar,28,1,29,3,"{""src/os_unix.c"": {""insertions"": 9, ""deletions"": 1, ""lines"": 10}, ""src/testdir/test_cd.vim"": {""insertions"": 17, ""deletions"": 0, ""lines"": 17}, ""src/version.c"": {""insertions"": 2, ""deletions"": 0, ""lines"": 2}}"
2021-10-03 15:22:05,5a9357d0bff9059f547906d8d03b31bca7215af1,Bram Moolenaar,21,0,21,3,"{""src/edit.c"": {""insertions"": 3, ""deletions"": 0, ""lines"": 3}, ""src/testdir/test_autocmd.vim"": {""insertions"": 16, ""deletions"": 0, ""lines"": 16}, ""src/version.c"": {""insertions"": 2, ""deletions"": 0, ""lines"": 2}}"
2021-10-03 14:19:14,cc8cd4453332276d55b4a1109eace5785a4f319d,zeertzjq,53,5,58,4,"{""runtime/doc/eval.txt"": {""insertions"": 7, ""deletions"": 5, ""lines"": 12}, ""src/misc1.c"": {""insertions"": 6, ""deletions"": 0, ""lines"": 6}, ""src/testdir/test_functions.vim"": {""insertions"": 38, ""deletions"": 0, ""lines"": 38}, ""src/version.c"": {""insertions"": 2, ""deletions"": 0, ""lines"": 2}}"
2021-10-03 11:01:27,27fef59dd1dd75f50c366f7f616ffa4451560452,zeertzjq,11,2,13,4,"{""runtime/doc/eval.txt"": {""insertions"": 2, ""deletions"": 0, ""lines"": 2}, ""src/insexpand.c"": {""insertions"": 3, ""deletions"": 2, ""lines"": 5}, ""src/testdir/test_popup.vim"": {""insertions"": 4, ""deletions"": 0, ""lines"": 4}, ""src/version.c"": {""insertions"": 2, ""deletions"": 0, ""lines"": 2}}"
2021-10-03 10:46:09,8b8c0ed657fabd88e610401ca8a12366f987db94,Chris Aumann,6,0,6,3,"{""runtime/filetype.vim"": {""insertions"": 3, ""deletions"": 0, ""lines"": 3}, ""src/testdir/test_filetype.vim"": {""insertions"": 1, ""deletions"": 0, ""lines"": 1}, ""src/version.c"": {""insertions"": 2, ""deletions"": 0, ""lines"": 2}}"
2021-10-02 20:48:15,72d2fa69e56dd0e61eac87a9c3b79cd89d47cdd9,Bram Moolenaar,23,0,23,2,"{""src/testdir/test_edit.vim"": {""insertions"": 21, ""deletions"": 0, ""lines"": 21}, ""src/version.c"": {""insertions"": 2, ""deletions"": 0, ""lines"": 2}}"
2021-10-02 15:55:39,d85931e67316e824878000d0ead122553ccef3a4,Bram Moolenaar,12,4,16,3,"{""src/misc1.c"": {""insertions"": 5, ""deletions"": 3, ""lines"": 8}, ""src/testdir/test_edit.vim"": {""insertions"": 5, ""deletions"": 1, ""lines"": 6}, ""src/version.c"": {""insertions"": 2, ""deletions"": 0, ""lines"": 2}}"
2021-10-02 15:34:55,72406a4bd2896915b6f541e26d41521a59b1f846,Bram Moolenaar,16,1,17,4,"{""runtime/doc/eval.txt"": {""insertions"": 2, ""deletions"": 1, ""lines"": 3}, ""src/misc1.c"": {""insertions"": 4, ""deletions"": 0, ""lines"": 4}, ""src/testdir/test_functions.vim"": {""insertions"": 8, ""deletions"": 0, ""lines"": 8}, ""src/version.c"": {""insertions"": 2, ""deletions"": 0, ""lines"": 2}}"
2021-10-02 10:26:51,dfa5e464d459f84200a73d178f1ecefe75bbe511,=?UTF-8?q?Dundar=20G=C3=B6c?=,20,18,38,9,"{""src/autocmd.c"": {""insertions"": 5, ""deletions"": 5, ""lines"": 10}, ""src/buffer.c"": {""insertions"": 1, ""deletions"": 1, ""lines"": 2}, ""src/debugger.c"": {""insertions"": 1, ""deletions"": 1, ""lines"": 2}, ""src/getchar.c"": {""insertions"": 3, ""deletions"": 3, ""lines"": 6}, ""src/hardcopy.c"": {""insertions"": 2, ""deletions"": 2, ""lines"": 4}, ""src/if_cscope.c"": {""insertions"": 2, ""deletions"": 2, ""lines"": 4}, ""src/move.c"": {""insertions"": 1, ""deletions"": 1, ""lines"": 2}, ""src/tag.c"": {""insertions"": 1, ""deletions"": 1, ""lines"": 2}, ""src/version.c"": {""insertions"": 4, ""deletions"": 2, ""lines"": 6}}"
2021-09-30 18:00:00,51491adfa86fd66a857cd7ec50d0b57dbdf3da59,Yegappan Lakshmanan,65,4,69,5,"{""runtime/doc/eval.txt"": {""insertions"": 16, ""deletions"": 1, ""lines"": 17}, ""src/menu.c"": {""insertions"": 21, ""deletions"": 3, ""lines"": 24}, ""src/testdir/test_menu.vim"": {""insertions"": 3, ""deletions"": 0, ""lines"": 3}, ""src/testdir/test_vim9_builtin.vim"": {""insertions"": 23, ""deletions"": 0, ""lines"": 23}, ""src/version.c"": {""insertions"": 2, ""deletions"": 0, ""lines"": 2}}"
2021-09-26 21:11:52,be01090efad242e30728275dea05420db6f96257,Bram Moolenaar,4,2,6,3,"{""runtime/filetype.vim"": {""insertions"": 1, ""deletions"": 1, ""lines"": 2}, ""src/testdir/test_filetype.vim"": {""insertions"": 1, ""deletions"": 1, ""lines"": 2}, ""src/version.c"": {""insertions"": 2, ""deletions"": 0, ""lines"": 2}}"
2021-09-26 19:14:39,b16ff292ad5f07ed5a7e36a2236b2f82c943c982,Bram Moolenaar,6,0,6,2,"{""src/testdir/test_vim9_script.vim"": {""insertions"": 4, ""deletions"": 0, ""lines"": 4}, ""src/version.c"": {""insertions"": 2, ""deletions"": 0, ""lines"": 2}}"
2021-09-26 18:04:05,f8dbd586660c35e44276151b731eeedeace9b53e,Yegappan Lakshmanan,81,5,86,3,"{""src/evalfunc.c"": {""insertions"": 2, ""deletions"": 3, ""lines"": 5}, ""src/testdir/test_vim9_builtin.vim"": {""insertions"": 77, ""deletions"": 2, ""lines"": 79}, ""src/version.c"": {""insertions"": 2, ""deletions"": 0, ""lines"": 2}}"
2021-09-22 14:43:59,56858e4ed4e338e15821767b8303b06099e40384,Bram Moolenaar,9,2,11,3,"{""src/register.c"": {""insertions"": 3, ""deletions"": 0, ""lines"": 3}, ""src/testdir/test_put.vim"": {""insertions"": 4, ""deletions"": 2, ""lines"": 6}, ""src/version.c"": {""insertions"": 2, ""deletions"": 0, ""lines"": 2}}"
2021-09-22 14:37:07,23003e51e18371afda4420d9e171a3dcba5a31cc,Bram Moolenaar,23,3,26,3,"{""src/register.c"": {""insertions"": 11, ""deletions"": 3, ""lines"": 14}, ""src/testdir/test_put.vim"": {""insertions"": 10, ""deletions"": 0, ""lines"": 10}, ""src/version.c"": {""insertions"": 2, ""deletions"": 0, ""lines"": 2}}"
2021-09-22 12:18:13,40fa12aea352474d229f2f750e954a4318aead4e,Bram Moolenaar,16,1,17,3,"{""src/fileio.c"": {""insertions"": 1, ""deletions"": 1, ""lines"": 2}, ""src/testdir/test_autocmd.vim"": {""insertions"": 13, ""deletions"": 0, ""lines"": 13}, ""src/version.c"": {""insertions"": 2, ""deletions"": 0, ""lines"": 2}}"
2021-09-21 19:04:01,da0b497c6e4e01447669773a931b0eaa5ca757f3,Bram Moolenaar,2,1,3,1,"{""src/po/es.po"": {""insertions"": 2, ""deletions"": 1, ""lines"": 3}}"
2021-09-21 18:09:51,34cc7d8c034f2bc5b57455577051db8d72e2b87c,Bram Moolenaar,378,113,491,20,"{""runtime/autoload/csscomplete.vim"": {""insertions"": 3, ""deletions"": 3, ""lines"": 6}, ""runtime/doc/eval.txt"": {""insertions"": 8, ""deletions"": 4, ""lines"": 12}, ""runtime/doc/filetype.txt"": {""insertions"": 8, ""deletions"": 0, ""lines"": 8}, ""runtime/doc/map.txt"": {""insertions"": 1, ""deletions"": 1, ""lines"": 2}, ""runtime/doc/options.txt"": {""insertions"": 5, ""deletions"": 3, ""lines"": 8}, ""runtime/doc/tags"": {""insertions"": 8, ""deletions"": 0, ""lines"": 8}, ""runtime/doc/todo.txt"": {""insertions"": 6, ""deletions"": 9, ""lines"": 15}, ""runtime/doc/usr_41.txt"": {""insertions"": 1, ""deletions"": 1, ""lines"": 2}, ""runtime/doc/vim9.txt"": {""insertions"": 10, ""deletions"": 1, ""lines"": 11}, ""runtime/filetype.vim"": {""insertions"": 1, ""deletions"": 1, ""lines"": 2}, ""runtime/ftplugin/8th.vim"": {""insertions"": 6, ""deletions"": 4, ""lines"": 10}, ""runtime/ftplugin/c.vim"": {""insertions"": 7, ""deletions"": 3, ""lines"": 10}, ""runtime/ftplugin/gprof.vim"": {""insertions"": 13, ""deletions"": 9, ""lines"": 22}, ""runtime/syntax/go.vim"": {""insertions"": 3, ""deletions"": 3, ""lines"": 6}, ""runtime/syntax/gprof.vim"": {""insertions"": 3, ""deletions"": 2, ""lines"": 5}, ""runtime/syntax/php.vim"": {""insertions"": 251, ""deletions"": 16, ""lines"": 267}, ""runtime/syntax/vim.vim"": {""insertions"": 8, ""deletions"": 8, ""lines"": 16}, ""runtime/tutor/tutor"": {""insertions"": 10, ""deletions"": 10, ""lines"": 20}, ""runtime/tutor/tutor.utf-8"": {""insertions"": 10, ""deletions"": 10, ""lines"": 20}, ""src/po/es.po"": {""insertions"": 16, ""deletions"": 25, ""lines"": 41}}"
2021-09-21 17:37:01,690c524ce6629f9ff67728541ba211f831caf0ee,Steven Penny,6,1,7,3,"{""runtime/filetype.vim"": {""insertions"": 3, ""deletions"": 0, ""lines"": 3}, ""src/testdir/test_filetype.vim"": {""insertions"": 1, ""deletions"": 1, ""lines"": 2}, ""src/version.c"": {""insertions"": 2, ""deletions"": 0, ""lines"": 2}}"
2021-09-20 18:57:31,770ddbe1595f6dab836304203d5ca2e0b069266f,Zdenek Dohnal,4,2,6,3,"{""runtime/filetype.vim"": {""insertions"": 1, ""deletions"": 1, ""lines"": 2}, ""src/testdir/test_filetype.vim"": {""insertions"": 1, ""deletions"": 1, ""lines"": 2}, ""src/version.c"": {""insertions"": 2, ""deletions"": 0, ""lines"": 2}}"
2021-09-19 15:55:16,18fefddcb023db3c8461953892650b0c5f0cc9fe,Bram Moolenaar,26,24,50,2,"{"".github/workflows/ci.yml"": {""insertions"": 24, ""deletions"": 24, ""lines"": 48}, ""src/version.c"": {""insertions"": 2, ""deletions"": 0, ""lines"": 2}}"
2021-09-19 15:01:39,c04f62346bfd6b92151908239a3c5ab1a7d18f2a,Yasuhiro Matsumoto,9,0,9,3,"{""src/list.c"": {""insertions"": 6, ""deletions"": 0, ""lines"": 6}, ""src/testdir/test_sort.vim"": {""insertions"": 1, ""deletions"": 0, ""lines"": 1}, ""src/version.c"": {""insertions"": 2, ""deletions"": 0, ""lines"": 2}}"
2021-09-18 13:25:52,1d34189ecb99fa76363c06e1aa815c1075675a1c,Bram Moolenaar,34,4,38,3,"{""src/testdir/test_trycatch.vim"": {""insertions"": 27, ""deletions"": 1, ""lines"": 28}, ""src/userfunc.c"": {""insertions"": 5, ""deletions"": 3, ""lines"": 8}, ""src/version.c"": {""insertions"": 2, ""deletions"": 0, ""lines"": 2}}"
2021-09-18 10:15:08,d2b98ab4ecf168514ae622948e3749dea7671946,Yegappan Lakshmanan,4,2,6,2,"{""src/os_unix.h"": {""insertions"": 2, ""deletions"": 2, ""lines"": 4}, ""src/version.c"": {""insertions"": 2, ""deletions"": 0, ""lines"": 2}}"
2021-09-17 19:07:35,820d5525cae707f39571c6abc2aa6a9e66ed171e,Yegappan Lakshmanan,66,17,83,6,"{""runtime/doc/sign.txt"": {""insertions"": 1, ""deletions"": 0, ""lines"": 1}, ""runtime/doc/textprop.txt"": {""insertions"": 1, ""deletions"": 1, ""lines"": 2}, ""src/sign.c"": {""insertions"": 0, ""deletions"": 4, ""lines"": 4}, ""src/testdir/test_blob.vim"": {""insertions"": 2, ""deletions"": 1, ""lines"": 3}, ""src/testdir/test_vim9_builtin.vim"": {""insertions"": 60, ""deletions"": 11, ""lines"": 71}, ""src/version.c"": {""insertions"": 2, ""deletions"": 0, ""lines"": 2}}"
2021-09-17 18:45:30,542ffe16a1b6961e9262a3c4c6ddb86e6149a1cd,Bram Moolenaar,6,2,8,2,"{""src/globals.h"": {""insertions"": 1, ""deletions"": 1, ""lines"": 2}, ""src/version.c"": {""insertions"": 5, ""deletions"": 1, ""lines"": 6}}"
2021-09-16 20:32:15,644b49fa0fb90143e8dbe90a7c14c9498d17b266,Bram Moolenaar,36,2,38,4,"{""src/edit.c"": {""insertions"": 10, ""deletions"": 0, ""lines"": 10}, ""src/testdir/dumps/Test_conceal_two_windows_07in.dump"": {""insertions"": 20, ""deletions"": 0, ""lines"": 20}, ""src/testdir/test_conceal.vim"": {""insertions"": 4, ""deletions"": 2, ""lines"": 6}, ""src/version.c"": {""insertions"": 2, ""deletions"": 0, ""lines"": 2}}"
2021-09-16 18:14:51,3dfe2e0fb8768914a019fa04b1ed9581e33c9b26,Bram Moolenaar,4,1,5,2,"{""src/version.c"": {""insertions"": 2, ""deletions"": 0, ""lines"": 2}, ""src/vim9compile.c"": {""insertions"": 2, ""deletions"": 1, ""lines"": 3}}"
2021-09-16 14:15:07,1a7ee4dd115329052670d7af176341bd09c9dc5a,Bram Moolenaar,137,38,175,5,"{""src/testdir/test_vim9_disassemble.vim"": {""insertions"": 50, ""deletions"": 12, ""lines"": 62}, ""src/version.c"": {""insertions"": 2, ""deletions"": 0, ""lines"": 2}, ""src/vim9.h"": {""insertions"": 1, ""deletions"": 0, ""lines"": 1}, ""src/vim9compile.c"": {""insertions"": 81, ""deletions"": 26, ""lines"": 107}, ""src/vim9execute.c"": {""insertions"": 3, ""deletions"": 0, ""lines"": 3}}"
2021-09-15 10:53:40,ee2cbcd99c54d7c4a3ccfaf0cd5ddeb1369a844e,Christian Brabandt,3,1,4,2,"{""src/version.c"": {""insertions"": 2, ""deletions"": 0, ""lines"": 2}, ""vimtutor.bat"": {""insertions"": 1, ""deletions"": 1, ""lines"": 2}}"
2021-09-14 20:58:23,f2a8bafa4b815e5b4e50a25c2b3a8a24fbe8aa11,Bram Moolenaar,8,0,8,2,"{""src/testdir/test_recover.vim"": {""insertions"": 6, ""deletions"": 0, ""lines"": 6}, ""src/version.c"": {""insertions"": 2, ""deletions"": 0, ""lines"": 2}}"
2021-09-14 16:55:51,78eb9cce911dcd662182443e0920649ec1596d41,Christian Brabandt,64,0,64,5,"{""src/ops.c"": {""insertions"": 2, ""deletions"": 0, ""lines"": 2}, ""src/proto/register.pro"": {""insertions"": 1, ""deletions"": 0, ""lines"": 1}, ""src/register.c"": {""insertions"": 7, ""deletions"": 0, ""lines"": 7}, ""src/testdir/test_registers.vim"": {""insertions"": 52, ""deletions"": 0, ""lines"": 52}, ""src/version.c"": {""insertions"": 2, ""deletions"": 0, ""lines"": 2}}"
2021-09-14 15:54:30,5dfe467432638fac2e0156a2f9cd0d9eb569fb39,Yegappan Lakshmanan,185,1,186,11,"{""runtime/doc/eval.txt"": {""insertions"": 27, ""deletions"": 1, ""lines"": 28}, ""runtime/doc/usr_41.txt"": {""insertions"": 6, ""deletions"": 0, ""lines"": 6}, ""src/blob.c"": {""insertions"": 61, ""deletions"": 0, ""lines"": 61}, ""src/errors.h"": {""insertions"": 4, ""deletions"": 0, ""lines"": 4}, ""src/evalfunc.c"": {""insertions"": 14, ""deletions"": 0, ""lines"": 14}, ""src/proto/blob.pro"": {""insertions"": 2, ""deletions"": 0, ""lines"": 2}, ""src/proto/typval.pro"": {""insertions"": 1, ""deletions"": 0, ""lines"": 1}, ""src/testdir/test_blob.vim"": {""insertions"": 39, ""deletions"": 0, ""lines"": 39}, ""src/testdir/test_vim9_builtin.vim"": {""insertions"": 12, ""deletions"": 0, ""lines"": 12}, ""src/typval.c"": {""insertions"": 17, ""deletions"": 0, ""lines"": 17}, ""src/version.c"": {""insertions"": 2, ""deletions"": 0, ""lines"": 2}}"
2021-09-13 20:17:38,f5785cf0592626ec17676e814d3ba58f5123bcda,Mike Williams,8,5,13,4,"{""src/screen.c"": {""insertions"": 4, ""deletions"": 3, ""lines"": 7}, ""src/version.c"": {""insertions"": 2, ""deletions"": 0, ""lines"": 2}, ""src/xdiff/xemit.c"": {""insertions"": 1, ""deletions"": 1, ""lines"": 2}, ""src/xdiff/xutils.c"": {""insertions"": 1, ""deletions"": 1, ""lines"": 2}}"
2021-09-13 19:36:27,a29856fcdc41541c607437629c1c1f45951100a4,Bram Moolenaar,7,3,10,2,"{""src/typval.c"": {""insertions"": 5, ""deletions"": 3, ""lines"": 8}, ""src/version.c"": {""insertions"": 2, ""deletions"": 0, ""lines"": 2}}"
2021-09-13 16:25:54,b1b6f4de2b0edc3b6622912132ddb8994ec52709,Bram Moolenaar,226,26,252,6,"{""src/testdir/test_vim9_disassemble.vim"": {""insertions"": 34, ""deletions"": 1, ""lines"": 35}, ""src/testdir/test_vim9_func.vim"": {""insertions"": 31, ""deletions"": 0, ""lines"": 31}, ""src/version.c"": {""insertions"": 2, ""deletions"": 0, ""lines"": 2}, ""src/vim9.h"": {""insertions"": 3, ""deletions"": 0, ""lines"": 3}, ""src/vim9compile.c"": {""insertions"": 33, ""deletions"": 6, ""lines"": 39}, ""src/vim9execute.c"": {""insertions"": 123, ""deletions"": 19, ""lines"": 142}}"
2021-09-12 19:00:14,28e591dd5080bbcd0f468f9d9597cedb716e28c9,Bram Moolenaar,3,1,4,2,"{""src/proto/misc1.pro"": {""insertions"": 1, ""deletions"": 1, ""lines"": 2}, ""src/version.c"": {""insertions"": 2, ""deletions"": 0, ""lines"": 2}}"
2021-09-12 18:58:02,bdcba24d8597abd5af509c2fb9206e64e713c711,Bram Moolenaar,47,6,53,5,"{""runtime/doc/map.txt"": {""insertions"": 4, ""deletions"": 0, ""lines"": 4}, ""src/errors.h"": {""insertions"": 4, ""deletions"": 0, ""lines"": 4}, ""src/testdir/test_usercommands.vim"": {""insertions"": 21, ""deletions"": 0, ""lines"": 21}, ""src/usercmd.c"": {""insertions"": 16, ""deletions"": 6, ""lines"": 22}, ""src/version.c"": {""insertions"": 2, ""deletions"": 0, ""lines"": 2}}"
2021-09-12 15:03:08,ca0627df69c29508f6f797bef27a1f5fa9a447d3,Bram Moolenaar,13,14,27,3,"{""runtime/autoload/dist/ft.vim"": {""insertions"": 3, ""deletions"": 3, ""lines"": 6}, ""src/testdir/test_filetype.vim"": {""insertions"": 8, ""deletions"": 11, ""lines"": 19}, ""src/version.c"": {""insertions"": 2, ""deletions"": 0, ""lines"": 2}}"
2021-09-12 13:45:10,dfe04dbff5863f6c089da8831d7ac2a3421a44b7,naohiro ono,9,1,10,3,"{""src/cmdexpand.c"": {""insertions"": 2, ""deletions"": 1, ""lines"": 3}, ""src/testdir/test_cmdline.vim"": {""insertions"": 5, ""deletions"": 0, ""lines"": 5}, ""src/version.c"": {""insertions"": 2, ""deletions"": 0, ""lines"": 2}}"
2021-09-12 11:39:55,f1e8876fa2359b572d262772747405d3616db670,=?UTF-8?q?Magnus=20Gro=C3=9F?=,135,4,139,13,"{""runtime/doc/autocmd.txt"": {""insertions"": 18, ""deletions"": 1, ""lines"": 19}, ""src/autocmd.c"": {""insertions"": 16, ""deletions"": 2, ""lines"": 18}, ""src/edit.c"": {""insertions"": 3, ""deletions"": 0, ""lines"": 3}, ""src/ex_docmd.c"": {""insertions"": 1, ""deletions"": 0, ""lines"": 1}, ""src/ex_getln.c"": {""insertions"": 10, ""deletions"": 0, ""lines"": 10}, ""src/globals.h"": {""insertions"": 3, ""deletions"": 0, ""lines"": 3}, ""src/misc1.c"": {""insertions"": 40, ""deletions"": 1, ""lines"": 41}, ""src/normal.c"": {""insertions"": 3, ""deletions"": 0, ""lines"": 3}, ""src/proto/autocmd.pro"": {""insertions"": 1, ""deletions"": 0, ""lines"": 1}, ""src/proto/misc1.pro"": {""insertions"": 1, ""deletions"": 0, ""lines"": 1}, ""src/testdir/test_edit.vim"": {""insertions"": 34, ""deletions"": 0, ""lines"": 34}, ""src/version.c"": {""insertions"": 2, ""deletions"": 0, ""lines"": 2}, ""src/vim.h"": {""insertions"": 3, ""deletions"": 0, ""lines"": 3}}"
2021-09-11 21:07:44,464393a6961d9b9de2bfe9c05f8e2ae5bdec0293,Bram Moolenaar,19,3,22,3,"{""src/evalvars.c"": {""insertions"": 14, ""deletions"": 2, ""lines"": 16}, ""src/version.c"": {""insertions"": 2, ""deletions"": 0, ""lines"": 2}, ""src/vim9type.c"": {""insertions"": 3, ""deletions"": 1, ""lines"": 4}}"
2021-09-11 19:14:20,35a9a00afcb20897d462a766793ff45534810dc3,Bram Moolenaar,21,3,24,3,"{""src/normal.c"": {""insertions"": 7, ""deletions"": 3, ""lines"": 10}, ""src/testdir/test_edit.vim"": {""insertions"": 12, ""deletions"": 0, ""lines"": 12}, ""src/version.c"": {""insertions"": 2, ""deletions"": 0, ""lines"": 2}}"
2021-09-11 18:20:38,b3bf33a7b227df871834e816c4ce4b2706b56bea,Bram Moolenaar,19,5,24,3,"{""src/list.c"": {""insertions"": 7, ""deletions"": 1, ""lines"": 8}, ""src/testdir/test_vim9_builtin.vim"": {""insertions"": 10, ""deletions"": 4, ""lines"": 14}, ""src/version.c"": {""insertions"": 2, ""deletions"": 0, ""lines"": 2}}"
2021-09-11 13:06:44,4b4b1b84eee70b74fa3bb57624533c65bafd8428,Bram Moolenaar,52,6,58,3,"{""src/change.c"": {""insertions"": 32, ""deletions"": 6, ""lines"": 38}, ""src/testdir/test_listener.vim"": {""insertions"": 18, ""deletions"": 0, ""lines"": 18}, ""src/version.c"": {""insertions"": 2, ""deletions"": 0, ""lines"": 2}}"
2021-09-11 10:15:09,56e14698b45a9c4ef8fa65c55c9bfe86fbb3d6bf,Bram Moolenaar,4,2,6,2,"{""src/screen.c"": {""insertions"": 2, ""deletions"": 2, ""lines"": 4}, ""src/version.c"": {""insertions"": 2, ""deletions"": 0, ""lines"": 2}}"
2021-09-10 14:58:30,f14b8ba1373f569705cb80419248054100b02360,zeertzjq,264,29,293,7,"{""runtime/doc/options.txt"": {""insertions"": 14, ""deletions"": 5, ""lines"": 19}, ""src/drawline.c"": {""insertions"": 20, ""deletions"": 3, ""lines"": 23}, ""src/message.c"": {""insertions"": 30, ""deletions"": 13, ""lines"": 43}, ""src/screen.c"": {""insertions"": 58, ""deletions"": 5, ""lines"": 63}, ""src/structs.h"": {""insertions"": 1, ""deletions"": 0, ""lines"": 1}, ""src/testdir/test_listchars.vim"": {""insertions"": 139, ""deletions"": 3, ""lines"": 142}, ""src/version.c"": {""insertions"": 2, ""deletions"": 0, ""lines"": 2}}"
2021-09-09 21:01:14,07802044b90b2cbcc64b2dfe235f019d7c37589c,Bram Moolenaar,36,12,48,5,"{""src/structs.h"": {""insertions"": 3, ""deletions"": 0, ""lines"": 3}, ""src/testdir/test_vim9_assign.vim"": {""insertions"": 8, ""deletions"": 7, ""lines"": 15}, ""src/version.c"": {""insertions"": 2, ""deletions"": 0, ""lines"": 2}, ""src/vim9compile.c"": {""insertions"": 15, ""deletions"": 4, ""lines"": 19}, ""src/vim9execute.c"": {""insertions"": 8, ""deletions"": 1, ""lines"": 9}}"
2021-09-09 20:30:52,efc084e3353d6854b6dac8b240f70cb0abb838ad,Bram Moolenaar,26,0,26,3,"{""src/list.c"": {""insertions"": 1, ""deletions"": 0, ""lines"": 1}, ""src/testdir/test_vim9_func.vim"": {""insertions"": 23, ""deletions"": 0, ""lines"": 23}, ""src/version.c"": {""insertions"": 2, ""deletions"": 0, ""lines"": 2}}"
2021-09-09 19:55:11,6c391a74fe90190796ca0b0c010112948a6e75d7,Bram Moolenaar,247,167,414,80,"{"".github/CODEOWNERS"": {""insertions"": 1, ""deletions"": 0, ""lines"": 1}, ""runtime/autoload/ada.vim"": {""insertions"": 3, ""deletions"": 3, ""lines"": 6}, ""runtime/autoload/adacomplete.vim"": {""insertions"": 1, ""deletions"": 1, ""lines"": 2}, ""runtime/autoload/csscomplete.vim"": {""insertions"": 1, ""deletions"": 1, ""lines"": 2}, ""runtime/autoload/decada.vim"": {""insertions"": 1, ""deletions"": 1, ""lines"": 2}, ""runtime/autoload/getscript.vim"": {""insertions"": 2, ""deletions"": 2, ""lines"": 4}, ""runtime/autoload/haskellcomplete.vim"": {""insertions"": 3, ""deletions"": 3, ""lines"": 6}, ""runtime/autoload/htmlcomplete.vim"": {""insertions"": 1, ""deletions"": 1, ""lines"": 2}, ""runtime/autoload/netrw.vim"": {""insertions"": 4, ""deletions"": 4, ""lines"": 8}, ""runtime/autoload/phpcomplete.vim"": {""insertions"": 21, ""deletions"": 21, ""lines"": 42}, ""runtime/autoload/python3complete.vim"": {""insertions"": 1, ""deletions"": 1, ""lines"": 2}, ""runtime/autoload/pythoncomplete.vim"": {""insertions"": 1, ""deletions"": 1, ""lines"": 2}, ""runtime/autoload/sqlcomplete.vim"": {""insertions"": 7, ""deletions"": 7, ""lines"": 14}, ""runtime/autoload/tar.vim"": {""insertions"": 1, ""deletions"": 1, ""lines"": 2}, ""runtime/autoload/tohtml.vim"": {""insertions"": 1, ""deletions"": 1, ""lines"": 2}, ""runtime/autoload/xmlcomplete.vim"": {""insertions"": 1, ""deletions"": 1, ""lines"": 2}, ""runtime/autoload/zip.vim"": {""insertions"": 1, ""deletions"": 1, ""lines"": 2}, ""runtime/compiler/fpc.vim"": {""insertions"": 1, ""deletions"": 1, ""lines"": 2}, ""runtime/compiler/tex.vim"": {""insertions"": 1, ""deletions"": 1, ""lines"": 2}, ""runtime/doc/eval.txt"": {""insertions"": 6, ""deletions"": 3, ""lines"": 9}, ""runtime/doc/index.txt"": {""insertions"": 1, ""deletions"": 1, ""lines"": 2}, ""runtime/doc/insert.txt"": {""insertions"": 1, ""deletions"": 1, ""lines"": 2}, ""runtime/doc/options.txt"": {""insertions"": 3, ""deletions"": 1, ""lines"": 4}, ""runtime/doc/repeat.txt"": {""insertions"": 6, ""deletions"": 2, ""lines"": 8}, ""runtime/doc/tags"": {""insertions"": 4, ""deletions"": 0, ""lines"": 4}, ""runtime/doc/todo.txt"": {""insertions"": 10, ""deletions"": 8, ""lines"": 18}, ""runtime/doc/various.txt"": {""insertions"": 2, ""deletions"": 2, ""lines"": 4}, ""runtime/doc/vim9.txt"": {""insertions"": 3, ""deletions"": 4, ""lines"": 7}, ""runtime/doc/windows.txt"": {""insertions"": 4, ""deletions"": 3, ""lines"": 7}, ""runtime/filetype.vim"": {""insertions"": 1, ""deletions"": 1, ""lines"": 2}, ""runtime/ftplugin/dosini.vim"": {""insertions"": 1, ""deletions"": 1, ""lines"": 2}, ""runtime/ftplugin/matlab.vim"": {""insertions"": 4, ""deletions"": 3, ""lines"": 7}, ""runtime/ftplugin/ocaml.vim"": {""insertions"": 4, ""deletions"": 4, ""lines"": 8}, ""runtime/ftplugin/octave.vim"": {""insertions"": 63, ""deletions"": 0, ""lines"": 63}, ""runtime/ftplugin/systemverilog.vim"": {""insertions"": 1, ""deletions"": 1, ""lines"": 2}, ""runtime/ftplugin/tex.vim"": {""insertions"": 1, ""deletions"": 1, ""lines"": 2}, ""runtime/indent/ada.vim"": {""insertions"": 1, ""deletions"": 1, ""lines"": 2}, ""runtime/indent/cdl.vim"": {""insertions"": 6, ""deletions"": 6, ""lines"": 12}, ""runtime/indent/config.vim"": {""insertions"": 2, ""deletions"": 2, ""lines"": 4}, ""runtime/indent/dtd.vim"": {""insertions"": 3, ""deletions"": 3, ""lines"": 6}, ""runtime/indent/erlang.vim"": {""insertions"": 4, ""deletions"": 4, ""lines"": 8}, ""runtime/indent/json.vim"": {""insertions"": 1, ""deletions"": 1, ""lines"": 2}, ""runtime/indent/lifelines.vim"": {""insertions"": 1, ""deletions"": 1, ""lines"": 2}, ""runtime/indent/objc.vim"": {""insertions"": 1, ""deletions"": 1, ""lines"": 2}, ""runtime/indent/pov.vim"": {""insertions"": 1, ""deletions"": 1, ""lines"": 2}, ""runtime/indent/ruby.vim"": {""insertions"": 1, ""deletions"": 1, ""lines"": 2}, ""runtime/indent/sqlanywhere.vim"": {""insertions"": 1, ""deletions"": 1, ""lines"": 2}, ""runtime/indent/systemverilog.vim"": {""insertions"": 2, ""deletions"": 2, ""lines"": 4}, ""runtime/indent/tex.vim"": {""insertions"": 1, ""deletions"": 1, ""lines"": 2}, ""runtime/indent/treetop.vim"": {""insertions"": 1, ""deletions"": 1, ""lines"": 2}, ""runtime/indent/typescript.vim"": {""insertions"": 1, ""deletions"": 1, ""lines"": 2}, ""runtime/indent/verilog.vim"": {""insertions"": 2, ""deletions"": 2, ""lines"": 4}, ""runtime/keymap/kana.vim"": {""insertions"": 2, ""deletions"": 2, ""lines"": 4}, ""runtime/keymap/korean.vim"": {""insertions"": 1, ""deletions"": 1, ""lines"": 2}, ""runtime/keymap/russian-jcukenwintype.vim"": {""insertions"": 1, ""deletions"": 1, ""lines"": 2}, ""runtime/keymap/russian-typograph.vim"": {""insertions"": 2, ""deletions"": 2, ""lines"": 4}, ""runtime/plugin/tohtml.vim"": {""insertions"": 1, ""deletions"": 1, ""lines"": 2}, ""runtime/syntax/2html.vim"": {""insertions"": 2, ""deletions"": 2, ""lines"": 4}, ""runtime/syntax/abel.vim"": {""insertions"": 1, ""deletions"": 1, ""lines"": 2}, ""runtime/syntax/ada.vim"": {""insertions"": 1, ""deletions"": 1, ""lines"": 2}, ""runtime/syntax/ahdl.vim"": {""insertions"": 1, ""deletions"": 1, ""lines"": 2}, ""runtime/syntax/aspvbs.vim"": {""insertions"": 5, ""deletions"": 5, ""lines"": 10}, ""runtime/syntax/cfg.vim"": {""insertions"": 1, ""deletions"": 1, ""lines"": 2}, ""runtime/syntax/csc.vim"": {""insertions"": 1, ""deletions"": 1, ""lines"": 2}, ""runtime/syntax/cupl.vim"": {""insertions"": 1, ""deletions"": 1, ""lines"": 2}, ""runtime/syntax/dosbatch.vim"": {""insertions"": 1, ""deletions"": 1, ""lines"": 2}, ""runtime/syntax/doxygen.vim"": {""insertions"": 4, ""deletions"": 4, ""lines"": 8}, ""runtime/syntax/focexec.vim"": {""insertions"": 1, ""deletions"": 1, ""lines"": 2}, ""runtime/syntax/forth.vim"": {""insertions"": 1, ""deletions"": 1, ""lines"": 2}, ""runtime/syntax/hamster.vim"": {""insertions"": 1, ""deletions"": 1, ""lines"": 2}, ""runtime/syntax/idl.vim"": {""insertions"": 1, ""deletions"": 1, ""lines"": 2}, ""runtime/syntax/iss.vim"": {""insertions"": 2, ""deletions"": 2, ""lines"": 4}, ""runtime/syntax/mma.vim"": {""insertions"": 2, ""deletions"": 2, ""lines"": 4}, ""runtime/syntax/objc.vim"": {""insertions"": 1, ""deletions"": 1, ""lines"": 2}, ""runtime/syntax/postscr.vim"": {""insertions"": 6, ""deletions"": 6, ""lines"": 12}, ""runtime/syntax/sgml.vim"": {""insertions"": 3, ""deletions"": 3, ""lines"": 6}, ""runtime/syntax/spup.vim"": {""insertions"": 3, ""deletions"": 3, ""lines"": 6}, ""runtime/syntax/st.vim"": {""insertions"": 2, ""deletions"": 2, ""lines"": 4}, ""runtime/syntax/tcl.vim"": {""insertions"": 1, ""deletions"": 1, ""lines"": 2}, ""runtime/syntax/tmux.vim"": {""insertions"": 1, ""deletions"": 1, ""lines"": 2}}"
2021-09-09 18:45:34,d176ca3dde47c11aae0376c31b7e1ba0939c8c6c,Dominique Pelle,21,2,23,4,"{""src/testdir/test_functions.vim"": {""insertions"": 1, ""deletions"": 0, ""lines"": 1}, ""src/testdir/test_history.vim"": {""insertions"": 16, ""deletions"": 0, ""lines"": 16}, ""src/testdir/test_startup.vim"": {""insertions"": 2, ""deletions"": 2, ""lines"": 4}, ""src/version.c"": {""insertions"": 2, ""deletions"": 0, ""lines"": 2}}"
2021-09-09 15:14:50,6b9efdde7828b3317b64f38bd90fb5a784a654c0,Christian Brabandt,9,3,12,3,"{""src/auto/configure"": {""insertions"": 4, ""deletions"": 2, ""lines"": 6}, ""src/configure.ac"": {""insertions"": 3, ""deletions"": 1, ""lines"": 4}, ""src/version.c"": {""insertions"": 2, ""deletions"": 0, ""lines"": 2}}"
2021-09-09 10:34:19,0325d3967ce7d0fd35bc1472fd476b911b895b76,Bram Moolenaar,11,17,28,3,"{""src/debugger.c"": {""insertions"": 8, ""deletions"": 14, ""lines"": 22}, ""src/testdir/test_debugger.vim"": {""insertions"": 1, ""deletions"": 3, ""lines"": 4}, ""src/version.c"": {""insertions"": 2, ""deletions"": 0, ""lines"": 2}}"
2021-09-09 10:12:03,070ac3433b0ebefd6dc6cd49707fcfa1421b9e67,Christian Brabandt,5,0,5,2,"{""src/eval.c"": {""insertions"": 3, ""deletions"": 0, ""lines"": 3}, ""src/version.c"": {""insertions"": 2, ""deletions"": 0, ""lines"": 2}}"
2021-09-08 18:40:34,072f1c68884a1e2d468a0f39e27fc28168fb4b03,Bram Moolenaar,57,8,65,3,"{""src/debugger.c"": {""insertions"": 26, ""deletions"": 8, ""lines"": 34}, ""src/testdir/test_debugger.vim"": {""insertions"": 29, ""deletions"": 0, ""lines"": 29}, ""src/version.c"": {""insertions"": 2, ""deletions"": 0, ""lines"": 2}}"
2021-09-08 13:33:30,36f691f5f1d0676f080cc97d697d742ed5cc8251,Bram Moolenaar,27,1,28,3,"{""src/testdir/test_trycatch.vim"": {""insertions"": 24, ""deletions"": 0, ""lines"": 24}, ""src/userfunc.c"": {""insertions"": 1, ""deletions"": 1, ""lines"": 2}, ""src/version.c"": {""insertions"": 2, ""deletions"": 0, ""lines"": 2}}"
2021-09-08 12:57:42,fc3b775055c2361e507a1a44008d5a7d37eecf14,Yegappan Lakshmanan,115,13,128,7,"{""src/channel.c"": {""insertions"": 1, ""deletions"": 1, ""lines"": 2}, ""src/digraph.c"": {""insertions"": 2, ""deletions"": 2, ""lines"": 4}, ""src/evalfunc.c"": {""insertions"": 2, ""deletions"": 6, ""lines"": 8}, ""src/terminal.c"": {""insertions"": 1, ""deletions"": 1, ""lines"": 2}, ""src/testdir/test_digraph.vim"": {""insertions"": 11, ""deletions"": 1, ""lines"": 12}, ""src/testdir/test_vim9_builtin.vim"": {""insertions"": 96, ""deletions"": 2, ""lines"": 98}, ""src/version.c"": {""insertions"": 2, ""deletions"": 0, ""lines"": 2}}"
2021-09-08 12:29:46,80c88eac5a81dd9f1a96fc80cb8aab6c84fe7b86,Bram Moolenaar,41,5,46,5,"{""src/ex_docmd.c"": {""insertions"": 3, ""deletions"": 3, ""lines"": 6}, ""src/proto/usercmd.pro"": {""insertions"": 2, ""deletions"": 1, ""lines"": 3}, ""src/testdir/test_cmdline.vim"": {""insertions"": 7, ""deletions"": 0, ""lines"": 7}, ""src/usercmd.c"": {""insertions"": 27, ""deletions"": 1, ""lines"": 28}, ""src/version.c"": {""insertions"": 2, ""deletions"": 0, ""lines"": 2}}"
2021-09-08 10:31:35,a9e3d560877489acf751f99e045ab1d78e13249c,Bram Moolenaar,31,5,36,4,"{""src/errors.h"": {""insertions"": 2, ""deletions"": 2, ""lines"": 4}, ""src/testdir/test_vim9_script.vim"": {""insertions"": 17, ""deletions"": 0, ""lines"": 17}, ""src/version.c"": {""insertions"": 2, ""deletions"": 0, ""lines"": 2}, ""src/vim9script.c"": {""insertions"": 10, ""deletions"": 3, ""lines"": 13}}"
2021-09-07 20:35:34,af2d5d2ce26029a47547c05be964e749bb0310d0,Bram Moolenaar,5,2,7,2,"{""src/testdir/test_vim9_script.vim"": {""insertions"": 3, ""deletions"": 2, ""lines"": 5}, ""src/version.c"": {""insertions"": 2, ""deletions"": 0, ""lines"": 2}}"
2021-09-07 20:12:19,6853c38b78fe5333f95470e1ff3ca6741247e600,Bram Moolenaar,25,0,25,4,"{""src/errors.h"": {""insertions"": 2, ""deletions"": 0, ""lines"": 2}, ""src/evalvars.c"": {""insertions"": 6, ""deletions"": 0, ""lines"": 6}, ""src/testdir/test_vim9_script.vim"": {""insertions"": 15, ""deletions"": 0, ""lines"": 15}, ""src/version.c"": {""insertions"": 2, ""deletions"": 0, ""lines"": 2}}"
2021-09-07 18:45:31,89a54b413a8c96206ce7e038dde81a6eff6cd6b8,Bram Moolenaar,48,31,79,3,"{""src/drawline.c"": {""insertions"": 36, ""deletions"": 31, ""lines"": 67}, ""src/testdir/test_listlbr_utf8.vim"": {""insertions"": 10, ""deletions"": 0, ""lines"": 10}, ""src/version.c"": {""insertions"": 2, ""deletions"": 0, ""lines"": 2}}"
2021-09-07 17:26:53,65b605665997fad54ef39a93199e305af2fe4d7f,Bram Moolenaar,12,1,13,3,"{""src/regexp_nfa.c"": {""insertions"": 2, ""deletions"": 1, ""lines"": 3}, ""src/testdir/test_regexp_utf8.vim"": {""insertions"": 8, ""deletions"": 0, ""lines"": 8}, ""src/version.c"": {""insertions"": 2, ""deletions"": 0, ""lines"": 2}}"
2021-09-06 18:56:56,ddfc05100a29263a682dd96bb924dfde4354a654,Bram Moolenaar,14,0,14,3,"{""src/testdir/test_user_func.vim"": {""insertions"": 5, ""deletions"": 0, ""lines"": 5}, ""src/userfunc.c"": {""insertions"": 7, ""deletions"": 0, ""lines"": 7}, ""src/version.c"": {""insertions"": 2, ""deletions"": 0, ""lines"": 2}}"
2021-09-06 17:19:45,3b318513561b5862944769188ae4af6b70311838,Bram Moolenaar,3,0,3,2,"{""src/dict.c"": {""insertions"": 1, ""deletions"": 0, ""lines"": 1}, ""src/version.c"": {""insertions"": 2, ""deletions"": 0, ""lines"": 2}}"
2021-09-06 16:57:30,3ae5fc9a6a881e0be381e4cc70080ac5908d7520,Bram Moolenaar,12,0,12,3,"{""src/auto/configure"": {""insertions"": 4, ""deletions"": 0, ""lines"": 4}, ""src/configure.ac"": {""insertions"": 6, ""deletions"": 0, ""lines"": 6}, ""src/version.c"": {""insertions"": 2, ""deletions"": 0, ""lines"": 2}}"
2021-09-06 15:10:59,ec1b0968aa90d408a79b5b5dca465f65e69753a1,Bram Moolenaar,13,1,14,3,"{""src/ex_docmd.c"": {""insertions"": 9, ""deletions"": 0, ""lines"": 9}, ""src/testdir/test_usercommands.vim"": {""insertions"": 2, ""deletions"": 1, ""lines"": 3}, ""src/version.c"": {""insertions"": 2, ""deletions"": 0, ""lines"": 2}}"
2021-09-05 14:36:23,01dd6c3732a2f352d598e36336a65049614d7508,Bram Moolenaar,12,2,14,3,"{""src/testdir/test_vim9_func.vim"": {""insertions"": 4, ""deletions"": 0, ""lines"": 4}, ""src/userfunc.c"": {""insertions"": 6, ""deletions"": 2, ""lines"": 8}, ""src/version.c"": {""insertions"": 2, ""deletions"": 0, ""lines"": 2}}"
2021-09-04 19:20:41,2ddb89f8a94425cda1e5491efc80c1ccccb6e08e,Bram Moolenaar,13,2,15,2,"{""src/indent.c"": {""insertions"": 11, ""deletions"": 2, ""lines"": 13}, ""src/version.c"": {""insertions"": 2, ""deletions"": 0, ""lines"": 2}}"
2021-09-04 16:47:28,b7081e135a16091c93f6f5f7525a5c58fb7ca9f9,Bram Moolenaar,34,21,55,5,"{""src/indent.c"": {""insertions"": 21, ""deletions"": 13, ""lines"": 34}, ""src/option.c"": {""insertions"": 6, ""deletions"": 6, ""lines"": 12}, ""src/optionstr.c"": {""insertions"": 2, ""deletions"": 2, ""lines"": 4}, ""src/testdir/test_retab.vim"": {""insertions"": 3, ""deletions"": 0, ""lines"": 3}, ""src/version.c"": {""insertions"": 2, ""deletions"": 0, ""lines"": 2}}"
2021-09-04 12:49:56,10c83dde554b57ab4db71b96a0a02a5b6d1798e9,Bram Moolenaar,18,2,20,3,"{""src/evalfunc.c"": {""insertions"": 2, ""deletions"": 2, ""lines"": 4}, ""src/testdir/test_vim9_builtin.vim"": {""insertions"": 14, ""deletions"": 0, ""lines"": 14}, ""src/version.c"": {""insertions"": 2, ""deletions"": 0, ""lines"": 2}}"
2021-09-04 11:44:01,7f2dd1e90c1d4a30c791fae20014594641769a1e,Dominique Pelle,45,8,53,5,"{""runtime/doc/various.txt"": {""insertions"": 8, ""deletions"": 3, ""lines"": 11}, ""src/ex_cmds.c"": {""insertions"": 1, ""deletions"": 1, ""lines"": 2}, ""src/ex_cmds.h"": {""insertions"": 1, ""deletions"": 1, ""lines"": 2}, ""src/testdir/test_ex_z.vim"": {""insertions"": 33, ""deletions"": 3, ""lines"": 36}, ""src/version.c"": {""insertions"": 2, ""deletions"": 0, ""lines"": 2}}"
2021-09-03 17:21:36,deba5eb195d6ac70171d4973091fa884809fa3fa,Bram Moolenaar,116,5,121,5,"{""runtime/autoload/dist/ft.vim"": {""insertions"": 15, ""deletions"": 4, ""lines"": 19}, ""runtime/doc/filetype.txt"": {""insertions"": 1, ""deletions"": 0, ""lines"": 1}, ""runtime/filetype.vim"": {""insertions"": 4, ""deletions"": 1, ""lines"": 5}, ""src/testdir/test_filetype.vim"": {""insertions"": 94, ""deletions"": 0, ""lines"": 94}, ""src/version.c"": {""insertions"": 2, ""deletions"": 0, ""lines"": 2}}"
2021-09-03 14:50:16,af631f61bc42d0dddafe1bc0c06872cf3aaeb239,Dominique Pelle,116,94,210,2,"{""src/testdir/test_textobjects.vim"": {""insertions"": 114, ""deletions"": 94, ""lines"": 208}, ""src/version.c"": {""insertions"": 2, ""deletions"": 0, ""lines"": 2}}"
2021-09-02 18:05:26,03d257998b6343fc91f9dfd5ffc92eebe98d4d24,Yegappan Lakshmanan,20,0,20,2,"{""src/testdir/test_breakindent.vim"": {""insertions"": 18, ""deletions"": 0, ""lines"": 18}, ""src/version.c"": {""insertions"": 2, ""deletions"": 0, ""lines"": 2}}"
2021-09-02 17:53:07,87e1587b8add93e40340170e4261cdadc4c8940e,Bram Moolenaar,7,0,7,2,"{""src/evalfunc.c"": {""insertions"": 5, ""deletions"": 0, ""lines"": 5}, ""src/version.c"": {""insertions"": 2, ""deletions"": 0, ""lines"": 2}}"
2021-09-02 16:49:06,26a4484da20039b61f18d3565a4b4339c4d1f7e3,Bram Moolenaar,75,5,80,8,"{""src/debugger.c"": {""insertions"": 28, ""deletions"": 0, ""lines"": 28}, ""src/proto/debugger.pro"": {""insertions"": 1, ""deletions"": 0, ""lines"": 1}, ""src/proto/vim9execute.pro"": {""insertions"": 1, ""deletions"": 0, ""lines"": 1}, ""src/testdir/test_debugger.vim"": {""insertions"": 21, ""deletions"": 0, ""lines"": 21}, ""src/version.c"": {""insertions"": 2, ""deletions"": 0, ""lines"": 2}, ""src/vim.h"": {""insertions"": 9, ""deletions"": 2, ""lines"": 11}, ""src/vim9.h"": {""insertions"": 2, ""deletions"": 2, ""lines"": 4}, ""src/vim9execute.c"": {""insertions"": 11, ""deletions"": 1, ""lines"": 12}}"
2021-09-01 14:02:07,04626c243c47af91c2580eaf23e12286180e0e81,Bram Moolenaar,86,1,87,6,"{""src/diff.c"": {""insertions"": 13, ""deletions"": 0, ""lines"": 13}, ""src/move.c"": {""insertions"": 7, ""deletions"": 1, ""lines"": 8}, ""src/testdir/dumps/Test_diff_scroll_change_01.dump"": {""insertions"": 20, ""deletions"": 0, ""lines"": 20}, ""src/testdir/dumps/Test_diff_scroll_change_02.dump"": {""insertions"": 20, ""deletions"": 0, ""lines"": 20}, ""src/testdir/test_diffmode.vim"": {""insertions"": 24, ""deletions"": 0, ""lines"": 24}, ""src/version.c"": {""insertions"": 2, ""deletions"": 0, ""lines"": 2}}"
2021-09-01 12:31:51,6631597452d4644f485a09e4036d117e5f91de70,Bram Moolenaar,13,10,23,3,"{""src/strings.c"": {""insertions"": 1, ""deletions"": 0, ""lines"": 1}, ""src/testdir/test_shell.vim"": {""insertions"": 10, ""deletions"": 10, ""lines"": 20}, ""src/version.c"": {""insertions"": 2, ""deletions"": 0, ""lines"": 2}}"
2021-09-01 11:03:39,b4d82e2a8d610c00139a74970df772eece2daf1c,Bram Moolenaar,9,5,14,3,"{""src/cmdexpand.c"": {""insertions"": 2, ""deletions"": 2, ""lines"": 4}, ""src/testdir/test_cmdline.vim"": {""insertions"": 5, ""deletions"": 3, ""lines"": 8}, ""src/version.c"": {""insertions"": 2, ""deletions"": 0, ""lines"": 2}}"
2021-08-31 18:57:55,20e0c3d27bda770542c1c0e4c81fd6443c12f3a6,Bram Moolenaar,10,3,13,2,"{""src/drawline.c"": {""insertions"": 8, ""deletions"": 3, ""lines"": 11}, ""src/version.c"": {""insertions"": 2, ""deletions"": 0, ""lines"": 2}}"
2021-08-31 18:46:39,ba02e4720f863fdb456e7023520f0a354eec0dcf,Christian Brabandt,239,144,383,16,"{""src/diff.c"": {""insertions"": 1, ""deletions"": 1, ""lines"": 2}, ""src/version.c"": {""insertions"": 2, ""deletions"": 0, ""lines"": 2}, ""src/xdiff/README.txt"": {""insertions"": 1, ""deletions"": 1, ""lines"": 2}, ""src/xdiff/xdiff.h"": {""insertions"": 24, ""deletions"": 13, ""lines"": 37}, ""src/xdiff/xdiffi.c"": {""insertions"": 117, ""deletions"": 59, ""lines"": 176}, ""src/xdiff/xdiffi.h"": {""insertions"": 1, ""deletions"": 1, ""lines"": 2}, ""src/xdiff/xemit.c"": {""insertions"": 26, ""deletions"": 10, ""lines"": 36}, ""src/xdiff/xemit.h"": {""insertions"": 1, ""deletions"": 1, ""lines"": 2}, ""src/xdiff/xhistogram.c"": {""insertions"": 8, ""deletions"": 8, ""lines"": 16}, ""src/xdiff/xinclude.h"": {""insertions"": 8, ""deletions"": 2, ""lines"": 10}, ""src/xdiff/xmacros.h"": {""insertions"": 1, ""deletions"": 1, ""lines"": 2}, ""src/xdiff/xpatience.c"": {""insertions"": 23, ""deletions"": 30, ""lines"": 53}, ""src/xdiff/xprepare.h"": {""insertions"": 1, ""deletions"": 1, ""lines"": 2}, ""src/xdiff/xtypes.h"": {""insertions"": 1, ""deletions"": 1, ""lines"": 2}, ""src/xdiff/xutils.c"": {""insertions"": 23, ""deletions"": 14, ""lines"": 37}, ""src/xdiff/xutils.h"": {""insertions"": 1, ""deletions"": 1, ""lines"": 2}}"
2021-08-31 17:12:51,dca29d9cf46cd1d4d4519211c7af78b6b1c56960,zeertzjq,119,7,126,5,"{""runtime/doc/index.txt"": {""insertions"": 1, ""deletions"": 0, ""lines"": 1}, ""runtime/doc/insert.txt"": {""insertions"": 8, ""deletions"": 0, ""lines"": 8}, ""src/insexpand.c"": {""insertions"": 48, ""deletions"": 7, ""lines"": 55}, ""src/testdir/test_ins_complete.vim"": {""insertions"": 60, ""deletions"": 0, ""lines"": 60}, ""src/version.c"": {""insertions"": 2, ""deletions"": 0, ""lines"": 2}}"
2021-08-30 19:26:16,4eaef9979fc5032606897963f1af37674ee0d422,Bram Moolenaar,11,1,12,3,"{""src/os_unix.c"": {""insertions"": 7, ""deletions"": 1, ""lines"": 8}, ""src/testdir/test_fnamemodify.vim"": {""insertions"": 2, ""deletions"": 0, ""lines"": 2}, ""src/version.c"": {""insertions"": 2, ""deletions"": 0, ""lines"": 2}}"
2021-08-30 17:57:34,de05ae71589f46c5d27642c33fe5eb21b22aaf5d,Dominique Pelle,3,1,4,2,"{""src/strings.c"": {""insertions"": 1, ""deletions"": 1, ""lines"": 2}, ""src/version.c"": {""insertions"": 2, ""deletions"": 0, ""lines"": 2}}"
2021-08-29 20:12:56,a91871262670f9d3a4e5d1c5c6dbc02f85625f7d,Dominique Pelle,3,0,3,2,"{""src/indent.c"": {""insertions"": 1, ""deletions"": 0, ""lines"": 1}, ""src/version.c"": {""insertions"": 2, ""deletions"": 0, ""lines"": 2}}"
2021-08-29 19:55:35,89a9c159f23fb7b3e24e6d09068adfc24a73afcb,Bram Moolenaar,649,242,891,39,"{"".github/workflows/codeql-analysis.yml"": {""insertions"": 1, ""deletions"": 1, ""lines"": 2}, ""CONTRIBUTING.md"": {""insertions"": 1, ""deletions"": 1, ""lines"": 2}, ""README.md"": {""insertions"": 7, ""deletions"": 7, ""lines"": 14}, ""README.txt"": {""insertions"": 6, ""deletions"": 6, ""lines"": 12}, ""README_VIM9.md"": {""insertions"": 1, ""deletions"": 1, ""lines"": 2}, ""nsis/lang/turkish.nsi"": {""insertions"": 7, ""deletions"": 7, ""lines"": 14}, ""pixmaps/gen-inline-pixbufs.sh"": {""insertions"": 2, ""deletions"": 4, ""lines"": 6}, ""runtime/autoload/netrw.vim"": {""insertions"": 213, ""deletions"": 80, ""lines"": 293}, ""runtime/autoload/netrwSettings.vim"": {""insertions"": 4, ""deletions"": 4, ""lines"": 8}, ""runtime/doc/eval.txt"": {""insertions"": 16, ""deletions"": 16, ""lines"": 32}, ""runtime/doc/index.txt"": {""insertions"": 1, ""deletions"": 1, ""lines"": 2}, ""runtime/doc/insert.txt"": {""insertions"": 1, ""deletions"": 1, ""lines"": 2}, ""runtime/doc/options.txt"": {""insertions"": 11, ""deletions"": 4, ""lines"": 15}, ""runtime/doc/pi_netrw.txt"": {""insertions"": 72, ""deletions"": 12, ""lines"": 84}, ""runtime/doc/popup.txt"": {""insertions"": 18, ""deletions"": 7, ""lines"": 25}, ""runtime/doc/syntax.txt"": {""insertions"": 6, ""deletions"": 5, ""lines"": 11}, ""runtime/doc/tags"": {""insertions"": 5, ""deletions"": 0, ""lines"": 5}, ""runtime/doc/term.txt"": {""insertions"": 37, ""deletions"": 1, ""lines"": 38}, ""runtime/doc/terminal.txt"": {""insertions"": 15, ""deletions"": 13, ""lines"": 28}, ""runtime/doc/testing.txt"": {""insertions"": 16, ""deletions"": 8, ""lines"": 24}, ""runtime/doc/textprop.txt"": {""insertions"": 1, ""deletions"": 1, ""lines"": 2}, ""runtime/doc/todo.txt"": {""insertions"": 5, ""deletions"": 1, ""lines"": 6}, ""runtime/doc/version6.txt"": {""insertions"": 1, ""deletions"": 1, ""lines"": 2}, ""runtime/doc/vim9.txt"": {""insertions"": 9, ""deletions"": 6, ""lines"": 15}, ""runtime/filetype.vim"": {""insertions"": 1, ""deletions"": 1, ""lines"": 2}, ""runtime/ftplugin/scala.vim"": {""insertions"": 3, ""deletions"": 3, ""lines"": 6}, ""runtime/indent/scala.vim"": {""insertions"": 6, ""deletions"": 3, ""lines"": 9}, ""runtime/pack/dist/opt/termdebug/plugin/termdebug.vim"": {""insertions"": 5, ""deletions"": 1, ""lines"": 6}, ""runtime/plugin/netrwPlugin.vim"": {""insertions"": 21, ""deletions"": 7, ""lines"": 28}, ""runtime/syntax/cpp.vim"": {""insertions"": 19, ""deletions"": 2, ""lines"": 21}, ""runtime/syntax/gemtext.vim"": {""insertions"": 24, ""deletions"": 0, ""lines"": 24}, ""runtime/syntax/scala.vim"": {""insertions"": 12, ""deletions"": 12, ""lines"": 24}, ""runtime/syntax/structurizr.vim"": {""insertions"": 76, ""deletions"": 0, ""lines"": 76}, ""runtime/tutor/tutor"": {""insertions"": 5, ""deletions"": 5, ""lines"": 10}, ""runtime/tutor/tutor.utf-8"": {""insertions"": 5, ""deletions"": 5, ""lines"": 10}, ""src/INSTALL"": {""insertions"": 1, ""deletions"": 0, ""lines"": 1}, ""src/gvimtutor"": {""insertions"": 1, ""deletions"": 1, ""lines"": 2}, ""src/vimtutor"": {""insertions"": 13, ""deletions"": 13, ""lines"": 26}, ""vimtutor.bat"": {""insertions"": 1, ""deletions"": 1, ""lines"": 2}}"
2021-08-29 10:36:49,6e82351130ddb8d13cf3748b47f07cae77886fc7,Jason Cox,38,8,46,4,"{""runtime/doc/eval.txt"": {""insertions"": 4, ""deletions"": 0, ""lines"": 4}, ""src/strings.c"": {""insertions"": 21, ""deletions"": 0, ""lines"": 21}, ""src/testdir/test_shell.vim"": {""insertions"": 11, ""deletions"": 8, ""lines"": 19}, ""src/version.c"": {""insertions"": 2, ""deletions"": 0, ""lines"": 2}}"
2021-08-28 18:42:50,9dcd349ca85e1df1abd1cbf1c29c0f1574b70bf8,Hu Jialun,21,2,23,4,"{""runtime/doc/options.txt"": {""insertions"": 9, ""deletions"": 0, ""lines"": 9}, ""src/buffer.c"": {""insertions"": 2, ""deletions"": 2, ""lines"": 4}, ""src/testdir/test_modeline.vim"": {""insertions"": 8, ""deletions"": 0, ""lines"": 8}, ""src/version.c"": {""insertions"": 2, ""deletions"": 0, ""lines"": 2}}"
2021-08-28 13:56:06,9aecf79c45da5593e4d8c0de1b2d212edc4765ce,naohiro ono,7,2,9,3,"{""src/testdir/test_cmdline.vim"": {""insertions"": 3, ""deletions"": 1, ""lines"": 4}, ""src/userfunc.c"": {""insertions"": 2, ""deletions"": 1, ""lines"": 3}, ""src/version.c"": {""insertions"": 2, ""deletions"": 0, ""lines"": 2}}"
2021-08-28 12:58:44,c8103b4c2547ce2044469bcd49e3d55907bd33d1,Bram Moolenaar,14,2,16,3,"{""src/testdir/test_vim9_builtin.vim"": {""insertions"": 9, ""deletions"": 0, ""lines"": 9}, ""src/version.c"": {""insertions"": 2, ""deletions"": 0, ""lines"": 2}, ""src/vim9type.c"": {""insertions"": 3, ""deletions"": 2, ""lines"": 5}}"
2021-08-28 12:42:25,5c56da4de8398566ef96122db44ec93e6c2d483a,Bram Moolenaar,10,1,11,3,"{""src/globals.h"": {""insertions"": 1, ""deletions"": 1, ""lines"": 2}, ""src/testdir/test_signs.vim"": {""insertions"": 7, ""deletions"": 0, ""lines"": 7}, ""src/version.c"": {""insertions"": 2, ""deletions"": 0, ""lines"": 2}}"
2021-08-28 10:49:27,60b6e6f6cc60ac99253e1c13bd0cae4ef0e43201,Bram Moolenaar,8,0,8,3,"{""src/evalfunc.c"": {""insertions"": 5, ""deletions"": 0, ""lines"": 5}, ""src/testdir/test_expr.vim"": {""insertions"": 1, ""deletions"": 0, ""lines"": 1}, ""src/version.c"": {""insertions"": 2, ""deletions"": 0, ""lines"": 2}}"
2021-08-28 10:30:12,271906bc067a8f25422016665001d2e44cf618e2,Bram Moolenaar,10,1,11,3,"{""src/job.c"": {""insertions"": 4, ""deletions"": 1, ""lines"": 5}, ""src/testdir/test_channel.vim"": {""insertions"": 4, ""deletions"": 0, ""lines"": 4}, ""src/version.c"": {""insertions"": 2, ""deletions"": 0, ""lines"": 2}}"
2021-08-27 18:59:35,6024c0427ce1196344439997d5e41a6f8546368c,Albert Liu,9,7,16,3,"{""src/cmdexpand.c"": {""insertions"": 3, ""deletions"": 7, ""lines"": 10}, ""src/testdir/test_cmdline.vim"": {""insertions"": 4, ""deletions"": 0, ""lines"": 4}, ""src/version.c"": {""insertions"": 2, ""deletions"": 0, ""lines"": 2}}"
2021-08-26 14:39:58,47016f57724d3970c54f4ca1f392dff39d3fecae,Bram Moolenaar,13,1,14,3,"{""src/cmdexpand.c"": {""insertions"": 3, ""deletions"": 1, ""lines"": 4}, ""src/testdir/test_cmdline.vim"": {""insertions"": 8, ""deletions"": 0, ""lines"": 8}, ""src/version.c"": {""insertions"": 2, ""deletions"": 0, ""lines"": 2}}"
2021-08-25 20:37:36,4799cef85ce43e26f5022290b41a7c85bbab8cad,Bram Moolenaar,32,15,47,5,"{""src/ex_eval.c"": {""insertions"": 21, ""deletions"": 9, ""lines"": 30}, ""src/proto/ex_eval.pro"": {""insertions"": 1, ""deletions"": 0, ""lines"": 1}, ""src/testdir/test_vim9_cmd.vim"": {""insertions"": 7, ""deletions"": 1, ""lines"": 8}, ""src/version.c"": {""insertions"": 2, ""deletions"": 0, ""lines"": 2}, ""src/vim9compile.c"": {""insertions"": 1, ""deletions"": 5, ""lines"": 6}}"
2021-08-25 15:31:37,df9070e300dabf0c54de87a75973a80adb38afa3,Bram Moolenaar,4,1,5,2,"{""src/memline.c"": {""insertions"": 2, ""deletions"": 1, ""lines"": 3}, ""src/version.c"": {""insertions"": 2, ""deletions"": 0, ""lines"": 2}}"
2021-08-25 15:10:39,eb05d05f8a049b32ba1b992074534ca4763e46b3,Bram Moolenaar,6,0,6,3,"{""runtime/filetype.vim"": {""insertions"": 3, ""deletions"": 0, ""lines"": 3}, ""src/testdir/test_filetype.vim"": {""insertions"": 1, ""deletions"": 0, ""lines"": 1}, ""src/version.c"": {""insertions"": 2, ""deletions"": 0, ""lines"": 2}}"
2021-08-25 15:02:00,49b93049c68653156609ebcdf22311ccbcdf00e2,Bram Moolenaar,3,0,3,2,"{""src/testdir/test_textprop.vim"": {""insertions"": 1, ""deletions"": 0, ""lines"": 1}, ""src/version.c"": {""insertions"": 2, ""deletions"": 0, ""lines"": 2}}"
2021-08-25 14:40:03,cdd8a5e6fe089a3b1370ac940d06fc3cefc6f8f2,Bram Moolenaar,22,1,23,3,"{""src/memline.c"": {""insertions"": 11, ""deletions"": 1, ""lines"": 12}, ""src/testdir/test_textprop.vim"": {""insertions"": 9, ""deletions"": 0, ""lines"": 9}, ""src/version.c"": {""insertions"": 2, ""deletions"": 0, ""lines"": 2}}"
2021-08-24 19:56:03,5ca5cc6412d7d68fd380926f9551a8b7ba335199,Bram Moolenaar,28,4,32,4,"{""src/ex_docmd.c"": {""insertions"": 8, ""deletions"": 4, ""lines"": 12}, ""src/testdir/test_vim9_cmd.vim"": {""insertions"": 16, ""deletions"": 0, ""lines"": 16}, ""src/version.c"": {""insertions"": 2, ""deletions"": 0, ""lines"": 2}, ""src/vim9compile.c"": {""insertions"": 2, ""deletions"": 0, ""lines"": 2}}"
2021-08-23 20:22:45,60faf8656e1a100778bf7cd4d305380fb852d540,Bram Moolenaar,11,1,12,3,"{""src/eval.c"": {""insertions"": 7, ""deletions"": 1, ""lines"": 8}, ""src/testdir/test_vim9_assign.vim"": {""insertions"": 2, ""deletions"": 0, ""lines"": 2}, ""src/version.c"": {""insertions"": 2, ""deletions"": 0, ""lines"": 2}}"
2021-08-23 19:19:01,6b36d2a16d7931bac82ef8b5654c68ac456b24bf,Bram Moolenaar,12,1,13,3,"{""src/ops.c"": {""insertions"": 3, ""deletions"": 1, ""lines"": 4}, ""src/testdir/test_textformat.vim"": {""insertions"": 7, ""deletions"": 0, ""lines"": 7}, ""src/version.c"": {""insertions"": 2, ""deletions"": 0, ""lines"": 2}}"
2021-08-23 18:48:43,9cd91a1e8816d727fbdbf0b3062288e15abc5f4d,Bram Moolenaar,4,2,6,3,"{""runtime/filetype.vim"": {""insertions"": 1, ""deletions"": 1, ""lines"": 2}, ""src/testdir/test_filetype.vim"": {""insertions"": 1, ""deletions"": 1, ""lines"": 2}, ""src/version.c"": {""insertions"": 2, ""deletions"": 0, ""lines"": 2}}"
2021-08-22 20:44:11,73170917f14d1b0d919c65fbc0a9d011b87d94da,Bram Moolenaar,32,7,39,3,"{""src/ex_docmd.c"": {""insertions"": 14, ""deletions"": 7, ""lines"": 21}, ""src/testdir/test_vim9_cmd.vim"": {""insertions"": 16, ""deletions"": 0, ""lines"": 16}, ""src/version.c"": {""insertions"": 2, ""deletions"": 0, ""lines"": 2}}"
2021-08-22 11:35:31,093165c899f1620543844d1c1a7a05975697c286,Bram Moolenaar,74,2,76,3,"{""src/testdir/test_vim9_disassemble.vim"": {""insertions"": 47, ""deletions"": 0, ""lines"": 47}, ""src/version.c"": {""insertions"": 2, ""deletions"": 0, ""lines"": 2}, ""src/vim9compile.c"": {""insertions"": 25, ""deletions"": 2, ""lines"": 27}}"
2021-08-21 18:50:35,bf5f2878333da934a8bdc560bf0bcf9a88ff86a1,Bram Moolenaar,40,3,43,5,"{""src/ex_docmd.c"": {""insertions"": 20, ""deletions"": 2, ""lines"": 22}, ""src/proto/vim9compile.pro"": {""insertions"": 1, ""deletions"": 0, ""lines"": 1}, ""src/testdir/test_vim9_cmd.vim"": {""insertions"": 16, ""deletions"": 0, ""lines"": 16}, ""src/version.c"": {""insertions"": 2, ""deletions"": 0, ""lines"": 2}, ""src/vim9compile.c"": {""insertions"": 1, ""deletions"": 1, ""lines"": 2}}"
2021-08-21 15:26:50,bebf06954e1c801870b57e06ab03151c2654d079,rbtnn,202,130,332,3,"{""src/testdir/test_vim9_script.vim"": {""insertions"": 64, ""deletions"": 0, ""lines"": 64}, ""src/version.c"": {""insertions"": 2, ""deletions"": 0, ""lines"": 2}, ""src/vim9compile.c"": {""insertions"": 136, ""deletions"": 130, ""lines"": 266}}"
2021-08-21 15:13:14,b8bd2e6ebab03baf2672067067a599df69a278c0,Bram Moolenaar,12,4,16,6,"{""src/ex_cmds.c"": {""insertions"": 6, ""deletions"": 0, ""lines"": 6}, ""src/testdir/test_cmdline.vim"": {""insertions"": 1, ""deletions"": 1, ""lines"": 2}, ""src/testdir/test_undo.vim"": {""insertions"": 1, ""deletions"": 1, ""lines"": 2}, ""src/testdir/test_vim9_builtin.vim"": {""insertions"": 1, ""deletions"": 1, ""lines"": 2}, ""src/testdir/test_vim9_script.vim"": {""insertions"": 1, ""deletions"": 1, ""lines"": 2}, ""src/version.c"": {""insertions"": 2, ""deletions"": 0, ""lines"": 2}}"
2021-08-21 14:21:19,489d60996deb5e7c1a3b4633412d54632e6def42,Gregory Anders,51,16,67,3,"{""src/tag.c"": {""insertions"": 39, ""deletions"": 16, ""lines"": 55}, ""src/testdir/test_tagjump.vim"": {""insertions"": 10, ""deletions"": 0, ""lines"": 10}, ""src/version.c"": {""insertions"": 2, ""deletions"": 0, ""lines"": 2}}"
2021-08-20 18:54:25,d895b1d918f7d56dd9dd564be4820082ba6492e9,rbtnn,107,17,124,3,"{""src/testdir/test_vim9_script.vim"": {""insertions"": 83, ""deletions"": 0, ""lines"": 83}, ""src/version.c"": {""insertions"": 2, ""deletions"": 0, ""lines"": 2}, ""src/vim9compile.c"": {""insertions"": 22, ""deletions"": 17, ""lines"": 39}}"
2021-08-19 19:20:41,5aec755b678cfd434b8ea2158d06992f33e1ff80,naohiro ono,14,3,17,3,"{""src/evalfunc.c"": {""insertions"": 3, ""deletions"": 2, ""lines"": 5}, ""src/testdir/test_cmdline.vim"": {""insertions"": 9, ""deletions"": 1, ""lines"": 10}, ""src/version.c"": {""insertions"": 2, ""deletions"": 0, ""lines"": 2}}"
2021-08-19 19:08:30,c66f645b809d0852592ca37afacb9031b5950c7f,Bram Moolenaar,23,0,23,4,"{""src/errors.h"": {""insertions"": 2, ""deletions"": 0, ""lines"": 2}, ""src/testdir/test_vim9_func.vim"": {""insertions"": 9, ""deletions"": 0, ""lines"": 9}, ""src/version.c"": {""insertions"": 2, ""deletions"": 0, ""lines"": 2}, ""src/vim9type.c"": {""insertions"": 10, ""deletions"": 0, ""lines"": 10}}"
2021-08-17 21:44:54,dea561111a5761bf99397a246b8baa43e73288de,Bastian Venthur,26,3,29,3,"{""runtime/filetype.vim"": {""insertions"": 7, ""deletions"": 2, ""lines"": 9}, ""src/testdir/test_filetype.vim"": {""insertions"": 17, ""deletions"": 1, ""lines"": 18}, ""src/version.c"": {""insertions"": 2, ""deletions"": 0, ""lines"": 2}}"
2021-08-17 20:14:29,02f8694a6bd116ab3316add4a7ea6735bf2e8839,Bram Moolenaar,15,1,16,3,"{""src/misc2.c"": {""insertions"": 2, ""deletions"": 1, ""lines"": 3}, ""src/testdir/test_number.vim"": {""insertions"": 11, ""deletions"": 0, ""lines"": 11}, ""src/version.c"": {""insertions"": 2, ""deletions"": 0, ""lines"": 2}}"
2021-08-16 19:39:09,ccfb7c6758510e0fe5f390149ea14aee6ff4f55e,Yegappan Lakshmanan,253,77,330,9,"{""runtime/doc/eval.txt"": {""insertions"": 3, ""deletions"": 1, ""lines"": 4}, ""runtime/doc/textprop.txt"": {""insertions"": 32, ""deletions"": 0, ""lines"": 32}, ""runtime/doc/usr_41.txt"": {""insertions"": 1, ""deletions"": 0, ""lines"": 1}, ""src/evalfunc.c"": {""insertions"": 3, ""deletions"": 0, ""lines"": 3}, ""src/proto/textprop.pro"": {""insertions"": 1, ""deletions"": 0, ""lines"": 1}, ""src/testdir/test_textprop.vim"": {""insertions"": 35, ""deletions"": 0, ""lines"": 35}, ""src/testdir/test_vim9_builtin.vim"": {""insertions"": 5, ""deletions"": 0, ""lines"": 5}, ""src/textprop.c"": {""insertions"": 171, ""deletions"": 76, ""lines"": 247}, ""src/version.c"": {""insertions"": 2, ""deletions"": 0, ""lines"": 2}}"
2021-08-16 19:15:32,434df7a401c92d4084bb0a01ffd6d1737ae0193b,Bram Moolenaar,4,2,6,2,"{""src/memline.c"": {""insertions"": 2, ""deletions"": 2, ""lines"": 4}, ""src/version.c"": {""insertions"": 2, ""deletions"": 0, ""lines"": 2}}"
2021-08-15 20:18:04,92755bba30ec7a4c72ae0280420ba5c3847a9385,Bram Moolenaar,5,3,8,2,"{""src/memline.c"": {""insertions"": 3, ""deletions"": 3, ""lines"": 6}, ""src/version.c"": {""insertions"": 2, ""deletions"": 0, ""lines"": 2}}"
2021-08-15 18:36:28,cd6b4f300189b4920f7ee7f0204338e91210674b,Bram Moolenaar,49,31,80,5,"{""src/testdir/test_vim9_disassemble.vim"": {""insertions"": 15, ""deletions"": 13, ""lines"": 28}, ""src/testdir/test_vim9_expr.vim"": {""insertions"": 17, ""deletions"": 6, ""lines"": 23}, ""src/testdir/test_vim9_script.vim"": {""insertions"": 3, ""deletions"": 3, ""lines"": 6}, ""src/version.c"": {""insertions"": 2, ""deletions"": 0, ""lines"": 2}, ""src/vim9compile.c"": {""insertions"": 12, ""deletions"": 9, ""lines"": 21}}"
2021-08-15 17:28:05,4bba16d252da6f072d311f9b3ebb50101d6d2eaf,Bram Moolenaar,15,0,15,3,"{""src/testdir/test_vim9_func.vim"": {""insertions"": 11, ""deletions"": 0, ""lines"": 11}, ""src/userfunc.c"": {""insertions"": 2, ""deletions"": 0, ""lines"": 2}, ""src/version.c"": {""insertions"": 2, ""deletions"": 0, ""lines"": 2}}"
2021-08-15 14:08:36,b033ee2ddfa8513b57111a56d6af9e45c41f7d1e,Bram Moolenaar,23,0,23,3,"{""src/evalvars.c"": {""insertions"": 4, ""deletions"": 0, ""lines"": 4}, ""src/testdir/test_vim9_func.vim"": {""insertions"": 17, ""deletions"": 0, ""lines"": 17}, ""src/version.c"": {""insertions"": 2, ""deletions"": 0, ""lines"": 2}}"
2021-08-15 13:04:41,a401bba0805856e295c213aa504648084dae7e24,Bram Moolenaar,3,0,3,2,"{""src/testdir/test_textprop.vim"": {""insertions"": 1, ""deletions"": 0, ""lines"": 1}, ""src/version.c"": {""insertions"": 2, ""deletions"": 0, ""lines"": 2}}"
2021-08-15 12:39:13,5cebca27b831880fb6e191e5271ee614625e1f8a,Bram Moolenaar,4,2,6,2,"{""src/version.c"": {""insertions"": 2, ""deletions"": 0, ""lines"": 2}, ""src/vim9script.c"": {""insertions"": 2, ""deletions"": 2, ""lines"": 4}}"
2021-08-15 12:28:40,14c7530c4fca786d3594508e28943f10125827c3,Bram Moolenaar,29,3,32,3,"{""src/memline.c"": {""insertions"": 17, ""deletions"": 3, ""lines"": 20}, ""src/testdir/test_textprop.vim"": {""insertions"": 10, ""deletions"": 0, ""lines"": 10}, ""src/version.c"": {""insertions"": 2, ""deletions"": 0, ""lines"": 2}}"
2021-08-15 11:49:42,dd9de50f4262898384be6ea7694d05507c7cb260,Bram Moolenaar,77,9,86,9,"{""src/errors.h"": {""insertions"": 2, ""deletions"": 0, ""lines"": 2}, ""src/eval.c"": {""insertions"": 3, ""deletions"": 4, ""lines"": 7}, ""src/evalvars.c"": {""insertions"": 2, ""deletions"": 2, ""lines"": 4}, ""src/ex_docmd.c"": {""insertions"": 1, ""deletions"": 1, ""lines"": 2}, ""src/proto/vim9script.pro"": {""insertions"": 1, ""deletions"": 0, ""lines"": 1}, ""src/testdir/test_vim9_cmd.vim"": {""insertions"": 53, ""deletions"": 1, ""lines"": 54}, ""src/typval.c"": {""insertions"": 1, ""deletions"": 1, ""lines"": 2}, ""src/version.c"": {""insertions"": 2, ""deletions"": 0, ""lines"": 2}, ""src/vim9script.c"": {""insertions"": 12, ""deletions"": 0, ""lines"": 12}}"
2021-08-14 19:35:40,2596a4e763e11eb8e406f262cb72fd2b39461572,Bram Moolenaar,5,1,6,3,"{""src/eval.c"": {""insertions"": 2, ""deletions"": 1, ""lines"": 3}, ""src/testdir/test_vim9_cmd.vim"": {""insertions"": 1, ""deletions"": 0, ""lines"": 1}, ""src/version.c"": {""insertions"": 2, ""deletions"": 0, ""lines"": 2}}"
2021-08-14 19:25:52,6aa57295cfbe8f21c15f0671e45fd53cf990d404,Bram Moolenaar,1650,284,1934,35,"{""runtime/compiler/scdoc.vim"": {""insertions"": 16, ""deletions"": 0, ""lines"": 16}, ""runtime/doc/autocmd.txt"": {""insertions"": 2, ""deletions"": 2, ""lines"": 4}, ""runtime/doc/channel.txt"": {""insertions"": 4, ""deletions"": 4, ""lines"": 8}, ""runtime/doc/cmdline.txt"": {""insertions"": 7, ""deletions"": 2, ""lines"": 9}, ""runtime/doc/eval.txt"": {""insertions"": 212, ""deletions"": 184, ""lines"": 396}, ""runtime/doc/if_lua.txt"": {""insertions"": 1, ""deletions"": 1, ""lines"": 2}, ""runtime/doc/insert.txt"": {""insertions"": 2, ""deletions"": 2, ""lines"": 4}, ""runtime/doc/map.txt"": {""insertions"": 1, ""deletions"": 1, ""lines"": 2}, ""runtime/doc/message.txt"": {""insertions"": 9, ""deletions"": 1, ""lines"": 10}, ""runtime/doc/popup.txt"": {""insertions"": 3, ""deletions"": 1, ""lines"": 4}, ""runtime/doc/sign.txt"": {""insertions"": 11, ""deletions"": 11, ""lines"": 22}, ""runtime/doc/tags"": {""insertions"": 21, ""deletions"": 2, ""lines"": 23}, ""runtime/doc/terminal.txt"": {""insertions"": 32, ""deletions"": 5, ""lines"": 37}, ""runtime/doc/testing.txt"": {""insertions"": 1, ""deletions"": 1, ""lines"": 2}, ""runtime/doc/todo.txt"": {""insertions"": 5, ""deletions"": 16, ""lines"": 21}, ""runtime/doc/usr_41.txt"": {""insertions"": 1, ""deletions"": 1, ""lines"": 2}, ""runtime/doc/vim9.txt"": {""insertions"": 41, ""deletions"": 15, ""lines"": 56}, ""runtime/ftplugin/chicken.vim"": {""insertions"": 1, ""deletions"": 0, ""lines"": 1}, ""runtime/ftplugin/julia.vim"": {""insertions"": 92, ""deletions"": 0, ""lines"": 92}, ""runtime/ftplugin/scdoc.vim"": {""insertions"": 26, ""deletions"": 0, ""lines"": 26}, ""runtime/ftplugin/scheme.vim"": {""insertions"": 3, ""deletions"": 2, ""lines"": 5}, ""runtime/gvim.desktop"": {""insertions"": 0, ""deletions"": 6, ""lines"": 6}, ""runtime/indent/julia.vim"": {""insertions"": 491, ""deletions"": 0, ""lines"": 491}, ""runtime/indent/yaml.vim"": {""insertions"": 1, ""deletions"": 1, ""lines"": 2}, ""runtime/pack/dist/opt/termdebug/plugin/termdebug.vim"": {""insertions"": 22, ""deletions"": 1, ""lines"": 23}, ""runtime/plugin/manpager.vim"": {""insertions"": 5, ""deletions"": 2, ""lines"": 7}, ""runtime/syntax/chicken.vim"": {""insertions"": 19, ""deletions"": 2, ""lines"": 21}, ""runtime/syntax/debchangelog.vim"": {""insertions"": 3, ""deletions"": 3, ""lines"": 6}, ""runtime/syntax/debsources.vim"": {""insertions"": 3, ""deletions"": 3, ""lines"": 6}, ""runtime/syntax/julia.vim"": {""insertions"": 550, ""deletions"": 0, ""lines"": 550}, ""runtime/syntax/redif.vim"": {""insertions"": 2, ""deletions"": 2, ""lines"": 4}, ""runtime/syntax/scala.vim"": {""insertions"": 3, ""deletions"": 2, ""lines"": 5}, ""runtime/syntax/scdoc.vim"": {""insertions"": 52, ""deletions"": 0, ""lines"": 52}, ""runtime/syntax/scheme.vim"": {""insertions"": 8, ""deletions"": 5, ""lines"": 13}, ""runtime/vim.desktop"": {""insertions"": 0, ""deletions"": 6, ""lines"": 6}}"
2021-08-14 19:11:51,bfb2bb16bc69441fa3ec13caacb2c94637a8a0ec,Dominique Pelle,84,0,84,5,"{""src/testdir/test_arglist.vim"": {""insertions"": 6, ""deletions"": 0, ""lines"": 6}, ""src/testdir/test_cmdline.vim"": {""insertions"": 12, ""deletions"": 0, ""lines"": 12}, ""src/testdir/test_spellfile.vim"": {""insertions"": 27, ""deletions"": 0, ""lines"": 27}, ""src/testdir/test_substitute.vim"": {""insertions"": 37, ""deletions"": 0, ""lines"": 37}, ""src/version.c"": {""insertions"": 2, ""deletions"": 0, ""lines"": 2}}"
2021-08-14 13:16:00,d2e9ccee90d2b39f4c9fd6cec271ef3fafd76f09,Bram Moolenaar,8,1,9,2,"{""src/testdir/test_vimscript.vim"": {""insertions"": 6, ""deletions"": 1, ""lines"": 7}, ""src/version.c"": {""insertions"": 2, ""deletions"": 0, ""lines"": 2}}"
2021-08-14 12:59:27,4830c211a47f39edcf1827ffd787306faf65c2a5,Bram Moolenaar,3,2,5,2,"{""src/evalvars.c"": {""insertions"": 1, ""deletions"": 2, ""lines"": 3}, ""src/version.c"": {""insertions"": 2, ""deletions"": 0, ""lines"": 2}}"
2021-08-14 12:27:30,b521766c56c0e17db6e8615f35cf21012af0670c,Bram Moolenaar,5,2,7,3,"{""src/evalvars.c"": {""insertions"": 2, ""deletions"": 1, ""lines"": 3}, ""src/testdir/test_let.vim"": {""insertions"": 1, ""deletions"": 1, ""lines"": 2}, ""src/version.c"": {""insertions"": 2, ""deletions"": 0, ""lines"": 2}}"
2021-08-14 12:01:05,88c89c77229e725ab2613b022249e2f506d82b82,Bram Moolenaar,63,12,75,8,"{""src/evalvars.c"": {""insertions"": 2, ""deletions"": 1, ""lines"": 3}, ""src/globals.h"": {""insertions"": 2, ""deletions"": 2, ""lines"": 4}, ""src/message.c"": {""insertions"": 1, ""deletions"": 1, ""lines"": 2}, ""src/testdir/test_vim9_func.vim"": {""insertions"": 46, ""deletions"": 0, ""lines"": 46}, ""src/testdir/vim9.vim"": {""insertions"": 1, ""deletions"": 1, ""lines"": 2}, ""src/time.c"": {""insertions"": 2, ""deletions"": 2, ""lines"": 4}, ""src/version.c"": {""insertions"": 2, ""deletions"": 0, ""lines"": 2}, ""src/vim9execute.c"": {""insertions"": 7, ""deletions"": 5, ""lines"": 12}}"
2021-08-13 18:12:13,78a9c2e670d29349404b346e0aa90264cab19e9b,Bram Moolenaar,4,0,4,2,"{""src/eval.c"": {""insertions"": 2, ""deletions"": 0, ""lines"": 2}, ""src/version.c"": {""insertions"": 2, ""deletions"": 0, ""lines"": 2}}"
2021-08-13 17:40:51,aacc966c5d0ed91e33ed32b08f17cf4df3ca1394,Bram Moolenaar,122,32,154,8,"{""src/eval.c"": {""insertions"": 19, ""deletions"": 11, ""lines"": 30}, ""src/globals.h"": {""insertions"": 2, ""deletions"": 0, ""lines"": 2}, ""src/testdir/test_vim9_cmd.vim"": {""insertions"": 17, ""deletions"": 0, ""lines"": 17}, ""src/testdir/test_vim9_disassemble.vim"": {""insertions"": 19, ""deletions"": 0, ""lines"": 19}, ""src/version.c"": {""insertions"": 2, ""deletions"": 0, ""lines"": 2}, ""src/vim9.h"": {""insertions"": 1, ""deletions"": 0, ""lines"": 1}, ""src/vim9compile.c"": {""insertions"": 19, ""deletions"": 6, ""lines"": 25}, ""src/vim9execute.c"": {""insertions"": 43, ""deletions"": 15, ""lines"": 58}}"
2021-08-13 16:20:09,89071cb6a116a74f78f77a1853e6fada44872a15,Bram Moolenaar,17,0,17,3,"{""src/list.c"": {""insertions"": 9, ""deletions"": 0, ""lines"": 9}, ""src/testdir/test_listdict.vim"": {""insertions"": 6, ""deletions"": 0, ""lines"": 6}, ""src/version.c"": {""insertions"": 2, ""deletions"": 0, ""lines"": 2}}"
2021-08-13 15:48:25,069f90852f1444cac50491c10dfbd339a3f9e0c8,Bram Moolenaar,8,1,9,3,"{""src/evalfunc.c"": {""insertions"": 1, ""deletions"": 1, ""lines"": 2}, ""src/testdir/test_cmdline.vim"": {""insertions"": 5, ""deletions"": 0, ""lines"": 5}, ""src/version.c"": {""insertions"": 2, ""deletions"": 0, ""lines"": 2}}"
2021-08-12 19:12:56,92f05f21afdb8a43581554a252cb2fc050f9e03b,Bram Moolenaar,26,3,29,3,"{""src/list.c"": {""insertions"": 7, ""deletions"": 3, ""lines"": 10}, ""src/testdir/test_listdict.vim"": {""insertions"": 17, ""deletions"": 0, ""lines"": 17}, ""src/version.c"": {""insertions"": 2, ""deletions"": 0, ""lines"": 2}}"
2021-08-12 17:27:57,ef98257593a0abf1300d0f70358dc45a70a62580,Bram Moolenaar,248,191,439,5,"{""src/dict.c"": {""insertions"": 3, ""deletions"": 2, ""lines"": 5}, ""src/list.c"": {""insertions"": 28, ""deletions"": 23, ""lines"": 51}, ""src/testdir/test_listdict.vim"": {""insertions"": 203, ""deletions"": 164, ""lines"": 367}, ""src/testdir/vim9.vim"": {""insertions"": 12, ""deletions"": 2, ""lines"": 14}, ""src/version.c"": {""insertions"": 2, ""deletions"": 0, ""lines"": 2}}"
2021-08-12 15:06:05,bd77aa92744d79f3ba69aee713739ec17da474f6,Bram Moolenaar,136,98,234,4,"{""src/evalfunc.c"": {""insertions"": 2, ""deletions"": 1, ""lines"": 3}, ""src/testdir/test_listdict.vim"": {""insertions"": 131, ""deletions"": 96, ""lines"": 227}, ""src/version.c"": {""insertions"": 2, ""deletions"": 0, ""lines"": 2}, ""src/vim9compile.c"": {""insertions"": 1, ""deletions"": 1, ""lines"": 2}}"
2021-08-12 08:39:10,3e9c0b9608736e7d888f3141443f8754143364d7,Bram Moolenaar,41,6,47,3,"{""src/testdir/test_listdict.vim"": {""insertions"": 13, ""deletions"": 0, ""lines"": 13}, ""src/testdir/vim9.vim"": {""insertions"": 26, ""deletions"": 6, ""lines"": 32}, ""src/version.c"": {""insertions"": 2, ""deletions"": 0, ""lines"": 2}}"
2021-08-11 19:49:23,4f0884d6e24d1d45ec83fd86b372b403177d3298,Bram Moolenaar,261,106,367,9,"{""src/eval.c"": {""insertions"": 9, ""deletions"": 89, ""lines"": 98}, ""src/list.c"": {""insertions"": 152, ""deletions"": 0, ""lines"": 152}, ""src/proto/eval.pro"": {""insertions"": 1, ""deletions"": 0, ""lines"": 1}, ""src/proto/list.pro"": {""insertions"": 3, ""deletions"": 0, ""lines"": 3}, ""src/testdir/test_listdict.vim"": {""insertions"": 8, ""deletions"": 5, ""lines"": 13}, ""src/testdir/test_vim9_assign.vim"": {""insertions"": 1, ""deletions"": 1, ""lines"": 2}, ""src/version.c"": {""insertions"": 2, ""deletions"": 0, ""lines"": 2}, ""src/vim9compile.c"": {""insertions"": 32, ""deletions"": 3, ""lines"": 35}, ""src/vim9execute.c"": {""insertions"": 53, ""deletions"": 8, ""lines"": 61}}"
2021-08-11 15:13:54,ed7cb2df35244e40e5c4df06169b50e705427576,Bram Moolenaar,6,3,9,2,"{""src/version.c"": {""insertions"": 2, ""deletions"": 0, ""lines"": 2}, ""src/viminfo.c"": {""insertions"": 4, ""deletions"": 3, ""lines"": 7}}"
2021-08-11 15:01:45,7deb4115ef72c0468cd6f9cc5f036d5c405641d4,Bram Moolenaar,3,0,3,2,"{""src/tag.c"": {""insertions"": 1, ""deletions"": 0, ""lines"": 1}, ""src/version.c"": {""insertions"": 2, ""deletions"": 0, ""lines"": 2}}"
2021-08-11 14:47:26,16e63e6d353c8b7337470644ceac02dc5e569db9,Bram Moolenaar,3,0,3,2,"{""src/typval.c"": {""insertions"": 1, ""deletions"": 0, ""lines"": 1}, ""src/version.c"": {""insertions"": 2, ""deletions"": 0, ""lines"": 2}}"
2021-08-11 13:54:59,b85d3627d9a7b41d603c58a16d0ddbf6b88beeaf,Bram Moolenaar,5,1,6,2,"{""src/spellfile.c"": {""insertions"": 3, ""deletions"": 1, ""lines"": 4}, ""src/version.c"": {""insertions"": 2, ""deletions"": 0, ""lines"": 2}}"
2021-08-11 12:20:05,ba9c23e77655766f6c59de8be732b7577f795ed3,Zdenek Dohnal,29,19,48,2,"{""src/os_unix.c"": {""insertions"": 27, ""deletions"": 19, ""lines"": 46}, ""src/version.c"": {""insertions"": 2, ""deletions"": 0, ""lines"": 2}}"
2021-08-10 20:52:02,6e48b84c5f08a7e192817aca0d8278ea2ff82bc7,Bram Moolenaar,32,3,35,4,"{""src/testdir/test_vim9_disassemble.vim"": {""insertions"": 1, ""deletions"": 0, ""lines"": 1}, ""src/testdir/test_vim9_func.vim"": {""insertions"": 21, ""deletions"": 0, ""lines"": 21}, ""src/version.c"": {""insertions"": 2, ""deletions"": 0, ""lines"": 2}, ""src/vim9compile.c"": {""insertions"": 8, ""deletions"": 3, ""lines"": 11}}"
2021-08-10 19:39:20,52eb372a04dfc5d5afef238c1b3c4a8e92020837,Bram Moolenaar,6,1,7,2,"{""src/testdir/test_digraph.vim"": {""insertions"": 4, ""deletions"": 1, ""lines"": 5}, ""src/version.c"": {""insertions"": 2, ""deletions"": 0, ""lines"": 2}}"
2021-08-10 17:53:01,917c46abe559f3d779ad87500e874376111ca1ef,Bram Moolenaar,34,16,50,6,"{""src/ex_docmd.c"": {""insertions"": 6, ""deletions"": 4, ""lines"": 10}, ""src/ex_eval.c"": {""insertions"": 6, ""deletions"": 6, ""lines"": 12}, ""src/proto/ex_docmd.pro"": {""insertions"": 3, ""deletions"": 3, ""lines"": 6}, ""src/testdir/test_vim9_cmd.vim"": {""insertions"": 16, ""deletions"": 2, ""lines"": 18}, ""src/version.c"": {""insertions"": 2, ""deletions"": 0, ""lines"": 2}, ""src/vim9compile.c"": {""insertions"": 1, ""deletions"": 1, ""lines"": 2}}"
2021-08-10 08:23:27,b6f55bb5b4d7d03cdf47d552db20d06e41354d5f,Bram Moolenaar,3,1,4,2,"{""runtime/doc/eval.txt"": {""insertions"": 1, ""deletions"": 1, ""lines"": 2}, ""src/version.c"": {""insertions"": 2, ""deletions"": 0, ""lines"": 2}}"
2021-08-09 20:22:27,b56c4419d42e024e79b1772c8468c0da7c11275f,Bram Moolenaar,20,2,22,3,"{""src/testdir/test_vim9_builtin.vim"": {""insertions"": 12, ""deletions"": 0, ""lines"": 12}, ""src/version.c"": {""insertions"": 2, ""deletions"": 0, ""lines"": 2}, ""src/vim9type.c"": {""insertions"": 6, ""deletions"": 2, ""lines"": 8}}"
2021-08-09 19:04:44,bd9e7961256ea6a98bd5a7bfe14e32c4c47186e6,Dominique Pelle,46,0,46,3,"{""src/testdir/test_excmd.vim"": {""insertions"": 36, ""deletions"": 0, ""lines"": 36}, ""src/testdir/test_writefile.vim"": {""insertions"": 8, ""deletions"": 0, ""lines"": 8}, ""src/version.c"": {""insertions"": 2, ""deletions"": 0, ""lines"": 2}}"
2021-08-09 17:59:06,8ee52affe7fd4daa03e002bc06611f0a8c3bcd5b,Yegappan Lakshmanan,1303,1327,2630,31,"{""src/alloc.c"": {""insertions"": 9, ""deletions"": 15, ""lines"": 24}, ""src/channel.c"": {""insertions"": 1, ""deletions"": 1, ""lines"": 2}, ""src/dict.c"": {""insertions"": 1, ""deletions"": 1, ""lines"": 2}, ""src/digraph.c"": {""insertions"": 2, ""deletions"": 2, ""lines"": 4}, ""src/edit.c"": {""insertions"": 1, ""deletions"": 1, ""lines"": 2}, ""src/ex_docmd.c"": {""insertions"": 1, ""deletions"": 1, ""lines"": 2}, ""src/getchar.c"": {""insertions"": 1, ""deletions"": 1, ""lines"": 2}, ""src/job.c"": {""insertions"": 1, ""deletions"": 1, ""lines"": 2}, ""src/list.c"": {""insertions"": 1, ""deletions"": 1, ""lines"": 2}, ""src/message.c"": {""insertions"": 0, ""deletions"": 1110, ""lines"": 1110}, ""src/profiler.c"": {""insertions"": 18, ""deletions"": 18, ""lines"": 36}, ""src/proto/channel.pro"": {""insertions"": 0, ""deletions"": 1, ""lines"": 1}, ""src/proto/dict.pro"": {""insertions"": 0, ""deletions"": 1, ""lines"": 1}, ""src/proto/digraph.pro"": {""insertions"": 0, ""deletions"": 2, ""lines"": 2}, ""src/proto/edit.pro"": {""insertions"": 0, ""deletions"": 1, ""lines"": 1}, ""src/proto/ex_docmd.pro"": {""insertions"": 0, ""deletions"": 1, ""lines"": 1}, ""src/proto/getchar.pro"": {""insertions"": 0, ""deletions"": 1, ""lines"": 1}, ""src/proto/job.pro"": {""insertions"": 0, ""deletions"": 1, ""lines"": 1}, ""src/proto/list.pro"": {""insertions"": 0, ""deletions"": 1, ""lines"": 1}, ""src/proto/profiler.pro"": {""insertions"": 0, ""deletions"": 1, ""lines"": 1}, ""src/proto/spell.pro"": {""insertions"": 0, ""deletions"": 1, ""lines"": 1}, ""src/proto/vim9compile.pro"": {""insertions"": 0, ""deletions"": 2, ""lines"": 2}, ""src/proto/vim9script.pro"": {""insertions"": 0, ""deletions"": 2, ""lines"": 2}, ""src/proto/vim9type.pro"": {""insertions"": 0, ""deletions"": 1, ""lines"": 1}, ""src/spell.c"": {""insertions"": 1, ""deletions"": 1, ""lines"": 2}, ""src/strings.c"": {""insertions"": 1114, ""deletions"": 8, ""lines"": 1122}, ""src/version.c"": {""insertions"": 2, ""deletions"": 0, ""lines"": 2}, ""src/vim9compile.c"": {""insertions"": 2, ""deletions"": 2, ""lines"": 4}, ""src/vim9script.c"": {""insertions"": 146, ""deletions"": 146, ""lines"": 292}, ""src/vim9type.c"": {""insertions"": 1, ""deletions"": 1, ""lines"": 2}, ""src/window.c"": {""insertions"": 1, ""deletions"": 1, ""lines"": 2}}"
2021-08-09 11:20:38,eed9616120f60ad17d5e133f505bba5c559aee89,James McCoy,4,2,6,2,"{"".github/workflows/coverity.yml"": {""insertions"": 2, ""deletions"": 2, ""lines"": 4}, ""src/version.c"": {""insertions"": 2, ""deletions"": 0, ""lines"": 2}}"
2021-08-08 17:56:28,ed8b099fd23b20d7b5a436182bde6672c8686189,Bram Moolenaar,7,1,8,3,"{""src/testdir/test_float_func.vim"": {""insertions"": 4, ""deletions"": 0, ""lines"": 4}, ""src/typval.c"": {""insertions"": 1, ""deletions"": 1, ""lines"": 2}, ""src/version.c"": {""insertions"": 2, ""deletions"": 0, ""lines"": 2}}"
2021-08-08 17:07:37,33ea9fd4d849324f1e958cc669987a51cf0baded,Bram Moolenaar,31,1,32,3,"{""src/testdir/test_vim9_func.vim"": {""insertions"": 21, ""deletions"": 0, ""lines"": 21}, ""src/userfunc.c"": {""insertions"": 8, ""deletions"": 1, ""lines"": 9}, ""src/version.c"": {""insertions"": 2, ""deletions"": 0, ""lines"": 2}}"
2021-08-08 13:51:10,80a070c36125662556232ab6e83da373e22953d8,Bram Moolenaar,3,1,4,2,"{""src/evalfunc.c"": {""insertions"": 1, ""deletions"": 1, ""lines"": 2}, ""src/version.c"": {""insertions"": 2, ""deletions"": 0, ""lines"": 2}}"
2021-08-08 13:43:34,2950065e18649d234b16e60dd0e3d75adeca4513,Bram Moolenaar,72,10,82,7,"{""src/float.c"": {""insertions"": 32, ""deletions"": 2, ""lines"": 34}, ""src/json.c"": {""insertions"": 3, ""deletions"": 2, ""lines"": 5}, ""src/proto/float.pro"": {""insertions"": 1, ""deletions"": 1, ""lines"": 2}, ""src/testdir/test_float_func.vim"": {""insertions"": 16, ""deletions"": 1, ""lines"": 17}, ""src/typval.c"": {""insertions"": 17, ""deletions"": 3, ""lines"": 20}, ""src/version.c"": {""insertions"": 2, ""deletions"": 0, ""lines"": 2}, ""src/viminfo.c"": {""insertions"": 1, ""deletions"": 1, ""lines"": 2}}"
2021-08-08 12:43:22,267359902c8792fed13543ddeb56c6df0ae74957,Bram Moolenaar,78,25,103,7,"{""runtime/doc/eval.txt"": {""insertions"": 30, ""deletions"": 12, ""lines"": 42}, ""runtime/doc/usr_41.txt"": {""insertions"": 1, ""deletions"": 0, ""lines"": 1}, ""src/errors.h"": {""insertions"": 4, ""deletions"": 0, ""lines"": 4}, ""src/evalfunc.c"": {""insertions"": 9, ""deletions"": 0, ""lines"": 9}, ""src/testdir/test_vim9_builtin.vim"": {""insertions"": 24, ""deletions"": 9, ""lines"": 33}, ""src/version.c"": {""insertions"": 2, ""deletions"": 0, ""lines"": 2}, ""src/vim9compile.c"": {""insertions"": 8, ""deletions"": 4, ""lines"": 12}}"
2021-08-07 20:35:52,9e2fa4bb9eb40a78a1ae1f67a4064651b5ce0aac,gmntroll,6,23,29,2,"{""src/version.c"": {""insertions"": 2, ""deletions"": 0, ""lines"": 2}, ""src/window.c"": {""insertions"": 4, ""deletions"": 23, ""lines"": 27}}"
2021-08-07 16:12:40,e525bdda3aa29f0ffcb18d8d16903ebafc2b5881,Bram Moolenaar,12,4,16,3,"{""src/testdir/test_vim9_script.vim"": {""insertions"": 8, ""deletions"": 0, ""lines"": 8}, ""src/version.c"": {""insertions"": 2, ""deletions"": 0, ""lines"": 2}, ""src/vim9compile.c"": {""insertions"": 2, ""deletions"": 4, ""lines"": 6}}"
2021-08-07 15:20:16,dae453f3397a26a53301d7327e6ed43e8b392035,Bram Moolenaar,51,3,54,3,"{""src/testdir/runtest.vim"": {""insertions"": 15, ""deletions"": 2, ""lines"": 17}, ""src/testdir/test_vim9_expr.vim"": {""insertions"": 34, ""deletions"": 1, ""lines"": 35}, ""src/version.c"": {""insertions"": 2, ""deletions"": 0, ""lines"": 2}}"
2021-08-07 14:30:42,4270d8b7626ff8a7006f6a09c89bc446a3f89d1e,Bram Moolenaar,47,12,59,4,"{""src/testdir/test_vim9_assign.vim"": {""insertions"": 16, ""deletions"": 0, ""lines"": 16}, ""src/testdir/test_vim9_disassemble.vim"": {""insertions"": 2, ""deletions"": 2, ""lines"": 4}, ""src/version.c"": {""insertions"": 2, ""deletions"": 0, ""lines"": 2}, ""src/vim9compile.c"": {""insertions"": 27, ""deletions"": 10, ""lines"": 37}}"
2021-08-07 13:50:23,fbeefb1b87b0d52a095c08fee47b62d290bf4c33,Bram Moolenaar,34,5,39,3,"{""src/testdir/test_vim9_expr.vim"": {""insertions"": 13, ""deletions"": 1, ""lines"": 14}, ""src/version.c"": {""insertions"": 2, ""deletions"": 0, ""lines"": 2}, ""src/vim9execute.c"": {""insertions"": 19, ""deletions"": 4, ""lines"": 23}}"
2021-08-07 13:35:36,6ce46b99635877fb0a17c06a6f5625fbc1ffa6f4,Bram Moolenaar,16,2,18,3,"{""src/testdir/test_vim9_func.vim"": {""insertions"": 12, ""deletions"": 0, ""lines"": 12}, ""src/version.c"": {""insertions"": 2, ""deletions"": 0, ""lines"": 2}, ""src/vim9execute.c"": {""insertions"": 2, ""deletions"": 2, ""lines"": 4}}"
2021-08-07 13:05:47,7de62623735d228c8f81f6ac8309fe4922822cb2,Bram Moolenaar,40,10,50,6,"{""src/testdir/test_vim9_disassemble.vim"": {""insertions"": 4, ""deletions"": 0, ""lines"": 4}, ""src/testdir/test_vim9_script.vim"": {""insertions"": 9, ""deletions"": 2, ""lines"": 11}, ""src/version.c"": {""insertions"": 2, ""deletions"": 0, ""lines"": 2}, ""src/vim9.h"": {""insertions"": 5, ""deletions"": 4, ""lines"": 9}, ""src/vim9compile.c"": {""insertions"": 5, ""deletions"": 1, ""lines"": 6}, ""src/vim9execute.c"": {""insertions"": 15, ""deletions"": 3, ""lines"": 18}}"
2021-08-07 11:59:43,1b154ea121d8374a129c3e30d50fa9742cd5faa1,Bram Moolenaar,10,3,13,2,"{""src/autocmd.c"": {""insertions"": 8, ""deletions"": 3, ""lines"": 11}, ""src/version.c"": {""insertions"": 2, ""deletions"": 0, ""lines"": 2}}"
2021-08-07 11:26:53,84934998806408db3f3ecff7ac4c3980e0c2a96e,rbtnn,57,37,94,4,"{""src/ex_eval.c"": {""insertions"": 2, ""deletions"": 1, ""lines"": 3}, ""src/testdir/test_vim9_script.vim"": {""insertions"": 14, ""deletions"": 0, ""lines"": 14}, ""src/version.c"": {""insertions"": 2, ""deletions"": 0, ""lines"": 2}, ""src/vim9compile.c"": {""insertions"": 39, ""deletions"": 36, ""lines"": 75}}"
2021-08-07 11:08:45,c611941c606328740b6e9acc1191a5d97ace13e2,rbtnn,5,3,8,4,"{""src/popupwin.c"": {""insertions"": 1, ""deletions"": 1, ""lines"": 2}, ""src/testdir/dumps/Test_popupwin_multibytetitle.dump"": {""insertions"": 1, ""deletions"": 1, ""lines"": 2}, ""src/testdir/test_popupwin.vim"": {""insertions"": 1, ""deletions"": 1, ""lines"": 2}, ""src/version.c"": {""insertions"": 2, ""deletions"": 0, ""lines"": 2}}"
2021-08-07 10:44:41,3276f5846f7ad61f55175959ac21c1b4cf595352,Dominique Pelle,14,12,26,4,"{""src/structs.h"": {""insertions"": 8, ""deletions"": 8, ""lines"": 16}, ""src/version.c"": {""insertions"": 2, ""deletions"": 0, ""lines"": 2}, ""src/vim9.h"": {""insertions"": 3, ""deletions"": 3, ""lines"": 6}, ""src/vim9execute.c"": {""insertions"": 1, ""deletions"": 1, ""lines"": 2}}"
2021-08-07 10:32:20,d57a6bd98c9a57b766eadcc3f10e9c4169c788aa,Bram Moolenaar,83,0,83,3,"{"".github/workflows/coverity.yml"": {""insertions"": 80, ""deletions"": 0, ""lines"": 80}, ""Filelist"": {""insertions"": 1, ""deletions"": 0, ""lines"": 1}, ""src/version.c"": {""insertions"": 2, ""deletions"": 0, ""lines"": 2}}"
2021-08-06 19:51:55,cbae5802832b29f3a1af4cb6b0fc8cf69f17cbf4,Yegappan Lakshmanan,938,884,1822,13,"{""Filelist"": {""insertions"": 2, ""deletions"": 0, ""lines"": 2}, ""src/Make_ami.mak"": {""insertions"": 1, ""deletions"": 0, ""lines"": 1}, ""src/Make_cyg_ming.mak"": {""insertions"": 1, ""deletions"": 0, ""lines"": 1}, ""src/Make_mvc.mak"": {""insertions"": 4, ""deletions"": 0, ""lines"": 4}, ""src/Make_vms.mms"": {""insertions"": 5, ""deletions"": 0, ""lines"": 5}, ""src/Makefile"": {""insertions"": 10, ""deletions"": 0, ""lines"": 10}, ""src/README.md"": {""insertions"": 1, ""deletions"": 0, ""lines"": 1}, ""src/alloc.c"": {""insertions"": 872, ""deletions"": 0, ""lines"": 872}, ""src/misc2.c"": {""insertions"": 9, ""deletions"": 857, ""lines"": 866}, ""src/proto.h"": {""insertions"": 1, ""deletions"": 0, ""lines"": 1}, ""src/proto/alloc.pro"": {""insertions"": 29, ""deletions"": 0, ""lines"": 29}, ""src/proto/misc2.pro"": {""insertions"": 1, ""deletions"": 27, ""lines"": 28}, ""src/version.c"": {""insertions"": 2, ""deletions"": 0, ""lines"": 2}}"
2021-08-06 19:34:38,11328bc7df0ecc47f4025a10bb86882a659e9994,Yegappan Lakshmanan,124,5,129,7,"{""runtime/doc/if_lua.txt"": {""insertions"": 14, ""deletions"": 1, ""lines"": 15}, ""src/evalfunc.c"": {""insertions"": 42, ""deletions"": 0, ""lines"": 42}, ""src/if_lua.c"": {""insertions"": 31, ""deletions"": 3, ""lines"": 34}, ""src/proto/evalfunc.pro"": {""insertions"": 1, ""deletions"": 0, ""lines"": 1}, ""src/testdir/test_lua.vim"": {""insertions"": 32, ""deletions"": 0, ""lines"": 32}, ""src/testdir/test_shell.vim"": {""insertions"": 2, ""deletions"": 1, ""lines"": 3}, ""src/version.c"": {""insertions"": 2, ""deletions"": 0, ""lines"": 2}}"
2021-08-05 20:48:11,5671f3f076573fa9133bc210d6580067698d9a1b,Bram Moolenaar,34,3,37,4,"{""src/evalfunc.c"": {""insertions"": 7, ""deletions"": 0, ""lines"": 7}, ""src/testdir/test_vim9_builtin.vim"": {""insertions"": 23, ""deletions"": 1, ""lines"": 24}, ""src/version.c"": {""insertions"": 2, ""deletions"": 0, ""lines"": 2}, ""src/vim9compile.c"": {""insertions"": 2, ""deletions"": 2, ""lines"": 4}}"
2021-08-05 19:17:32,6f6d58c3809010b1386634c1aeec61f1a66e72c2,Bram Moolenaar,6,1,7,2,"{""src/ex_docmd.c"": {""insertions"": 4, ""deletions"": 1, ""lines"": 5}, ""src/version.c"": {""insertions"": 2, ""deletions"": 0, ""lines"": 2}}"
2021-08-05 18:40:03,63b9173693015b135aad8e3657bef5e7f776787e,Bram Moolenaar,90,36,126,16,"{""runtime/doc/map.txt"": {""insertions"": 5, ""deletions"": 2, ""lines"": 7}, ""src/errors.h"": {""insertions"": 3, ""deletions"": 1, ""lines"": 4}, ""src/eval.c"": {""insertions"": 3, ""deletions"": 3, ""lines"": 6}, ""src/evalvars.c"": {""insertions"": 2, ""deletions"": 2, ""lines"": 4}, ""src/ex_cmds.c"": {""insertions"": 2, ""deletions"": 2, ""lines"": 4}, ""src/ex_docmd.c"": {""insertions"": 28, ""deletions"": 11, ""lines"": 39}, ""src/ex_eval.c"": {""insertions"": 12, ""deletions"": 0, ""lines"": 12}, ""src/proto/ex_docmd.pro"": {""insertions"": 1, ""deletions"": 0, ""lines"": 1}, ""src/proto/ex_eval.pro"": {""insertions"": 1, ""deletions"": 0, ""lines"": 1}, ""src/syntax.c"": {""insertions"": 7, ""deletions"": 7, ""lines"": 14}, ""src/testdir/test_autocmd.vim"": {""insertions"": 8, ""deletions"": 0, ""lines"": 8}, ""src/testdir/test_usercommands.vim"": {""insertions"": 8, ""deletions"": 0, ""lines"": 8}, ""src/userfunc.c"": {""insertions"": 6, ""deletions"": 6, ""lines"": 12}, ""src/version.c"": {""insertions"": 2, ""deletions"": 0, ""lines"": 2}, ""src/vim9compile.c"": {""insertions"": 1, ""deletions"": 1, ""lines"": 2}, ""src/vim9script.c"": {""insertions"": 1, ""deletions"": 1, ""lines"": 2}}"
2021-08-05 17:01:17,af647e76cacc60d3cfc5df3ff5b3d9d4b69b519d,Bram Moolenaar,23,2,25,3,"{""src/testdir/test_vim9_assign.vim"": {""insertions"": 17, ""deletions"": 0, ""lines"": 17}, ""src/version.c"": {""insertions"": 2, ""deletions"": 0, ""lines"": 2}, ""src/vim9compile.c"": {""insertions"": 4, ""deletions"": 2, ""lines"": 6}}"
2021-08-05 15:57:02,4f33bc20d7d5444e44d13f954e8219ad1abd26ef,zeertzjq,268,19,287,14,"{""src/drawline.c"": {""insertions"": 13, ""deletions"": 19, ""lines"": 32}, ""src/testdir/dumps/Test_Xcursorline_19.dump"": {""insertions"": 20, ""deletions"": 0, ""lines"": 20}, ""src/testdir/dumps/Test_Xcursorline_20.dump"": {""insertions"": 20, ""deletions"": 0, ""lines"": 20}, ""src/testdir/dumps/Test_Xcursorline_21.dump"": {""insertions"": 20, ""deletions"": 0, ""lines"": 20}, ""src/testdir/dumps/Test_Xcursorline_22.dump"": {""insertions"": 20, ""deletions"": 0, ""lines"": 20}, ""src/testdir/dumps/Test_Xcursorline_23.dump"": {""insertions"": 20, ""deletions"": 0, ""lines"": 20}, ""src/testdir/dumps/Test_Xcursorline_24.dump"": {""insertions"": 20, ""deletions"": 0, ""lines"": 20}, ""src/testdir/dumps/Test_diff_with_cul_bri_01.dump"": {""insertions"": 20, ""deletions"": 0, ""lines"": 20}, ""src/testdir/dumps/Test_diff_with_cul_bri_02.dump"": {""insertions"": 20, ""deletions"": 0, ""lines"": 20}, ""src/testdir/dumps/Test_diff_with_cul_bri_03.dump"": {""insertions"": 20, ""deletions"": 0, ""lines"": 20}, ""src/testdir/dumps/Test_diff_with_cul_bri_04.dump"": {""insertions"": 20, ""deletions"": 0, ""lines"": 20}, ""src/testdir/test_cursorline.vim"": {""insertions"": 22, ""deletions"": 0, ""lines"": 22}, ""src/testdir/test_diffmode.vim"": {""insertions"": 31, ""deletions"": 0, ""lines"": 31}, ""src/version.c"": {""insertions"": 2, ""deletions"": 0, ""lines"": 2}}"
2021-08-05 14:47:08,1b6acf02b7e685ecb87ccba52c91835a7519073e,Bram Moolenaar,11,1,12,2,"{""src/if_lua.c"": {""insertions"": 9, ""deletions"": 1, ""lines"": 10}, ""src/version.c"": {""insertions"": 2, ""deletions"": 0, ""lines"": 2}}"
2021-08-05 14:23:27,6a230c6b32695393785ae64b440ce5f023a22382,Andy Gozas,82,1,83,4,"{""src/insexpand.c"": {""insertions"": 27, ""deletions"": 1, ""lines"": 28}, ""src/testdir/Make_all.mak"": {""insertions"": 2, ""deletions"": 0, ""lines"": 2}, ""src/testdir/test_ins_complete_no_halt.vim"": {""insertions"": 51, ""deletions"": 0, ""lines"": 51}, ""src/version.c"": {""insertions"": 2, ""deletions"": 0, ""lines"": 2}}"
2021-08-05 13:24:59,bc67e5a0a494f5fc48e872d747371e31a782d171,Christian Brabandt,16,1,17,3,"{""src/search.c"": {""insertions"": 3, ""deletions"": 1, ""lines"": 4}, ""src/testdir/test_search.vim"": {""insertions"": 11, ""deletions"": 0, ""lines"": 11}, ""src/version.c"": {""insertions"": 2, ""deletions"": 0, ""lines"": 2}}"
2021-08-05 13:11:08,4a01159da23a279005b7c5042a15af47eb9617fe,Bram Moolenaar,8,1,9,3,"{""src/if_lua.c"": {""insertions"": 2, ""deletions"": 1, ""lines"": 3}, ""src/testdir/test_lua.vim"": {""insertions"": 4, ""deletions"": 0, ""lines"": 4}, ""src/version.c"": {""insertions"": 2, ""deletions"": 0, ""lines"": 2}}"
2021-08-04 20:30:52,9fe17d473a6041e2ea85229f4fa09831d910def4,Zdenek Dohnal,23,13,36,2,"{""src/version.c"": {""insertions"": 2, ""deletions"": 0, ""lines"": 2}, ""src/vim9compile.c"": {""insertions"": 21, ""deletions"": 13, ""lines"": 34}}"
2021-08-04 19:16:50,f18e8a969a3414ed5e6b7159c40fe43963021ff3,Bram Moolenaar,10,1,11,2,"{""src/version.c"": {""insertions"": 2, ""deletions"": 0, ""lines"": 2}, ""src/window.c"": {""insertions"": 8, ""deletions"": 1, ""lines"": 9}}"
2021-08-04 19:12:52,9dc4bef897a37a610a28d69cee6d30749db61296,Yegappan Lakshmanan,414,0,414,4,"{""runtime/doc/if_lua.txt"": {""insertions"": 32, ""deletions"": 0, ""lines"": 32}, ""src/if_lua.c"": {""insertions"": 138, ""deletions"": 0, ""lines"": 138}, ""src/testdir/test_lua.vim"": {""insertions"": 242, ""deletions"": 0, ""lines"": 242}, ""src/version.c"": {""insertions"": 2, ""deletions"": 0, ""lines"": 2}}"
2021-08-04 18:54:55,57942237c1d54d8a236b43c56dc2b002339eb394,Bram Moolenaar,65,14,79,3,"{""src/testdir/test_channel.vim"": {""insertions"": 29, ""deletions"": 0, ""lines"": 29}, ""src/version.c"": {""insertions"": 2, ""deletions"": 0, ""lines"": 2}, ""src/window.c"": {""insertions"": 34, ""deletions"": 14, ""lines"": 48}}"
2021-08-04 18:26:19,d61f2f772a59617850e9aa2f5fa069c1aad8e074,Bram Moolenaar,28,20,48,2,"{""src/version.c"": {""insertions"": 2, ""deletions"": 0, ""lines"": 2}, ""src/window.c"": {""insertions"": 26, ""deletions"": 20, ""lines"": 46}}"
2021-08-04 18:00:27,dd097bdc1376e4ca2cfd4a4d64021b6ba0df4bed,Gregory Anders,6,0,6,3,"{""runtime/filetype.vim"": {""insertions"": 3, ""deletions"": 0, ""lines"": 3}, ""src/testdir/test_filetype.vim"": {""insertions"": 1, ""deletions"": 0, ""lines"": 1}, ""src/version.c"": {""insertions"": 2, ""deletions"": 0, ""lines"": 2}}"
2021-08-04 17:25:54,80d7395dcfe96158428da6bb3d28a6eee1244e28,Sean Dewar,79,36,115,8,"{""src/blob.c"": {""insertions"": 5, ""deletions"": 2, ""lines"": 7}, ""src/errors.h"": {""insertions"": 2, ""deletions"": 1, ""lines"": 3}, ""src/eval.c"": {""insertions"": 1, ""deletions"": 1, ""lines"": 2}, ""src/list.c"": {""insertions"": 32, ""deletions"": 28, ""lines"": 60}, ""src/proto/blob.pro"": {""insertions"": 1, ""deletions"": 1, ""lines"": 2}, ""src/testdir/test_blob.vim"": {""insertions"": 33, ""deletions"": 0, ""lines"": 33}, ""src/testdir/test_eval_stuff.vim"": {""insertions"": 3, ""deletions"": 3, ""lines"": 6}, ""src/version.c"": {""insertions"": 2, ""deletions"": 0, ""lines"": 2}}"
2021-08-04 15:03:59,0eec8519424eaea7baebfda979c33dd609a4e3fa,Christian Clason,7,0,7,3,"{""runtime/filetype.vim"": {""insertions"": 3, ""deletions"": 0, ""lines"": 3}, ""src/testdir/test_filetype.vim"": {""insertions"": 2, ""deletions"": 0, ""lines"": 2}, ""src/version.c"": {""insertions"": 2, ""deletions"": 0, ""lines"": 2}}"
2021-08-04 14:09:24,41a3485dd638a09e4c463b1a1da231f4290454f2,Bram Moolenaar,7,4,11,3,"{""src/errors.h"": {""insertions"": 2, ""deletions"": 2, ""lines"": 4}, ""src/usercmd.c"": {""insertions"": 3, ""deletions"": 2, ""lines"": 5}, ""src/version.c"": {""insertions"": 2, ""deletions"": 0, ""lines"": 2}}"
2021-08-03 19:16:18,23e2e115154ef0bf05d809024eed328a46ed0f82,Bram Moolenaar,8,21,29,4,"{""src/testdir/test_vim9_assign.vim"": {""insertions"": 2, ""deletions"": 14, ""lines"": 16}, ""src/testdir/test_vim9_func.vim"": {""insertions"": 2, ""deletions"": 3, ""lines"": 5}, ""src/testdir/test_vim9_script.vim"": {""insertions"": 2, ""deletions"": 4, ""lines"": 6}, ""src/version.c"": {""insertions"": 2, ""deletions"": 0, ""lines"": 2}}"
2021-08-03 16:33:08,51ad850f5fbafa7aa3f60affa74ec9c9f992c6cc,Gary Johnson,56,37,93,10,"{""runtime/doc/options.txt"": {""insertions"": 1, ""deletions"": 1, ""lines"": 2}, ""src/buffer.c"": {""insertions"": 0, ""deletions"": 1, ""lines"": 1}, ""src/drawscreen.c"": {""insertions"": 3, ""deletions"": 3, ""lines"": 6}, ""src/ops.c"": {""insertions"": 5, ""deletions"": 5, ""lines"": 10}, ""src/option.c"": {""insertions"": 11, ""deletions"": 9, ""lines"": 20}, ""src/option.h"": {""insertions"": 2, ""deletions"": 2, ""lines"": 4}, ""src/optionstr.c"": {""insertions"": 2, ""deletions"": 3, ""lines"": 5}, ""src/structs.h"": {""insertions"": 4, ""deletions"": 2, ""lines"": 6}, ""src/testdir/test_virtualedit.vim"": {""insertions"": 26, ""deletions"": 11, ""lines"": 37}, ""src/version.c"": {""insertions"": 2, ""deletions"": 0, ""lines"": 2}}"
2021-08-02 20:26:56,2c70711e3fb2ef24a7f55322fdadbf7f9e657c2f,Bram Moolenaar,17,2,19,3,"{""src/ex_cmds.h"": {""insertions"": 1, ""deletions"": 1, ""lines"": 2}, ""src/testdir/test_vim9_cmd.vim"": {""insertions"": 14, ""deletions"": 1, ""lines"": 15}, ""src/version.c"": {""insertions"": 2, ""deletions"": 0, ""lines"": 2}}"
2021-08-02 19:55:15,7bf9a07bd7d6264f623109c2896b2a4002c86080,Bram Moolenaar,10,1,11,3,"{""src/testdir/test_vim9_assign.vim"": {""insertions"": 6, ""deletions"": 0, ""lines"": 6}, ""src/version.c"": {""insertions"": 2, ""deletions"": 0, ""lines"": 2}, ""src/vim9compile.c"": {""insertions"": 2, ""deletions"": 1, ""lines"": 3}}"
2021-08-02 19:12:05,c3160727b940b762e18fd9431416dc1a4a081c3a,Bram Moolenaar,7,4,11,2,"{""src/version.c"": {""insertions"": 2, ""deletions"": 0, ""lines"": 2}, ""src/vim9compile.c"": {""insertions"": 5, ""deletions"": 4, ""lines"": 9}}"
2021-08-02 18:06:50,bb7ee7abe1ea1e60b8a5dadd2bed8cdbe4f3e8fb,Bram Moolenaar,34,6,40,5,"{""src/evalfunc.c"": {""insertions"": 1, ""deletions"": 2, ""lines"": 3}, ""src/proto/evalfunc.pro"": {""insertions"": 1, ""deletions"": 0, ""lines"": 1}, ""src/testdir/test_vim9_builtin.vim"": {""insertions"": 19, ""deletions"": 0, ""lines"": 19}, ""src/version.c"": {""insertions"": 2, ""deletions"": 0, ""lines"": 2}, ""src/vim9compile.c"": {""insertions"": 11, ""deletions"": 4, ""lines"": 15}}"
2021-08-02 17:10:38,35578168becd1e11973bec413f2078a4bf81ba6b,Bram Moolenaar,64,61,125,5,"{""src/arglist.c"": {""insertions"": 3, ""deletions"": 3, ""lines"": 6}, ""src/macros.h"": {""insertions"": 4, ""deletions"": 2, ""lines"": 6}, ""src/version.c"": {""insertions"": 2, ""deletions"": 0, ""lines"": 2}, ""src/vim9compile.c"": {""insertions"": 21, ""deletions"": 21, ""lines"": 42}, ""src/vim9execute.c"": {""insertions"": 34, ""deletions"": 35, ""lines"": 69}}"
2021-08-02 16:07:18,952d9d827e5bfc66a6b1d39956e4e5596b09e2bd,Bram Moolenaar,38,67,105,11,"{""src/channel.c"": {""insertions"": 1, ""deletions"": 5, ""lines"": 6}, ""src/gui_xim.c"": {""insertions"": 3, ""deletions"": 1, ""lines"": 4}, ""src/if_mzsch.c"": {""insertions"": 1, ""deletions"": 1, ""lines"": 2}, ""src/nbdebug.c"": {""insertions"": 1, ""deletions"": 1, ""lines"": 2}, ""src/nbdebug.h"": {""insertions"": 1, ""deletions"": 5, ""lines"": 6}, ""src/netbeans.c"": {""insertions"": 1, ""deletions"": 1, ""lines"": 2}, ""src/proto.h"": {""insertions"": 12, ""deletions"": 42, ""lines"": 54}, ""src/term.c"": {""insertions"": 1, ""deletions"": 1, ""lines"": 2}, ""src/version.c"": {""insertions"": 2, ""deletions"": 0, ""lines"": 2}, ""src/vim.h"": {""insertions"": 15, ""deletions"": 2, ""lines"": 17}, ""src/vim9execute.c"": {""insertions"": 0, ""deletions"": 8, ""lines"": 8}}"
2021-08-01 20:01:30,1321257317b7d28228a6a9a0d612f81f70290b4c,Bram Moolenaar,3,1,4,2,"{""src/userfunc.c"": {""insertions"": 1, ""deletions"": 1, ""lines"": 2}, ""src/version.c"": {""insertions"": 2, ""deletions"": 0, ""lines"": 2}}"
2021-08-01 19:30:12,e041dde7bb9157644fa5135a252c84924b9ea433,Bram Moolenaar,12,4,16,3,"{""src/testdir/test_textprop.vim"": {""insertions"": 9, ""deletions"": 3, ""lines"": 12}, ""src/textprop.c"": {""insertions"": 1, ""deletions"": 1, ""lines"": 2}, ""src/version.c"": {""insertions"": 2, ""deletions"": 0, ""lines"": 2}}"
2021-08-01 19:19:43,e4db17fb6e2d029aa2dddfca703ace9bcf0d85fd,Bram Moolenaar,98,20,118,7,"{""src/ex_docmd.c"": {""insertions"": 1, ""deletions"": 1, ""lines"": 2}, ""src/proto/ex_docmd.pro"": {""insertions"": 1, ""deletions"": 0, ""lines"": 1}, ""src/testdir/test_vim9_script.vim"": {""insertions"": 28, ""deletions"": 0, ""lines"": 28}, ""src/usercmd.c"": {""insertions"": 19, ""deletions"": 16, ""lines"": 35}, ""src/userfunc.c"": {""insertions"": 15, ""deletions"": 2, ""lines"": 17}, ""src/version.c"": {""insertions"": 2, ""deletions"": 0, ""lines"": 2}, ""src/vim9compile.c"": {""insertions"": 32, ""deletions"": 1, ""lines"": 33}}"
2021-08-01 17:28:15,0d4d9ee9bb18f89d76c67f037baebe2c2db545f0,Bram Moolenaar,9,6,15,2,"{""src/textprop.c"": {""insertions"": 7, ""deletions"": 6, ""lines"": 13}, ""src/version.c"": {""insertions"": 2, ""deletions"": 0, ""lines"": 2}}"
2021-08-01 13:40:31,f78da4f9d6daf1907e4ce4be74146375dbd9a546,Bram Moolenaar,44,24,68,4,"{""src/evalfunc.c"": {""insertions"": 16, ""deletions"": 10, ""lines"": 26}, ""src/testdir/test_vim9_func.vim"": {""insertions"": 21, ""deletions"": 14, ""lines"": 35}, ""src/version.c"": {""insertions"": 2, ""deletions"": 0, ""lines"": 2}, ""src/vim9type.c"": {""insertions"": 5, ""deletions"": 0, ""lines"": 5}}"
2021-08-01 12:52:32,73b8b0ae3acac220e823076f8ca1c14524ed96dd,Bram Moolenaar,100,50,150,10,"{""runtime/doc/autocmd.txt"": {""insertions"": 6, ""deletions"": 0, ""lines"": 6}, ""runtime/doc/map.txt"": {""insertions"": 4, ""deletions"": 4, ""lines"": 8}, ""src/autocmd.c"": {""insertions"": 20, ""deletions"": 9, ""lines"": 29}, ""src/ex_docmd.c"": {""insertions"": 1, ""deletions"": 1, ""lines"": 2}, ""src/proto/autocmd.pro"": {""insertions"": 1, ""deletions"": 1, ""lines"": 2}, ""src/proto/usercmd.pro"": {""insertions"": 1, ""deletions"": 0, ""lines"": 1}, ""src/testdir/test_autocmd.vim"": {""insertions"": 16, ""deletions"": 0, ""lines"": 16}, ""src/usercmd.c"": {""insertions"": 44, ""deletions"": 35, ""lines"": 79}, ""src/version.c"": {""insertions"": 2, ""deletions"": 0, ""lines"": 2}, ""src/vim.h"": {""insertions"": 5, ""deletions"": 0, ""lines"": 5}}"
2021-08-01 12:08:54,6db660bed9ed5063f8c6e0fadeef32d44bbd017d,Bram Moolenaar,94,30,124,3,"{""src/testdir/test_vim9_disassemble.vim"": {""insertions"": 48, ""deletions"": 0, ""lines"": 48}, ""src/version.c"": {""insertions"": 2, ""deletions"": 0, ""lines"": 2}, ""src/vim9execute.c"": {""insertions"": 44, ""deletions"": 30, ""lines"": 74}}"
2021-08-01 11:17:17,e97976baa7a74fbbe0cfecd1943fe1c5f9dfba4f,Bram Moolenaar,19,5,24,3,"{""src/testdir/test_vim9_assign.vim"": {""insertions"": 6, ""deletions"": 0, ""lines"": 6}, ""src/version.c"": {""insertions"": 2, ""deletions"": 0, ""lines"": 2}, ""src/vim9compile.c"": {""insertions"": 11, ""deletions"": 5, ""lines"": 16}}"
2021-08-01 10:44:37,78ba933d18439ff1a02f6be4c571e73ddceb3cd4,Christian Brabandt,66,1,67,3,"{""src/search.c"": {""insertions"": 10, ""deletions"": 1, ""lines"": 11}, ""src/testdir/test_search.vim"": {""insertions"": 54, ""deletions"": 0, ""lines"": 54}, ""src/version.c"": {""insertions"": 2, ""deletions"": 0, ""lines"": 2}}"
2021-08-01 10:01:49,f24f51d03035379cf3e5b2dccf489a40bc4ca92a,Bram Moolenaar,6,2,8,2,"{""src/eval.c"": {""insertions"": 4, ""deletions"": 2, ""lines"": 6}, ""src/version.c"": {""insertions"": 2, ""deletions"": 0, ""lines"": 2}}"
2021-07-31 20:51:10,f5d52c90e0f2f51622a911b646024b2ad1225ed4,Bram Moolenaar,40,7,47,4,"{""src/testdir/test_vim9_assign.vim"": {""insertions"": 26, ""deletions"": 0, ""lines"": 26}, ""src/testdir/test_vim9_disassemble.vim"": {""insertions"": 1, ""deletions"": 1, ""lines"": 2}, ""src/version.c"": {""insertions"": 2, ""deletions"": 0, ""lines"": 2}, ""src/vim9compile.c"": {""insertions"": 11, ""deletions"": 6, ""lines"": 17}}"
2021-07-31 20:17:28,9e0ee590197d74f94b7127bf0e033e4f83cf3762,Bram Moolenaar,3,2,5,2,"{""src/ex_docmd.c"": {""insertions"": 1, ""deletions"": 2, ""lines"": 3}, ""src/version.c"": {""insertions"": 2, ""deletions"": 0, ""lines"": 2}}"
2021-07-31 20:03:59,1780f08ba42837b6d4a5f0451117a79b2d49974a,Bram Moolenaar,19,4,23,3,"{""src/evalfunc.c"": {""insertions"": 8, ""deletions"": 1, ""lines"": 9}, ""src/testdir/test_vim9_builtin.vim"": {""insertions"": 9, ""deletions"": 3, ""lines"": 12}, ""src/version.c"": {""insertions"": 2, ""deletions"": 0, ""lines"": 2}}"
2021-07-31 19:44:35,335c8c7b206df776b59fb63a1c7f91c8b1425398,Bram Moolenaar,3,1,4,2,"{""src/ex_docmd.c"": {""insertions"": 1, ""deletions"": 1, ""lines"": 2}, ""src/version.c"": {""insertions"": 2, ""deletions"": 0, ""lines"": 2}}"
2021-07-31 19:32:31,620c959c6c00e469c4d3b1ab2e08e4767ee142a4,Bram Moolenaar,78,61,139,4,"{""src/ex_docmd.c"": {""insertions"": 68, ""deletions"": 61, ""lines"": 129}, ""src/indent.c"": {""insertions"": 7, ""deletions"": 0, ""lines"": 7}, ""src/proto/ex_docmd.pro"": {""insertions"": 1, ""deletions"": 0, ""lines"": 1}, ""src/version.c"": {""insertions"": 2, ""deletions"": 0, ""lines"": 2}}"
2021-07-31 17:12:58,78db17c6f335f518752ca221ec6bde79db584e15,Bram Moolenaar,39,37,76,4,"{""src/errors.h"": {""insertions"": 8, ""deletions"": 8, ""lines"": 16}, ""src/testdir/test_vim9_builtin.vim"": {""insertions"": 26, ""deletions"": 26, ""lines"": 52}, ""src/typval.c"": {""insertions"": 3, ""deletions"": 3, ""lines"": 6}, ""src/version.c"": {""insertions"": 2, ""deletions"": 0, ""lines"": 2}}"
2021-07-31 16:33:57,8e3fc135e884a30620fb1c6e84986fae1467acd3,Bram Moolenaar,9,0,9,3,"{""src/testdir/test_textprop.vim"": {""insertions"": 3, ""deletions"": 0, ""lines"": 3}, ""src/textprop.c"": {""insertions"": 4, ""deletions"": 0, ""lines"": 4}, ""src/version.c"": {""insertions"": 2, ""deletions"": 0, ""lines"": 2}}"
2021-07-31 15:20:04,bf634a0a8b64fda2e53d3e2254fe0ffdc3d67196,Bram Moolenaar,5,0,5,2,"{""src/testdir/test_functions.vim"": {""insertions"": 3, ""deletions"": 0, ""lines"": 3}, ""src/version.c"": {""insertions"": 2, ""deletions"": 0, ""lines"": 2}}"
2021-07-31 11:31:42,b9115da4bec5e6cfff69da85cc47c42dd67e42e4,Connor Lane Smith,54,5,59,4,"{""src/search.c"": {""insertions"": 2, ""deletions"": 0, ""lines"": 2}, ""src/testdir/test_textobjects.vim"": {""insertions"": 32, ""deletions"": 0, ""lines"": 32}, ""src/textobject.c"": {""insertions"": 18, ""deletions"": 5, ""lines"": 23}, ""src/version.c"": {""insertions"": 2, ""deletions"": 0, ""lines"": 2}}"
2021-07-31 10:43:23,28d8421bfb3327d7a5e81369977e8fc108b0229e,Yegappan Lakshmanan,32,5,37,5,"{""runtime/doc/eval.txt"": {""insertions"": 4, ""deletions"": 2, ""lines"": 6}, ""src/evalwindow.c"": {""insertions"": 6, ""deletions"": 0, ""lines"": 6}, ""src/misc2.c"": {""insertions"": 3, ""deletions"": 3, ""lines"": 6}, ""src/testdir/test_quickfix.vim"": {""insertions"": 17, ""deletions"": 0, ""lines"": 17}, ""src/version.c"": {""insertions"": 2, ""deletions"": 0, ""lines"": 2}}"
2021-07-30 19:56:10,890ee4e2be1dca0c07a91f836e26baead952ae7c,Bram Moolenaar,7,5,12,3,"{""src/testdir/test_channel.py"": {""insertions"": 5, ""deletions"": 0, ""lines"": 5}, ""src/testdir/test_channel.vim"": {""insertions"": 0, ""deletions"": 5, ""lines"": 5}, ""src/version.c"": {""insertions"": 2, ""deletions"": 0, ""lines"": 2}}"
2021-07-30 19:32:45,4a15504e911bc90a29d862862f0b7a46d8acd12a,Yegappan Lakshmanan,53,59,112,5,"{""src/evalbuffer.c"": {""insertions"": 14, ""deletions"": 21, ""lines"": 35}, ""src/evalfunc.c"": {""insertions"": 0, ""deletions"": 36, ""lines"": 36}, ""src/map.c"": {""insertions"": 35, ""deletions"": 1, ""lines"": 36}, ""src/proto/map.pro"": {""insertions"": 2, ""deletions"": 1, ""lines"": 3}, ""src/version.c"": {""insertions"": 2, ""deletions"": 0, ""lines"": 2}}"
2021-07-30 19:18:03,0f5575d0a7316a9c9a4b02df3372a07514cd8f26,Bram Moolenaar,16,1,17,3,"{""src/term.c"": {""insertions"": 2, ""deletions"": 1, ""lines"": 3}, ""src/testdir/test_termcodes.vim"": {""insertions"": 12, ""deletions"": 0, ""lines"": 12}, ""src/version.c"": {""insertions"": 2, ""deletions"": 0, ""lines"": 2}}"
2021-07-30 18:51:59,1790be6cb6f2edfd8a833dd848b8df02cef599cf,Christian Brabandt,3,1,4,2,"{""src/Make_mvc.mak"": {""insertions"": 1, ""deletions"": 1, ""lines"": 2}, ""src/version.c"": {""insertions"": 2, ""deletions"": 0, ""lines"": 2}}"
2021-07-29 20:48:54,60dc8274e9f8c6a20d54efebc7a8752fe062eead,Bram Moolenaar,26,10,36,8,"{""src/eval.c"": {""insertions"": 1, ""deletions"": 1, ""lines"": 2}, ""src/proto/vim9type.pro"": {""insertions"": 1, ""deletions"": 1, ""lines"": 2}, ""src/testdir/test_vim9_script.vim"": {""insertions"": 6, ""deletions"": 0, ""lines"": 6}, ""src/version.c"": {""insertions"": 2, ""deletions"": 0, ""lines"": 2}, ""src/vim.h"": {""insertions"": 3, ""deletions"": 0, ""lines"": 3}, ""src/vim9execute.c"": {""insertions"": 1, ""deletions"": 1, ""lines"": 2}, ""src/vim9script.c"": {""insertions"": 3, ""deletions"": 2, ""lines"": 5}, ""src/vim9type.c"": {""insertions"": 9, ""deletions"": 5, ""lines"": 14}}"
2021-07-29 20:25:05,921ba529266c8dfc0809d41e1f084e26d25fffb1,Bram Moolenaar,16,0,16,3,"{""src/testdir/test_vim9_script.vim"": {""insertions"": 10, ""deletions"": 0, ""lines"": 10}, ""src/version.c"": {""insertions"": 2, ""deletions"": 0, ""lines"": 2}, ""src/vim9script.c"": {""insertions"": 4, ""deletions"": 0, ""lines"": 4}}"
2021-07-29 19:23:50,77ab4e28a26a92628bc85cd580c1bfa2b6230be6,Bram Moolenaar,8,5,13,2,"{""src/fileio.c"": {""insertions"": 6, ""deletions"": 5, ""lines"": 11}, ""src/version.c"": {""insertions"": 2, ""deletions"": 0, ""lines"": 2}}"
2021-07-29 19:11:30,77111e2bfc7316eb6b1e653386cef6441af806f8,Bram Moolenaar,3,1,4,2,"{""src/option.c"": {""insertions"": 1, ""deletions"": 1, ""lines"": 2}, ""src/version.c"": {""insertions"": 2, ""deletions"": 0, ""lines"": 2}}"
2021-07-29 18:37:49,131530a54d0f72b820b027606231744e3a09b9ef,Bram Moolenaar,25,13,38,7,"{""src/buffer.c"": {""insertions"": 4, ""deletions"": 0, ""lines"": 4}, ""src/crypt.c"": {""insertions"": 13, ""deletions"": 4, ""lines"": 17}, ""src/errors.h"": {""insertions"": 2, ""deletions"": 0, ""lines"": 2}, ""src/fileio.c"": {""insertions"": 0, ""deletions"": 4, ""lines"": 4}, ""src/memline.c"": {""insertions"": 0, ""deletions"": 5, ""lines"": 5}, ""src/version.c"": {""insertions"": 2, ""deletions"": 0, ""lines"": 2}, ""src/vim.h"": {""insertions"": 4, ""deletions"": 0, ""lines"": 4}}"
2021-07-29 18:22:14,41114a2a27047bf1884e092b98c6298c128eb2f0,Yegappan Lakshmanan,34,8,42,4,"{""src/if_lua.c"": {""insertions"": 15, ""deletions"": 8, ""lines"": 23}, ""src/misc2.c"": {""insertions"": 16, ""deletions"": 0, ""lines"": 16}, ""src/proto/misc2.pro"": {""insertions"": 1, ""deletions"": 0, ""lines"": 1}, ""src/version.c"": {""insertions"": 2, ""deletions"": 0, ""lines"": 2}}"
2021-07-29 17:18:33,83cd0156e01b5befadf12ee66bc26436ee8d023f,msoyka-of-wharton,34,96,130,3,"{""src/GvimExt/gvimext.cpp"": {""insertions"": 31, ""deletions"": 89, ""lines"": 120}, ""src/GvimExt/gvimext.h"": {""insertions"": 1, ""deletions"": 7, ""lines"": 8}, ""src/version.c"": {""insertions"": 2, ""deletions"": 0, ""lines"": 2}}"
2021-07-28 20:44:08,0732932553e54e9bfca07e55b47201b8f30b2c4f,Bram Moolenaar,4,2,6,2,"{""src/testdir/test_vim9_builtin.vim"": {""insertions"": 2, ""deletions"": 2, ""lines"": 4}, ""src/version.c"": {""insertions"": 2, ""deletions"": 0, ""lines"": 2}}"
2021-07-28 20:21:23,6e850a6900793e215c08b39d6490173488cb05ce,Bram Moolenaar,5,0,5,2,"{""src/userfunc.c"": {""insertions"": 3, ""deletions"": 0, ""lines"": 3}, ""src/version.c"": {""insertions"": 2, ""deletions"": 0, ""lines"": 2}}"
2021-07-28 19:48:59,2a4bd00cef1a291059903e26a126b84718e47804,Bram Moolenaar,5,2,7,3,"{""src/if_lua.c"": {""insertions"": 1, ""deletions"": 0, ""lines"": 1}, ""src/testdir/test_lua.vim"": {""insertions"": 2, ""deletions"": 2, ""lines"": 4}, ""src/version.c"": {""insertions"": 2, ""deletions"": 0, ""lines"": 2}}"
2021-07-28 19:25:49,81530e36033dec2c2cd94af6dd48ceb0389e95a2,Bram Moolenaar,22,1,23,4,"{""src/evalvars.c"": {""insertions"": 3, ""deletions"": 0, ""lines"": 3}, ""src/testdir/test_vim9_assign.vim"": {""insertions"": 8, ""deletions"": 0, ""lines"": 8}, ""src/version.c"": {""insertions"": 2, ""deletions"": 0, ""lines"": 2}, ""src/vim9compile.c"": {""insertions"": 9, ""deletions"": 1, ""lines"": 10}}"
2021-07-28 18:52:13,d47c39775b8d381005751b7b20da56412dafb5e4,Bram Moolenaar,10,2,12,4,"{""src/errors.h"": {""insertions"": 2, ""deletions"": 0, ""lines"": 2}, ""src/testdir/test_vim9_expr.vim"": {""insertions"": 1, ""deletions"": 1, ""lines"": 2}, ""src/version.c"": {""insertions"": 2, ""deletions"": 0, ""lines"": 2}, ""src/vim9compile.c"": {""insertions"": 5, ""deletions"": 1, ""lines"": 6}}"
2021-07-28 18:10:16,53f7fccc9413c9f770694b56f40f242d383b2d5f,Bram Moolenaar,804,353,1157,33,"{"".github/CODEOWNERS"": {""insertions"": 2, ""deletions"": 0, ""lines"": 2}, "".github/workflows/ci.yml"": {""insertions"": 1, ""deletions"": 1, ""lines"": 2}, ""README_VIM9.md"": {""insertions"": 13, ""deletions"": 7, ""lines"": 20}, ""runtime/compiler/spectral.vim"": {""insertions"": 17, ""deletions"": 0, ""lines"": 17}, ""runtime/compiler/yamllint.vim"": {""insertions"": 16, ""deletions"": 0, ""lines"": 16}, ""runtime/doc/autocmd.txt"": {""insertions"": 3, ""deletions"": 2, ""lines"": 5}, ""runtime/doc/digraph.txt"": {""insertions"": 1, ""deletions"": 1, ""lines"": 2}, ""runtime/doc/editing.txt"": {""insertions"": 6, ""deletions"": 3, ""lines"": 9}, ""runtime/doc/eval.txt"": {""insertions"": 66, ""deletions"": 31, ""lines"": 97}, ""runtime/doc/fold.txt"": {""insertions"": 3, ""deletions"": 1, ""lines"": 4}, ""runtime/doc/map.txt"": {""insertions"": 3, ""deletions"": 2, ""lines"": 5}, ""runtime/doc/options.txt"": {""insertions"": 2, ""deletions"": 1, ""lines"": 3}, ""runtime/doc/pattern.txt"": {""insertions"": 6, ""deletions"": 5, ""lines"": 11}, ""runtime/doc/syntax.txt"": {""insertions"": 1, ""deletions"": 1, ""lines"": 2}, ""runtime/doc/tags"": {""insertions"": 8, ""deletions"": 0, ""lines"": 8}, ""runtime/doc/todo.txt"": {""insertions"": 23, ""deletions"": 10, ""lines"": 33}, ""runtime/doc/usr_41.txt"": {""insertions"": 1, ""deletions"": 1, ""lines"": 2}, ""runtime/doc/version6.txt"": {""insertions"": 1, ""deletions"": 1, ""lines"": 2}, ""runtime/doc/version7.txt"": {""insertions"": 2, ""deletions"": 2, ""lines"": 4}, ""runtime/doc/version8.txt"": {""insertions"": 8, ""deletions"": 4, ""lines"": 12}, ""runtime/doc/vim9.txt"": {""insertions"": 54, ""deletions"": 12, ""lines"": 66}, ""runtime/indent/bzl.vim"": {""insertions"": 26, ""deletions"": 15, ""lines"": 41}, ""runtime/indent/testdir/xml.in"": {""insertions"": 1, ""deletions"": 1, ""lines"": 2}, ""runtime/indent/testdir/xml.ok"": {""insertions"": 1, ""deletions"": 1, ""lines"": 2}, ""runtime/macros/hanoi/hanoi.vim"": {""insertions"": 1, ""deletions"": 1, ""lines"": 2}, ""runtime/pack/dist/opt/matchit/doc/matchit.txt"": {""insertions"": 2, ""deletions"": 2, ""lines"": 4}, ""runtime/spell/tet/main.aap"": {""insertions"": 1, ""deletions"": 1, ""lines"": 2}, ""runtime/syntax/aptconf.vim"": {""insertions"": 8, ""deletions"": 5, ""lines"": 13}, ""runtime/syntax/pascal.vim"": {""insertions"": 1, ""deletions"": 1, ""lines"": 2}, ""runtime/syntax/redif.vim"": {""insertions"": 2, ""deletions"": 2, ""lines"": 4}, ""runtime/tools/shtags.1"": {""insertions"": 1, ""deletions"": 1, ""lines"": 2}, ""runtime/tools/xcmdsrv_client.c"": {""insertions"": 1, ""deletions"": 1, ""lines"": 2}, ""src/po/tr.po"": {""insertions"": 522, ""deletions"": 237, ""lines"": 759}}"
2021-07-28 17:34:14,327d3ee4557027b51aad86e68743a85ed3a6f52b,Bram Moolenaar,23,1,24,3,"{""src/testdir/test_vim9_assign.vim"": {""insertions"": 15, ""deletions"": 0, ""lines"": 15}, ""src/userfunc.c"": {""insertions"": 6, ""deletions"": 1, ""lines"": 7}, ""src/version.c"": {""insertions"": 2, ""deletions"": 0, ""lines"": 2}}"
2021-07-28 14:51:53,eaf3f36168f85c8e0ab7083cd996b9fbe937045d,zeertzjq,22,1,23,6,"{""runtime/doc/eval.txt"": {""insertions"": 4, ""deletions"": 0, ""lines"": 4}, ""src/globals.h"": {""insertions"": 2, ""deletions"": 0, ""lines"": 2}, ""src/misc1.c"": {""insertions"": 4, ""deletions"": 0, ""lines"": 4}, ""src/normal.c"": {""insertions"": 0, ""deletions"": 1, ""lines"": 1}, ""src/testdir/test_functions.vim"": {""insertions"": 10, ""deletions"": 0, ""lines"": 10}, ""src/version.c"": {""insertions"": 2, ""deletions"": 0, ""lines"": 2}}"
2021-07-28 13:54:54,6868634abd6a49b2dfd3a994a6da7d5911457a37,Bram Moolenaar,10,1,11,3,"{""src/testdir/test_usercommands.vim"": {""insertions"": 7, ""deletions"": 0, ""lines"": 7}, ""src/userfunc.c"": {""insertions"": 1, ""deletions"": 1, ""lines"": 2}, ""src/version.c"": {""insertions"": 2, ""deletions"": 0, ""lines"": 2}}"
2021-07-28 13:07:01,78e006b9b02fac94c910445d842f6dc5331fa57a,Bram Moolenaar,22,2,24,3,"{""src/if_lua.c"": {""insertions"": 2, ""deletions"": 2, ""lines"": 4}, ""src/testdir/test_lua.vim"": {""insertions"": 18, ""deletions"": 0, ""lines"": 18}, ""src/version.c"": {""insertions"": 2, ""deletions"": 0, ""lines"": 2}}"
2021-07-28 11:30:16,e2390c7f32879ab7942adf0d38b1db34933695fa,Martin Tournoij,149,61,210,4,"{""runtime/doc/textprop.txt"": {""insertions"": 2, ""deletions"": 0, ""lines"": 2}, ""src/testdir/test_textprop.vim"": {""insertions"": 129, ""deletions"": 58, ""lines"": 187}, ""src/textprop.c"": {""insertions"": 16, ""deletions"": 3, ""lines"": 19}, ""src/version.c"": {""insertions"": 2, ""deletions"": 0, ""lines"": 2}}"
2021-07-28 09:51:48,7e6a2a64f09df577f29e024c1d1e6733d6bc1b7c,Yegappan Lakshmanan,21,1,22,5,"{""src/misc1.c"": {""insertions"": 1, ""deletions"": 1, ""lines"": 2}, ""src/proto/typval.pro"": {""insertions"": 1, ""deletions"": 0, ""lines"": 1}, ""src/testdir/test_vim9_builtin.vim"": {""insertions"": 6, ""deletions"": 0, ""lines"": 6}, ""src/typval.c"": {""insertions"": 11, ""deletions"": 0, ""lines"": 11}, ""src/version.c"": {""insertions"": 2, ""deletions"": 0, ""lines"": 2}}"
2021-07-27 20:35:42,9088784972c0ed72997de8752964d6b587218778,Bram Moolenaar,4,0,4,2,"{""src/errors.h"": {""insertions"": 2, ""deletions"": 0, ""lines"": 2}, ""src/version.c"": {""insertions"": 2, ""deletions"": 0, ""lines"": 2}}"
2021-07-27 20:21:44,f723701de0636ad8b4aad6179b322f72b04354b9,Bram Moolenaar,15,0,15,3,"{""src/testdir/test_vim9_builtin.vim"": {""insertions"": 10, ""deletions"": 0, ""lines"": 10}, ""src/version.c"": {""insertions"": 2, ""deletions"": 0, ""lines"": 2}, ""src/vim9compile.c"": {""insertions"": 3, ""deletions"": 0, ""lines"": 3}}"
2021-07-27 20:00:44,4490ec4e839e45a2e6923c265c7e9e64c240b805,Yegappan Lakshmanan,1710,630,2340,55,"{""src/arglist.c"": {""insertions"": 15, ""deletions"": 0, ""lines"": 15}, ""src/change.c"": {""insertions"": 8, ""deletions"": 1, ""lines"": 9}, ""src/channel.c"": {""insertions"": 41, ""deletions"": 6, ""lines"": 47}, ""src/cindent.c"": {""insertions"": 3, ""deletions"": 0, ""lines"": 3}, ""src/clientserver.c"": {""insertions"": 28, ""deletions"": 11, ""lines"": 39}, ""src/cmdhist.c"": {""insertions"": 10, ""deletions"": 1, ""lines"": 11}, ""src/dict.c"": {""insertions"": 8, ""deletions"": 0, ""lines"": 8}, ""src/diff.c"": {""insertions"": 3, ""deletions"": 0, ""lines"": 3}, ""src/digraph.c"": {""insertions"": 12, ""deletions"": 0, ""lines"": 12}, ""src/errors.h"": {""insertions"": 20, ""deletions"": 0, ""lines"": 20}, ""src/eval.c"": {""insertions"": 2, ""deletions"": 2, ""lines"": 4}, ""src/evalbuffer.c"": {""insertions"": 48, ""deletions"": 6, ""lines"": 54}, ""src/evalfunc.c"": {""insertions"": 278, ""deletions"": 33, ""lines"": 311}, ""src/evalwindow.c"": {""insertions"": 68, ""deletions"": 3, ""lines"": 71}, ""src/ex_docmd.c"": {""insertions"": 6, ""deletions"": 1, ""lines"": 7}, ""src/ex_getln.c"": {""insertions"": 15, ""deletions"": 2, ""lines"": 17}, ""src/filepath.c"": {""insertions"": 57, ""deletions"": 5, ""lines"": 62}, ""src/findfile.c"": {""insertions"": 3, ""deletions"": 0, ""lines"": 3}, ""src/float.c"": {""insertions"": 86, ""deletions"": 2, ""lines"": 88}, ""src/fold.c"": {""insertions"": 10, ""deletions"": 0, ""lines"": 10}, ""src/getchar.c"": {""insertions"": 3, ""deletions"": 0, ""lines"": 3}, ""src/indent.c"": {""insertions"": 6, ""deletions"": 0, ""lines"": 6}, ""src/insexpand.c"": {""insertions"": 4, ""deletions"": 4, ""lines"": 8}, ""src/job.c"": {""insertions"": 16, ""deletions"": 2, ""lines"": 18}, ""src/json.c"": {""insertions"": 6, ""deletions"": 0, ""lines"": 6}, ""src/list.c"": {""insertions"": 1, ""deletions"": 4, ""lines"": 5}, ""src/mark.c"": {""insertions"": 3, ""deletions"": 0, ""lines"": 3}, ""src/match.c"": {""insertions"": 22, ""deletions"": 4, ""lines"": 26}, ""src/mbyte.c"": {""insertions"": 9, ""deletions"": 0, ""lines"": 9}, ""src/menu.c"": {""insertions"": 5, ""deletions"": 0, ""lines"": 5}, ""src/misc1.c"": {""insertions"": 7, ""deletions"": 1, ""lines"": 8}, ""src/move.c"": {""insertions"": 6, ""deletions"": 0, ""lines"": 6}, ""src/popupwin.c"": {""insertions"": 45, ""deletions"": 10, ""lines"": 55}, ""src/proto/typval.pro"": {""insertions"": 6, ""deletions"": 1, ""lines"": 7}, ""src/quickfix.c"": {""insertions"": 8, ""deletions"": 0, ""lines"": 8}, ""src/search.c"": {""insertions"": 3, ""deletions"": 0, ""lines"": 3}, ""src/sign.c"": {""insertions"": 18, ""deletions"": 0, ""lines"": 18}, ""src/sound.c"": {""insertions"": 8, ""deletions"": 1, ""lines"": 9}, ""src/strings.c"": {""insertions"": 63, ""deletions"": 2, ""lines"": 65}, ""src/terminal.c"": {""insertions"": 51, ""deletions"": 16, ""lines"": 67}, ""src/testdir/test_assert.vim"": {""insertions"": 1, ""deletions"": 1, ""lines"": 2}, ""src/testdir/test_blob.vim"": {""insertions"": 1, ""deletions"": 1, ""lines"": 2}, ""src/testdir/test_execute_func.vim"": {""insertions"": 1, ""deletions"": 1, ""lines"": 2}, ""src/testdir/test_float_func.vim"": {""insertions"": 1, ""deletions"": 2, ""lines"": 3}, ""src/testdir/test_functions.vim"": {""insertions"": 3, ""deletions"": 6, ""lines"": 9}, ""src/testdir/test_glob2regpat.vim"": {""insertions"": 1, ""deletions"": 2, ""lines"": 3}, ""src/testdir/test_listdict.vim"": {""insertions"": 1, ""deletions"": 1, ""lines"": 2}, ""src/testdir/test_vim9_builtin.vim"": {""insertions"": 482, ""deletions"": 482, ""lines"": 964}, ""src/testdir/test_vim9_script.vim"": {""insertions"": 1, ""deletions"": 1, ""lines"": 2}, ""src/testing.c"": {""insertions"": 57, ""deletions"": 4, ""lines"": 61}, ""src/textprop.c"": {""insertions"": 25, ""deletions"": 1, ""lines"": 26}, ""src/time.c"": {""insertions"": 24, ""deletions"": 0, ""lines"": 24}, ""src/typval.c"": {""insertions"": 96, ""deletions"": 10, ""lines"": 106}, ""src/undo.c"": {""insertions"": 3, ""deletions"": 0, ""lines"": 3}, ""src/version.c"": {""insertions"": 2, ""deletions"": 0, ""lines"": 2}}"
2021-07-27 19:17:32,5d7c2df536c17db4a9c61e0760bdcf78d0db7330,Bram Moolenaar,84,14,98,6,"{""runtime/doc/map.txt"": {""insertions"": 10, ""deletions"": 0, ""lines"": 10}, ""src/misc2.c"": {""insertions"": 10, ""deletions"": 11, ""lines"": 21}, ""src/proto/misc2.pro"": {""insertions"": 1, ""deletions"": 1, ""lines"": 2}, ""src/testdir/test_usercommands.vim"": {""insertions"": 18, ""deletions"": 0, ""lines"": 18}, ""src/usercmd.c"": {""insertions"": 43, ""deletions"": 2, ""lines"": 45}, ""src/version.c"": {""insertions"": 2, ""deletions"": 0, ""lines"": 2}}"
2021-07-26 20:19:10,53ba05b09075f14227f9be831a22ed16f7cc26b2,Gary Johnson,220,41,261,17,"{""runtime/doc/options.txt"": {""insertions"": 5, ""deletions"": 1, ""lines"": 6}, ""src/buffer.c"": {""insertions"": 1, ""deletions"": 0, ""lines"": 1}, ""src/change.c"": {""insertions"": 1, ""deletions"": 1, ""lines"": 2}, ""src/drawscreen.c"": {""insertions"": 4, ""deletions"": 4, ""lines"": 8}, ""src/edit.c"": {""insertions"": 3, ""deletions"": 3, ""lines"": 6}, ""src/misc2.c"": {""insertions"": 12, ""deletions"": 9, ""lines"": 21}, ""src/normal.c"": {""insertions"": 3, ""deletions"": 3, ""lines"": 6}, ""src/ops.c"": {""insertions"": 11, ""deletions"": 5, ""lines"": 16}, ""src/option.c"": {""insertions"": 20, ""deletions"": 1, ""lines"": 21}, ""src/option.h"": {""insertions"": 3, ""deletions"": 0, ""lines"": 3}, ""src/optiondefs.h"": {""insertions"": 2, ""deletions"": 1, ""lines"": 3}, ""src/optionstr.c"": {""insertions"": 25, ""deletions"": 9, ""lines"": 34}, ""src/proto/option.pro"": {""insertions"": 1, ""deletions"": 0, ""lines"": 1}, ""src/register.c"": {""insertions"": 5, ""deletions"": 4, ""lines"": 9}, ""src/structs.h"": {""insertions"": 2, ""deletions"": 0, ""lines"": 2}, ""src/testdir/test_virtualedit.vim"": {""insertions"": 120, ""deletions"": 0, ""lines"": 120}, ""src/version.c"": {""insertions"": 2, ""deletions"": 0, ""lines"": 2}}"
2021-07-26 19:54:04,29b857150c111a455f1a38a8f748243524f692e1,h-east,190,189,379,10,"{""runtime/doc/digraph.txt"": {""insertions"": 1, ""deletions"": 1, ""lines"": 2}, ""runtime/doc/eval.txt"": {""insertions"": 105, ""deletions"": 106, ""lines"": 211}, ""runtime/doc/usr_41.txt"": {""insertions"": 4, ""deletions"": 4, ""lines"": 8}, ""src/digraph.c"": {""insertions"": 24, ""deletions"": 24, ""lines"": 48}, ""src/edit.c"": {""insertions"": 1, ""deletions"": 1, ""lines"": 2}, ""src/errors.h"": {""insertions"": 2, ""deletions"": 2, ""lines"": 4}, ""src/evalfunc.c"": {""insertions"": 8, ""deletions"": 8, ""lines"": 16}, ""src/proto/digraph.pro"": {""insertions"": 6, ""deletions"": 6, ""lines"": 12}, ""src/testdir/test_digraph.vim"": {""insertions"": 37, ""deletions"": 37, ""lines"": 74}, ""src/version.c"": {""insertions"": 2, ""deletions"": 0, ""lines"": 2}}"
2021-07-26 19:11:32,ccb148ac63941feba879ea4678aa4713d81494f2,Bram Moolenaar,3,1,4,2,"{""src/ex_getln.c"": {""insertions"": 1, ""deletions"": 1, ""lines"": 2}, ""src/version.c"": {""insertions"": 2, ""deletions"": 0, ""lines"": 2}}"
2021-07-26 19:10:11,678b207fb111840fec1f0dc43910613ba106b90d,Bram Moolenaar,23,2,25,4,"{""src/eval.c"": {""insertions"": 2, ""deletions"": 1, ""lines"": 3}, ""src/testdir/test_vim9_cmd.vim"": {""insertions"": 14, ""deletions"": 0, ""lines"": 14}, ""src/version.c"": {""insertions"": 2, ""deletions"": 0, ""lines"": 2}, ""src/vim9compile.c"": {""insertions"": 5, ""deletions"": 1, ""lines"": 6}}"
2021-07-25 18:27:06,ff34bee3a2d22f2ff7abd4519270b5518082c33d,Bram Moolenaar,34,1,35,3,"{""src/ex_cmds.h"": {""insertions"": 1, ""deletions"": 1, ""lines"": 2}, ""src/testdir/test_ins_complete.vim"": {""insertions"": 31, ""deletions"": 0, ""lines"": 31}, ""src/version.c"": {""insertions"": 2, ""deletions"": 0, ""lines"": 2}}"
2021-07-25 16:07:00,3c77b6a1ce1d4a06c60bb9fae7eec2775f547d55,Bram Moolenaar,27,3,30,3,"{""src/testdir/test_vim9_func.vim"": {""insertions"": 10, ""deletions"": 1, ""lines"": 11}, ""src/version.c"": {""insertions"": 2, ""deletions"": 0, ""lines"": 2}, ""src/vim9compile.c"": {""insertions"": 15, ""deletions"": 2, ""lines"": 17}}"
2021-07-25 13:57:32,a764e73d4ffc5d046807c757eaacb9b0a5408152,Yegappan Lakshmanan,189,17,206,9,"{""src/evalfunc.c"": {""insertions"": 70, ""deletions"": 10, ""lines"": 80}, ""src/popupwin.c"": {""insertions"": 5, ""deletions"": 1, ""lines"": 6}, ""src/proto/typval.pro"": {""insertions"": 2, ""deletions"": 0, ""lines"": 2}, ""src/testdir/test_assert.vim"": {""insertions"": 3, ""deletions"": 3, ""lines"": 6}, ""src/testdir/test_vim9_builtin.vim"": {""insertions"": 60, ""deletions"": 0, ""lines"": 60}, ""src/testdir/test_vim9_script.vim"": {""insertions"": 2, ""deletions"": 2, ""lines"": 4}, ""src/testing.c"": {""insertions"": 18, ""deletions"": 1, ""lines"": 19}, ""src/typval.c"": {""insertions"": 27, ""deletions"": 0, ""lines"": 27}, ""src/version.c"": {""insertions"": 2, ""deletions"": 0, ""lines"": 2}}"
2021-07-25 13:41:44,2ec28aec9d4f1b9c1c008e36adde9fc82affae0f,Dominique Pelle,9,2,11,2,"{""src/testdir/test_vim9_builtin.vim"": {""insertions"": 7, ""deletions"": 2, ""lines"": 9}, ""src/version.c"": {""insertions"": 2, ""deletions"": 0, ""lines"": 2}}"
2021-07-25 13:08:05,7a4ca32175bef0f9a177052796bd9addd10dc218,Christian Brabandt,39,0,39,4,"{""runtime/doc/editing.txt"": {""insertions"": 6, ""deletions"": 0, ""lines"": 6}, ""src/findfile.c"": {""insertions"": 9, ""deletions"": 0, ""lines"": 9}, ""src/testdir/test_findfile.vim"": {""insertions"": 22, ""deletions"": 0, ""lines"": 22}, ""src/version.c"": {""insertions"": 2, ""deletions"": 0, ""lines"": 2}}"
2021-07-25 12:36:05,8a4c812ede5b01a8e71082c1ff4ebfcbf1bd515f,Christian Brabandt,43,11,54,6,"{""src/bufwrite.c"": {""insertions"": 13, ""deletions"": 4, ""lines"": 17}, ""src/crypt.c"": {""insertions"": 1, ""deletions"": 4, ""lines"": 5}, ""src/proto/undo.pro"": {""insertions"": 1, ""deletions"": 0, ""lines"": 1}, ""src/testdir/test_crypt.vim"": {""insertions"": 4, ""deletions"": 3, ""lines"": 7}, ""src/undo.c"": {""insertions"": 22, ""deletions"": 0, ""lines"": 22}, ""src/version.c"": {""insertions"": 2, ""deletions"": 0, ""lines"": 2}}"
2021-07-25 12:21:11,3ed0d9379683246a77aa8c1a59da7a0ac6395339,Bram Moolenaar,3,1,4,2,"{""src/globals.h"": {""insertions"": 1, ""deletions"": 1, ""lines"": 2}, ""src/version.c"": {""insertions"": 2, ""deletions"": 0, ""lines"": 2}}"
2021-07-25 12:13:53,2eb6fc3b52148f961e804ec2be361d531ff770d8,Bram Moolenaar,135,76,211,8,"{""src/eval.c"": {""insertions"": 7, ""deletions"": 3, ""lines"": 10}, ""src/evalvars.c"": {""insertions"": 1, ""deletions"": 7, ""lines"": 8}, ""src/ex_eval.c"": {""insertions"": 4, ""deletions"": 14, ""lines"": 18}, ""src/structs.h"": {""insertions"": 3, ""deletions"": 0, ""lines"": 3}, ""src/testdir/test_vim9_script.vim"": {""insertions"": 28, ""deletions"": 0, ""lines"": 28}, ""src/userfunc.c"": {""insertions"": 36, ""deletions"": 22, ""lines"": 58}, ""src/version.c"": {""insertions"": 2, ""deletions"": 0, ""lines"": 2}, ""src/vim9script.c"": {""insertions"": 54, ""deletions"": 30, ""lines"": 84}}"
2021-07-24 19:33:26,5bca906b307728fa74a112914dc55b424d512d39,Yegappan Lakshmanan,223,102,325,8,"{""src/change.c"": {""insertions"": 3, ""deletions"": 0, ""lines"": 3}, ""src/evalfunc.c"": {""insertions"": 112, ""deletions"": 77, ""lines"": 189}, ""src/filepath.c"": {""insertions"": 14, ""deletions"": 0, ""lines"": 14}, ""src/sound.c"": {""insertions"": 9, ""deletions"": 0, ""lines"": 9}, ""src/testdir/test_gui.vim"": {""insertions"": 4, ""deletions"": 4, ""lines"": 8}, ""src/testdir/test_vim9_builtin.vim"": {""insertions"": 70, ""deletions"": 14, ""lines"": 84}, ""src/testing.c"": {""insertions"": 9, ""deletions"": 7, ""lines"": 16}, ""src/version.c"": {""insertions"": 2, ""deletions"": 0, ""lines"": 2}}"
2021-07-24 19:19:42,7d60384a00755e5c0112cebeb5e232fc133c9eca,Christian Brabandt,38,16,54,3,"{""nsis/gvim.nsi"": {""insertions"": 11, ""deletions"": 14, ""lines"": 25}, ""runtime/doc/os_win32.txt"": {""insertions"": 25, ""deletions"": 2, ""lines"": 27}, ""src/version.c"": {""insertions"": 2, ""deletions"": 0, ""lines"": 2}}"
2021-07-24 18:51:13,9c9472ff49b09c3d8f747b330eeb1cdb92bab449,Dominique Pelle,48,0,48,2,"{""src/testdir/test_spellfile.vim"": {""insertions"": 46, ""deletions"": 0, ""lines"": 46}, ""src/version.c"": {""insertions"": 2, ""deletions"": 0, ""lines"": 2}}"
2021-07-24 17:32:12,5a9e5845e1539592e94963fcdf5b3ad4fdc59db4,Dominique Pelle,54,44,98,2,"{""src/version.c"": {""insertions"": 2, ""deletions"": 0, ""lines"": 2}, ""src/vim9execute.c"": {""insertions"": 52, ""deletions"": 44, ""lines"": 96}}"
2021-07-24 14:16:15,7973de35ba6840b7e106e2e8a8912522e9a2a960,Yegappan Lakshmanan,165,22,187,10,"{""src/channel.c"": {""insertions"": 7, ""deletions"": 1, ""lines"": 8}, ""src/evalfunc.c"": {""insertions"": 48, ""deletions"": 17, ""lines"": 65}, ""src/evalvars.c"": {""insertions"": 11, ""deletions"": 0, ""lines"": 11}, ""src/if_cscope.c"": {""insertions"": 8, ""deletions"": 0, ""lines"": 8}, ""src/job.c"": {""insertions"": 8, ""deletions"": 0, ""lines"": 8}, ""src/proto/typval.pro"": {""insertions"": 1, ""deletions"": 0, ""lines"": 1}, ""src/testdir/test_vim9_builtin.vim"": {""insertions"": 61, ""deletions"": 3, ""lines"": 64}, ""src/time.c"": {""insertions"": 8, ""deletions"": 1, ""lines"": 9}, ""src/typval.c"": {""insertions"": 11, ""deletions"": 0, ""lines"": 11}, ""src/version.c"": {""insertions"": 2, ""deletions"": 0, ""lines"": 2}}"
2021-07-24 13:44:30,dd0b287c1ec8314034a2dbb14c4267994c47520c,Bram Moolenaar,13,3,16,3,"{""src/testdir/test_vim9_builtin.vim"": {""insertions"": 10, ""deletions"": 2, ""lines"": 12}, ""src/version.c"": {""insertions"": 2, ""deletions"": 0, ""lines"": 2}, ""src/vim9compile.c"": {""insertions"": 1, ""deletions"": 1, ""lines"": 2}}"
2021-07-24 12:14:52,88421d6dc812a2f3b0eab34740f174c9558cb734,Bram Moolenaar,42,1,43,3,"{""src/testdir/test_vim9_func.vim"": {""insertions"": 36, ""deletions"": 0, ""lines"": 36}, ""src/version.c"": {""insertions"": 2, ""deletions"": 0, ""lines"": 2}, ""src/vim9compile.c"": {""insertions"": 4, ""deletions"": 1, ""lines"": 5}}"
2021-07-24 11:57:29,1a3e5747b7df7ddda312bbfd18e04fc2122001fb,Martin Tournoij,45,30,75,14,"{""src/globals.h"": {""insertions"": 1, ""deletions"": 1, ""lines"": 2}, ""src/if_cscope.c"": {""insertions"": 0, ""deletions"": 18, ""lines"": 18}, ""src/if_lua.c"": {""insertions"": 3, ""deletions"": 1, ""lines"": 4}, ""src/if_mzsch.c"": {""insertions"": 2, ""deletions"": 2, ""lines"": 4}, ""src/if_perl.xs"": {""insertions"": 2, ""deletions"": 0, ""lines"": 2}, ""src/if_python.c"": {""insertions"": 3, ""deletions"": 1, ""lines"": 4}, ""src/if_python3.c"": {""insertions"": 3, ""deletions"": 1, ""lines"": 4}, ""src/if_ruby.c"": {""insertions"": 3, ""deletions"": 1, ""lines"": 4}, ""src/if_tcl.c"": {""insertions"": 3, ""deletions"": 1, ""lines"": 4}, ""src/mbyte.c"": {""insertions"": 2, ""deletions"": 1, ""lines"": 3}, ""src/os_win32.c"": {""insertions"": 17, ""deletions"": 1, ""lines"": 18}, ""src/proto/os_win32.pro"": {""insertions"": 1, ""deletions"": 0, ""lines"": 1}, ""src/terminal.c"": {""insertions"": 3, ""deletions"": 2, ""lines"": 5}, ""src/version.c"": {""insertions"": 2, ""deletions"": 0, ""lines"": 2}}"
2021-07-24 11:18:48,5a234eb18e6e43408755bb24e813330306c11629,Bram Moolenaar,9,1,10,3,"{""src/testdir/test_vim9_builtin.vim"": {""insertions"": 6, ""deletions"": 1, ""lines"": 7}, ""src/version.c"": {""insertions"": 2, ""deletions"": 0, ""lines"": 2}, ""src/vim9compile.c"": {""insertions"": 1, ""deletions"": 0, ""lines"": 1}}"
2021-07-23 18:37:56,0ad871dc4dfe1026e14931a55c225616b63f4c5b,Yegappan Lakshmanan,456,152,608,19,"{""src/blob.c"": {""insertions"": 0, ""deletions"": 6, ""lines"": 6}, ""src/cmdhist.c"": {""insertions"": 5, ""deletions"": 0, ""lines"": 5}, ""src/dict.c"": {""insertions"": 0, ""deletions"": 5, ""lines"": 5}, ""src/errors.h"": {""insertions"": 2, ""deletions"": 4, ""lines"": 6}, ""src/evalfunc.c"": {""insertions"": 138, ""deletions"": 82, ""lines"": 220}, ""src/filepath.c"": {""insertions"": 6, ""deletions"": 0, ""lines"": 6}, ""src/globals.h"": {""insertions"": 0, ""deletions"": 1, ""lines"": 1}, ""src/job.c"": {""insertions"": 6, ""deletions"": 0, ""lines"": 6}, ""src/list.c"": {""insertions"": 38, ""deletions"": 6, ""lines"": 44}, ""src/match.c"": {""insertions"": 24, ""deletions"": 2, ""lines"": 26}, ""src/misc1.c"": {""insertions"": 5, ""deletions"": 0, ""lines"": 5}, ""src/popupwin.c"": {""insertions"": 9, ""deletions"": 2, ""lines"": 11}, ""src/proto/typval.pro"": {""insertions"": 2, ""deletions"": 1, ""lines"": 3}, ""src/sign.c"": {""insertions"": 19, ""deletions"": 0, ""lines"": 19}, ""src/terminal.c"": {""insertions"": 15, ""deletions"": 1, ""lines"": 16}, ""src/testdir/test_blob.vim"": {""insertions"": 4, ""deletions"": 4, ""lines"": 8}, ""src/testdir/test_vim9_builtin.vim"": {""insertions"": 140, ""deletions"": 15, ""lines"": 155}, ""src/typval.c"": {""insertions"": 41, ""deletions"": 23, ""lines"": 64}, ""src/version.c"": {""insertions"": 2, ""deletions"": 0, ""lines"": 2}}"
2021-07-23 17:30:19,1b862c466ba4242857eec581f67982d265005ef4,Bram Moolenaar,5,3,8,2,"{""src/version.c"": {""insertions"": 2, ""deletions"": 0, ""lines"": 2}, ""src/vim9compile.c"": {""insertions"": 3, ""deletions"": 3, ""lines"": 6}}"
2021-07-22 19:33:03,c9e7e344ed390d2a22afb88001b6aa80832d2541,Bram Moolenaar,94,1,95,5,"{""src/drawscreen.c"": {""insertions"": 3, ""deletions"": 1, ""lines"": 4}, ""src/testdir/dumps/Test_cursorline_redraw_1.dump"": {""insertions"": 20, ""deletions"": 0, ""lines"": 20}, ""src/testdir/dumps/Test_cursorline_redraw_2.dump"": {""insertions"": 20, ""deletions"": 0, ""lines"": 20}, ""src/testdir/test_cursorline.vim"": {""insertions"": 49, ""deletions"": 0, ""lines"": 49}, ""src/version.c"": {""insertions"": 2, ""deletions"": 0, ""lines"": 2}}"
2021-07-22 17:11:08,cd268017cf79a546a494883b4b026a3cbbd9a8a0,Bram Moolenaar,10,3,13,3,"{""src/evalfunc.c"": {""insertions"": 3, ""deletions"": 1, ""lines"": 4}, ""src/version.c"": {""insertions"": 2, ""deletions"": 0, ""lines"": 2}, ""src/vim9compile.c"": {""insertions"": 5, ""deletions"": 2, ""lines"": 7}}"
2021-07-22 16:48:53,5dd839ce20466eea52e59ecf86456f1ab370d2bd,Bram Moolenaar,127,39,166,4,"{""src/ex_docmd.c"": {""insertions"": 2, ""deletions"": 1, ""lines"": 3}, ""src/testdir/test_listdict.vim"": {""insertions"": 116, ""deletions"": 38, ""lines"": 154}, ""src/version.c"": {""insertions"": 2, ""deletions"": 0, ""lines"": 2}, ""src/vim9execute.c"": {""insertions"": 7, ""deletions"": 0, ""lines"": 7}}"
2021-07-22 13:14:25,2b59df00d80ea8d2c0fcf4f4ae9a018c1790206f,Bram Moolenaar,5,5,10,3,"{""src/eval.c"": {""insertions"": 1, ""deletions"": 2, ""lines"": 3}, ""src/evalvars.c"": {""insertions"": 2, ""deletions"": 3, ""lines"": 5}, ""src/version.c"": {""insertions"": 2, ""deletions"": 0, ""lines"": 2}}"
2021-07-22 12:58:47,7a3fe3e180bdbce8f193abdf399559c5154bdaae,Bram Moolenaar,78,49,127,13,"{""src/dict.c"": {""insertions"": 3, ""deletions"": 3, ""lines"": 6}, ""src/errors.h"": {""insertions"": 6, ""deletions"": 0, ""lines"": 6}, ""src/eval.c"": {""insertions"": 4, ""deletions"": 3, ""lines"": 7}, ""src/if_py_both.h"": {""insertions"": 1, ""deletions"": 1, ""lines"": 2}, ""src/list.c"": {""insertions"": 18, ""deletions"": 13, ""lines"": 31}, ""src/proto/dict.pro"": {""insertions"": 1, ""deletions"": 1, ""lines"": 2}, ""src/proto/vim9type.pro"": {""insertions"": 1, ""deletions"": 1, ""lines"": 2}, ""src/structs.h"": {""insertions"": 3, ""deletions"": 0, ""lines"": 3}, ""src/testdir/test_vim9_builtin.vim"": {""insertions"": 5, ""deletions"": 3, ""lines"": 8}, ""src/version.c"": {""insertions"": 2, ""deletions"": 0, ""lines"": 2}, ""src/vim9compile.c"": {""insertions"": 5, ""deletions"": 11, ""lines"": 16}, ""src/vim9execute.c"": {""insertions"": 7, ""deletions"": 3, ""lines"": 10}, ""src/vim9type.c"": {""insertions"": 22, ""deletions"": 10, ""lines"": 32}}"
2021-07-22 10:26:14,a74901929e999a0052c1ce388ab09359c10cbb0d,Bram Moolenaar,4,2,6,2,"{""src/version.c"": {""insertions"": 2, ""deletions"": 0, ""lines"": 2}, ""src/vim9execute.c"": {""insertions"": 2, ""deletions"": 2, ""lines"": 4}}"
2021-07-22 09:46:59,f674b358fc18cf1641a066cc5de73da69e651024,Maxim Kim,71,8,79,4,"{""runtime/doc/options.txt"": {""insertions"": 3, ""deletions"": 1, ""lines"": 4}, ""src/indent.c"": {""insertions"": 12, ""deletions"": 6, ""lines"": 18}, ""src/testdir/test_breakindent.vim"": {""insertions"": 54, ""deletions"": 1, ""lines"": 55}, ""src/version.c"": {""insertions"": 2, ""deletions"": 0, ""lines"": 2}}"
2021-07-21 20:20:33,d8e44476d84b5f0cc8c4de080a47a3a9af547028,Bram Moolenaar,61,35,96,15,"{""src/edit.c"": {""insertions"": 1, ""deletions"": 1, ""lines"": 2}, ""src/errors.h"": {""insertions"": 33, ""deletions"": 0, ""lines"": 33}, ""src/evalvars.c"": {""insertions"": 3, ""deletions"": 2, ""lines"": 5}, ""src/ex_cmds.c"": {""insertions"": 1, ""deletions"": 1, ""lines"": 2}, ""src/ex_docmd.c"": {""insertions"": 1, ""deletions"": 1, ""lines"": 2}, ""src/globals.h"": {""insertions"": 0, ""deletions"": 8, ""lines"": 8}, ""src/option.c"": {""insertions"": 4, ""deletions"": 4, ""lines"": 8}, ""src/quickfix.c"": {""insertions"": 1, ""deletions"": 1, ""lines"": 2}, ""src/regexp.c"": {""insertions"": 0, ""deletions"": 3, ""lines"": 3}, ""src/regexp_bt.c"": {""insertions"": 8, ""deletions"": 8, ""lines"": 16}, ""src/regexp_nfa.c"": {""insertions"": 4, ""deletions"": 3, ""lines"": 7}, ""src/undo.c"": {""insertions"": 1, ""deletions"": 1, ""lines"": 2}, ""src/version.c"": {""insertions"": 2, ""deletions"": 0, ""lines"": 2}, ""src/vim9compile.c"": {""insertions"": 1, ""deletions"": 1, ""lines"": 2}, ""src/vim9script.c"": {""insertions"": 1, ""deletions"": 1, ""lines"": 2}}"
2021-07-21 19:37:28,05bd9785fd0fd0102ab64554307bff0ec0ae34c1,Bram Moolenaar,57,22,79,3,"{""src/testdir/test_vim9_expr.vim"": {""insertions"": 18, ""deletions"": 11, ""lines"": 29}, ""src/version.c"": {""insertions"": 2, ""deletions"": 0, ""lines"": 2}, ""src/vim9compile.c"": {""insertions"": 37, ""deletions"": 11, ""lines"": 48}}"
2021-07-21 18:38:46,c4c5642513ac41b22b7772cc880c776c69e964c9,Bram Moolenaar,9,2,11,3,"{""src/testdir/test_vim9_func.vim"": {""insertions"": 6, ""deletions"": 0, ""lines"": 6}, ""src/version.c"": {""insertions"": 2, ""deletions"": 0, ""lines"": 2}, ""src/vim9compile.c"": {""insertions"": 1, ""deletions"": 2, ""lines"": 3}}"
2021-07-21 17:09:09,cd9172077bc8c0aafddf2e5367cc0ae2c00c8ff7,Yegappan Lakshmanan,253,139,392,10,"{""src/diff.c"": {""insertions"": 1, ""deletions"": 1, ""lines"": 2}, ""src/evalbuffer.c"": {""insertions"": 11, ""deletions"": 1, ""lines"": 12}, ""src/evalfunc.c"": {""insertions"": 115, ""deletions"": 92, ""lines"": 207}, ""src/job.c"": {""insertions"": 1, ""deletions"": 1, ""lines"": 2}, ""src/proto/typval.pro"": {""insertions"": 3, ""deletions"": 0, ""lines"": 3}, ""src/sign.c"": {""insertions"": 1, ""deletions"": 1, ""lines"": 2}, ""src/terminal.c"": {""insertions"": 36, ""deletions"": 10, ""lines"": 46}, ""src/testdir/test_vim9_builtin.vim"": {""insertions"": 28, ""deletions"": 0, ""lines"": 28}, ""src/typval.c"": {""insertions"": 55, ""deletions"": 33, ""lines"": 88}, ""src/version.c"": {""insertions"": 2, ""deletions"": 0, ""lines"": 2}}"
2021-07-21 16:04:56,189663bdac1156237c49925f77bd197c1bdea12c,Bram Moolenaar,22,4,26,3,"{""src/move.c"": {""insertions"": 4, ""deletions"": 4, ""lines"": 8}, ""src/testdir/test_cursor_func.vim"": {""insertions"": 16, ""deletions"": 0, ""lines"": 16}, ""src/version.c"": {""insertions"": 2, ""deletions"": 0, ""lines"": 2}}"
2021-07-20 20:29:19,11d7e62f1d29fdd7a88b86131b7bbb853f29fe8b,Bram Moolenaar,2,2,4,2,"{""src/errors.h"": {""insertions"": 0, ""deletions"": 2, ""lines"": 2}, ""src/version.c"": {""insertions"": 2, ""deletions"": 0, ""lines"": 2}}"
2021-07-20 20:21:59,63cb6567f0153c35dc75cbc09039ff5d0a7b60e3,Bram Moolenaar,148,90,238,4,"{""src/testdir/test_listdict.vim"": {""insertions"": 121, ""deletions"": 84, ""lines"": 205}, ""src/version.c"": {""insertions"": 2, ""deletions"": 0, ""lines"": 2}, ""src/vim9compile.c"": {""insertions"": 1, ""deletions"": 1, ""lines"": 2}, ""src/vim9execute.c"": {""insertions"": 24, ""deletions"": 5, ""lines"": 29}}"
2021-07-20 19:07:36,e29a27f6f8eef8f00d3c2d4cd9811d81cf3026b3,Bram Moolenaar,127,98,225,29,"{""src/buffer.c"": {""insertions"": 2, ""deletions"": 2, ""lines"": 4}, ""src/debugger.c"": {""insertions"": 1, ""deletions"": 1, ""lines"": 2}, ""src/digraph.c"": {""insertions"": 2, ""deletions"": 2, ""lines"": 4}, ""src/edit.c"": {""insertions"": 1, ""deletions"": 1, ""lines"": 2}, ""src/errors.h"": {""insertions"": 56, ""deletions"": 0, ""lines"": 56}, ""src/ex_cmds.c"": {""insertions"": 5, ""deletions"": 5, ""lines"": 10}, ""src/ex_cmds2.c"": {""insertions"": 1, ""deletions"": 1, ""lines"": 2}, ""src/ex_docmd.c"": {""insertions"": 2, ""deletions"": 2, ""lines"": 4}, ""src/ex_eval.c"": {""insertions"": 4, ""deletions"": 4, ""lines"": 8}, ""src/globals.h"": {""insertions"": 0, ""deletions"": 30, ""lines"": 30}, ""src/gui.c"": {""insertions"": 1, ""deletions"": 1, ""lines"": 2}, ""src/list.c"": {""insertions"": 1, ""deletions"": 1, ""lines"": 2}, ""src/main.c"": {""insertions"": 3, ""deletions"": 3, ""lines"": 6}, ""src/map.c"": {""insertions"": 2, ""deletions"": 1, ""lines"": 3}, ""src/match.c"": {""insertions"": 1, ""deletions"": 1, ""lines"": 2}, ""src/quickfix.c"": {""insertions"": 7, ""deletions"": 7, ""lines"": 14}, ""src/regexp.c"": {""insertions"": 3, ""deletions"": 3, ""lines"": 6}, ""src/regexp_bt.c"": {""insertions"": 6, ""deletions"": 6, ""lines"": 12}, ""src/regexp_nfa.c"": {""insertions"": 2, ""deletions"": 2, ""lines"": 4}, ""src/register.c"": {""insertions"": 5, ""deletions"": 5, ""lines"": 10}, ""src/search.c"": {""insertions"": 3, ""deletions"": 3, ""lines"": 6}, ""src/session.c"": {""insertions"": 1, ""deletions"": 1, ""lines"": 2}, ""src/spell.c"": {""insertions"": 1, ""deletions"": 1, ""lines"": 2}, ""src/syntax.c"": {""insertions"": 2, ""deletions"": 2, ""lines"": 4}, ""src/time.c"": {""insertions"": 3, ""deletions"": 3, ""lines"": 6}, ""src/userfunc.c"": {""insertions"": 1, ""deletions"": 1, ""lines"": 2}, ""src/version.c"": {""insertions"": 2, ""deletions"": 0, ""lines"": 2}, ""src/vim9execute.c"": {""insertions"": 2, ""deletions"": 2, ""lines"": 4}, ""src/window.c"": {""insertions"": 7, ""deletions"": 7, ""lines"": 14}}"
2021-07-20 17:18:44,9fa5dabedc4ed5af85773413e91c2fdbe4cb9f0a,Bram Moolenaar,6,1,7,3,"{""src/ex_docmd.c"": {""insertions"": 1, ""deletions"": 1, ""lines"": 2}, ""src/testdir/test_vim9_script.vim"": {""insertions"": 3, ""deletions"": 0, ""lines"": 3}, ""src/version.c"": {""insertions"": 2, ""deletions"": 0, ""lines"": 2}}"
2021-07-20 15:51:51,83494b4ac61898f687d6ef9dce4bad5802fb8e51,Yegappan Lakshmanan,1417,299,1716,34,"{""src/blob.c"": {""insertions"": 8, ""deletions"": 1, ""lines"": 9}, ""src/channel.c"": {""insertions"": 20, ""deletions"": 1, ""lines"": 21}, ""src/clientserver.c"": {""insertions"": 17, ""deletions"": 2, ""lines"": 19}, ""src/cmdexpand.c"": {""insertions"": 6, ""deletions"": 0, ""lines"": 6}, ""src/cmdhist.c"": {""insertions"": 1, ""deletions"": 2, ""lines"": 3}, ""src/dict.c"": {""insertions"": 5, ""deletions"": 0, ""lines"": 5}, ""src/diff.c"": {""insertions"": 1, ""deletions"": 3, ""lines"": 4}, ""src/errors.h"": {""insertions"": 6, ""deletions"": 0, ""lines"": 6}, ""src/eval.c"": {""insertions"": 9, ""deletions"": 0, ""lines"": 9}, ""src/evalbuffer.c"": {""insertions"": 18, ""deletions"": 0, ""lines"": 18}, ""src/evalfunc.c"": {""insertions"": 385, ""deletions"": 103, ""lines"": 488}, ""src/evalvars.c"": {""insertions"": 32, ""deletions"": 0, ""lines"": 32}, ""src/evalwindow.c"": {""insertions"": 7, ""deletions"": 2, ""lines"": 9}, ""src/filepath.c"": {""insertions"": 26, ""deletions"": 4, ""lines"": 30}, ""src/globals.h"": {""insertions"": 4, ""deletions"": 1, ""lines"": 5}, ""src/insexpand.c"": {""insertions"": 11, ""deletions"": 0, ""lines"": 11}, ""src/job.c"": {""insertions"": 15, ""deletions"": 5, ""lines"": 20}, ""src/list.c"": {""insertions"": 32, ""deletions"": 0, ""lines"": 32}, ""src/map.c"": {""insertions"": 6, ""deletions"": 0, ""lines"": 6}, ""src/match.c"": {""insertions"": 8, ""deletions"": 1, ""lines"": 9}, ""src/proto/typval.pro"": {""insertions"": 14, ""deletions"": 0, ""lines"": 14}, ""src/quickfix.c"": {""insertions"": 15, ""deletions"": 0, ""lines"": 15}, ""src/search.c"": {""insertions"": 18, ""deletions"": 8, ""lines"": 26}, ""src/sign.c"": {""insertions"": 6, ""deletions"": 0, ""lines"": 6}, ""src/strings.c"": {""insertions"": 19, ""deletions"": 6, ""lines"": 25}, ""src/terminal.c"": {""insertions"": 21, ""deletions"": 19, ""lines"": 40}, ""src/testdir/test_blob.vim"": {""insertions"": 0, ""deletions"": 28, ""lines"": 28}, ""src/testdir/test_gui.vim"": {""insertions"": 5, ""deletions"": 5, ""lines"": 10}, ""src/testdir/test_vim9_builtin.vim"": {""insertions"": 459, ""deletions"": 93, ""lines"": 552}, ""src/testing.c"": {""insertions"": 5, ""deletions"": 8, ""lines"": 13}, ""src/textprop.c"": {""insertions"": 26, ""deletions"": 4, ""lines"": 30}, ""src/time.c"": {""insertions"": 7, ""deletions"": 3, ""lines"": 10}, ""src/typval.c"": {""insertions"": 203, ""deletions"": 0, ""lines"": 203}, ""src/version.c"": {""insertions"": 2, ""deletions"": 0, ""lines"": 2}}"
2021-07-19 20:19:29,9bb0dad0d8283c86fddf5b950f4fbb6fb8f12741,Bram Moolenaar,46,2,48,4,"{""src/popupwin.c"": {""insertions"": 2, ""deletions"": 2, ""lines"": 4}, ""src/proto/vim9compile.pro"": {""insertions"": 1, ""deletions"": 0, ""lines"": 1}, ""src/version.c"": {""insertions"": 2, ""deletions"": 0, ""lines"": 2}, ""src/vim9compile.c"": {""insertions"": 41, ""deletions"": 0, ""lines"": 41}}"
2021-07-19 19:45:07,605793500b351ee92483d04b1e03fb8af30dd101,Bram Moolenaar,38,5,43,4,"{""src/errors.h"": {""insertions"": 1, ""deletions"": 1, ""lines"": 2}, ""src/evalvars.c"": {""insertions"": 11, ""deletions"": 4, ""lines"": 15}, ""src/testdir/test_vim9_script.vim"": {""insertions"": 24, ""deletions"": 0, ""lines"": 24}, ""src/version.c"": {""insertions"": 2, ""deletions"": 0, ""lines"": 2}}"
2021-07-19 19:04:23,ac2cd2b08f0fd15e9c3759da043e9b28da80dca8,Bram Moolenaar,24,15,39,3,"{""src/testdir/test_vim9_expr.vim"": {""insertions"": 4, ""deletions"": 0, ""lines"": 4}, ""src/userfunc.c"": {""insertions"": 18, ""deletions"": 15, ""lines"": 33}, ""src/version.c"": {""insertions"": 2, ""deletions"": 0, ""lines"": 2}}"
2021-07-19 18:07:21,6106504e9edc8500131f7a36e59bc146f90180fa,mityu,583,37,620,11,"{""runtime/doc/digraph.txt"": {""insertions"": 3, ""deletions"": 0, ""lines"": 3}, ""runtime/doc/eval.txt"": {""insertions"": 107, ""deletions"": 0, ""lines"": 107}, ""runtime/doc/usr_41.txt"": {""insertions"": 4, ""deletions"": 0, ""lines"": 4}, ""src/digraph.c"": {""insertions"": 353, ""deletions"": 35, ""lines"": 388}, ""src/errors.h"": {""insertions"": 12, ""deletions"": 0, ""lines"": 12}, ""src/evalfunc.c"": {""insertions"": 15, ""deletions"": 0, ""lines"": 15}, ""src/ex_docmd.c"": {""insertions"": 1, ""deletions"": 1, ""lines"": 2}, ""src/globals.h"": {""insertions"": 2, ""deletions"": 0, ""lines"": 2}, ""src/proto/digraph.pro"": {""insertions"": 6, ""deletions"": 0, ""lines"": 6}, ""src/testdir/test_digraph.vim"": {""insertions"": 78, ""deletions"": 1, ""lines"": 79}, ""src/version.c"": {""insertions"": 2, ""deletions"": 0, ""lines"": 2}}"
2021-07-19 08:38:49,98c2eaed27579602e05e7b96aa3a60428a8b9cb2,Bram Moolenaar,7,5,12,3,"{""src/errors.h"": {""insertions"": 2, ""deletions"": 2, ""lines"": 4}, ""src/testdir/test_vim9_builtin.vim"": {""insertions"": 3, ""deletions"": 3, ""lines"": 6}, ""src/version.c"": {""insertions"": 2, ""deletions"": 0, ""lines"": 2}}"
2021-07-18 20:25:29,885971e2f5eabc4108e083086c1d6d0a31a2782f,Bram Moolenaar,34,6,40,3,"{""src/list.c"": {""insertions"": 26, ""deletions"": 6, ""lines"": 32}, ""src/testdir/test_vim9_builtin.vim"": {""insertions"": 6, ""deletions"": 0, ""lines"": 6}, ""src/version.c"": {""insertions"": 2, ""deletions"": 0, ""lines"": 2}}"
2021-07-18 19:44:37,9ff9c7b9741b216d3dc75603e50654088dc5f55b,Dominique Pelle,37,15,52,2,"{""src/testdir/test_vim9_builtin.vim"": {""insertions"": 35, ""deletions"": 15, ""lines"": 50}, ""src/version.c"": {""insertions"": 2, ""deletions"": 0, ""lines"": 2}}"
2021-07-18 19:24:50,f6488547e3c7e41ff2c12dd0b93c9ef04e4c8c6f,Bram Moolenaar,21,14,35,2,"{""src/evalvars.c"": {""insertions"": 19, ""deletions"": 14, ""lines"": 33}, ""src/version.c"": {""insertions"": 2, ""deletions"": 0, ""lines"": 2}}"
2021-07-18 18:40:33,24e9316560bd5c9ea2e5a963335aedff025e7f66,Bram Moolenaar,223,157,380,5,"{""src/errors.h"": {""insertions"": 2, ""deletions"": 0, ""lines"": 2}, ""src/eval.c"": {""insertions"": 2, ""deletions"": 1, ""lines"": 3}, ""src/evalvars.c"": {""insertions"": 162, ""deletions"": 132, ""lines"": 294}, ""src/testdir/test_vim9_script.vim"": {""insertions"": 55, ""deletions"": 24, ""lines"": 79}, ""src/version.c"": {""insertions"": 2, ""deletions"": 0, ""lines"": 2}}"
2021-07-18 16:21:38,4db572eeb2b42819268e934e76c67163316d873f,Bram Moolenaar,25,65,90,5,"{""runtime/doc/vim9.txt"": {""insertions"": 4, ""deletions"": 0, ""lines"": 4}, ""src/testdir/test_vim9_script.vim"": {""insertions"": 8, ""deletions"": 41, ""lines"": 49}, ""src/version.c"": {""insertions"": 2, ""deletions"": 0, ""lines"": 2}, ""src/vim9compile.c"": {""insertions"": 2, ""deletions"": 11, ""lines"": 13}, ""src/vim9script.c"": {""insertions"": 9, ""deletions"": 13, ""lines"": 22}}"
2021-07-18 15:08:50,ad2d4969e1616d3a0354c181e3a09271d5433b3d,Bram Moolenaar,20,2,22,3,"{""src/eval.c"": {""insertions"": 12, ""deletions"": 2, ""lines"": 14}, ""src/testdir/test_vim9_script.vim"": {""insertions"": 6, ""deletions"": 0, ""lines"": 6}, ""src/version.c"": {""insertions"": 2, ""deletions"": 0, ""lines"": 2}}"
2021-07-18 12:43:43,0c35752d04f70408a3c560d5b3edbafcaddff302,Bram Moolenaar,41,4,45,4,"{""src/errors.h"": {""insertions"": 2, ""deletions"": 2, ""lines"": 4}, ""src/testdir/test_vim9_expr.vim"": {""insertions"": 23, ""deletions"": 0, ""lines"": 23}, ""src/typval.c"": {""insertions"": 14, ""deletions"": 2, ""lines"": 16}, ""src/version.c"": {""insertions"": 2, ""deletions"": 0, ""lines"": 2}}"
2021-07-18 11:42:29,c6ba2f9dde6d01c8ab356c239c2259f7d83652a4,Bram Moolenaar,23,0,23,3,"{""src/eval.c"": {""insertions"": 5, ""deletions"": 0, ""lines"": 5}, ""src/testdir/test_vim9_func.vim"": {""insertions"": 16, ""deletions"": 0, ""lines"": 16}, ""src/version.c"": {""insertions"": 2, ""deletions"": 0, ""lines"": 2}}"
2021-07-17 19:24:56,47bc9c333766ee3d45cb18c583a630e4ad53405a,Bram Moolenaar,11,1,12,3,"{""src/testdir/test_vim9_assign.vim"": {""insertions"": 7, ""deletions"": 0, ""lines"": 7}, ""src/version.c"": {""insertions"": 2, ""deletions"": 0, ""lines"": 2}, ""src/vim9compile.c"": {""insertions"": 2, ""deletions"": 1, ""lines"": 3}}"
2021-07-17 17:11:07,a9a7c0c602b231dc37c4b0f62ade0421c84fca03,Yegappan Lakshmanan,329,31,360,11,"{""src/diff.c"": {""insertions"": 9, ""deletions"": 1, ""lines"": 10}, ""src/errors.h"": {""insertions"": 4, ""deletions"": 0, ""lines"": 4}, ""src/evalfunc.c"": {""insertions"": 55, ""deletions"": 22, ""lines"": 77}, ""src/globals.h"": {""insertions"": 1, ""deletions"": 0, ""lines"": 1}, ""src/job.c"": {""insertions"": 7, ""deletions"": 0, ""lines"": 7}, ""src/proto/typval.pro"": {""insertions"": 2, ""deletions"": 0, ""lines"": 2}, ""src/strings.c"": {""insertions"": 12, ""deletions"": 0, ""lines"": 12}, ""src/terminal.c"": {""insertions"": 46, ""deletions"": 5, ""lines"": 51}, ""src/testdir/test_vim9_builtin.vim"": {""insertions"": 151, ""deletions"": 0, ""lines"": 151}, ""src/typval.c"": {""insertions"": 40, ""deletions"": 3, ""lines"": 43}, ""src/version.c"": {""insertions"": 2, ""deletions"": 0, ""lines"": 2}}"
2021-07-16 08:39:28,20c370d9f2ee89cb854054edf71f5004f6efff77,Bram Moolenaar,3,1,4,2,"{""src/testdir/test_vim9_builtin.vim"": {""insertions"": 1, ""deletions"": 1, ""lines"": 2}, ""src/version.c"": {""insertions"": 2, ""deletions"": 0, ""lines"": 2}}"
2021-07-15 21:44:54,f5f1b59d3b98f1a00180cbaf0a12115fb58b573a,Bram Moolenaar,3,1,4,2,"{""src/userfunc.c"": {""insertions"": 1, ""deletions"": 1, ""lines"": 2}, ""src/version.c"": {""insertions"": 2, ""deletions"": 0, ""lines"": 2}}"
2021-07-15 21:15:59,d8cee76b498507c48706f651aeb78b93b5376d00,Bram Moolenaar,3,1,4,2,"{""src/userfunc.c"": {""insertions"": 1, ""deletions"": 1, ""lines"": 2}, ""src/version.c"": {""insertions"": 2, ""deletions"": 0, ""lines"": 2}}"
2021-07-15 20:03:50,5245beb37cb52991a745644c20d7ca1b0138ef2c,Bram Moolenaar,47,6,53,4,"{""src/testdir/test_vim9_expr.vim"": {""insertions"": 2, ""deletions"": 1, ""lines"": 3}, ""src/testdir/test_vim9_func.vim"": {""insertions"": 10, ""deletions"": 0, ""lines"": 10}, ""src/userfunc.c"": {""insertions"": 33, ""deletions"": 5, ""lines"": 38}, ""src/version.c"": {""insertions"": 2, ""deletions"": 0, ""lines"": 2}}"
2021-07-15 17:23:18,378697ac58b8f9705286e36d1805a052e96fb86e,Bram Moolenaar,14,1,15,3,"{""src/testdir/test_vim9_assign.vim"": {""insertions"": 10, ""deletions"": 0, ""lines"": 10}, ""src/version.c"": {""insertions"": 2, ""deletions"": 0, ""lines"": 2}, ""src/vim9compile.c"": {""insertions"": 2, ""deletions"": 1, ""lines"": 3}}"
2021-07-15 16:14:56,547f94f33098b060da9d62c29d9fcbe9bf1e2b11,Bram Moolenaar,18,16,34,2,"{""src/tag.c"": {""insertions"": 16, ""deletions"": 16, ""lines"": 32}, ""src/version.c"": {""insertions"": 2, ""deletions"": 0, ""lines"": 2}}"
2021-07-15 16:09:53,b5841b99e678da187b68c21f46d56a608a0dc10c,Bram Moolenaar,44,1,45,3,"{""src/testdir/test_vim9_script.vim"": {""insertions"": 40, ""deletions"": 0, ""lines"": 40}, ""src/version.c"": {""insertions"": 2, ""deletions"": 0, ""lines"": 2}, ""src/vim9execute.c"": {""insertions"": 2, ""deletions"": 1, ""lines"": 3}}"
2021-07-15 13:40:58,9e60e899ee546a8a35c4cbe0319971719c1839e9,Bram Moolenaar,12,0,12,3,"{""src/testdir/test_vim9_expr.vim"": {""insertions"": 7, ""deletions"": 0, ""lines"": 7}, ""src/version.c"": {""insertions"": 2, ""deletions"": 0, ""lines"": 2}, ""src/vim9compile.c"": {""insertions"": 3, ""deletions"": 0, ""lines"": 3}}"
2021-07-15 12:14:30,0894e0d8087aad4d467fd7b3d87b1930fe661916,Bram Moolenaar,6,1,7,2,"{""src/dosinst.c"": {""insertions"": 4, ""deletions"": 1, ""lines"": 5}, ""src/version.c"": {""insertions"": 2, ""deletions"": 0, ""lines"": 2}}"
2021-07-15 11:13:39,1557b16dad2b1a3466a93d015575cd7fdb4661c9,Wei-Chung Wen,36,0,36,3,"{""src/quickfix.c"": {""insertions"": 1, ""deletions"": 0, ""lines"": 1}, ""src/testdir/test_quickfix.vim"": {""insertions"": 33, ""deletions"": 0, ""lines"": 33}, ""src/version.c"": {""insertions"": 2, ""deletions"": 0, ""lines"": 2}}"
2021-07-15 10:49:58,1a71d31bf34b0b2b08517903826004ec6fd440e5,Yegappan Lakshmanan,780,269,1049,22,"{""runtime/doc/channel.txt"": {""insertions"": 1, ""deletions"": 1, ""lines"": 2}, ""src/clientserver.c"": {""insertions"": 8, ""deletions"": 1, ""lines"": 9}, ""src/cmdhist.c"": {""insertions"": 6, ""deletions"": 0, ""lines"": 6}, ""src/errors.h"": {""insertions"": 2, ""deletions"": 0, ""lines"": 2}, ""src/evalfunc.c"": {""insertions"": 144, ""deletions"": 105, ""lines"": 249}, ""src/evalwindow.c"": {""insertions"": 6, ""deletions"": 0, ""lines"": 6}, ""src/filepath.c"": {""insertions"": 6, ""deletions"": 0, ""lines"": 6}, ""src/globals.h"": {""insertions"": 1, ""deletions"": 0, ""lines"": 1}, ""src/popupwin.c"": {""insertions"": 40, ""deletions"": 10, ""lines"": 50}, ""src/proto/typval.pro"": {""insertions"": 1, ""deletions"": 0, ""lines"": 1}, ""src/sign.c"": {""insertions"": 4, ""deletions"": 0, ""lines"": 4}, ""src/strings.c"": {""insertions"": 23, ""deletions"": 2, ""lines"": 25}, ""src/terminal.c"": {""insertions"": 5, ""deletions"": 0, ""lines"": 5}, ""src/testdir/test_normal.vim"": {""insertions"": 1, ""deletions"": 1, ""lines"": 2}, ""src/testdir/test_reltime.vim"": {""insertions"": 2, ""deletions"": 2, ""lines"": 4}, ""src/testdir/test_vim9_builtin.vim"": {""insertions"": 474, ""deletions"": 131, ""lines"": 605}, ""src/testdir/test_vim9_expr.vim"": {""insertions"": 1, ""deletions"": 1, ""lines"": 2}, ""src/testing.c"": {""insertions"": 12, ""deletions"": 3, ""lines"": 15}, ""src/textprop.c"": {""insertions"": 8, ""deletions"": 1, ""lines"": 9}, ""src/time.c"": {""insertions"": 16, ""deletions"": 11, ""lines"": 27}, ""src/typval.c"": {""insertions"": 17, ""deletions"": 0, ""lines"": 17}, ""src/version.c"": {""insertions"": 2, ""deletions"": 0, ""lines"": 2}}"
2021-07-14 19:00:41,c816a2c22667108fcd61f445de2c926f78ff9fa7,Bram Moolenaar,27,0,27,3,"{""src/testdir/test_vim9_builtin.vim"": {""insertions"": 13, ""deletions"": 0, ""lines"": 13}, ""src/time.c"": {""insertions"": 12, ""deletions"": 0, ""lines"": 12}, ""src/version.c"": {""insertions"": 2, ""deletions"": 0, ""lines"": 2}}"
2021-07-14 18:00:27,4a0b85ad0193ac162e2d8458e4b1c5ad2e2b0193,Christian Brabandt,100,1,101,5,"{""runtime/doc/options.txt"": {""insertions"": 4, ""deletions"": 1, ""lines"": 5}, ""src/indent.c"": {""insertions"": 23, ""deletions"": 0, ""lines"": 23}, ""src/structs.h"": {""insertions"": 1, ""deletions"": 0, ""lines"": 1}, ""src/testdir/test_breakindent.vim"": {""insertions"": 70, ""deletions"": 0, ""lines"": 70}, ""src/version.c"": {""insertions"": 2, ""deletions"": 0, ""lines"": 2}}"
2021-07-13 20:21:44,5bea41dea34bcc73c4efb1b554ad0a2018966ecc,Bram Moolenaar,8,3,11,2,"{""src/change.c"": {""insertions"": 6, ""deletions"": 3, ""lines"": 9}, ""src/version.c"": {""insertions"": 2, ""deletions"": 0, ""lines"": 2}}"
2021-07-13 18:32:29,1840a7b4e3577e617f724c9d07ccc78195cc010a,Bram Moolenaar,11,1,12,3,"{""src/evalfunc.c"": {""insertions"": 4, ""deletions"": 1, ""lines"": 5}, ""src/testdir/test_functions.vim"": {""insertions"": 5, ""deletions"": 0, ""lines"": 5}, ""src/version.c"": {""insertions"": 2, ""deletions"": 0, ""lines"": 2}}"
2021-07-13 17:09:12,16e26a31161d65baca7885c46c43ab4a48399c92,Christian Brabandt,4,2,6,2,"{""src/testdir/test_crypt.vim"": {""insertions"": 2, ""deletions"": 2, ""lines"": 4}, ""src/version.c"": {""insertions"": 2, ""deletions"": 0, ""lines"": 2}}"
2021-07-12 20:15:24,ee41052ccb65f8109f285fc43eed3e232de68375,Dominique Pelle,3,0,3,2,"{""src/testdir/test_vim9_builtin.vim"": {""insertions"": 1, ""deletions"": 0, ""lines"": 1}, ""src/version.c"": {""insertions"": 2, ""deletions"": 0, ""lines"": 2}}"
2021-07-12 19:43:19,042414fa0053388f9a35cad61886405507554068,Dominique Pelle,65,0,65,3,"{""src/testdir/test_options.vim"": {""insertions"": 44, ""deletions"": 0, ""lines"": 44}, ""src/testdir/test_set.vim"": {""insertions"": 19, ""deletions"": 0, ""lines"": 19}, ""src/version.c"": {""insertions"": 2, ""deletions"": 0, ""lines"": 2}}"
2021-07-11 20:04:25,841e498c5d1765eab17bce5242543b47dfc25b41,Yegappan Lakshmanan,21,3,24,3,"{""src/evalfunc.c"": {""insertions"": 4, ""deletions"": 3, ""lines"": 7}, ""src/testdir/test_vim9_builtin.vim"": {""insertions"": 15, ""deletions"": 0, ""lines"": 15}, ""src/version.c"": {""insertions"": 2, ""deletions"": 0, ""lines"": 2}}"
2021-07-11 19:51:17,7b7a118e74d25ff35cd277c2bb5191ae44bb20b2,Tsuyoshi CHO,49,3,52,3,"{""src/misc1.c"": {""insertions"": 18, ""deletions"": 3, ""lines"": 21}, ""src/testdir/test_buffer.vim"": {""insertions"": 29, ""deletions"": 0, ""lines"": 29}, ""src/version.c"": {""insertions"": 2, ""deletions"": 0, ""lines"": 2}}"
2021-07-11 18:59:00,11005b078d2485a306c74f77c9dd158fdd7f3cbe,Bram Moolenaar,11,1,12,3,"{""src/evalvars.c"": {""insertions"": 2, ""deletions"": 1, ""lines"": 3}, ""src/testdir/test_vim9_expr.vim"": {""insertions"": 7, ""deletions"": 0, ""lines"": 7}, ""src/version.c"": {""insertions"": 2, ""deletions"": 0, ""lines"": 2}}"
2021-07-11 18:22:30,ffcfddc759e583471a1ed55e0938d042bf68c507,Bram Moolenaar,30,5,35,3,"{""src/testdir/test_vim9_script.vim"": {""insertions"": 17, ""deletions"": 0, ""lines"": 17}, ""src/version.c"": {""insertions"": 2, ""deletions"": 0, ""lines"": 2}, ""src/vim9compile.c"": {""insertions"": 11, ""deletions"": 5, ""lines"": 16}}"
2021-07-11 17:44:18,c72bdd28ac5fe079825155930af8e792580139bb,Yegappan Lakshmanan,118,21,139,4,"{""src/evalfunc.c"": {""insertions"": 51, ""deletions"": 19, ""lines"": 70}, ""src/testdir/test_vim9_builtin.vim"": {""insertions"": 62, ""deletions"": 2, ""lines"": 64}, ""src/testing.c"": {""insertions"": 3, ""deletions"": 0, ""lines"": 3}, ""src/version.c"": {""insertions"": 2, ""deletions"": 0, ""lines"": 2}}"
2021-07-11 17:12:04,cc7eb2aa7a7f2e6ae41f1e7cf60965c083d8a9e9,Bram Moolenaar,52,4,56,5,"{""src/message.c"": {""insertions"": 20, ""deletions"": 1, ""lines"": 21}, ""src/proto/message.pro"": {""insertions"": 1, ""deletions"": 0, ""lines"": 1}, ""src/testdir/test_usercommands.vim"": {""insertions"": 20, ""deletions"": 2, ""lines"": 22}, ""src/usercmd.c"": {""insertions"": 9, ""deletions"": 1, ""lines"": 10}, ""src/version.c"": {""insertions"": 2, ""deletions"": 0, ""lines"": 2}}"
2021-07-11 16:23:19,5231224e11bf468f5366a7400414368908c40795,Bram Moolenaar,17,1,18,4,"{""src/evalfunc.c"": {""insertions"": 2, ""deletions"": 1, ""lines"": 3}, ""src/testdir/test_vim9_builtin.vim"": {""insertions"": 2, ""deletions"": 0, ""lines"": 2}, ""src/version.c"": {""insertions"": 2, ""deletions"": 0, ""lines"": 2}, ""src/vim9compile.c"": {""insertions"": 11, ""deletions"": 0, ""lines"": 11}}"
2021-07-11 15:55:01,648594eaf703fe9a862cb12a35702a10aff6e5a9,Bram Moolenaar,34,15,49,4,"{""src/testdir/test_vim9_script.vim"": {""insertions"": 13, ""deletions"": 3, ""lines"": 16}, ""src/version.c"": {""insertions"": 2, ""deletions"": 0, ""lines"": 2}, ""src/vim9compile.c"": {""insertions"": 10, ""deletions"": 0, ""lines"": 10}, ""src/vim9execute.c"": {""insertions"": 9, ""deletions"": 12, ""lines"": 21}}"
2021-07-11 14:52:45,c03fe66ade4c79a4eb5fc05d1d549c8f931a04b6,Bram Moolenaar,16,0,16,3,"{""src/eval.c"": {""insertions"": 4, ""deletions"": 0, ""lines"": 4}, ""src/testdir/test_vim9_script.vim"": {""insertions"": 10, ""deletions"": 0, ""lines"": 10}, ""src/version.c"": {""insertions"": 2, ""deletions"": 0, ""lines"": 2}}"
2021-07-11 14:31:51,4ece152ad60c4fbd5b98b849a39b8ad9a987d319,Bram Moolenaar,4,0,4,2,"{""src/testdir/test_vim9_script.vim"": {""insertions"": 2, ""deletions"": 0, ""lines"": 2}, ""src/version.c"": {""insertions"": 2, ""deletions"": 0, ""lines"": 2}}"
2021-07-11 14:01:58,0f1227f7d5a3e368f61d396c1640088c079fef91,Bram Moolenaar,27,2,29,4,"{""src/errors.h"": {""insertions"": 2, ""deletions"": 0, ""lines"": 2}, ""src/eval.c"": {""insertions"": 2, ""deletions"": 0, ""lines"": 2}, ""src/testdir/test_vim9_builtin.vim"": {""insertions"": 21, ""deletions"": 2, ""lines"": 23}, ""src/version.c"": {""insertions"": 2, ""deletions"": 0, ""lines"": 2}}"
2021-07-11 13:26:13,d9162550aa47ca3865a5cadf78ff2212a1d8eca7,Bram Moolenaar,20,0,20,3,"{""src/testdir/test_vim9_script.vim"": {""insertions"": 13, ""deletions"": 0, ""lines"": 13}, ""src/version.c"": {""insertions"": 2, ""deletions"": 0, ""lines"": 2}, ""src/vim9compile.c"": {""insertions"": 5, ""deletions"": 0, ""lines"": 5}}"
2021-07-11 12:55:49,1aeddeb8bd29a69fa118734c7f27d7df1b37801f,Bram Moolenaar,10,1,11,3,"{""src/evalfunc.c"": {""insertions"": 2, ""deletions"": 1, ""lines"": 3}, ""src/testdir/test_vim9_builtin.vim"": {""insertions"": 6, ""deletions"": 0, ""lines"": 6}, ""src/version.c"": {""insertions"": 2, ""deletions"": 0, ""lines"": 2}}"
2021-07-11 12:28:25,de69a7353e9bec552e15dbe3706a9f4e88080fce,Martin Tournoij,23,27,50,4,"{""src/errors.h"": {""insertions"": 2, ""deletions"": 0, ""lines"": 2}, ""src/testdir/test_usercommands.vim"": {""insertions"": 17, ""deletions"": 19, ""lines"": 36}, ""src/usercmd.c"": {""insertions"": 2, ""deletions"": 8, ""lines"": 10}, ""src/version.c"": {""insertions"": 2, ""deletions"": 0, ""lines"": 2}}"
2021-07-10 20:21:40,482d2f37a5ce43157ab1e22c26f389770d0c20cf,Bram Moolenaar,5,3,8,2,"{""src/testdir/test_channel.vim"": {""insertions"": 3, ""deletions"": 3, ""lines"": 6}, ""src/version.c"": {""insertions"": 2, ""deletions"": 0, ""lines"": 2}}"
2021-07-10 19:29:18,a2438132a675be4dde3acbdf03ba1fdb2f09427c,Yegappan Lakshmanan,1673,1627,3300,21,"{""Filelist"": {""insertions"": 2, ""deletions"": 0, ""lines"": 2}, ""src/Make_ami.mak"": {""insertions"": 1, ""deletions"": 0, ""lines"": 1}, ""src/Make_cyg_ming.mak"": {""insertions"": 1, ""deletions"": 0, ""lines"": 1}, ""src/Make_mvc.mak"": {""insertions"": 4, ""deletions"": 0, ""lines"": 4}, ""src/Make_vms.mms"": {""insertions"": 6, ""deletions"": 0, ""lines"": 6}, ""src/Makefile"": {""insertions"": 10, ""deletions"": 0, ""lines"": 10}, ""src/README.md"": {""insertions"": 1, ""deletions"": 0, ""lines"": 1}, ""src/eval.c"": {""insertions"": 3, ""deletions"": 46, ""lines"": 49}, ""src/evalfunc.c"": {""insertions"": 0, ""deletions"": 825, ""lines"": 825}, ""src/mbyte.c"": {""insertions"": 31, ""deletions"": 0, ""lines"": 31}, ""src/misc1.c"": {""insertions"": 2, ""deletions"": 24, ""lines"": 26}, ""src/misc2.c"": {""insertions"": 0, ""deletions"": 706, ""lines"": 706}, ""src/proto.h"": {""insertions"": 1, ""deletions"": 0, ""lines"": 1}, ""src/proto/eval.pro"": {""insertions"": 0, ""deletions"": 3, ""lines"": 3}, ""src/proto/evalfunc.pro"": {""insertions"": 0, ""deletions"": 1, ""lines"": 1}, ""src/proto/mbyte.pro"": {""insertions"": 1, ""deletions"": 0, ""lines"": 1}, ""src/proto/misc1.pro"": {""insertions"": 0, ""deletions"": 1, ""lines"": 1}, ""src/proto/misc2.pro"": {""insertions"": 0, ""deletions"": 21, ""lines"": 21}, ""src/proto/strings.pro"": {""insertions"": 45, ""deletions"": 0, ""lines"": 45}, ""src/strings.c"": {""insertions"": 1563, ""deletions"": 0, ""lines"": 1563}, ""src/version.c"": {""insertions"": 2, ""deletions"": 0, ""lines"": 2}}"
2021-07-10 18:43:59,31e21766d6fb0a386e15ccc8c2192f6a3a210f53,Bram Moolenaar,9,7,16,2,"{""src/testdir/test_debugger.vim"": {""insertions"": 7, ""deletions"": 7, ""lines"": 14}, ""src/version.c"": {""insertions"": 2, ""deletions"": 0, ""lines"": 2}}"
2021-07-10 17:42:03,c323527d67081cfaff22503d1d282495976c7042,Bram Moolenaar,76,15,91,7,"{""src/errors.h"": {""insertions"": 2, ""deletions"": 0, ""lines"": 2}, ""src/ex_eval.c"": {""insertions"": 19, ""deletions"": 2, ""lines"": 21}, ""src/testdir/test_vim9_expr.vim"": {""insertions"": 1, ""deletions"": 1, ""lines"": 2}, ""src/testdir/test_vim9_func.vim"": {""insertions"": 3, ""deletions"": 3, ""lines"": 6}, ""src/testdir/test_vim9_script.vim"": {""insertions"": 17, ""deletions"": 2, ""lines"": 19}, ""src/version.c"": {""insertions"": 2, ""deletions"": 0, ""lines"": 2}, ""src/vim9compile.c"": {""insertions"": 32, ""deletions"": 7, ""lines"": 39}}"
2021-07-10 15:59:48,fe3418abe0dac65e42e85b5a91c5d0c975bc65bb,Dominique Pelle,22,0,22,3,"{""src/testdir/test_cd.vim"": {""insertions"": 16, ""deletions"": 0, ""lines"": 16}, ""src/testdir/test_swap.vim"": {""insertions"": 4, ""deletions"": 0, ""lines"": 4}, ""src/version.c"": {""insertions"": 2, ""deletions"": 0, ""lines"": 2}}"
2021-07-10 11:15:41,5b73992d8f82be7ac4b6f46c17f53ffb9640e5fa,Yegappan Lakshmanan,563,186,749,12,"{""src/channel.c"": {""insertions"": 5, ""deletions"": 0, ""lines"": 5}, ""src/errors.h"": {""insertions"": 2, ""deletions"": 0, ""lines"": 2}, ""src/evalfunc.c"": {""insertions"": 94, ""deletions"": 70, ""lines"": 164}, ""src/proto/typval.pro"": {""insertions"": 1, ""deletions"": 0, ""lines"": 1}, ""src/terminal.c"": {""insertions"": 5, ""deletions"": 0, ""lines"": 5}, ""src/testdir/test_search.vim"": {""insertions"": 6, ""deletions"": 6, ""lines"": 12}, ""src/testdir/test_textprop.vim"": {""insertions"": 1, ""deletions"": 1, ""lines"": 2}, ""src/testdir/test_vim9_builtin.vim"": {""insertions"": 421, ""deletions"": 103, ""lines"": 524}, ""src/testing.c"": {""insertions"": 4, ""deletions"": 1, ""lines"": 5}, ""src/textprop.c"": {""insertions"": 1, ""deletions"": 1, ""lines"": 2}, ""src/typval.c"": {""insertions"": 21, ""deletions"": 4, ""lines"": 25}, ""src/version.c"": {""insertions"": 2, ""deletions"": 0, ""lines"": 2}}"
2021-07-09 17:53:57,9da32e4d578f4e93ef5397f9dd13e2c28b2a2595,Bram Moolenaar,9,1,10,3,"{""src/testdir/test_vim9_builtin.vim"": {""insertions"": 6, ""deletions"": 0, ""lines"": 6}, ""src/version.c"": {""insertions"": 2, ""deletions"": 0, ""lines"": 2}, ""src/vim9type.c"": {""insertions"": 1, ""deletions"": 1, ""lines"": 2}}"
2021-07-09 17:17:55,90fba5627b361dbc970b3afc2eebf7411c49a0cc,Bram Moolenaar,4,1,5,2,"{""src/list.c"": {""insertions"": 2, ""deletions"": 1, ""lines"": 3}, ""src/version.c"": {""insertions"": 2, ""deletions"": 0, ""lines"": 2}}"
2021-07-09 13:54:00,6bcb18253a392cf75d3784953ef9c71de7af9019,Bram Moolenaar,3,1,4,2,"{""src/drawscreen.c"": {""insertions"": 1, ""deletions"": 1, ""lines"": 2}, ""src/version.c"": {""insertions"": 2, ""deletions"": 0, ""lines"": 2}}"
2021-07-08 20:20:50,981217c11f92b37f2baa51492cbe12e85d0ea493,Bram Moolenaar,8,0,8,2,"{""src/testdir/test_channel.vim"": {""insertions"": 6, ""deletions"": 0, ""lines"": 6}, ""src/version.c"": {""insertions"": 2, ""deletions"": 0, ""lines"": 2}}"
2021-07-08 20:02:11,b885a7c72c8fed5f14454633fb3ba9d77fff1c24,Bram Moolenaar,5,3,8,2,"{""src/testdir/test_vim9_script.vim"": {""insertions"": 3, ""deletions"": 3, ""lines"": 6}, ""src/version.c"": {""insertions"": 2, ""deletions"": 0, ""lines"": 2}}"
2021-07-08 19:38:50,c967d57aa9a6bede0f50c6986dcddc1dc035a354,Bram Moolenaar,29,20,49,7,"{""src/eval.c"": {""insertions"": 1, ""deletions"": 1, ""lines"": 2}, ""src/evalvars.c"": {""insertions"": 7, ""deletions"": 6, ""lines"": 13}, ""src/proto/vim9script.pro"": {""insertions"": 1, ""deletions"": 1, ""lines"": 2}, ""src/testdir/test_vim9_script.vim"": {""insertions"": 11, ""deletions"": 3, ""lines"": 14}, ""src/userfunc.c"": {""insertions"": 1, ""deletions"": 1, ""lines"": 2}, ""src/version.c"": {""insertions"": 2, ""deletions"": 0, ""lines"": 2}, ""src/vim9script.c"": {""insertions"": 6, ""deletions"": 8, ""lines"": 14}}"
2021-07-08 18:57:24,f055d4502365f24de6c0f210a06e2c146a75dc4d,Bram Moolenaar,38,9,47,7,"{""src/eval.c"": {""insertions"": 1, ""deletions"": 1, ""lines"": 2}, ""src/evalvars.c"": {""insertions"": 19, ""deletions"": 1, ""lines"": 20}, ""src/proto/vim9script.pro"": {""insertions"": 1, ""deletions"": 1, ""lines"": 2}, ""src/testdir/test_vim9_builtin.vim"": {""insertions"": 7, ""deletions"": 0, ""lines"": 7}, ""src/userfunc.c"": {""insertions"": 1, ""deletions"": 1, ""lines"": 2}, ""src/version.c"": {""insertions"": 2, ""deletions"": 0, ""lines"": 2}, ""src/vim9script.c"": {""insertions"": 7, ""deletions"": 5, ""lines"": 12}}"
2021-07-08 18:53:40,f32f099761e5ae0603149b305a0086e4f4627d81,Bram Moolenaar,13,1,14,3,"{""src/list.c"": {""insertions"": 4, ""deletions"": 1, ""lines"": 5}, ""src/testdir/test_vim9_builtin.vim"": {""insertions"": 7, ""deletions"": 0, ""lines"": 7}, ""src/version.c"": {""insertions"": 2, ""deletions"": 0, ""lines"": 2}}"
2021-07-08 17:22:12,d4ab807d62c1a8262e78deb674c6750183bc030a,Bram Moolenaar,8,0,8,3,"{""src/ex_eval.c"": {""insertions"": 5, ""deletions"": 0, ""lines"": 5}, ""src/testdir/test_vim9_script.vim"": {""insertions"": 1, ""deletions"": 0, ""lines"": 1}, ""src/version.c"": {""insertions"": 2, ""deletions"": 0, ""lines"": 2}}"
2021-07-08 16:05:00,09f688c33aad9692276dfb68842cf0621a0e2002,=?UTF-8?q?Dundar=20G=C3=B6c?=,7,5,12,2,"{""src/regexp_nfa.c"": {""insertions"": 5, ""deletions"": 5, ""lines"": 10}, ""src/version.c"": {""insertions"": 2, ""deletions"": 0, ""lines"": 2}}"
2021-07-08 15:35:36,deb108ba0a8599c1307ddc1507c73e7b60f17d36,Bram Moolenaar,57,1,58,3,"{""src/option.c"": {""insertions"": 16, ""deletions"": 1, ""lines"": 17}, ""src/testdir/test_vim9_script.vim"": {""insertions"": 39, ""deletions"": 0, ""lines"": 39}, ""src/version.c"": {""insertions"": 2, ""deletions"": 0, ""lines"": 2}}"
2021-07-08 14:40:13,1594f313452cf6ca88375d9c8f68605a9c3c8ab5,Bram Moolenaar,25,7,32,4,"{""src/errors.h"": {""insertions"": 2, ""deletions"": 0, ""lines"": 2}, ""src/option.c"": {""insertions"": 7, ""deletions"": 2, ""lines"": 9}, ""src/testdir/test_vim9_script.vim"": {""insertions"": 14, ""deletions"": 5, ""lines"": 19}, ""src/version.c"": {""insertions"": 2, ""deletions"": 0, ""lines"": 2}}"
2021-07-08 11:19:31,30441bb3d5fa73f888b09684db3f54ff5ab48dbc,Bram Moolenaar,33,1,34,5,"{""src/move.c"": {""insertions"": 5, ""deletions"": 1, ""lines"": 6}, ""src/testdir/dumps/Test_listchars_06.dump"": {""insertions"": 10, ""deletions"": 0, ""lines"": 10}, ""src/testdir/dumps/Test_listchars_07.dump"": {""insertions"": 10, ""deletions"": 0, ""lines"": 10}, ""src/testdir/test_listchars.vim"": {""insertions"": 6, ""deletions"": 0, ""lines"": 6}, ""src/version.c"": {""insertions"": 2, ""deletions"": 0, ""lines"": 2}}"
2021-07-08 10:40:05,41fb723ee97baa2f095cde601a5a144b168b7a6b,Bram Moolenaar,87,1,88,8,"{""src/drawline.c"": {""insertions"": 3, ""deletions"": 1, ""lines"": 4}, ""src/testdir/dumps/Test_listchars_01.dump"": {""insertions"": 10, ""deletions"": 0, ""lines"": 10}, ""src/testdir/dumps/Test_listchars_02.dump"": {""insertions"": 10, ""deletions"": 0, ""lines"": 10}, ""src/testdir/dumps/Test_listchars_03.dump"": {""insertions"": 10, ""deletions"": 0, ""lines"": 10}, ""src/testdir/dumps/Test_listchars_04.dump"": {""insertions"": 10, ""deletions"": 0, ""lines"": 10}, ""src/testdir/dumps/Test_listchars_05.dump"": {""insertions"": 10, ""deletions"": 0, ""lines"": 10}, ""src/testdir/test_listchars.vim"": {""insertions"": 32, ""deletions"": 0, ""lines"": 32}, ""src/version.c"": {""insertions"": 2, ""deletions"": 0, ""lines"": 2}}"
2021-07-08 09:37:50,db8647277082a8a69a189ded8bd1408af993b54e,Bram Moolenaar,7,2,9,2,"{""src/testdir/test_crypt.vim"": {""insertions"": 5, ""deletions"": 2, ""lines"": 7}, ""src/version.c"": {""insertions"": 2, ""deletions"": 0, ""lines"": 2}}"
2021-07-07 20:13:08,6a9e5c69cf36676e65ae191264872a3e41bde37f,Bram Moolenaar,3,1,4,2,"{""src/evalfunc.c"": {""insertions"": 1, ""deletions"": 1, ""lines"": 2}, ""src/version.c"": {""insertions"": 2, ""deletions"": 0, ""lines"": 2}}"
2021-07-07 19:55:25,5ede5b231eb2269b0ef335f3cd24e4c4b1d4395b,Bram Moolenaar,9,1,10,3,"{""src/testdir/test_vim9_script.vim"": {""insertions"": 6, ""deletions"": 0, ""lines"": 6}, ""src/version.c"": {""insertions"": 2, ""deletions"": 0, ""lines"": 2}, ""src/vim9compile.c"": {""insertions"": 1, ""deletions"": 1, ""lines"": 2}}"
2021-07-07 19:21:30,efc5db5215b4efc424b2de34613525d729a05c93,Bram Moolenaar,23,3,26,5,"{""src/evalfunc.c"": {""insertions"": 7, ""deletions"": 1, ""lines"": 8}, ""src/globals.h"": {""insertions"": 1, ""deletions"": 0, ""lines"": 1}, ""src/testdir/test_vim9_script.vim"": {""insertions"": 8, ""deletions"": 0, ""lines"": 8}, ""src/version.c"": {""insertions"": 2, ""deletions"": 0, ""lines"": 2}, ""src/vim9compile.c"": {""insertions"": 5, ""deletions"": 2, ""lines"": 7}}"
2021-07-07 18:26:08,90df4b9d423485f7db16e3a65cab4f14edc815ae,Bram Moolenaar,846,194,1040,22,"{"".github/CODEOWNERS"": {""insertions"": 1, ""deletions"": 0, ""lines"": 1}, ""runtime/doc/autocmd.txt"": {""insertions"": 5, ""deletions"": 3, ""lines"": 8}, ""runtime/doc/eval.txt"": {""insertions"": 20, ""deletions"": 4, ""lines"": 24}, ""runtime/doc/gui.txt"": {""insertions"": 3, ""deletions"": 2, ""lines"": 5}, ""runtime/doc/insert.txt"": {""insertions"": 3, ""deletions"": 2, ""lines"": 5}, ""runtime/doc/repeat.txt"": {""insertions"": 2, ""deletions"": 2, ""lines"": 4}, ""runtime/doc/sponsor.txt"": {""insertions"": 3, ""deletions"": 17, ""lines"": 20}, ""runtime/doc/syntax.txt"": {""insertions"": 25, ""deletions"": 3, ""lines"": 28}, ""runtime/doc/tags"": {""insertions"": 5, ""deletions"": 0, ""lines"": 5}, ""runtime/doc/testing.txt"": {""insertions"": 3, ""deletions"": 2, ""lines"": 5}, ""runtime/doc/todo.txt"": {""insertions"": 6, ""deletions"": 7, ""lines"": 13}, ""runtime/doc/version6.txt"": {""insertions"": 2, ""deletions"": 2, ""lines"": 4}, ""runtime/doc/version8.txt"": {""insertions"": 2, ""deletions"": 2, ""lines"": 4}, ""runtime/doc/vim9.txt"": {""insertions"": 47, ""deletions"": 15, ""lines"": 62}, ""runtime/filetype.vim"": {""insertions"": 1, ""deletions"": 1, ""lines"": 2}, ""runtime/ftplugin/jsonc.vim"": {""insertions"": 27, ""deletions"": 0, ""lines"": 27}, ""runtime/indent/jsonc.vim"": {""insertions"": 189, ""deletions"": 0, ""lines"": 189}, ""runtime/indent/pascal.vim"": {""insertions"": 3, ""deletions"": 1, ""lines"": 4}, ""runtime/syntax/go.vim"": {""insertions"": 361, ""deletions"": 83, ""lines"": 444}, ""runtime/syntax/jsonc.vim"": {""insertions"": 44, ""deletions"": 0, ""lines"": 44}, ""runtime/syntax/vim.vim"": {""insertions"": 1, ""deletions"": 1, ""lines"": 2}, ""src/po/it.po"": {""insertions"": 93, ""deletions"": 47, ""lines"": 140}}"
2021-07-07 18:10:43,303215d60cece0462f040035502b5bc95373bd6e,Bram Moolenaar,19,2,21,3,"{""src/testdir/test_debugger.vim"": {""insertions"": 13, ""deletions"": 0, ""lines"": 13}, ""src/version.c"": {""insertions"": 2, ""deletions"": 0, ""lines"": 2}, ""src/vim9execute.c"": {""insertions"": 4, ""deletions"": 2, ""lines"": 6}}"
2021-07-07 17:26:19,b5098060f4acae4dac3203130278c948d670a3d5,Bram Moolenaar,4,1,5,2,"{""src/version.c"": {""insertions"": 2, ""deletions"": 0, ""lines"": 2}, ""src/window.c"": {""insertions"": 2, ""deletions"": 1, ""lines"": 3}}"
2021-07-06 18:15:46,599a6e5b3629d943a795cd69e4d3d19886f86405,=?UTF-8?q?Ola=20S=C3=B6der?=,8,4,12,2,"{""src/memline.c"": {""insertions"": 6, ""deletions"": 4, ""lines"": 10}, ""src/version.c"": {""insertions"": 2, ""deletions"": 0, ""lines"": 2}}"
2021-07-05 20:23:00,442b29c968eff1c8fec1a96418aa47be9cba62ea,Bram Moolenaar,14,7,21,3,"{""src/eval.c"": {""insertions"": 6, ""deletions"": 1, ""lines"": 7}, ""src/testdir/test_vim9_script.vim"": {""insertions"": 6, ""deletions"": 6, ""lines"": 12}, ""src/version.c"": {""insertions"": 2, ""deletions"": 0, ""lines"": 2}}"
2021-07-05 20:03:04,5cb09620c1e0a0178c0dc986230997a8aac0e61a,Bram Moolenaar,6,1,7,2,"{""src/drawscreen.c"": {""insertions"": 4, ""deletions"": 1, ""lines"": 5}, ""src/version.c"": {""insertions"": 2, ""deletions"": 0, ""lines"": 2}}"
2021-07-05 19:41:48,404557e6a60389d09bbf91dd0cf3bae11bd623b9,Bram Moolenaar,22,5,27,4,"{""src/eval.c"": {""insertions"": 9, ""deletions"": 4, ""lines"": 13}, ""src/testdir/test_vim9_script.vim"": {""insertions"": 7, ""deletions"": 0, ""lines"": 7}, ""src/version.c"": {""insertions"": 2, ""deletions"": 0, ""lines"": 2}, ""src/vim9compile.c"": {""insertions"": 4, ""deletions"": 1, ""lines"": 5}}"
2021-07-05 18:15:23,04db26b36000a4677b95403ec94bd11f6cc73975,Bram Moolenaar,183,6,189,6,"{""runtime/doc/pattern.txt"": {""insertions"": 27, ""deletions"": 4, ""lines"": 31}, ""src/errors.h"": {""insertions"": 2, ""deletions"": 0, ""lines"": 2}, ""src/regexp_bt.c"": {""insertions"": 33, ""deletions"": 1, ""lines"": 34}, ""src/regexp_nfa.c"": {""insertions"": 29, ""deletions"": 1, ""lines"": 30}, ""src/testdir/test_regexp_latin.vim"": {""insertions"": 90, ""deletions"": 0, ""lines"": 90}, ""src/version.c"": {""insertions"": 2, ""deletions"": 0, ""lines"": 2}}"
2021-07-05 15:49:02,f6d877975ba93fc9b4bee2c5d2aff88dbf9bea59,Bram Moolenaar,3,1,4,2,"{""src/testdir/check.vim"": {""insertions"": 1, ""deletions"": 1, ""lines"": 2}, ""src/version.c"": {""insertions"": 2, ""deletions"": 0, ""lines"": 2}}"
2021-07-05 12:10:04,d6fa7bd5b900dd363d3a824e0ebe3619a1634df6,Bram Moolenaar,13,3,16,4,"{""src/testdir/check.vim"": {""insertions"": 8, ""deletions"": 0, ""lines"": 8}, ""src/testdir/test_clientserver.vim"": {""insertions"": 1, ""deletions"": 3, ""lines"": 4}, ""src/testdir/test_vim9_builtin.vim"": {""insertions"": 2, ""deletions"": 0, ""lines"": 2}, ""src/version.c"": {""insertions"": 2, ""deletions"": 0, ""lines"": 2}}"
2021-07-04 21:29:30,22f85d04594e1a09936227ef62955a7939d584b4,Bram Moolenaar,14,1,15,3,"{""src/testdir/test_vim9_assign.vim"": {""insertions"": 10, ""deletions"": 0, ""lines"": 10}, ""src/userfunc.c"": {""insertions"": 2, ""deletions"": 1, ""lines"": 3}, ""src/version.c"": {""insertions"": 2, ""deletions"": 0, ""lines"": 2}}"
2021-07-04 20:48:12,6977dba04b68b91410585ada65079651788ca7dc,Bram Moolenaar,25,1,26,3,"{""src/testdir/test_vim9_assign.vim"": {""insertions"": 10, ""deletions"": 0, ""lines"": 10}, ""src/version.c"": {""insertions"": 2, ""deletions"": 0, ""lines"": 2}, ""src/vim9compile.c"": {""insertions"": 13, ""deletions"": 1, ""lines"": 14}}"
2021-07-04 18:20:52,97f227d9c9351f12138d923ffdf9232dc5520bef,Bram Moolenaar,32,3,35,4,"{""src/testdir/test_vim9_assign.vim"": {""insertions"": 6, ""deletions"": 3, ""lines"": 9}, ""src/userfunc.c"": {""insertions"": 11, ""deletions"": 0, ""lines"": 11}, ""src/version.c"": {""insertions"": 2, ""deletions"": 0, ""lines"": 2}, ""src/vim9type.c"": {""insertions"": 13, ""deletions"": 0, ""lines"": 13}}"
2021-07-04 16:28:15,b7480cd8931fa1696265f75c7d4d9fdf0be69e12,Bram Moolenaar,13,1,14,4,"{""src/globals.h"": {""insertions"": 1, ""deletions"": 1, ""lines"": 2}, ""src/testdir/test_vim9_assign.vim"": {""insertions"": 9, ""deletions"": 0, ""lines"": 9}, ""src/version.c"": {""insertions"": 2, ""deletions"": 0, ""lines"": 2}, ""src/vim9type.c"": {""insertions"": 1, ""deletions"": 0, ""lines"": 1}}"
2021-07-04 15:36:54,f33cae605064c8bdb908a8069d936f752572cd76,Bram Moolenaar,15,13,28,2,"{""src/testdir/test_swap.vim"": {""insertions"": 13, ""deletions"": 13, ""lines"": 26}, ""src/version.c"": {""insertions"": 2, ""deletions"": 0, ""lines"": 2}}"
2021-07-04 15:23:25,3777d6e32b22f0a70b774760c24160079e303bad,Bram Moolenaar,14,8,22,2,"{""src/testdir/test_swap.vim"": {""insertions"": 12, ""deletions"": 8, ""lines"": 20}, ""src/version.c"": {""insertions"": 2, ""deletions"": 0, ""lines"": 2}}"
2021-07-04 15:21:04,26e88ec8e23fa04e559044199ccb369aed29e570,Bram Moolenaar,2,0,2,1,"{""src/version.c"": {""insertions"": 2, ""deletions"": 0, ""lines"": 2}}"
2021-07-04 14:50:55,67b17a6fc62156383d24dcbd6e6df34e180d7235,Bram Moolenaar,2,1,3,1,"{""src/proto/float.pro"": {""insertions"": 2, ""deletions"": 1, ""lines"": 3}}"
2021-07-04 13:54:08,7a40ff00edd35cc4313d74a43e7a7b67cd24372d,Bram Moolenaar,35,8,43,7,"{""src/evalfunc.c"": {""insertions"": 12, ""deletions"": 0, ""lines"": 12}, ""src/proto/evalfunc.pro"": {""insertions"": 1, ""deletions"": 1, ""lines"": 2}, ""src/testdir/test_vim9_assign.vim"": {""insertions"": 9, ""deletions"": 0, ""lines"": 9}, ""src/testdir/test_vim9_expr.vim"": {""insertions"": 1, ""deletions"": 1, ""lines"": 2}, ""src/testdir/test_vim9_func.vim"": {""insertions"": 1, ""deletions"": 1, ""lines"": 2}, ""src/version.c"": {""insertions"": 2, ""deletions"": 0, ""lines"": 2}, ""src/vim9type.c"": {""insertions"": 9, ""deletions"": 5, ""lines"": 14}}"
2021-07-04 12:47:30,4197828dc666f2d258594f7f9461534d23cc50e4,Bram Moolenaar,28,6,34,4,"{""src/ex_eval.c"": {""insertions"": 12, ""deletions"": 2, ""lines"": 14}, ""src/structs.h"": {""insertions"": 5, ""deletions"": 4, ""lines"": 9}, ""src/testdir/test_vim9_script.vim"": {""insertions"": 9, ""deletions"": 0, ""lines"": 9}, ""src/version.c"": {""insertions"": 2, ""deletions"": 0, ""lines"": 2}}"
2021-07-04 12:00:55,999db2346b61e6f6e6fde2d0b56f4646a46b727d,Bram Moolenaar,12,2,14,2,"{""src/testdir/test_popupwin.vim"": {""insertions"": 10, ""deletions"": 2, ""lines"": 12}, ""src/version.c"": {""insertions"": 2, ""deletions"": 0, ""lines"": 2}}"
2021-07-04 11:27:11,1d97efce0ce31ddf0dd4c1ae2228ef4caee6880c,Bram Moolenaar,19,0,19,3,"{""src/buffer.c"": {""insertions"": 5, ""deletions"": 0, ""lines"": 5}, ""src/testdir/test_swap.vim"": {""insertions"": 12, ""deletions"": 0, ""lines"": 12}, ""src/version.c"": {""insertions"": 2, ""deletions"": 0, ""lines"": 2}}"
2021-07-04 10:30:06,6c72fd51a899e6f0c272b08b9784d3c7a3cede20,Dominique Pelle,5,3,8,4,"{""src/testdir/test_debugger.vim"": {""insertions"": 1, ""deletions"": 2, ""lines"": 3}, ""src/testdir/test_lambda.vim"": {""insertions"": 1, ""deletions"": 0, ""lines"": 1}, ""src/testdir/test_visual.vim"": {""insertions"": 1, ""deletions"": 1, ""lines"": 2}, ""src/version.c"": {""insertions"": 2, ""deletions"": 0, ""lines"": 2}}"
2021-07-03 20:15:17,b17ab86e7b8712206aa9ea7198c28db969e25936,Bram Moolenaar,43,3,46,4,"{""src/drawscreen.c"": {""insertions"": 30, ""deletions"": 3, ""lines"": 33}, ""src/testdir/dumps/Test_visual_block_with_virtualedit2.dump"": {""insertions"": 8, ""deletions"": 0, ""lines"": 8}, ""src/testdir/test_visual.vim"": {""insertions"": 3, ""deletions"": 0, ""lines"": 3}, ""src/version.c"": {""insertions"": 2, ""deletions"": 0, ""lines"": 2}}"
2021-07-03 19:41:38,c60e959cba03fae9cff9b2674fab646cc70819fc,Dominique Pelle,3,0,3,2,"{""src/testdir/test_popupwin.vim"": {""insertions"": 1, ""deletions"": 0, ""lines"": 1}, ""src/version.c"": {""insertions"": 2, ""deletions"": 0, ""lines"": 2}}"
2021-07-03 19:37:59,fb773a3e0aa9466bb953c29bad0bf4ba34461a40,Bram Moolenaar,15,0,15,3,"{""src/testdir/check.vim"": {""insertions"": 11, ""deletions"": 0, ""lines"": 11}, ""src/testdir/test_gui.vim"": {""insertions"": 2, ""deletions"": 0, ""lines"": 2}, ""src/version.c"": {""insertions"": 2, ""deletions"": 0, ""lines"": 2}}"
2021-07-03 17:27:37,74509239df107b04abe4f30ada12109629c85939,Dominique Pelle,13,2,15,3,"{""runtime/doc/eval.txt"": {""insertions"": 7, ""deletions"": 0, ""lines"": 7}, ""src/testdir/test_vim9_builtin.vim"": {""insertions"": 4, ""deletions"": 2, ""lines"": 6}, ""src/version.c"": {""insertions"": 2, ""deletions"": 0, ""lines"": 2}}"
2021-07-03 16:56:53,e28d9b3bd4de2c7288add83ec35dc001ba280617,Bram Moolenaar,13,4,17,4,"{""src/structs.h"": {""insertions"": 2, ""deletions"": 0, ""lines"": 2}, ""src/testdir/test_vim9_func.vim"": {""insertions"": 6, ""deletions"": 0, ""lines"": 6}, ""src/version.c"": {""insertions"": 2, ""deletions"": 0, ""lines"": 2}, ""src/vim9compile.c"": {""insertions"": 3, ""deletions"": 4, ""lines"": 7}}"
2021-07-03 16:04:11,00aaa512d5e775e0db21e251f43d7afb8fca910f,Bram Moolenaar,8,0,8,2,"{""src/drawscreen.c"": {""insertions"": 6, ""deletions"": 0, ""lines"": 6}, ""src/version.c"": {""insertions"": 2, ""deletions"": 0, ""lines"": 2}}"
2021-07-03 14:33:16,20cc52832067d22a3cd47dfb0805251228c32e7d,Bram Moolenaar,30,31,61,2,"{""src/userfunc.c"": {""insertions"": 28, ""deletions"": 31, ""lines"": 59}, ""src/version.c"": {""insertions"": 2, ""deletions"": 0, ""lines"": 2}}"
2021-07-03 13:08:37,9cee4a1c9c69542ccd73bcd2db05920150856361,Bram Moolenaar,34,1,35,4,"{""src/drawscreen.c"": {""insertions"": 3, ""deletions"": 1, ""lines"": 4}, ""src/testdir/dumps/Test_visual_block_with_virtualedit.dump"": {""insertions"": 8, ""deletions"": 0, ""lines"": 8}, ""src/testdir/test_visual.vim"": {""insertions"": 21, ""deletions"": 0, ""lines"": 21}, ""src/version.c"": {""insertions"": 2, ""deletions"": 0, ""lines"": 2}}"
2021-07-03 11:51:44,fcde67c99fbb6d7294e01b9e87d8d2ae7af31255,Bram Moolenaar,6,0,6,3,"{""runtime/filetype.vim"": {""insertions"": 3, ""deletions"": 0, ""lines"": 3}, ""src/testdir/test_filetype.vim"": {""insertions"": 1, ""deletions"": 0, ""lines"": 1}, ""src/version.c"": {""insertions"": 2, ""deletions"": 0, ""lines"": 2}}"
2021-07-03 11:36:31,6fc016168249360f0524b68f72cf33efd0574d40,Bram Moolenaar,30,0,30,3,"{""src/testdir/test_debugger.vim"": {""insertions"": 16, ""deletions"": 0, ""lines"": 16}, ""src/version.c"": {""insertions"": 2, ""deletions"": 0, ""lines"": 2}, ""src/vim9compile.c"": {""insertions"": 12, ""deletions"": 0, ""lines"": 12}}"
2021-07-03 11:09:37,acbb4b5720fc27b8b07357b763ed4e5a944ae1da,Izhak Jakov,6,0,6,3,"{""runtime/filetype.vim"": {""insertions"": 3, ""deletions"": 0, ""lines"": 3}, ""src/testdir/test_filetype.vim"": {""insertions"": 1, ""deletions"": 0, ""lines"": 1}, ""src/version.c"": {""insertions"": 2, ""deletions"": 0, ""lines"": 2}}"
2021-07-03 09:58:12,a26f56f67502c72d44c61afdede2206cdde47c17,Yegappan Lakshmanan,645,146,791,6,"{""src/evalfunc.c"": {""insertions"": 150, ""deletions"": 103, ""lines"": 253}, ""src/testdir/test_functions.vim"": {""insertions"": 5, ""deletions"": 3, ""lines"": 8}, ""src/testdir/test_glob2regpat.vim"": {""insertions"": 2, ""deletions"": 1, ""lines"": 3}, ""src/testdir/test_vim9_builtin.vim"": {""insertions"": 486, ""deletions"": 32, ""lines"": 518}, ""src/testdir/test_vim9_expr.vim"": {""insertions"": 0, ""deletions"": 7, ""lines"": 7}, ""src/version.c"": {""insertions"": 2, ""deletions"": 0, ""lines"": 2}}"
2021-07-02 18:19:31,72463f883cdfd08e29ab0018ef3889284848d5f1,Christian Brabandt,6,1,7,3,"{""src/mbyte.c"": {""insertions"": 2, ""deletions"": 1, ""lines"": 3}, ""src/testdir/test_functions.vim"": {""insertions"": 2, ""deletions"": 0, ""lines"": 2}, ""src/version.c"": {""insertions"": 2, ""deletions"": 0, ""lines"": 2}}"
