date,hexsha,author,insertions,deletions,lines,files,files_json
2021-09-05 14:36:23,01dd6c3732a2f352d598e36336a65049614d7508,Bram Moolenaar,12,2,14,3,"{""src/testdir/test_vim9_func.vim"": {""insertions"": 4, ""deletions"": 0, ""lines"": 4}, ""src/userfunc.c"": {""insertions"": 6, ""deletions"": 2, ""lines"": 8}, ""src/version.c"": {""insertions"": 2, ""deletions"": 0, ""lines"": 2}}"
2021-09-04 19:20:41,2ddb89f8a94425cda1e5491efc80c1ccccb6e08e,Bram Moolenaar,13,2,15,2,"{""src/indent.c"": {""insertions"": 11, ""deletions"": 2, ""lines"": 13}, ""src/version.c"": {""insertions"": 2, ""deletions"": 0, ""lines"": 2}}"
2021-09-04 16:47:28,b7081e135a16091c93f6f5f7525a5c58fb7ca9f9,Bram Moolenaar,34,21,55,5,"{""src/indent.c"": {""insertions"": 21, ""deletions"": 13, ""lines"": 34}, ""src/option.c"": {""insertions"": 6, ""deletions"": 6, ""lines"": 12}, ""src/optionstr.c"": {""insertions"": 2, ""deletions"": 2, ""lines"": 4}, ""src/testdir/test_retab.vim"": {""insertions"": 3, ""deletions"": 0, ""lines"": 3}, ""src/version.c"": {""insertions"": 2, ""deletions"": 0, ""lines"": 2}}"
2021-09-04 12:49:56,10c83dde554b57ab4db71b96a0a02a5b6d1798e9,Bram Moolenaar,18,2,20,3,"{""src/evalfunc.c"": {""insertions"": 2, ""deletions"": 2, ""lines"": 4}, ""src/testdir/test_vim9_builtin.vim"": {""insertions"": 14, ""deletions"": 0, ""lines"": 14}, ""src/version.c"": {""insertions"": 2, ""deletions"": 0, ""lines"": 2}}"
2021-09-04 11:44:01,7f2dd1e90c1d4a30c791fae20014594641769a1e,Dominique Pelle,45,8,53,5,"{""runtime/doc/various.txt"": {""insertions"": 8, ""deletions"": 3, ""lines"": 11}, ""src/ex_cmds.c"": {""insertions"": 1, ""deletions"": 1, ""lines"": 2}, ""src/ex_cmds.h"": {""insertions"": 1, ""deletions"": 1, ""lines"": 2}, ""src/testdir/test_ex_z.vim"": {""insertions"": 33, ""deletions"": 3, ""lines"": 36}, ""src/version.c"": {""insertions"": 2, ""deletions"": 0, ""lines"": 2}}"
2021-09-03 17:21:36,deba5eb195d6ac70171d4973091fa884809fa3fa,Bram Moolenaar,116,5,121,5,"{""runtime/autoload/dist/ft.vim"": {""insertions"": 15, ""deletions"": 4, ""lines"": 19}, ""runtime/doc/filetype.txt"": {""insertions"": 1, ""deletions"": 0, ""lines"": 1}, ""runtime/filetype.vim"": {""insertions"": 4, ""deletions"": 1, ""lines"": 5}, ""src/testdir/test_filetype.vim"": {""insertions"": 94, ""deletions"": 0, ""lines"": 94}, ""src/version.c"": {""insertions"": 2, ""deletions"": 0, ""lines"": 2}}"
2021-09-03 14:50:16,af631f61bc42d0dddafe1bc0c06872cf3aaeb239,Dominique Pelle,116,94,210,2,"{""src/testdir/test_textobjects.vim"": {""insertions"": 114, ""deletions"": 94, ""lines"": 208}, ""src/version.c"": {""insertions"": 2, ""deletions"": 0, ""lines"": 2}}"
2021-09-02 18:05:26,03d257998b6343fc91f9dfd5ffc92eebe98d4d24,Yegappan Lakshmanan,20,0,20,2,"{""src/testdir/test_breakindent.vim"": {""insertions"": 18, ""deletions"": 0, ""lines"": 18}, ""src/version.c"": {""insertions"": 2, ""deletions"": 0, ""lines"": 2}}"
2021-09-02 17:53:07,87e1587b8add93e40340170e4261cdadc4c8940e,Bram Moolenaar,7,0,7,2,"{""src/evalfunc.c"": {""insertions"": 5, ""deletions"": 0, ""lines"": 5}, ""src/version.c"": {""insertions"": 2, ""deletions"": 0, ""lines"": 2}}"
2021-09-02 16:49:06,26a4484da20039b61f18d3565a4b4339c4d1f7e3,Bram Moolenaar,75,5,80,8,"{""src/debugger.c"": {""insertions"": 28, ""deletions"": 0, ""lines"": 28}, ""src/proto/debugger.pro"": {""insertions"": 1, ""deletions"": 0, ""lines"": 1}, ""src/proto/vim9execute.pro"": {""insertions"": 1, ""deletions"": 0, ""lines"": 1}, ""src/testdir/test_debugger.vim"": {""insertions"": 21, ""deletions"": 0, ""lines"": 21}, ""src/version.c"": {""insertions"": 2, ""deletions"": 0, ""lines"": 2}, ""src/vim.h"": {""insertions"": 9, ""deletions"": 2, ""lines"": 11}, ""src/vim9.h"": {""insertions"": 2, ""deletions"": 2, ""lines"": 4}, ""src/vim9execute.c"": {""insertions"": 11, ""deletions"": 1, ""lines"": 12}}"
2021-09-01 14:02:07,04626c243c47af91c2580eaf23e12286180e0e81,Bram Moolenaar,86,1,87,6,"{""src/diff.c"": {""insertions"": 13, ""deletions"": 0, ""lines"": 13}, ""src/move.c"": {""insertions"": 7, ""deletions"": 1, ""lines"": 8}, ""src/testdir/dumps/Test_diff_scroll_change_01.dump"": {""insertions"": 20, ""deletions"": 0, ""lines"": 20}, ""src/testdir/dumps/Test_diff_scroll_change_02.dump"": {""insertions"": 20, ""deletions"": 0, ""lines"": 20}, ""src/testdir/test_diffmode.vim"": {""insertions"": 24, ""deletions"": 0, ""lines"": 24}, ""src/version.c"": {""insertions"": 2, ""deletions"": 0, ""lines"": 2}}"
2021-09-01 12:31:51,6631597452d4644f485a09e4036d117e5f91de70,Bram Moolenaar,13,10,23,3,"{""src/strings.c"": {""insertions"": 1, ""deletions"": 0, ""lines"": 1}, ""src/testdir/test_shell.vim"": {""insertions"": 10, ""deletions"": 10, ""lines"": 20}, ""src/version.c"": {""insertions"": 2, ""deletions"": 0, ""lines"": 2}}"
2021-09-01 11:03:39,b4d82e2a8d610c00139a74970df772eece2daf1c,Bram Moolenaar,9,5,14,3,"{""src/cmdexpand.c"": {""insertions"": 2, ""deletions"": 2, ""lines"": 4}, ""src/testdir/test_cmdline.vim"": {""insertions"": 5, ""deletions"": 3, ""lines"": 8}, ""src/version.c"": {""insertions"": 2, ""deletions"": 0, ""lines"": 2}}"
2021-08-31 18:57:55,20e0c3d27bda770542c1c0e4c81fd6443c12f3a6,Bram Moolenaar,10,3,13,2,"{""src/drawline.c"": {""insertions"": 8, ""deletions"": 3, ""lines"": 11}, ""src/version.c"": {""insertions"": 2, ""deletions"": 0, ""lines"": 2}}"
2021-08-31 18:46:39,ba02e4720f863fdb456e7023520f0a354eec0dcf,Christian Brabandt,239,144,383,16,"{""src/diff.c"": {""insertions"": 1, ""deletions"": 1, ""lines"": 2}, ""src/version.c"": {""insertions"": 2, ""deletions"": 0, ""lines"": 2}, ""src/xdiff/README.txt"": {""insertions"": 1, ""deletions"": 1, ""lines"": 2}, ""src/xdiff/xdiff.h"": {""insertions"": 24, ""deletions"": 13, ""lines"": 37}, ""src/xdiff/xdiffi.c"": {""insertions"": 117, ""deletions"": 59, ""lines"": 176}, ""src/xdiff/xdiffi.h"": {""insertions"": 1, ""deletions"": 1, ""lines"": 2}, ""src/xdiff/xemit.c"": {""insertions"": 26, ""deletions"": 10, ""lines"": 36}, ""src/xdiff/xemit.h"": {""insertions"": 1, ""deletions"": 1, ""lines"": 2}, ""src/xdiff/xhistogram.c"": {""insertions"": 8, ""deletions"": 8, ""lines"": 16}, ""src/xdiff/xinclude.h"": {""insertions"": 8, ""deletions"": 2, ""lines"": 10}, ""src/xdiff/xmacros.h"": {""insertions"": 1, ""deletions"": 1, ""lines"": 2}, ""src/xdiff/xpatience.c"": {""insertions"": 23, ""deletions"": 30, ""lines"": 53}, ""src/xdiff/xprepare.h"": {""insertions"": 1, ""deletions"": 1, ""lines"": 2}, ""src/xdiff/xtypes.h"": {""insertions"": 1, ""deletions"": 1, ""lines"": 2}, ""src/xdiff/xutils.c"": {""insertions"": 23, ""deletions"": 14, ""lines"": 37}, ""src/xdiff/xutils.h"": {""insertions"": 1, ""deletions"": 1, ""lines"": 2}}"
2021-08-31 17:12:51,dca29d9cf46cd1d4d4519211c7af78b6b1c56960,zeertzjq,119,7,126,5,"{""runtime/doc/index.txt"": {""insertions"": 1, ""deletions"": 0, ""lines"": 1}, ""runtime/doc/insert.txt"": {""insertions"": 8, ""deletions"": 0, ""lines"": 8}, ""src/insexpand.c"": {""insertions"": 48, ""deletions"": 7, ""lines"": 55}, ""src/testdir/test_ins_complete.vim"": {""insertions"": 60, ""deletions"": 0, ""lines"": 60}, ""src/version.c"": {""insertions"": 2, ""deletions"": 0, ""lines"": 2}}"
2021-08-30 19:26:16,4eaef9979fc5032606897963f1af37674ee0d422,Bram Moolenaar,11,1,12,3,"{""src/os_unix.c"": {""insertions"": 7, ""deletions"": 1, ""lines"": 8}, ""src/testdir/test_fnamemodify.vim"": {""insertions"": 2, ""deletions"": 0, ""lines"": 2}, ""src/version.c"": {""insertions"": 2, ""deletions"": 0, ""lines"": 2}}"
2021-08-30 17:57:34,de05ae71589f46c5d27642c33fe5eb21b22aaf5d,Dominique Pelle,3,1,4,2,"{""src/strings.c"": {""insertions"": 1, ""deletions"": 1, ""lines"": 2}, ""src/version.c"": {""insertions"": 2, ""deletions"": 0, ""lines"": 2}}"
2021-08-29 20:12:56,a91871262670f9d3a4e5d1c5c6dbc02f85625f7d,Dominique Pelle,3,0,3,2,"{""src/indent.c"": {""insertions"": 1, ""deletions"": 0, ""lines"": 1}, ""src/version.c"": {""insertions"": 2, ""deletions"": 0, ""lines"": 2}}"
2021-08-29 19:55:35,89a9c159f23fb7b3e24e6d09068adfc24a73afcb,Bram Moolenaar,649,242,891,39,"{"".github/workflows/codeql-analysis.yml"": {""insertions"": 1, ""deletions"": 1, ""lines"": 2}, ""CONTRIBUTING.md"": {""insertions"": 1, ""deletions"": 1, ""lines"": 2}, ""README.md"": {""insertions"": 7, ""deletions"": 7, ""lines"": 14}, ""README.txt"": {""insertions"": 6, ""deletions"": 6, ""lines"": 12}, ""README_VIM9.md"": {""insertions"": 1, ""deletions"": 1, ""lines"": 2}, ""nsis/lang/turkish.nsi"": {""insertions"": 7, ""deletions"": 7, ""lines"": 14}, ""pixmaps/gen-inline-pixbufs.sh"": {""insertions"": 2, ""deletions"": 4, ""lines"": 6}, ""runtime/autoload/netrw.vim"": {""insertions"": 213, ""deletions"": 80, ""lines"": 293}, ""runtime/autoload/netrwSettings.vim"": {""insertions"": 4, ""deletions"": 4, ""lines"": 8}, ""runtime/doc/eval.txt"": {""insertions"": 16, ""deletions"": 16, ""lines"": 32}, ""runtime/doc/index.txt"": {""insertions"": 1, ""deletions"": 1, ""lines"": 2}, ""runtime/doc/insert.txt"": {""insertions"": 1, ""deletions"": 1, ""lines"": 2}, ""runtime/doc/options.txt"": {""insertions"": 11, ""deletions"": 4, ""lines"": 15}, ""runtime/doc/pi_netrw.txt"": {""insertions"": 72, ""deletions"": 12, ""lines"": 84}, ""runtime/doc/popup.txt"": {""insertions"": 18, ""deletions"": 7, ""lines"": 25}, ""runtime/doc/syntax.txt"": {""insertions"": 6, ""deletions"": 5, ""lines"": 11}, ""runtime/doc/tags"": {""insertions"": 5, ""deletions"": 0, ""lines"": 5}, ""runtime/doc/term.txt"": {""insertions"": 37, ""deletions"": 1, ""lines"": 38}, ""runtime/doc/terminal.txt"": {""insertions"": 15, ""deletions"": 13, ""lines"": 28}, ""runtime/doc/testing.txt"": {""insertions"": 16, ""deletions"": 8, ""lines"": 24}, ""runtime/doc/textprop.txt"": {""insertions"": 1, ""deletions"": 1, ""lines"": 2}, ""runtime/doc/todo.txt"": {""insertions"": 5, ""deletions"": 1, ""lines"": 6}, ""runtime/doc/version6.txt"": {""insertions"": 1, ""deletions"": 1, ""lines"": 2}, ""runtime/doc/vim9.txt"": {""insertions"": 9, ""deletions"": 6, ""lines"": 15}, ""runtime/filetype.vim"": {""insertions"": 1, ""deletions"": 1, ""lines"": 2}, ""runtime/ftplugin/scala.vim"": {""insertions"": 3, ""deletions"": 3, ""lines"": 6}, ""runtime/indent/scala.vim"": {""insertions"": 6, ""deletions"": 3, ""lines"": 9}, ""runtime/pack/dist/opt/termdebug/plugin/termdebug.vim"": {""insertions"": 5, ""deletions"": 1, ""lines"": 6}, ""runtime/plugin/netrwPlugin.vim"": {""insertions"": 21, ""deletions"": 7, ""lines"": 28}, ""runtime/syntax/cpp.vim"": {""insertions"": 19, ""deletions"": 2, ""lines"": 21}, ""runtime/syntax/gemtext.vim"": {""insertions"": 24, ""deletions"": 0, ""lines"": 24}, ""runtime/syntax/scala.vim"": {""insertions"": 12, ""deletions"": 12, ""lines"": 24}, ""runtime/syntax/structurizr.vim"": {""insertions"": 76, ""deletions"": 0, ""lines"": 76}, ""runtime/tutor/tutor"": {""insertions"": 5, ""deletions"": 5, ""lines"": 10}, ""runtime/tutor/tutor.utf-8"": {""insertions"": 5, ""deletions"": 5, ""lines"": 10}, ""src/INSTALL"": {""insertions"": 1, ""deletions"": 0, ""lines"": 1}, ""src/gvimtutor"": {""insertions"": 1, ""deletions"": 1, ""lines"": 2}, ""src/vimtutor"": {""insertions"": 13, ""deletions"": 13, ""lines"": 26}, ""vimtutor.bat"": {""insertions"": 1, ""deletions"": 1, ""lines"": 2}}"
2021-08-29 10:36:49,6e82351130ddb8d13cf3748b47f07cae77886fc7,Jason Cox,38,8,46,4,"{""runtime/doc/eval.txt"": {""insertions"": 4, ""deletions"": 0, ""lines"": 4}, ""src/strings.c"": {""insertions"": 21, ""deletions"": 0, ""lines"": 21}, ""src/testdir/test_shell.vim"": {""insertions"": 11, ""deletions"": 8, ""lines"": 19}, ""src/version.c"": {""insertions"": 2, ""deletions"": 0, ""lines"": 2}}"
2021-08-28 18:42:50,9dcd349ca85e1df1abd1cbf1c29c0f1574b70bf8,Hu Jialun,21,2,23,4,"{""runtime/doc/options.txt"": {""insertions"": 9, ""deletions"": 0, ""lines"": 9}, ""src/buffer.c"": {""insertions"": 2, ""deletions"": 2, ""lines"": 4}, ""src/testdir/test_modeline.vim"": {""insertions"": 8, ""deletions"": 0, ""lines"": 8}, ""src/version.c"": {""insertions"": 2, ""deletions"": 0, ""lines"": 2}}"
2021-08-28 13:56:06,9aecf79c45da5593e4d8c0de1b2d212edc4765ce,naohiro ono,7,2,9,3,"{""src/testdir/test_cmdline.vim"": {""insertions"": 3, ""deletions"": 1, ""lines"": 4}, ""src/userfunc.c"": {""insertions"": 2, ""deletions"": 1, ""lines"": 3}, ""src/version.c"": {""insertions"": 2, ""deletions"": 0, ""lines"": 2}}"
2021-08-28 12:58:44,c8103b4c2547ce2044469bcd49e3d55907bd33d1,Bram Moolenaar,14,2,16,3,"{""src/testdir/test_vim9_builtin.vim"": {""insertions"": 9, ""deletions"": 0, ""lines"": 9}, ""src/version.c"": {""insertions"": 2, ""deletions"": 0, ""lines"": 2}, ""src/vim9type.c"": {""insertions"": 3, ""deletions"": 2, ""lines"": 5}}"
2021-08-28 12:42:25,5c56da4de8398566ef96122db44ec93e6c2d483a,Bram Moolenaar,10,1,11,3,"{""src/globals.h"": {""insertions"": 1, ""deletions"": 1, ""lines"": 2}, ""src/testdir/test_signs.vim"": {""insertions"": 7, ""deletions"": 0, ""lines"": 7}, ""src/version.c"": {""insertions"": 2, ""deletions"": 0, ""lines"": 2}}"
2021-08-28 10:49:27,60b6e6f6cc60ac99253e1c13bd0cae4ef0e43201,Bram Moolenaar,8,0,8,3,"{""src/evalfunc.c"": {""insertions"": 5, ""deletions"": 0, ""lines"": 5}, ""src/testdir/test_expr.vim"": {""insertions"": 1, ""deletions"": 0, ""lines"": 1}, ""src/version.c"": {""insertions"": 2, ""deletions"": 0, ""lines"": 2}}"
2021-08-28 10:30:12,271906bc067a8f25422016665001d2e44cf618e2,Bram Moolenaar,10,1,11,3,"{""src/job.c"": {""insertions"": 4, ""deletions"": 1, ""lines"": 5}, ""src/testdir/test_channel.vim"": {""insertions"": 4, ""deletions"": 0, ""lines"": 4}, ""src/version.c"": {""insertions"": 2, ""deletions"": 0, ""lines"": 2}}"
2021-08-27 18:59:35,6024c0427ce1196344439997d5e41a6f8546368c,Albert Liu,9,7,16,3,"{""src/cmdexpand.c"": {""insertions"": 3, ""deletions"": 7, ""lines"": 10}, ""src/testdir/test_cmdline.vim"": {""insertions"": 4, ""deletions"": 0, ""lines"": 4}, ""src/version.c"": {""insertions"": 2, ""deletions"": 0, ""lines"": 2}}"
2021-08-26 14:39:58,47016f57724d3970c54f4ca1f392dff39d3fecae,Bram Moolenaar,13,1,14,3,"{""src/cmdexpand.c"": {""insertions"": 3, ""deletions"": 1, ""lines"": 4}, ""src/testdir/test_cmdline.vim"": {""insertions"": 8, ""deletions"": 0, ""lines"": 8}, ""src/version.c"": {""insertions"": 2, ""deletions"": 0, ""lines"": 2}}"
2021-08-25 20:37:36,4799cef85ce43e26f5022290b41a7c85bbab8cad,Bram Moolenaar,32,15,47,5,"{""src/ex_eval.c"": {""insertions"": 21, ""deletions"": 9, ""lines"": 30}, ""src/proto/ex_eval.pro"": {""insertions"": 1, ""deletions"": 0, ""lines"": 1}, ""src/testdir/test_vim9_cmd.vim"": {""insertions"": 7, ""deletions"": 1, ""lines"": 8}, ""src/version.c"": {""insertions"": 2, ""deletions"": 0, ""lines"": 2}, ""src/vim9compile.c"": {""insertions"": 1, ""deletions"": 5, ""lines"": 6}}"
2021-08-25 15:31:37,df9070e300dabf0c54de87a75973a80adb38afa3,Bram Moolenaar,4,1,5,2,"{""src/memline.c"": {""insertions"": 2, ""deletions"": 1, ""lines"": 3}, ""src/version.c"": {""insertions"": 2, ""deletions"": 0, ""lines"": 2}}"
2021-08-25 15:10:39,eb05d05f8a049b32ba1b992074534ca4763e46b3,Bram Moolenaar,6,0,6,3,"{""runtime/filetype.vim"": {""insertions"": 3, ""deletions"": 0, ""lines"": 3}, ""src/testdir/test_filetype.vim"": {""insertions"": 1, ""deletions"": 0, ""lines"": 1}, ""src/version.c"": {""insertions"": 2, ""deletions"": 0, ""lines"": 2}}"
2021-08-25 15:02:00,49b93049c68653156609ebcdf22311ccbcdf00e2,Bram Moolenaar,3,0,3,2,"{""src/testdir/test_textprop.vim"": {""insertions"": 1, ""deletions"": 0, ""lines"": 1}, ""src/version.c"": {""insertions"": 2, ""deletions"": 0, ""lines"": 2}}"
2021-08-25 14:40:03,cdd8a5e6fe089a3b1370ac940d06fc3cefc6f8f2,Bram Moolenaar,22,1,23,3,"{""src/memline.c"": {""insertions"": 11, ""deletions"": 1, ""lines"": 12}, ""src/testdir/test_textprop.vim"": {""insertions"": 9, ""deletions"": 0, ""lines"": 9}, ""src/version.c"": {""insertions"": 2, ""deletions"": 0, ""lines"": 2}}"
2021-08-24 19:56:03,5ca5cc6412d7d68fd380926f9551a8b7ba335199,Bram Moolenaar,28,4,32,4,"{""src/ex_docmd.c"": {""insertions"": 8, ""deletions"": 4, ""lines"": 12}, ""src/testdir/test_vim9_cmd.vim"": {""insertions"": 16, ""deletions"": 0, ""lines"": 16}, ""src/version.c"": {""insertions"": 2, ""deletions"": 0, ""lines"": 2}, ""src/vim9compile.c"": {""insertions"": 2, ""deletions"": 0, ""lines"": 2}}"
2021-08-23 20:22:45,60faf8656e1a100778bf7cd4d305380fb852d540,Bram Moolenaar,11,1,12,3,"{""src/eval.c"": {""insertions"": 7, ""deletions"": 1, ""lines"": 8}, ""src/testdir/test_vim9_assign.vim"": {""insertions"": 2, ""deletions"": 0, ""lines"": 2}, ""src/version.c"": {""insertions"": 2, ""deletions"": 0, ""lines"": 2}}"
2021-08-23 19:19:01,6b36d2a16d7931bac82ef8b5654c68ac456b24bf,Bram Moolenaar,12,1,13,3,"{""src/ops.c"": {""insertions"": 3, ""deletions"": 1, ""lines"": 4}, ""src/testdir/test_textformat.vim"": {""insertions"": 7, ""deletions"": 0, ""lines"": 7}, ""src/version.c"": {""insertions"": 2, ""deletions"": 0, ""lines"": 2}}"
2021-08-23 18:48:43,9cd91a1e8816d727fbdbf0b3062288e15abc5f4d,Bram Moolenaar,4,2,6,3,"{""runtime/filetype.vim"": {""insertions"": 1, ""deletions"": 1, ""lines"": 2}, ""src/testdir/test_filetype.vim"": {""insertions"": 1, ""deletions"": 1, ""lines"": 2}, ""src/version.c"": {""insertions"": 2, ""deletions"": 0, ""lines"": 2}}"
2021-08-22 20:44:11,73170917f14d1b0d919c65fbc0a9d011b87d94da,Bram Moolenaar,32,7,39,3,"{""src/ex_docmd.c"": {""insertions"": 14, ""deletions"": 7, ""lines"": 21}, ""src/testdir/test_vim9_cmd.vim"": {""insertions"": 16, ""deletions"": 0, ""lines"": 16}, ""src/version.c"": {""insertions"": 2, ""deletions"": 0, ""lines"": 2}}"
2021-08-22 11:35:31,093165c899f1620543844d1c1a7a05975697c286,Bram Moolenaar,74,2,76,3,"{""src/testdir/test_vim9_disassemble.vim"": {""insertions"": 47, ""deletions"": 0, ""lines"": 47}, ""src/version.c"": {""insertions"": 2, ""deletions"": 0, ""lines"": 2}, ""src/vim9compile.c"": {""insertions"": 25, ""deletions"": 2, ""lines"": 27}}"
2021-08-21 18:50:35,bf5f2878333da934a8bdc560bf0bcf9a88ff86a1,Bram Moolenaar,40,3,43,5,"{""src/ex_docmd.c"": {""insertions"": 20, ""deletions"": 2, ""lines"": 22}, ""src/proto/vim9compile.pro"": {""insertions"": 1, ""deletions"": 0, ""lines"": 1}, ""src/testdir/test_vim9_cmd.vim"": {""insertions"": 16, ""deletions"": 0, ""lines"": 16}, ""src/version.c"": {""insertions"": 2, ""deletions"": 0, ""lines"": 2}, ""src/vim9compile.c"": {""insertions"": 1, ""deletions"": 1, ""lines"": 2}}"
2021-08-21 15:26:50,bebf06954e1c801870b57e06ab03151c2654d079,rbtnn,202,130,332,3,"{""src/testdir/test_vim9_script.vim"": {""insertions"": 64, ""deletions"": 0, ""lines"": 64}, ""src/version.c"": {""insertions"": 2, ""deletions"": 0, ""lines"": 2}, ""src/vim9compile.c"": {""insertions"": 136, ""deletions"": 130, ""lines"": 266}}"
2021-08-21 15:13:14,b8bd2e6ebab03baf2672067067a599df69a278c0,Bram Moolenaar,12,4,16,6,"{""src/ex_cmds.c"": {""insertions"": 6, ""deletions"": 0, ""lines"": 6}, ""src/testdir/test_cmdline.vim"": {""insertions"": 1, ""deletions"": 1, ""lines"": 2}, ""src/testdir/test_undo.vim"": {""insertions"": 1, ""deletions"": 1, ""lines"": 2}, ""src/testdir/test_vim9_builtin.vim"": {""insertions"": 1, ""deletions"": 1, ""lines"": 2}, ""src/testdir/test_vim9_script.vim"": {""insertions"": 1, ""deletions"": 1, ""lines"": 2}, ""src/version.c"": {""insertions"": 2, ""deletions"": 0, ""lines"": 2}}"
2021-08-21 14:21:19,489d60996deb5e7c1a3b4633412d54632e6def42,Gregory Anders,51,16,67,3,"{""src/tag.c"": {""insertions"": 39, ""deletions"": 16, ""lines"": 55}, ""src/testdir/test_tagjump.vim"": {""insertions"": 10, ""deletions"": 0, ""lines"": 10}, ""src/version.c"": {""insertions"": 2, ""deletions"": 0, ""lines"": 2}}"
2021-08-20 18:54:25,d895b1d918f7d56dd9dd564be4820082ba6492e9,rbtnn,107,17,124,3,"{""src/testdir/test_vim9_script.vim"": {""insertions"": 83, ""deletions"": 0, ""lines"": 83}, ""src/version.c"": {""insertions"": 2, ""deletions"": 0, ""lines"": 2}, ""src/vim9compile.c"": {""insertions"": 22, ""deletions"": 17, ""lines"": 39}}"
2021-08-19 19:20:41,5aec755b678cfd434b8ea2158d06992f33e1ff80,naohiro ono,14,3,17,3,"{""src/evalfunc.c"": {""insertions"": 3, ""deletions"": 2, ""lines"": 5}, ""src/testdir/test_cmdline.vim"": {""insertions"": 9, ""deletions"": 1, ""lines"": 10}, ""src/version.c"": {""insertions"": 2, ""deletions"": 0, ""lines"": 2}}"
2021-08-19 19:08:30,c66f645b809d0852592ca37afacb9031b5950c7f,Bram Moolenaar,23,0,23,4,"{""src/errors.h"": {""insertions"": 2, ""deletions"": 0, ""lines"": 2}, ""src/testdir/test_vim9_func.vim"": {""insertions"": 9, ""deletions"": 0, ""lines"": 9}, ""src/version.c"": {""insertions"": 2, ""deletions"": 0, ""lines"": 2}, ""src/vim9type.c"": {""insertions"": 10, ""deletions"": 0, ""lines"": 10}}"
2021-08-17 21:44:54,dea561111a5761bf99397a246b8baa43e73288de,Bastian Venthur,26,3,29,3,"{""runtime/filetype.vim"": {""insertions"": 7, ""deletions"": 2, ""lines"": 9}, ""src/testdir/test_filetype.vim"": {""insertions"": 17, ""deletions"": 1, ""lines"": 18}, ""src/version.c"": {""insertions"": 2, ""deletions"": 0, ""lines"": 2}}"
2021-08-17 20:14:29,02f8694a6bd116ab3316add4a7ea6735bf2e8839,Bram Moolenaar,15,1,16,3,"{""src/misc2.c"": {""insertions"": 2, ""deletions"": 1, ""lines"": 3}, ""src/testdir/test_number.vim"": {""insertions"": 11, ""deletions"": 0, ""lines"": 11}, ""src/version.c"": {""insertions"": 2, ""deletions"": 0, ""lines"": 2}}"
2021-08-16 19:39:09,ccfb7c6758510e0fe5f390149ea14aee6ff4f55e,Yegappan Lakshmanan,253,77,330,9,"{""runtime/doc/eval.txt"": {""insertions"": 3, ""deletions"": 1, ""lines"": 4}, ""runtime/doc/textprop.txt"": {""insertions"": 32, ""deletions"": 0, ""lines"": 32}, ""runtime/doc/usr_41.txt"": {""insertions"": 1, ""deletions"": 0, ""lines"": 1}, ""src/evalfunc.c"": {""insertions"": 3, ""deletions"": 0, ""lines"": 3}, ""src/proto/textprop.pro"": {""insertions"": 1, ""deletions"": 0, ""lines"": 1}, ""src/testdir/test_textprop.vim"": {""insertions"": 35, ""deletions"": 0, ""lines"": 35}, ""src/testdir/test_vim9_builtin.vim"": {""insertions"": 5, ""deletions"": 0, ""lines"": 5}, ""src/textprop.c"": {""insertions"": 171, ""deletions"": 76, ""lines"": 247}, ""src/version.c"": {""insertions"": 2, ""deletions"": 0, ""lines"": 2}}"
2021-08-16 19:15:32,434df7a401c92d4084bb0a01ffd6d1737ae0193b,Bram Moolenaar,4,2,6,2,"{""src/memline.c"": {""insertions"": 2, ""deletions"": 2, ""lines"": 4}, ""src/version.c"": {""insertions"": 2, ""deletions"": 0, ""lines"": 2}}"
2021-08-15 20:18:04,92755bba30ec7a4c72ae0280420ba5c3847a9385,Bram Moolenaar,5,3,8,2,"{""src/memline.c"": {""insertions"": 3, ""deletions"": 3, ""lines"": 6}, ""src/version.c"": {""insertions"": 2, ""deletions"": 0, ""lines"": 2}}"
2021-08-15 18:36:28,cd6b4f300189b4920f7ee7f0204338e91210674b,Bram Moolenaar,49,31,80,5,"{""src/testdir/test_vim9_disassemble.vim"": {""insertions"": 15, ""deletions"": 13, ""lines"": 28}, ""src/testdir/test_vim9_expr.vim"": {""insertions"": 17, ""deletions"": 6, ""lines"": 23}, ""src/testdir/test_vim9_script.vim"": {""insertions"": 3, ""deletions"": 3, ""lines"": 6}, ""src/version.c"": {""insertions"": 2, ""deletions"": 0, ""lines"": 2}, ""src/vim9compile.c"": {""insertions"": 12, ""deletions"": 9, ""lines"": 21}}"
2021-08-15 17:28:05,4bba16d252da6f072d311f9b3ebb50101d6d2eaf,Bram Moolenaar,15,0,15,3,"{""src/testdir/test_vim9_func.vim"": {""insertions"": 11, ""deletions"": 0, ""lines"": 11}, ""src/userfunc.c"": {""insertions"": 2, ""deletions"": 0, ""lines"": 2}, ""src/version.c"": {""insertions"": 2, ""deletions"": 0, ""lines"": 2}}"
2021-08-15 14:08:36,b033ee2ddfa8513b57111a56d6af9e45c41f7d1e,Bram Moolenaar,23,0,23,3,"{""src/evalvars.c"": {""insertions"": 4, ""deletions"": 0, ""lines"": 4}, ""src/testdir/test_vim9_func.vim"": {""insertions"": 17, ""deletions"": 0, ""lines"": 17}, ""src/version.c"": {""insertions"": 2, ""deletions"": 0, ""lines"": 2}}"
2021-08-15 13:04:41,a401bba0805856e295c213aa504648084dae7e24,Bram Moolenaar,3,0,3,2,"{""src/testdir/test_textprop.vim"": {""insertions"": 1, ""deletions"": 0, ""lines"": 1}, ""src/version.c"": {""insertions"": 2, ""deletions"": 0, ""lines"": 2}}"
2021-08-15 12:39:13,5cebca27b831880fb6e191e5271ee614625e1f8a,Bram Moolenaar,4,2,6,2,"{""src/version.c"": {""insertions"": 2, ""deletions"": 0, ""lines"": 2}, ""src/vim9script.c"": {""insertions"": 2, ""deletions"": 2, ""lines"": 4}}"
2021-08-15 12:28:40,14c7530c4fca786d3594508e28943f10125827c3,Bram Moolenaar,29,3,32,3,"{""src/memline.c"": {""insertions"": 17, ""deletions"": 3, ""lines"": 20}, ""src/testdir/test_textprop.vim"": {""insertions"": 10, ""deletions"": 0, ""lines"": 10}, ""src/version.c"": {""insertions"": 2, ""deletions"": 0, ""lines"": 2}}"
2021-08-15 11:49:42,dd9de50f4262898384be6ea7694d05507c7cb260,Bram Moolenaar,77,9,86,9,"{""src/errors.h"": {""insertions"": 2, ""deletions"": 0, ""lines"": 2}, ""src/eval.c"": {""insertions"": 3, ""deletions"": 4, ""lines"": 7}, ""src/evalvars.c"": {""insertions"": 2, ""deletions"": 2, ""lines"": 4}, ""src/ex_docmd.c"": {""insertions"": 1, ""deletions"": 1, ""lines"": 2}, ""src/proto/vim9script.pro"": {""insertions"": 1, ""deletions"": 0, ""lines"": 1}, ""src/testdir/test_vim9_cmd.vim"": {""insertions"": 53, ""deletions"": 1, ""lines"": 54}, ""src/typval.c"": {""insertions"": 1, ""deletions"": 1, ""lines"": 2}, ""src/version.c"": {""insertions"": 2, ""deletions"": 0, ""lines"": 2}, ""src/vim9script.c"": {""insertions"": 12, ""deletions"": 0, ""lines"": 12}}"
2021-08-14 19:35:40,2596a4e763e11eb8e406f262cb72fd2b39461572,Bram Moolenaar,5,1,6,3,"{""src/eval.c"": {""insertions"": 2, ""deletions"": 1, ""lines"": 3}, ""src/testdir/test_vim9_cmd.vim"": {""insertions"": 1, ""deletions"": 0, ""lines"": 1}, ""src/version.c"": {""insertions"": 2, ""deletions"": 0, ""lines"": 2}}"
2021-08-14 19:25:52,6aa57295cfbe8f21c15f0671e45fd53cf990d404,Bram Moolenaar,1650,284,1934,35,"{""runtime/compiler/scdoc.vim"": {""insertions"": 16, ""deletions"": 0, ""lines"": 16}, ""runtime/doc/autocmd.txt"": {""insertions"": 2, ""deletions"": 2, ""lines"": 4}, ""runtime/doc/channel.txt"": {""insertions"": 4, ""deletions"": 4, ""lines"": 8}, ""runtime/doc/cmdline.txt"": {""insertions"": 7, ""deletions"": 2, ""lines"": 9}, ""runtime/doc/eval.txt"": {""insertions"": 212, ""deletions"": 184, ""lines"": 396}, ""runtime/doc/if_lua.txt"": {""insertions"": 1, ""deletions"": 1, ""lines"": 2}, ""runtime/doc/insert.txt"": {""insertions"": 2, ""deletions"": 2, ""lines"": 4}, ""runtime/doc/map.txt"": {""insertions"": 1, ""deletions"": 1, ""lines"": 2}, ""runtime/doc/message.txt"": {""insertions"": 9, ""deletions"": 1, ""lines"": 10}, ""runtime/doc/popup.txt"": {""insertions"": 3, ""deletions"": 1, ""lines"": 4}, ""runtime/doc/sign.txt"": {""insertions"": 11, ""deletions"": 11, ""lines"": 22}, ""runtime/doc/tags"": {""insertions"": 21, ""deletions"": 2, ""lines"": 23}, ""runtime/doc/terminal.txt"": {""insertions"": 32, ""deletions"": 5, ""lines"": 37}, ""runtime/doc/testing.txt"": {""insertions"": 1, ""deletions"": 1, ""lines"": 2}, ""runtime/doc/todo.txt"": {""insertions"": 5, ""deletions"": 16, ""lines"": 21}, ""runtime/doc/usr_41.txt"": {""insertions"": 1, ""deletions"": 1, ""lines"": 2}, ""runtime/doc/vim9.txt"": {""insertions"": 41, ""deletions"": 15, ""lines"": 56}, ""runtime/ftplugin/chicken.vim"": {""insertions"": 1, ""deletions"": 0, ""lines"": 1}, ""runtime/ftplugin/julia.vim"": {""insertions"": 92, ""deletions"": 0, ""lines"": 92}, ""runtime/ftplugin/scdoc.vim"": {""insertions"": 26, ""deletions"": 0, ""lines"": 26}, ""runtime/ftplugin/scheme.vim"": {""insertions"": 3, ""deletions"": 2, ""lines"": 5}, ""runtime/gvim.desktop"": {""insertions"": 0, ""deletions"": 6, ""lines"": 6}, ""runtime/indent/julia.vim"": {""insertions"": 491, ""deletions"": 0, ""lines"": 491}, ""runtime/indent/yaml.vim"": {""insertions"": 1, ""deletions"": 1, ""lines"": 2}, ""runtime/pack/dist/opt/termdebug/plugin/termdebug.vim"": {""insertions"": 22, ""deletions"": 1, ""lines"": 23}, ""runtime/plugin/manpager.vim"": {""insertions"": 5, ""deletions"": 2, ""lines"": 7}, ""runtime/syntax/chicken.vim"": {""insertions"": 19, ""deletions"": 2, ""lines"": 21}, ""runtime/syntax/debchangelog.vim"": {""insertions"": 3, ""deletions"": 3, ""lines"": 6}, ""runtime/syntax/debsources.vim"": {""insertions"": 3, ""deletions"": 3, ""lines"": 6}, ""runtime/syntax/julia.vim"": {""insertions"": 550, ""deletions"": 0, ""lines"": 550}, ""runtime/syntax/redif.vim"": {""insertions"": 2, ""deletions"": 2, ""lines"": 4}, ""runtime/syntax/scala.vim"": {""insertions"": 3, ""deletions"": 2, ""lines"": 5}, ""runtime/syntax/scdoc.vim"": {""insertions"": 52, ""deletions"": 0, ""lines"": 52}, ""runtime/syntax/scheme.vim"": {""insertions"": 8, ""deletions"": 5, ""lines"": 13}, ""runtime/vim.desktop"": {""insertions"": 0, ""deletions"": 6, ""lines"": 6}}"
2021-08-14 19:11:51,bfb2bb16bc69441fa3ec13caacb2c94637a8a0ec,Dominique Pelle,84,0,84,5,"{""src/testdir/test_arglist.vim"": {""insertions"": 6, ""deletions"": 0, ""lines"": 6}, ""src/testdir/test_cmdline.vim"": {""insertions"": 12, ""deletions"": 0, ""lines"": 12}, ""src/testdir/test_spellfile.vim"": {""insertions"": 27, ""deletions"": 0, ""lines"": 27}, ""src/testdir/test_substitute.vim"": {""insertions"": 37, ""deletions"": 0, ""lines"": 37}, ""src/version.c"": {""insertions"": 2, ""deletions"": 0, ""lines"": 2}}"
2021-08-14 13:16:00,d2e9ccee90d2b39f4c9fd6cec271ef3fafd76f09,Bram Moolenaar,8,1,9,2,"{""src/testdir/test_vimscript.vim"": {""insertions"": 6, ""deletions"": 1, ""lines"": 7}, ""src/version.c"": {""insertions"": 2, ""deletions"": 0, ""lines"": 2}}"
2021-08-14 12:59:27,4830c211a47f39edcf1827ffd787306faf65c2a5,Bram Moolenaar,3,2,5,2,"{""src/evalvars.c"": {""insertions"": 1, ""deletions"": 2, ""lines"": 3}, ""src/version.c"": {""insertions"": 2, ""deletions"": 0, ""lines"": 2}}"
2021-08-14 12:27:30,b521766c56c0e17db6e8615f35cf21012af0670c,Bram Moolenaar,5,2,7,3,"{""src/evalvars.c"": {""insertions"": 2, ""deletions"": 1, ""lines"": 3}, ""src/testdir/test_let.vim"": {""insertions"": 1, ""deletions"": 1, ""lines"": 2}, ""src/version.c"": {""insertions"": 2, ""deletions"": 0, ""lines"": 2}}"
2021-08-14 12:01:05,88c89c77229e725ab2613b022249e2f506d82b82,Bram Moolenaar,63,12,75,8,"{""src/evalvars.c"": {""insertions"": 2, ""deletions"": 1, ""lines"": 3}, ""src/globals.h"": {""insertions"": 2, ""deletions"": 2, ""lines"": 4}, ""src/message.c"": {""insertions"": 1, ""deletions"": 1, ""lines"": 2}, ""src/testdir/test_vim9_func.vim"": {""insertions"": 46, ""deletions"": 0, ""lines"": 46}, ""src/testdir/vim9.vim"": {""insertions"": 1, ""deletions"": 1, ""lines"": 2}, ""src/time.c"": {""insertions"": 2, ""deletions"": 2, ""lines"": 4}, ""src/version.c"": {""insertions"": 2, ""deletions"": 0, ""lines"": 2}, ""src/vim9execute.c"": {""insertions"": 7, ""deletions"": 5, ""lines"": 12}}"
2021-08-13 18:12:13,78a9c2e670d29349404b346e0aa90264cab19e9b,Bram Moolenaar,4,0,4,2,"{""src/eval.c"": {""insertions"": 2, ""deletions"": 0, ""lines"": 2}, ""src/version.c"": {""insertions"": 2, ""deletions"": 0, ""lines"": 2}}"
2021-08-13 17:40:51,aacc966c5d0ed91e33ed32b08f17cf4df3ca1394,Bram Moolenaar,122,32,154,8,"{""src/eval.c"": {""insertions"": 19, ""deletions"": 11, ""lines"": 30}, ""src/globals.h"": {""insertions"": 2, ""deletions"": 0, ""lines"": 2}, ""src/testdir/test_vim9_cmd.vim"": {""insertions"": 17, ""deletions"": 0, ""lines"": 17}, ""src/testdir/test_vim9_disassemble.vim"": {""insertions"": 19, ""deletions"": 0, ""lines"": 19}, ""src/version.c"": {""insertions"": 2, ""deletions"": 0, ""lines"": 2}, ""src/vim9.h"": {""insertions"": 1, ""deletions"": 0, ""lines"": 1}, ""src/vim9compile.c"": {""insertions"": 19, ""deletions"": 6, ""lines"": 25}, ""src/vim9execute.c"": {""insertions"": 43, ""deletions"": 15, ""lines"": 58}}"
2021-08-13 16:20:09,89071cb6a116a74f78f77a1853e6fada44872a15,Bram Moolenaar,17,0,17,3,"{""src/list.c"": {""insertions"": 9, ""deletions"": 0, ""lines"": 9}, ""src/testdir/test_listdict.vim"": {""insertions"": 6, ""deletions"": 0, ""lines"": 6}, ""src/version.c"": {""insertions"": 2, ""deletions"": 0, ""lines"": 2}}"
2021-08-13 15:48:25,069f90852f1444cac50491c10dfbd339a3f9e0c8,Bram Moolenaar,8,1,9,3,"{""src/evalfunc.c"": {""insertions"": 1, ""deletions"": 1, ""lines"": 2}, ""src/testdir/test_cmdline.vim"": {""insertions"": 5, ""deletions"": 0, ""lines"": 5}, ""src/version.c"": {""insertions"": 2, ""deletions"": 0, ""lines"": 2}}"
2021-08-12 19:12:56,92f05f21afdb8a43581554a252cb2fc050f9e03b,Bram Moolenaar,26,3,29,3,"{""src/list.c"": {""insertions"": 7, ""deletions"": 3, ""lines"": 10}, ""src/testdir/test_listdict.vim"": {""insertions"": 17, ""deletions"": 0, ""lines"": 17}, ""src/version.c"": {""insertions"": 2, ""deletions"": 0, ""lines"": 2}}"
2021-08-12 17:27:57,ef98257593a0abf1300d0f70358dc45a70a62580,Bram Moolenaar,248,191,439,5,"{""src/dict.c"": {""insertions"": 3, ""deletions"": 2, ""lines"": 5}, ""src/list.c"": {""insertions"": 28, ""deletions"": 23, ""lines"": 51}, ""src/testdir/test_listdict.vim"": {""insertions"": 203, ""deletions"": 164, ""lines"": 367}, ""src/testdir/vim9.vim"": {""insertions"": 12, ""deletions"": 2, ""lines"": 14}, ""src/version.c"": {""insertions"": 2, ""deletions"": 0, ""lines"": 2}}"
2021-08-12 15:06:05,bd77aa92744d79f3ba69aee713739ec17da474f6,Bram Moolenaar,136,98,234,4,"{""src/evalfunc.c"": {""insertions"": 2, ""deletions"": 1, ""lines"": 3}, ""src/testdir/test_listdict.vim"": {""insertions"": 131, ""deletions"": 96, ""lines"": 227}, ""src/version.c"": {""insertions"": 2, ""deletions"": 0, ""lines"": 2}, ""src/vim9compile.c"": {""insertions"": 1, ""deletions"": 1, ""lines"": 2}}"
2021-08-12 08:39:10,3e9c0b9608736e7d888f3141443f8754143364d7,Bram Moolenaar,41,6,47,3,"{""src/testdir/test_listdict.vim"": {""insertions"": 13, ""deletions"": 0, ""lines"": 13}, ""src/testdir/vim9.vim"": {""insertions"": 26, ""deletions"": 6, ""lines"": 32}, ""src/version.c"": {""insertions"": 2, ""deletions"": 0, ""lines"": 2}}"
2021-08-11 19:49:23,4f0884d6e24d1d45ec83fd86b372b403177d3298,Bram Moolenaar,261,106,367,9,"{""src/eval.c"": {""insertions"": 9, ""deletions"": 89, ""lines"": 98}, ""src/list.c"": {""insertions"": 152, ""deletions"": 0, ""lines"": 152}, ""src/proto/eval.pro"": {""insertions"": 1, ""deletions"": 0, ""lines"": 1}, ""src/proto/list.pro"": {""insertions"": 3, ""deletions"": 0, ""lines"": 3}, ""src/testdir/test_listdict.vim"": {""insertions"": 8, ""deletions"": 5, ""lines"": 13}, ""src/testdir/test_vim9_assign.vim"": {""insertions"": 1, ""deletions"": 1, ""lines"": 2}, ""src/version.c"": {""insertions"": 2, ""deletions"": 0, ""lines"": 2}, ""src/vim9compile.c"": {""insertions"": 32, ""deletions"": 3, ""lines"": 35}, ""src/vim9execute.c"": {""insertions"": 53, ""deletions"": 8, ""lines"": 61}}"
2021-08-11 15:13:54,ed7cb2df35244e40e5c4df06169b50e705427576,Bram Moolenaar,6,3,9,2,"{""src/version.c"": {""insertions"": 2, ""deletions"": 0, ""lines"": 2}, ""src/viminfo.c"": {""insertions"": 4, ""deletions"": 3, ""lines"": 7}}"
2021-08-11 15:01:45,7deb4115ef72c0468cd6f9cc5f036d5c405641d4,Bram Moolenaar,3,0,3,2,"{""src/tag.c"": {""insertions"": 1, ""deletions"": 0, ""lines"": 1}, ""src/version.c"": {""insertions"": 2, ""deletions"": 0, ""lines"": 2}}"
2021-08-11 14:47:26,16e63e6d353c8b7337470644ceac02dc5e569db9,Bram Moolenaar,3,0,3,2,"{""src/typval.c"": {""insertions"": 1, ""deletions"": 0, ""lines"": 1}, ""src/version.c"": {""insertions"": 2, ""deletions"": 0, ""lines"": 2}}"
2021-08-11 13:54:59,b85d3627d9a7b41d603c58a16d0ddbf6b88beeaf,Bram Moolenaar,5,1,6,2,"{""src/spellfile.c"": {""insertions"": 3, ""deletions"": 1, ""lines"": 4}, ""src/version.c"": {""insertions"": 2, ""deletions"": 0, ""lines"": 2}}"
2021-08-11 12:20:05,ba9c23e77655766f6c59de8be732b7577f795ed3,Zdenek Dohnal,29,19,48,2,"{""src/os_unix.c"": {""insertions"": 27, ""deletions"": 19, ""lines"": 46}, ""src/version.c"": {""insertions"": 2, ""deletions"": 0, ""lines"": 2}}"
2021-08-10 20:52:02,6e48b84c5f08a7e192817aca0d8278ea2ff82bc7,Bram Moolenaar,32,3,35,4,"{""src/testdir/test_vim9_disassemble.vim"": {""insertions"": 1, ""deletions"": 0, ""lines"": 1}, ""src/testdir/test_vim9_func.vim"": {""insertions"": 21, ""deletions"": 0, ""lines"": 21}, ""src/version.c"": {""insertions"": 2, ""deletions"": 0, ""lines"": 2}, ""src/vim9compile.c"": {""insertions"": 8, ""deletions"": 3, ""lines"": 11}}"
2021-08-10 19:39:20,52eb372a04dfc5d5afef238c1b3c4a8e92020837,Bram Moolenaar,6,1,7,2,"{""src/testdir/test_digraph.vim"": {""insertions"": 4, ""deletions"": 1, ""lines"": 5}, ""src/version.c"": {""insertions"": 2, ""deletions"": 0, ""lines"": 2}}"
2021-08-10 17:53:01,917c46abe559f3d779ad87500e874376111ca1ef,Bram Moolenaar,34,16,50,6,"{""src/ex_docmd.c"": {""insertions"": 6, ""deletions"": 4, ""lines"": 10}, ""src/ex_eval.c"": {""insertions"": 6, ""deletions"": 6, ""lines"": 12}, ""src/proto/ex_docmd.pro"": {""insertions"": 3, ""deletions"": 3, ""lines"": 6}, ""src/testdir/test_vim9_cmd.vim"": {""insertions"": 16, ""deletions"": 2, ""lines"": 18}, ""src/version.c"": {""insertions"": 2, ""deletions"": 0, ""lines"": 2}, ""src/vim9compile.c"": {""insertions"": 1, ""deletions"": 1, ""lines"": 2}}"
2021-08-10 08:23:27,b6f55bb5b4d7d03cdf47d552db20d06e41354d5f,Bram Moolenaar,3,1,4,2,"{""runtime/doc/eval.txt"": {""insertions"": 1, ""deletions"": 1, ""lines"": 2}, ""src/version.c"": {""insertions"": 2, ""deletions"": 0, ""lines"": 2}}"
2021-08-09 20:22:27,b56c4419d42e024e79b1772c8468c0da7c11275f,Bram Moolenaar,20,2,22,3,"{""src/testdir/test_vim9_builtin.vim"": {""insertions"": 12, ""deletions"": 0, ""lines"": 12}, ""src/version.c"": {""insertions"": 2, ""deletions"": 0, ""lines"": 2}, ""src/vim9type.c"": {""insertions"": 6, ""deletions"": 2, ""lines"": 8}}"
2021-08-09 19:04:44,bd9e7961256ea6a98bd5a7bfe14e32c4c47186e6,Dominique Pelle,46,0,46,3,"{""src/testdir/test_excmd.vim"": {""insertions"": 36, ""deletions"": 0, ""lines"": 36}, ""src/testdir/test_writefile.vim"": {""insertions"": 8, ""deletions"": 0, ""lines"": 8}, ""src/version.c"": {""insertions"": 2, ""deletions"": 0, ""lines"": 2}}"
2021-08-09 17:59:06,8ee52affe7fd4daa03e002bc06611f0a8c3bcd5b,Yegappan Lakshmanan,1303,1327,2630,31,"{""src/alloc.c"": {""insertions"": 9, ""deletions"": 15, ""lines"": 24}, ""src/channel.c"": {""insertions"": 1, ""deletions"": 1, ""lines"": 2}, ""src/dict.c"": {""insertions"": 1, ""deletions"": 1, ""lines"": 2}, ""src/digraph.c"": {""insertions"": 2, ""deletions"": 2, ""lines"": 4}, ""src/edit.c"": {""insertions"": 1, ""deletions"": 1, ""lines"": 2}, ""src/ex_docmd.c"": {""insertions"": 1, ""deletions"": 1, ""lines"": 2}, ""src/getchar.c"": {""insertions"": 1, ""deletions"": 1, ""lines"": 2}, ""src/job.c"": {""insertions"": 1, ""deletions"": 1, ""lines"": 2}, ""src/list.c"": {""insertions"": 1, ""deletions"": 1, ""lines"": 2}, ""src/message.c"": {""insertions"": 0, ""deletions"": 1110, ""lines"": 1110}, ""src/profiler.c"": {""insertions"": 18, ""deletions"": 18, ""lines"": 36}, ""src/proto/channel.pro"": {""insertions"": 0, ""deletions"": 1, ""lines"": 1}, ""src/proto/dict.pro"": {""insertions"": 0, ""deletions"": 1, ""lines"": 1}, ""src/proto/digraph.pro"": {""insertions"": 0, ""deletions"": 2, ""lines"": 2}, ""src/proto/edit.pro"": {""insertions"": 0, ""deletions"": 1, ""lines"": 1}, ""src/proto/ex_docmd.pro"": {""insertions"": 0, ""deletions"": 1, ""lines"": 1}, ""src/proto/getchar.pro"": {""insertions"": 0, ""deletions"": 1, ""lines"": 1}, ""src/proto/job.pro"": {""insertions"": 0, ""deletions"": 1, ""lines"": 1}, ""src/proto/list.pro"": {""insertions"": 0, ""deletions"": 1, ""lines"": 1}, ""src/proto/profiler.pro"": {""insertions"": 0, ""deletions"": 1, ""lines"": 1}, ""src/proto/spell.pro"": {""insertions"": 0, ""deletions"": 1, ""lines"": 1}, ""src/proto/vim9compile.pro"": {""insertions"": 0, ""deletions"": 2, ""lines"": 2}, ""src/proto/vim9script.pro"": {""insertions"": 0, ""deletions"": 2, ""lines"": 2}, ""src/proto/vim9type.pro"": {""insertions"": 0, ""deletions"": 1, ""lines"": 1}, ""src/spell.c"": {""insertions"": 1, ""deletions"": 1, ""lines"": 2}, ""src/strings.c"": {""insertions"": 1114, ""deletions"": 8, ""lines"": 1122}, ""src/version.c"": {""insertions"": 2, ""deletions"": 0, ""lines"": 2}, ""src/vim9compile.c"": {""insertions"": 2, ""deletions"": 2, ""lines"": 4}, ""src/vim9script.c"": {""insertions"": 146, ""deletions"": 146, ""lines"": 292}, ""src/vim9type.c"": {""insertions"": 1, ""deletions"": 1, ""lines"": 2}, ""src/window.c"": {""insertions"": 1, ""deletions"": 1, ""lines"": 2}}"
2021-08-09 11:20:38,eed9616120f60ad17d5e133f505bba5c559aee89,James McCoy,4,2,6,2,"{"".github/workflows/coverity.yml"": {""insertions"": 2, ""deletions"": 2, ""lines"": 4}, ""src/version.c"": {""insertions"": 2, ""deletions"": 0, ""lines"": 2}}"
2021-08-08 17:56:28,ed8b099fd23b20d7b5a436182bde6672c8686189,Bram Moolenaar,7,1,8,3,"{""src/testdir/test_float_func.vim"": {""insertions"": 4, ""deletions"": 0, ""lines"": 4}, ""src/typval.c"": {""insertions"": 1, ""deletions"": 1, ""lines"": 2}, ""src/version.c"": {""insertions"": 2, ""deletions"": 0, ""lines"": 2}}"
2021-08-08 17:07:37,33ea9fd4d849324f1e958cc669987a51cf0baded,Bram Moolenaar,31,1,32,3,"{""src/testdir/test_vim9_func.vim"": {""insertions"": 21, ""deletions"": 0, ""lines"": 21}, ""src/userfunc.c"": {""insertions"": 8, ""deletions"": 1, ""lines"": 9}, ""src/version.c"": {""insertions"": 2, ""deletions"": 0, ""lines"": 2}}"
2021-08-08 13:51:10,80a070c36125662556232ab6e83da373e22953d8,Bram Moolenaar,3,1,4,2,"{""src/evalfunc.c"": {""insertions"": 1, ""deletions"": 1, ""lines"": 2}, ""src/version.c"": {""insertions"": 2, ""deletions"": 0, ""lines"": 2}}"
2021-08-08 13:43:34,2950065e18649d234b16e60dd0e3d75adeca4513,Bram Moolenaar,72,10,82,7,"{""src/float.c"": {""insertions"": 32, ""deletions"": 2, ""lines"": 34}, ""src/json.c"": {""insertions"": 3, ""deletions"": 2, ""lines"": 5}, ""src/proto/float.pro"": {""insertions"": 1, ""deletions"": 1, ""lines"": 2}, ""src/testdir/test_float_func.vim"": {""insertions"": 16, ""deletions"": 1, ""lines"": 17}, ""src/typval.c"": {""insertions"": 17, ""deletions"": 3, ""lines"": 20}, ""src/version.c"": {""insertions"": 2, ""deletions"": 0, ""lines"": 2}, ""src/viminfo.c"": {""insertions"": 1, ""deletions"": 1, ""lines"": 2}}"
2021-08-08 12:43:22,267359902c8792fed13543ddeb56c6df0ae74957,Bram Moolenaar,78,25,103,7,"{""runtime/doc/eval.txt"": {""insertions"": 30, ""deletions"": 12, ""lines"": 42}, ""runtime/doc/usr_41.txt"": {""insertions"": 1, ""deletions"": 0, ""lines"": 1}, ""src/errors.h"": {""insertions"": 4, ""deletions"": 0, ""lines"": 4}, ""src/evalfunc.c"": {""insertions"": 9, ""deletions"": 0, ""lines"": 9}, ""src/testdir/test_vim9_builtin.vim"": {""insertions"": 24, ""deletions"": 9, ""lines"": 33}, ""src/version.c"": {""insertions"": 2, ""deletions"": 0, ""lines"": 2}, ""src/vim9compile.c"": {""insertions"": 8, ""deletions"": 4, ""lines"": 12}}"
2021-08-07 20:35:52,9e2fa4bb9eb40a78a1ae1f67a4064651b5ce0aac,gmntroll,6,23,29,2,"{""src/version.c"": {""insertions"": 2, ""deletions"": 0, ""lines"": 2}, ""src/window.c"": {""insertions"": 4, ""deletions"": 23, ""lines"": 27}}"
2021-08-07 16:12:40,e525bdda3aa29f0ffcb18d8d16903ebafc2b5881,Bram Moolenaar,12,4,16,3,"{""src/testdir/test_vim9_script.vim"": {""insertions"": 8, ""deletions"": 0, ""lines"": 8}, ""src/version.c"": {""insertions"": 2, ""deletions"": 0, ""lines"": 2}, ""src/vim9compile.c"": {""insertions"": 2, ""deletions"": 4, ""lines"": 6}}"
2021-08-07 15:20:16,dae453f3397a26a53301d7327e6ed43e8b392035,Bram Moolenaar,51,3,54,3,"{""src/testdir/runtest.vim"": {""insertions"": 15, ""deletions"": 2, ""lines"": 17}, ""src/testdir/test_vim9_expr.vim"": {""insertions"": 34, ""deletions"": 1, ""lines"": 35}, ""src/version.c"": {""insertions"": 2, ""deletions"": 0, ""lines"": 2}}"
2021-08-07 14:30:42,4270d8b7626ff8a7006f6a09c89bc446a3f89d1e,Bram Moolenaar,47,12,59,4,"{""src/testdir/test_vim9_assign.vim"": {""insertions"": 16, ""deletions"": 0, ""lines"": 16}, ""src/testdir/test_vim9_disassemble.vim"": {""insertions"": 2, ""deletions"": 2, ""lines"": 4}, ""src/version.c"": {""insertions"": 2, ""deletions"": 0, ""lines"": 2}, ""src/vim9compile.c"": {""insertions"": 27, ""deletions"": 10, ""lines"": 37}}"
2021-08-07 13:50:23,fbeefb1b87b0d52a095c08fee47b62d290bf4c33,Bram Moolenaar,34,5,39,3,"{""src/testdir/test_vim9_expr.vim"": {""insertions"": 13, ""deletions"": 1, ""lines"": 14}, ""src/version.c"": {""insertions"": 2, ""deletions"": 0, ""lines"": 2}, ""src/vim9execute.c"": {""insertions"": 19, ""deletions"": 4, ""lines"": 23}}"
2021-08-07 13:35:36,6ce46b99635877fb0a17c06a6f5625fbc1ffa6f4,Bram Moolenaar,16,2,18,3,"{""src/testdir/test_vim9_func.vim"": {""insertions"": 12, ""deletions"": 0, ""lines"": 12}, ""src/version.c"": {""insertions"": 2, ""deletions"": 0, ""lines"": 2}, ""src/vim9execute.c"": {""insertions"": 2, ""deletions"": 2, ""lines"": 4}}"
2021-08-07 13:05:47,7de62623735d228c8f81f6ac8309fe4922822cb2,Bram Moolenaar,40,10,50,6,"{""src/testdir/test_vim9_disassemble.vim"": {""insertions"": 4, ""deletions"": 0, ""lines"": 4}, ""src/testdir/test_vim9_script.vim"": {""insertions"": 9, ""deletions"": 2, ""lines"": 11}, ""src/version.c"": {""insertions"": 2, ""deletions"": 0, ""lines"": 2}, ""src/vim9.h"": {""insertions"": 5, ""deletions"": 4, ""lines"": 9}, ""src/vim9compile.c"": {""insertions"": 5, ""deletions"": 1, ""lines"": 6}, ""src/vim9execute.c"": {""insertions"": 15, ""deletions"": 3, ""lines"": 18}}"
2021-08-07 11:59:43,1b154ea121d8374a129c3e30d50fa9742cd5faa1,Bram Moolenaar,10,3,13,2,"{""src/autocmd.c"": {""insertions"": 8, ""deletions"": 3, ""lines"": 11}, ""src/version.c"": {""insertions"": 2, ""deletions"": 0, ""lines"": 2}}"
2021-08-07 11:26:53,84934998806408db3f3ecff7ac4c3980e0c2a96e,rbtnn,57,37,94,4,"{""src/ex_eval.c"": {""insertions"": 2, ""deletions"": 1, ""lines"": 3}, ""src/testdir/test_vim9_script.vim"": {""insertions"": 14, ""deletions"": 0, ""lines"": 14}, ""src/version.c"": {""insertions"": 2, ""deletions"": 0, ""lines"": 2}, ""src/vim9compile.c"": {""insertions"": 39, ""deletions"": 36, ""lines"": 75}}"
2021-08-07 11:08:45,c611941c606328740b6e9acc1191a5d97ace13e2,rbtnn,5,3,8,4,"{""src/popupwin.c"": {""insertions"": 1, ""deletions"": 1, ""lines"": 2}, ""src/testdir/dumps/Test_popupwin_multibytetitle.dump"": {""insertions"": 1, ""deletions"": 1, ""lines"": 2}, ""src/testdir/test_popupwin.vim"": {""insertions"": 1, ""deletions"": 1, ""lines"": 2}, ""src/version.c"": {""insertions"": 2, ""deletions"": 0, ""lines"": 2}}"
2021-08-07 10:44:41,3276f5846f7ad61f55175959ac21c1b4cf595352,Dominique Pelle,14,12,26,4,"{""src/structs.h"": {""insertions"": 8, ""deletions"": 8, ""lines"": 16}, ""src/version.c"": {""insertions"": 2, ""deletions"": 0, ""lines"": 2}, ""src/vim9.h"": {""insertions"": 3, ""deletions"": 3, ""lines"": 6}, ""src/vim9execute.c"": {""insertions"": 1, ""deletions"": 1, ""lines"": 2}}"
2021-08-07 10:32:20,d57a6bd98c9a57b766eadcc3f10e9c4169c788aa,Bram Moolenaar,83,0,83,3,"{"".github/workflows/coverity.yml"": {""insertions"": 80, ""deletions"": 0, ""lines"": 80}, ""Filelist"": {""insertions"": 1, ""deletions"": 0, ""lines"": 1}, ""src/version.c"": {""insertions"": 2, ""deletions"": 0, ""lines"": 2}}"
2021-08-06 19:51:55,cbae5802832b29f3a1af4cb6b0fc8cf69f17cbf4,Yegappan Lakshmanan,938,884,1822,13,"{""Filelist"": {""insertions"": 2, ""deletions"": 0, ""lines"": 2}, ""src/Make_ami.mak"": {""insertions"": 1, ""deletions"": 0, ""lines"": 1}, ""src/Make_cyg_ming.mak"": {""insertions"": 1, ""deletions"": 0, ""lines"": 1}, ""src/Make_mvc.mak"": {""insertions"": 4, ""deletions"": 0, ""lines"": 4}, ""src/Make_vms.mms"": {""insertions"": 5, ""deletions"": 0, ""lines"": 5}, ""src/Makefile"": {""insertions"": 10, ""deletions"": 0, ""lines"": 10}, ""src/README.md"": {""insertions"": 1, ""deletions"": 0, ""lines"": 1}, ""src/alloc.c"": {""insertions"": 872, ""deletions"": 0, ""lines"": 872}, ""src/misc2.c"": {""insertions"": 9, ""deletions"": 857, ""lines"": 866}, ""src/proto.h"": {""insertions"": 1, ""deletions"": 0, ""lines"": 1}, ""src/proto/alloc.pro"": {""insertions"": 29, ""deletions"": 0, ""lines"": 29}, ""src/proto/misc2.pro"": {""insertions"": 1, ""deletions"": 27, ""lines"": 28}, ""src/version.c"": {""insertions"": 2, ""deletions"": 0, ""lines"": 2}}"
2021-08-06 19:34:38,11328bc7df0ecc47f4025a10bb86882a659e9994,Yegappan Lakshmanan,124,5,129,7,"{""runtime/doc/if_lua.txt"": {""insertions"": 14, ""deletions"": 1, ""lines"": 15}, ""src/evalfunc.c"": {""insertions"": 42, ""deletions"": 0, ""lines"": 42}, ""src/if_lua.c"": {""insertions"": 31, ""deletions"": 3, ""lines"": 34}, ""src/proto/evalfunc.pro"": {""insertions"": 1, ""deletions"": 0, ""lines"": 1}, ""src/testdir/test_lua.vim"": {""insertions"": 32, ""deletions"": 0, ""lines"": 32}, ""src/testdir/test_shell.vim"": {""insertions"": 2, ""deletions"": 1, ""lines"": 3}, ""src/version.c"": {""insertions"": 2, ""deletions"": 0, ""lines"": 2}}"
2021-08-05 20:48:11,5671f3f076573fa9133bc210d6580067698d9a1b,Bram Moolenaar,34,3,37,4,"{""src/evalfunc.c"": {""insertions"": 7, ""deletions"": 0, ""lines"": 7}, ""src/testdir/test_vim9_builtin.vim"": {""insertions"": 23, ""deletions"": 1, ""lines"": 24}, ""src/version.c"": {""insertions"": 2, ""deletions"": 0, ""lines"": 2}, ""src/vim9compile.c"": {""insertions"": 2, ""deletions"": 2, ""lines"": 4}}"
2021-08-05 19:17:32,6f6d58c3809010b1386634c1aeec61f1a66e72c2,Bram Moolenaar,6,1,7,2,"{""src/ex_docmd.c"": {""insertions"": 4, ""deletions"": 1, ""lines"": 5}, ""src/version.c"": {""insertions"": 2, ""deletions"": 0, ""lines"": 2}}"
2021-08-05 18:40:03,63b9173693015b135aad8e3657bef5e7f776787e,Bram Moolenaar,90,36,126,16,"{""runtime/doc/map.txt"": {""insertions"": 5, ""deletions"": 2, ""lines"": 7}, ""src/errors.h"": {""insertions"": 3, ""deletions"": 1, ""lines"": 4}, ""src/eval.c"": {""insertions"": 3, ""deletions"": 3, ""lines"": 6}, ""src/evalvars.c"": {""insertions"": 2, ""deletions"": 2, ""lines"": 4}, ""src/ex_cmds.c"": {""insertions"": 2, ""deletions"": 2, ""lines"": 4}, ""src/ex_docmd.c"": {""insertions"": 28, ""deletions"": 11, ""lines"": 39}, ""src/ex_eval.c"": {""insertions"": 12, ""deletions"": 0, ""lines"": 12}, ""src/proto/ex_docmd.pro"": {""insertions"": 1, ""deletions"": 0, ""lines"": 1}, ""src/proto/ex_eval.pro"": {""insertions"": 1, ""deletions"": 0, ""lines"": 1}, ""src/syntax.c"": {""insertions"": 7, ""deletions"": 7, ""lines"": 14}, ""src/testdir/test_autocmd.vim"": {""insertions"": 8, ""deletions"": 0, ""lines"": 8}, ""src/testdir/test_usercommands.vim"": {""insertions"": 8, ""deletions"": 0, ""lines"": 8}, ""src/userfunc.c"": {""insertions"": 6, ""deletions"": 6, ""lines"": 12}, ""src/version.c"": {""insertions"": 2, ""deletions"": 0, ""lines"": 2}, ""src/vim9compile.c"": {""insertions"": 1, ""deletions"": 1, ""lines"": 2}, ""src/vim9script.c"": {""insertions"": 1, ""deletions"": 1, ""lines"": 2}}"
2021-08-05 17:01:17,af647e76cacc60d3cfc5df3ff5b3d9d4b69b519d,Bram Moolenaar,23,2,25,3,"{""src/testdir/test_vim9_assign.vim"": {""insertions"": 17, ""deletions"": 0, ""lines"": 17}, ""src/version.c"": {""insertions"": 2, ""deletions"": 0, ""lines"": 2}, ""src/vim9compile.c"": {""insertions"": 4, ""deletions"": 2, ""lines"": 6}}"
2021-08-05 15:57:02,4f33bc20d7d5444e44d13f954e8219ad1abd26ef,zeertzjq,268,19,287,14,"{""src/drawline.c"": {""insertions"": 13, ""deletions"": 19, ""lines"": 32}, ""src/testdir/dumps/Test_Xcursorline_19.dump"": {""insertions"": 20, ""deletions"": 0, ""lines"": 20}, ""src/testdir/dumps/Test_Xcursorline_20.dump"": {""insertions"": 20, ""deletions"": 0, ""lines"": 20}, ""src/testdir/dumps/Test_Xcursorline_21.dump"": {""insertions"": 20, ""deletions"": 0, ""lines"": 20}, ""src/testdir/dumps/Test_Xcursorline_22.dump"": {""insertions"": 20, ""deletions"": 0, ""lines"": 20}, ""src/testdir/dumps/Test_Xcursorline_23.dump"": {""insertions"": 20, ""deletions"": 0, ""lines"": 20}, ""src/testdir/dumps/Test_Xcursorline_24.dump"": {""insertions"": 20, ""deletions"": 0, ""lines"": 20}, ""src/testdir/dumps/Test_diff_with_cul_bri_01.dump"": {""insertions"": 20, ""deletions"": 0, ""lines"": 20}, ""src/testdir/dumps/Test_diff_with_cul_bri_02.dump"": {""insertions"": 20, ""deletions"": 0, ""lines"": 20}, ""src/testdir/dumps/Test_diff_with_cul_bri_03.dump"": {""insertions"": 20, ""deletions"": 0, ""lines"": 20}, ""src/testdir/dumps/Test_diff_with_cul_bri_04.dump"": {""insertions"": 20, ""deletions"": 0, ""lines"": 20}, ""src/testdir/test_cursorline.vim"": {""insertions"": 22, ""deletions"": 0, ""lines"": 22}, ""src/testdir/test_diffmode.vim"": {""insertions"": 31, ""deletions"": 0, ""lines"": 31}, ""src/version.c"": {""insertions"": 2, ""deletions"": 0, ""lines"": 2}}"
2021-08-05 14:47:08,1b6acf02b7e685ecb87ccba52c91835a7519073e,Bram Moolenaar,11,1,12,2,"{""src/if_lua.c"": {""insertions"": 9, ""deletions"": 1, ""lines"": 10}, ""src/version.c"": {""insertions"": 2, ""deletions"": 0, ""lines"": 2}}"
2021-08-05 14:23:27,6a230c6b32695393785ae64b440ce5f023a22382,Andy Gozas,82,1,83,4,"{""src/insexpand.c"": {""insertions"": 27, ""deletions"": 1, ""lines"": 28}, ""src/testdir/Make_all.mak"": {""insertions"": 2, ""deletions"": 0, ""lines"": 2}, ""src/testdir/test_ins_complete_no_halt.vim"": {""insertions"": 51, ""deletions"": 0, ""lines"": 51}, ""src/version.c"": {""insertions"": 2, ""deletions"": 0, ""lines"": 2}}"
2021-08-05 13:24:59,bc67e5a0a494f5fc48e872d747371e31a782d171,Christian Brabandt,16,1,17,3,"{""src/search.c"": {""insertions"": 3, ""deletions"": 1, ""lines"": 4}, ""src/testdir/test_search.vim"": {""insertions"": 11, ""deletions"": 0, ""lines"": 11}, ""src/version.c"": {""insertions"": 2, ""deletions"": 0, ""lines"": 2}}"
2021-08-05 13:11:08,4a01159da23a279005b7c5042a15af47eb9617fe,Bram Moolenaar,8,1,9,3,"{""src/if_lua.c"": {""insertions"": 2, ""deletions"": 1, ""lines"": 3}, ""src/testdir/test_lua.vim"": {""insertions"": 4, ""deletions"": 0, ""lines"": 4}, ""src/version.c"": {""insertions"": 2, ""deletions"": 0, ""lines"": 2}}"
2021-08-04 20:30:52,9fe17d473a6041e2ea85229f4fa09831d910def4,Zdenek Dohnal,23,13,36,2,"{""src/version.c"": {""insertions"": 2, ""deletions"": 0, ""lines"": 2}, ""src/vim9compile.c"": {""insertions"": 21, ""deletions"": 13, ""lines"": 34}}"
2021-08-04 19:16:50,f18e8a969a3414ed5e6b7159c40fe43963021ff3,Bram Moolenaar,10,1,11,2,"{""src/version.c"": {""insertions"": 2, ""deletions"": 0, ""lines"": 2}, ""src/window.c"": {""insertions"": 8, ""deletions"": 1, ""lines"": 9}}"
2021-08-04 19:12:52,9dc4bef897a37a610a28d69cee6d30749db61296,Yegappan Lakshmanan,414,0,414,4,"{""runtime/doc/if_lua.txt"": {""insertions"": 32, ""deletions"": 0, ""lines"": 32}, ""src/if_lua.c"": {""insertions"": 138, ""deletions"": 0, ""lines"": 138}, ""src/testdir/test_lua.vim"": {""insertions"": 242, ""deletions"": 0, ""lines"": 242}, ""src/version.c"": {""insertions"": 2, ""deletions"": 0, ""lines"": 2}}"
2021-08-04 18:54:55,57942237c1d54d8a236b43c56dc2b002339eb394,Bram Moolenaar,65,14,79,3,"{""src/testdir/test_channel.vim"": {""insertions"": 29, ""deletions"": 0, ""lines"": 29}, ""src/version.c"": {""insertions"": 2, ""deletions"": 0, ""lines"": 2}, ""src/window.c"": {""insertions"": 34, ""deletions"": 14, ""lines"": 48}}"
2021-08-04 18:26:19,d61f2f772a59617850e9aa2f5fa069c1aad8e074,Bram Moolenaar,28,20,48,2,"{""src/version.c"": {""insertions"": 2, ""deletions"": 0, ""lines"": 2}, ""src/window.c"": {""insertions"": 26, ""deletions"": 20, ""lines"": 46}}"
2021-08-04 18:00:27,dd097bdc1376e4ca2cfd4a4d64021b6ba0df4bed,Gregory Anders,6,0,6,3,"{""runtime/filetype.vim"": {""insertions"": 3, ""deletions"": 0, ""lines"": 3}, ""src/testdir/test_filetype.vim"": {""insertions"": 1, ""deletions"": 0, ""lines"": 1}, ""src/version.c"": {""insertions"": 2, ""deletions"": 0, ""lines"": 2}}"
2021-08-04 17:25:54,80d7395dcfe96158428da6bb3d28a6eee1244e28,Sean Dewar,79,36,115,8,"{""src/blob.c"": {""insertions"": 5, ""deletions"": 2, ""lines"": 7}, ""src/errors.h"": {""insertions"": 2, ""deletions"": 1, ""lines"": 3}, ""src/eval.c"": {""insertions"": 1, ""deletions"": 1, ""lines"": 2}, ""src/list.c"": {""insertions"": 32, ""deletions"": 28, ""lines"": 60}, ""src/proto/blob.pro"": {""insertions"": 1, ""deletions"": 1, ""lines"": 2}, ""src/testdir/test_blob.vim"": {""insertions"": 33, ""deletions"": 0, ""lines"": 33}, ""src/testdir/test_eval_stuff.vim"": {""insertions"": 3, ""deletions"": 3, ""lines"": 6}, ""src/version.c"": {""insertions"": 2, ""deletions"": 0, ""lines"": 2}}"
2021-08-04 15:03:59,0eec8519424eaea7baebfda979c33dd609a4e3fa,Christian Clason,7,0,7,3,"{""runtime/filetype.vim"": {""insertions"": 3, ""deletions"": 0, ""lines"": 3}, ""src/testdir/test_filetype.vim"": {""insertions"": 2, ""deletions"": 0, ""lines"": 2}, ""src/version.c"": {""insertions"": 2, ""deletions"": 0, ""lines"": 2}}"
2021-08-04 14:09:24,41a3485dd638a09e4c463b1a1da231f4290454f2,Bram Moolenaar,7,4,11,3,"{""src/errors.h"": {""insertions"": 2, ""deletions"": 2, ""lines"": 4}, ""src/usercmd.c"": {""insertions"": 3, ""deletions"": 2, ""lines"": 5}, ""src/version.c"": {""insertions"": 2, ""deletions"": 0, ""lines"": 2}}"
2021-08-03 19:16:18,23e2e115154ef0bf05d809024eed328a46ed0f82,Bram Moolenaar,8,21,29,4,"{""src/testdir/test_vim9_assign.vim"": {""insertions"": 2, ""deletions"": 14, ""lines"": 16}, ""src/testdir/test_vim9_func.vim"": {""insertions"": 2, ""deletions"": 3, ""lines"": 5}, ""src/testdir/test_vim9_script.vim"": {""insertions"": 2, ""deletions"": 4, ""lines"": 6}, ""src/version.c"": {""insertions"": 2, ""deletions"": 0, ""lines"": 2}}"
2021-08-03 16:33:08,51ad850f5fbafa7aa3f60affa74ec9c9f992c6cc,Gary Johnson,56,37,93,10,"{""runtime/doc/options.txt"": {""insertions"": 1, ""deletions"": 1, ""lines"": 2}, ""src/buffer.c"": {""insertions"": 0, ""deletions"": 1, ""lines"": 1}, ""src/drawscreen.c"": {""insertions"": 3, ""deletions"": 3, ""lines"": 6}, ""src/ops.c"": {""insertions"": 5, ""deletions"": 5, ""lines"": 10}, ""src/option.c"": {""insertions"": 11, ""deletions"": 9, ""lines"": 20}, ""src/option.h"": {""insertions"": 2, ""deletions"": 2, ""lines"": 4}, ""src/optionstr.c"": {""insertions"": 2, ""deletions"": 3, ""lines"": 5}, ""src/structs.h"": {""insertions"": 4, ""deletions"": 2, ""lines"": 6}, ""src/testdir/test_virtualedit.vim"": {""insertions"": 26, ""deletions"": 11, ""lines"": 37}, ""src/version.c"": {""insertions"": 2, ""deletions"": 0, ""lines"": 2}}"
2021-08-02 20:26:56,2c70711e3fb2ef24a7f55322fdadbf7f9e657c2f,Bram Moolenaar,17,2,19,3,"{""src/ex_cmds.h"": {""insertions"": 1, ""deletions"": 1, ""lines"": 2}, ""src/testdir/test_vim9_cmd.vim"": {""insertions"": 14, ""deletions"": 1, ""lines"": 15}, ""src/version.c"": {""insertions"": 2, ""deletions"": 0, ""lines"": 2}}"
2021-08-02 19:55:15,7bf9a07bd7d6264f623109c2896b2a4002c86080,Bram Moolenaar,10,1,11,3,"{""src/testdir/test_vim9_assign.vim"": {""insertions"": 6, ""deletions"": 0, ""lines"": 6}, ""src/version.c"": {""insertions"": 2, ""deletions"": 0, ""lines"": 2}, ""src/vim9compile.c"": {""insertions"": 2, ""deletions"": 1, ""lines"": 3}}"
2021-08-02 19:12:05,c3160727b940b762e18fd9431416dc1a4a081c3a,Bram Moolenaar,7,4,11,2,"{""src/version.c"": {""insertions"": 2, ""deletions"": 0, ""lines"": 2}, ""src/vim9compile.c"": {""insertions"": 5, ""deletions"": 4, ""lines"": 9}}"
2021-08-02 18:06:50,bb7ee7abe1ea1e60b8a5dadd2bed8cdbe4f3e8fb,Bram Moolenaar,34,6,40,5,"{""src/evalfunc.c"": {""insertions"": 1, ""deletions"": 2, ""lines"": 3}, ""src/proto/evalfunc.pro"": {""insertions"": 1, ""deletions"": 0, ""lines"": 1}, ""src/testdir/test_vim9_builtin.vim"": {""insertions"": 19, ""deletions"": 0, ""lines"": 19}, ""src/version.c"": {""insertions"": 2, ""deletions"": 0, ""lines"": 2}, ""src/vim9compile.c"": {""insertions"": 11, ""deletions"": 4, ""lines"": 15}}"
2021-08-02 17:10:38,35578168becd1e11973bec413f2078a4bf81ba6b,Bram Moolenaar,64,61,125,5,"{""src/arglist.c"": {""insertions"": 3, ""deletions"": 3, ""lines"": 6}, ""src/macros.h"": {""insertions"": 4, ""deletions"": 2, ""lines"": 6}, ""src/version.c"": {""insertions"": 2, ""deletions"": 0, ""lines"": 2}, ""src/vim9compile.c"": {""insertions"": 21, ""deletions"": 21, ""lines"": 42}, ""src/vim9execute.c"": {""insertions"": 34, ""deletions"": 35, ""lines"": 69}}"
2021-08-02 16:07:18,952d9d827e5bfc66a6b1d39956e4e5596b09e2bd,Bram Moolenaar,38,67,105,11,"{""src/channel.c"": {""insertions"": 1, ""deletions"": 5, ""lines"": 6}, ""src/gui_xim.c"": {""insertions"": 3, ""deletions"": 1, ""lines"": 4}, ""src/if_mzsch.c"": {""insertions"": 1, ""deletions"": 1, ""lines"": 2}, ""src/nbdebug.c"": {""insertions"": 1, ""deletions"": 1, ""lines"": 2}, ""src/nbdebug.h"": {""insertions"": 1, ""deletions"": 5, ""lines"": 6}, ""src/netbeans.c"": {""insertions"": 1, ""deletions"": 1, ""lines"": 2}, ""src/proto.h"": {""insertions"": 12, ""deletions"": 42, ""lines"": 54}, ""src/term.c"": {""insertions"": 1, ""deletions"": 1, ""lines"": 2}, ""src/version.c"": {""insertions"": 2, ""deletions"": 0, ""lines"": 2}, ""src/vim.h"": {""insertions"": 15, ""deletions"": 2, ""lines"": 17}, ""src/vim9execute.c"": {""insertions"": 0, ""deletions"": 8, ""lines"": 8}}"
2021-08-01 20:01:30,1321257317b7d28228a6a9a0d612f81f70290b4c,Bram Moolenaar,3,1,4,2,"{""src/userfunc.c"": {""insertions"": 1, ""deletions"": 1, ""lines"": 2}, ""src/version.c"": {""insertions"": 2, ""deletions"": 0, ""lines"": 2}}"
2021-08-01 19:30:12,e041dde7bb9157644fa5135a252c84924b9ea433,Bram Moolenaar,12,4,16,3,"{""src/testdir/test_textprop.vim"": {""insertions"": 9, ""deletions"": 3, ""lines"": 12}, ""src/textprop.c"": {""insertions"": 1, ""deletions"": 1, ""lines"": 2}, ""src/version.c"": {""insertions"": 2, ""deletions"": 0, ""lines"": 2}}"
2021-08-01 19:19:43,e4db17fb6e2d029aa2dddfca703ace9bcf0d85fd,Bram Moolenaar,98,20,118,7,"{""src/ex_docmd.c"": {""insertions"": 1, ""deletions"": 1, ""lines"": 2}, ""src/proto/ex_docmd.pro"": {""insertions"": 1, ""deletions"": 0, ""lines"": 1}, ""src/testdir/test_vim9_script.vim"": {""insertions"": 28, ""deletions"": 0, ""lines"": 28}, ""src/usercmd.c"": {""insertions"": 19, ""deletions"": 16, ""lines"": 35}, ""src/userfunc.c"": {""insertions"": 15, ""deletions"": 2, ""lines"": 17}, ""src/version.c"": {""insertions"": 2, ""deletions"": 0, ""lines"": 2}, ""src/vim9compile.c"": {""insertions"": 32, ""deletions"": 1, ""lines"": 33}}"
2021-08-01 17:28:15,0d4d9ee9bb18f89d76c67f037baebe2c2db545f0,Bram Moolenaar,9,6,15,2,"{""src/textprop.c"": {""insertions"": 7, ""deletions"": 6, ""lines"": 13}, ""src/version.c"": {""insertions"": 2, ""deletions"": 0, ""lines"": 2}}"
2021-08-01 13:40:31,f78da4f9d6daf1907e4ce4be74146375dbd9a546,Bram Moolenaar,44,24,68,4,"{""src/evalfunc.c"": {""insertions"": 16, ""deletions"": 10, ""lines"": 26}, ""src/testdir/test_vim9_func.vim"": {""insertions"": 21, ""deletions"": 14, ""lines"": 35}, ""src/version.c"": {""insertions"": 2, ""deletions"": 0, ""lines"": 2}, ""src/vim9type.c"": {""insertions"": 5, ""deletions"": 0, ""lines"": 5}}"
2021-08-01 12:52:32,73b8b0ae3acac220e823076f8ca1c14524ed96dd,Bram Moolenaar,100,50,150,10,"{""runtime/doc/autocmd.txt"": {""insertions"": 6, ""deletions"": 0, ""lines"": 6}, ""runtime/doc/map.txt"": {""insertions"": 4, ""deletions"": 4, ""lines"": 8}, ""src/autocmd.c"": {""insertions"": 20, ""deletions"": 9, ""lines"": 29}, ""src/ex_docmd.c"": {""insertions"": 1, ""deletions"": 1, ""lines"": 2}, ""src/proto/autocmd.pro"": {""insertions"": 1, ""deletions"": 1, ""lines"": 2}, ""src/proto/usercmd.pro"": {""insertions"": 1, ""deletions"": 0, ""lines"": 1}, ""src/testdir/test_autocmd.vim"": {""insertions"": 16, ""deletions"": 0, ""lines"": 16}, ""src/usercmd.c"": {""insertions"": 44, ""deletions"": 35, ""lines"": 79}, ""src/version.c"": {""insertions"": 2, ""deletions"": 0, ""lines"": 2}, ""src/vim.h"": {""insertions"": 5, ""deletions"": 0, ""lines"": 5}}"
2021-08-01 12:08:54,6db660bed9ed5063f8c6e0fadeef32d44bbd017d,Bram Moolenaar,94,30,124,3,"{""src/testdir/test_vim9_disassemble.vim"": {""insertions"": 48, ""deletions"": 0, ""lines"": 48}, ""src/version.c"": {""insertions"": 2, ""deletions"": 0, ""lines"": 2}, ""src/vim9execute.c"": {""insertions"": 44, ""deletions"": 30, ""lines"": 74}}"
2021-08-01 11:17:17,e97976baa7a74fbbe0cfecd1943fe1c5f9dfba4f,Bram Moolenaar,19,5,24,3,"{""src/testdir/test_vim9_assign.vim"": {""insertions"": 6, ""deletions"": 0, ""lines"": 6}, ""src/version.c"": {""insertions"": 2, ""deletions"": 0, ""lines"": 2}, ""src/vim9compile.c"": {""insertions"": 11, ""deletions"": 5, ""lines"": 16}}"
2021-08-01 10:44:37,78ba933d18439ff1a02f6be4c571e73ddceb3cd4,Christian Brabandt,66,1,67,3,"{""src/search.c"": {""insertions"": 10, ""deletions"": 1, ""lines"": 11}, ""src/testdir/test_search.vim"": {""insertions"": 54, ""deletions"": 0, ""lines"": 54}, ""src/version.c"": {""insertions"": 2, ""deletions"": 0, ""lines"": 2}}"
2021-08-01 10:01:49,f24f51d03035379cf3e5b2dccf489a40bc4ca92a,Bram Moolenaar,6,2,8,2,"{""src/eval.c"": {""insertions"": 4, ""deletions"": 2, ""lines"": 6}, ""src/version.c"": {""insertions"": 2, ""deletions"": 0, ""lines"": 2}}"
2021-07-31 20:51:10,f5d52c90e0f2f51622a911b646024b2ad1225ed4,Bram Moolenaar,40,7,47,4,"{""src/testdir/test_vim9_assign.vim"": {""insertions"": 26, ""deletions"": 0, ""lines"": 26}, ""src/testdir/test_vim9_disassemble.vim"": {""insertions"": 1, ""deletions"": 1, ""lines"": 2}, ""src/version.c"": {""insertions"": 2, ""deletions"": 0, ""lines"": 2}, ""src/vim9compile.c"": {""insertions"": 11, ""deletions"": 6, ""lines"": 17}}"
2021-07-31 20:17:28,9e0ee590197d74f94b7127bf0e033e4f83cf3762,Bram Moolenaar,3,2,5,2,"{""src/ex_docmd.c"": {""insertions"": 1, ""deletions"": 2, ""lines"": 3}, ""src/version.c"": {""insertions"": 2, ""deletions"": 0, ""lines"": 2}}"
2021-07-31 20:03:59,1780f08ba42837b6d4a5f0451117a79b2d49974a,Bram Moolenaar,19,4,23,3,"{""src/evalfunc.c"": {""insertions"": 8, ""deletions"": 1, ""lines"": 9}, ""src/testdir/test_vim9_builtin.vim"": {""insertions"": 9, ""deletions"": 3, ""lines"": 12}, ""src/version.c"": {""insertions"": 2, ""deletions"": 0, ""lines"": 2}}"
2021-07-31 19:44:35,335c8c7b206df776b59fb63a1c7f91c8b1425398,Bram Moolenaar,3,1,4,2,"{""src/ex_docmd.c"": {""insertions"": 1, ""deletions"": 1, ""lines"": 2}, ""src/version.c"": {""insertions"": 2, ""deletions"": 0, ""lines"": 2}}"
2021-07-31 19:32:31,620c959c6c00e469c4d3b1ab2e08e4767ee142a4,Bram Moolenaar,78,61,139,4,"{""src/ex_docmd.c"": {""insertions"": 68, ""deletions"": 61, ""lines"": 129}, ""src/indent.c"": {""insertions"": 7, ""deletions"": 0, ""lines"": 7}, ""src/proto/ex_docmd.pro"": {""insertions"": 1, ""deletions"": 0, ""lines"": 1}, ""src/version.c"": {""insertions"": 2, ""deletions"": 0, ""lines"": 2}}"
2021-07-31 17:12:58,78db17c6f335f518752ca221ec6bde79db584e15,Bram Moolenaar,39,37,76,4,"{""src/errors.h"": {""insertions"": 8, ""deletions"": 8, ""lines"": 16}, ""src/testdir/test_vim9_builtin.vim"": {""insertions"": 26, ""deletions"": 26, ""lines"": 52}, ""src/typval.c"": {""insertions"": 3, ""deletions"": 3, ""lines"": 6}, ""src/version.c"": {""insertions"": 2, ""deletions"": 0, ""lines"": 2}}"
2021-07-31 16:33:57,8e3fc135e884a30620fb1c6e84986fae1467acd3,Bram Moolenaar,9,0,9,3,"{""src/testdir/test_textprop.vim"": {""insertions"": 3, ""deletions"": 0, ""lines"": 3}, ""src/textprop.c"": {""insertions"": 4, ""deletions"": 0, ""lines"": 4}, ""src/version.c"": {""insertions"": 2, ""deletions"": 0, ""lines"": 2}}"
2021-07-31 15:20:04,bf634a0a8b64fda2e53d3e2254fe0ffdc3d67196,Bram Moolenaar,5,0,5,2,"{""src/testdir/test_functions.vim"": {""insertions"": 3, ""deletions"": 0, ""lines"": 3}, ""src/version.c"": {""insertions"": 2, ""deletions"": 0, ""lines"": 2}}"
2021-07-31 11:31:42,b9115da4bec5e6cfff69da85cc47c42dd67e42e4,Connor Lane Smith,54,5,59,4,"{""src/search.c"": {""insertions"": 2, ""deletions"": 0, ""lines"": 2}, ""src/testdir/test_textobjects.vim"": {""insertions"": 32, ""deletions"": 0, ""lines"": 32}, ""src/textobject.c"": {""insertions"": 18, ""deletions"": 5, ""lines"": 23}, ""src/version.c"": {""insertions"": 2, ""deletions"": 0, ""lines"": 2}}"
2021-07-31 10:43:23,28d8421bfb3327d7a5e81369977e8fc108b0229e,Yegappan Lakshmanan,32,5,37,5,"{""runtime/doc/eval.txt"": {""insertions"": 4, ""deletions"": 2, ""lines"": 6}, ""src/evalwindow.c"": {""insertions"": 6, ""deletions"": 0, ""lines"": 6}, ""src/misc2.c"": {""insertions"": 3, ""deletions"": 3, ""lines"": 6}, ""src/testdir/test_quickfix.vim"": {""insertions"": 17, ""deletions"": 0, ""lines"": 17}, ""src/version.c"": {""insertions"": 2, ""deletions"": 0, ""lines"": 2}}"
2021-07-30 19:56:10,890ee4e2be1dca0c07a91f836e26baead952ae7c,Bram Moolenaar,7,5,12,3,"{""src/testdir/test_channel.py"": {""insertions"": 5, ""deletions"": 0, ""lines"": 5}, ""src/testdir/test_channel.vim"": {""insertions"": 0, ""deletions"": 5, ""lines"": 5}, ""src/version.c"": {""insertions"": 2, ""deletions"": 0, ""lines"": 2}}"
2021-07-30 19:32:45,4a15504e911bc90a29d862862f0b7a46d8acd12a,Yegappan Lakshmanan,53,59,112,5,"{""src/evalbuffer.c"": {""insertions"": 14, ""deletions"": 21, ""lines"": 35}, ""src/evalfunc.c"": {""insertions"": 0, ""deletions"": 36, ""lines"": 36}, ""src/map.c"": {""insertions"": 35, ""deletions"": 1, ""lines"": 36}, ""src/proto/map.pro"": {""insertions"": 2, ""deletions"": 1, ""lines"": 3}, ""src/version.c"": {""insertions"": 2, ""deletions"": 0, ""lines"": 2}}"
2021-07-30 19:18:03,0f5575d0a7316a9c9a4b02df3372a07514cd8f26,Bram Moolenaar,16,1,17,3,"{""src/term.c"": {""insertions"": 2, ""deletions"": 1, ""lines"": 3}, ""src/testdir/test_termcodes.vim"": {""insertions"": 12, ""deletions"": 0, ""lines"": 12}, ""src/version.c"": {""insertions"": 2, ""deletions"": 0, ""lines"": 2}}"
2021-07-30 18:51:59,1790be6cb6f2edfd8a833dd848b8df02cef599cf,Christian Brabandt,3,1,4,2,"{""src/Make_mvc.mak"": {""insertions"": 1, ""deletions"": 1, ""lines"": 2}, ""src/version.c"": {""insertions"": 2, ""deletions"": 0, ""lines"": 2}}"
2021-07-29 20:48:54,60dc8274e9f8c6a20d54efebc7a8752fe062eead,Bram Moolenaar,26,10,36,8,"{""src/eval.c"": {""insertions"": 1, ""deletions"": 1, ""lines"": 2}, ""src/proto/vim9type.pro"": {""insertions"": 1, ""deletions"": 1, ""lines"": 2}, ""src/testdir/test_vim9_script.vim"": {""insertions"": 6, ""deletions"": 0, ""lines"": 6}, ""src/version.c"": {""insertions"": 2, ""deletions"": 0, ""lines"": 2}, ""src/vim.h"": {""insertions"": 3, ""deletions"": 0, ""lines"": 3}, ""src/vim9execute.c"": {""insertions"": 1, ""deletions"": 1, ""lines"": 2}, ""src/vim9script.c"": {""insertions"": 3, ""deletions"": 2, ""lines"": 5}, ""src/vim9type.c"": {""insertions"": 9, ""deletions"": 5, ""lines"": 14}}"
2021-07-29 20:25:05,921ba529266c8dfc0809d41e1f084e26d25fffb1,Bram Moolenaar,16,0,16,3,"{""src/testdir/test_vim9_script.vim"": {""insertions"": 10, ""deletions"": 0, ""lines"": 10}, ""src/version.c"": {""insertions"": 2, ""deletions"": 0, ""lines"": 2}, ""src/vim9script.c"": {""insertions"": 4, ""deletions"": 0, ""lines"": 4}}"
2021-07-29 19:23:50,77ab4e28a26a92628bc85cd580c1bfa2b6230be6,Bram Moolenaar,8,5,13,2,"{""src/fileio.c"": {""insertions"": 6, ""deletions"": 5, ""lines"": 11}, ""src/version.c"": {""insertions"": 2, ""deletions"": 0, ""lines"": 2}}"
2021-07-29 19:11:30,77111e2bfc7316eb6b1e653386cef6441af806f8,Bram Moolenaar,3,1,4,2,"{""src/option.c"": {""insertions"": 1, ""deletions"": 1, ""lines"": 2}, ""src/version.c"": {""insertions"": 2, ""deletions"": 0, ""lines"": 2}}"
2021-07-29 18:37:49,131530a54d0f72b820b027606231744e3a09b9ef,Bram Moolenaar,25,13,38,7,"{""src/buffer.c"": {""insertions"": 4, ""deletions"": 0, ""lines"": 4}, ""src/crypt.c"": {""insertions"": 13, ""deletions"": 4, ""lines"": 17}, ""src/errors.h"": {""insertions"": 2, ""deletions"": 0, ""lines"": 2}, ""src/fileio.c"": {""insertions"": 0, ""deletions"": 4, ""lines"": 4}, ""src/memline.c"": {""insertions"": 0, ""deletions"": 5, ""lines"": 5}, ""src/version.c"": {""insertions"": 2, ""deletions"": 0, ""lines"": 2}, ""src/vim.h"": {""insertions"": 4, ""deletions"": 0, ""lines"": 4}}"
2021-07-29 18:22:14,41114a2a27047bf1884e092b98c6298c128eb2f0,Yegappan Lakshmanan,34,8,42,4,"{""src/if_lua.c"": {""insertions"": 15, ""deletions"": 8, ""lines"": 23}, ""src/misc2.c"": {""insertions"": 16, ""deletions"": 0, ""lines"": 16}, ""src/proto/misc2.pro"": {""insertions"": 1, ""deletions"": 0, ""lines"": 1}, ""src/version.c"": {""insertions"": 2, ""deletions"": 0, ""lines"": 2}}"
2021-07-29 17:18:33,83cd0156e01b5befadf12ee66bc26436ee8d023f,msoyka-of-wharton,34,96,130,3,"{""src/GvimExt/gvimext.cpp"": {""insertions"": 31, ""deletions"": 89, ""lines"": 120}, ""src/GvimExt/gvimext.h"": {""insertions"": 1, ""deletions"": 7, ""lines"": 8}, ""src/version.c"": {""insertions"": 2, ""deletions"": 0, ""lines"": 2}}"
2021-07-28 20:44:08,0732932553e54e9bfca07e55b47201b8f30b2c4f,Bram Moolenaar,4,2,6,2,"{""src/testdir/test_vim9_builtin.vim"": {""insertions"": 2, ""deletions"": 2, ""lines"": 4}, ""src/version.c"": {""insertions"": 2, ""deletions"": 0, ""lines"": 2}}"
2021-07-28 20:21:23,6e850a6900793e215c08b39d6490173488cb05ce,Bram Moolenaar,5,0,5,2,"{""src/userfunc.c"": {""insertions"": 3, ""deletions"": 0, ""lines"": 3}, ""src/version.c"": {""insertions"": 2, ""deletions"": 0, ""lines"": 2}}"
2021-07-28 19:48:59,2a4bd00cef1a291059903e26a126b84718e47804,Bram Moolenaar,5,2,7,3,"{""src/if_lua.c"": {""insertions"": 1, ""deletions"": 0, ""lines"": 1}, ""src/testdir/test_lua.vim"": {""insertions"": 2, ""deletions"": 2, ""lines"": 4}, ""src/version.c"": {""insertions"": 2, ""deletions"": 0, ""lines"": 2}}"
2021-07-28 19:25:49,81530e36033dec2c2cd94af6dd48ceb0389e95a2,Bram Moolenaar,22,1,23,4,"{""src/evalvars.c"": {""insertions"": 3, ""deletions"": 0, ""lines"": 3}, ""src/testdir/test_vim9_assign.vim"": {""insertions"": 8, ""deletions"": 0, ""lines"": 8}, ""src/version.c"": {""insertions"": 2, ""deletions"": 0, ""lines"": 2}, ""src/vim9compile.c"": {""insertions"": 9, ""deletions"": 1, ""lines"": 10}}"
2021-07-28 18:52:13,d47c39775b8d381005751b7b20da56412dafb5e4,Bram Moolenaar,10,2,12,4,"{""src/errors.h"": {""insertions"": 2, ""deletions"": 0, ""lines"": 2}, ""src/testdir/test_vim9_expr.vim"": {""insertions"": 1, ""deletions"": 1, ""lines"": 2}, ""src/version.c"": {""insertions"": 2, ""deletions"": 0, ""lines"": 2}, ""src/vim9compile.c"": {""insertions"": 5, ""deletions"": 1, ""lines"": 6}}"
2021-07-28 18:10:16,53f7fccc9413c9f770694b56f40f242d383b2d5f,Bram Moolenaar,804,353,1157,33,"{"".github/CODEOWNERS"": {""insertions"": 2, ""deletions"": 0, ""lines"": 2}, "".github/workflows/ci.yml"": {""insertions"": 1, ""deletions"": 1, ""lines"": 2}, ""README_VIM9.md"": {""insertions"": 13, ""deletions"": 7, ""lines"": 20}, ""runtime/compiler/spectral.vim"": {""insertions"": 17, ""deletions"": 0, ""lines"": 17}, ""runtime/compiler/yamllint.vim"": {""insertions"": 16, ""deletions"": 0, ""lines"": 16}, ""runtime/doc/autocmd.txt"": {""insertions"": 3, ""deletions"": 2, ""lines"": 5}, ""runtime/doc/digraph.txt"": {""insertions"": 1, ""deletions"": 1, ""lines"": 2}, ""runtime/doc/editing.txt"": {""insertions"": 6, ""deletions"": 3, ""lines"": 9}, ""runtime/doc/eval.txt"": {""insertions"": 66, ""deletions"": 31, ""lines"": 97}, ""runtime/doc/fold.txt"": {""insertions"": 3, ""deletions"": 1, ""lines"": 4}, ""runtime/doc/map.txt"": {""insertions"": 3, ""deletions"": 2, ""lines"": 5}, ""runtime/doc/options.txt"": {""insertions"": 2, ""deletions"": 1, ""lines"": 3}, ""runtime/doc/pattern.txt"": {""insertions"": 6, ""deletions"": 5, ""lines"": 11}, ""runtime/doc/syntax.txt"": {""insertions"": 1, ""deletions"": 1, ""lines"": 2}, ""runtime/doc/tags"": {""insertions"": 8, ""deletions"": 0, ""lines"": 8}, ""runtime/doc/todo.txt"": {""insertions"": 23, ""deletions"": 10, ""lines"": 33}, ""runtime/doc/usr_41.txt"": {""insertions"": 1, ""deletions"": 1, ""lines"": 2}, ""runtime/doc/version6.txt"": {""insertions"": 1, ""deletions"": 1, ""lines"": 2}, ""runtime/doc/version7.txt"": {""insertions"": 2, ""deletions"": 2, ""lines"": 4}, ""runtime/doc/version8.txt"": {""insertions"": 8, ""deletions"": 4, ""lines"": 12}, ""runtime/doc/vim9.txt"": {""insertions"": 54, ""deletions"": 12, ""lines"": 66}, ""runtime/indent/bzl.vim"": {""insertions"": 26, ""deletions"": 15, ""lines"": 41}, ""runtime/indent/testdir/xml.in"": {""insertions"": 1, ""deletions"": 1, ""lines"": 2}, ""runtime/indent/testdir/xml.ok"": {""insertions"": 1, ""deletions"": 1, ""lines"": 2}, ""runtime/macros/hanoi/hanoi.vim"": {""insertions"": 1, ""deletions"": 1, ""lines"": 2}, ""runtime/pack/dist/opt/matchit/doc/matchit.txt"": {""insertions"": 2, ""deletions"": 2, ""lines"": 4}, ""runtime/spell/tet/main.aap"": {""insertions"": 1, ""deletions"": 1, ""lines"": 2}, ""runtime/syntax/aptconf.vim"": {""insertions"": 8, ""deletions"": 5, ""lines"": 13}, ""runtime/syntax/pascal.vim"": {""insertions"": 1, ""deletions"": 1, ""lines"": 2}, ""runtime/syntax/redif.vim"": {""insertions"": 2, ""deletions"": 2, ""lines"": 4}, ""runtime/tools/shtags.1"": {""insertions"": 1, ""deletions"": 1, ""lines"": 2}, ""runtime/tools/xcmdsrv_client.c"": {""insertions"": 1, ""deletions"": 1, ""lines"": 2}, ""src/po/tr.po"": {""insertions"": 522, ""deletions"": 237, ""lines"": 759}}"
2021-07-28 17:34:14,327d3ee4557027b51aad86e68743a85ed3a6f52b,Bram Moolenaar,23,1,24,3,"{""src/testdir/test_vim9_assign.vim"": {""insertions"": 15, ""deletions"": 0, ""lines"": 15}, ""src/userfunc.c"": {""insertions"": 6, ""deletions"": 1, ""lines"": 7}, ""src/version.c"": {""insertions"": 2, ""deletions"": 0, ""lines"": 2}}"
2021-07-28 14:51:53,eaf3f36168f85c8e0ab7083cd996b9fbe937045d,zeertzjq,22,1,23,6,"{""runtime/doc/eval.txt"": {""insertions"": 4, ""deletions"": 0, ""lines"": 4}, ""src/globals.h"": {""insertions"": 2, ""deletions"": 0, ""lines"": 2}, ""src/misc1.c"": {""insertions"": 4, ""deletions"": 0, ""lines"": 4}, ""src/normal.c"": {""insertions"": 0, ""deletions"": 1, ""lines"": 1}, ""src/testdir/test_functions.vim"": {""insertions"": 10, ""deletions"": 0, ""lines"": 10}, ""src/version.c"": {""insertions"": 2, ""deletions"": 0, ""lines"": 2}}"
2021-07-28 13:54:54,6868634abd6a49b2dfd3a994a6da7d5911457a37,Bram Moolenaar,10,1,11,3,"{""src/testdir/test_usercommands.vim"": {""insertions"": 7, ""deletions"": 0, ""lines"": 7}, ""src/userfunc.c"": {""insertions"": 1, ""deletions"": 1, ""lines"": 2}, ""src/version.c"": {""insertions"": 2, ""deletions"": 0, ""lines"": 2}}"
2021-07-28 13:07:01,78e006b9b02fac94c910445d842f6dc5331fa57a,Bram Moolenaar,22,2,24,3,"{""src/if_lua.c"": {""insertions"": 2, ""deletions"": 2, ""lines"": 4}, ""src/testdir/test_lua.vim"": {""insertions"": 18, ""deletions"": 0, ""lines"": 18}, ""src/version.c"": {""insertions"": 2, ""deletions"": 0, ""lines"": 2}}"
2021-07-28 11:30:16,e2390c7f32879ab7942adf0d38b1db34933695fa,Martin Tournoij,149,61,210,4,"{""runtime/doc/textprop.txt"": {""insertions"": 2, ""deletions"": 0, ""lines"": 2}, ""src/testdir/test_textprop.vim"": {""insertions"": 129, ""deletions"": 58, ""lines"": 187}, ""src/textprop.c"": {""insertions"": 16, ""deletions"": 3, ""lines"": 19}, ""src/version.c"": {""insertions"": 2, ""deletions"": 0, ""lines"": 2}}"
2021-07-28 09:51:48,7e6a2a64f09df577f29e024c1d1e6733d6bc1b7c,Yegappan Lakshmanan,21,1,22,5,"{""src/misc1.c"": {""insertions"": 1, ""deletions"": 1, ""lines"": 2}, ""src/proto/typval.pro"": {""insertions"": 1, ""deletions"": 0, ""lines"": 1}, ""src/testdir/test_vim9_builtin.vim"": {""insertions"": 6, ""deletions"": 0, ""lines"": 6}, ""src/typval.c"": {""insertions"": 11, ""deletions"": 0, ""lines"": 11}, ""src/version.c"": {""insertions"": 2, ""deletions"": 0, ""lines"": 2}}"
2021-07-27 20:35:42,9088784972c0ed72997de8752964d6b587218778,Bram Moolenaar,4,0,4,2,"{""src/errors.h"": {""insertions"": 2, ""deletions"": 0, ""lines"": 2}, ""src/version.c"": {""insertions"": 2, ""deletions"": 0, ""lines"": 2}}"
2021-07-27 20:21:44,f723701de0636ad8b4aad6179b322f72b04354b9,Bram Moolenaar,15,0,15,3,"{""src/testdir/test_vim9_builtin.vim"": {""insertions"": 10, ""deletions"": 0, ""lines"": 10}, ""src/version.c"": {""insertions"": 2, ""deletions"": 0, ""lines"": 2}, ""src/vim9compile.c"": {""insertions"": 3, ""deletions"": 0, ""lines"": 3}}"
2021-07-27 20:00:44,4490ec4e839e45a2e6923c265c7e9e64c240b805,Yegappan Lakshmanan,1710,630,2340,55,"{""src/arglist.c"": {""insertions"": 15, ""deletions"": 0, ""lines"": 15}, ""src/change.c"": {""insertions"": 8, ""deletions"": 1, ""lines"": 9}, ""src/channel.c"": {""insertions"": 41, ""deletions"": 6, ""lines"": 47}, ""src/cindent.c"": {""insertions"": 3, ""deletions"": 0, ""lines"": 3}, ""src/clientserver.c"": {""insertions"": 28, ""deletions"": 11, ""lines"": 39}, ""src/cmdhist.c"": {""insertions"": 10, ""deletions"": 1, ""lines"": 11}, ""src/dict.c"": {""insertions"": 8, ""deletions"": 0, ""lines"": 8}, ""src/diff.c"": {""insertions"": 3, ""deletions"": 0, ""lines"": 3}, ""src/digraph.c"": {""insertions"": 12, ""deletions"": 0, ""lines"": 12}, ""src/errors.h"": {""insertions"": 20, ""deletions"": 0, ""lines"": 20}, ""src/eval.c"": {""insertions"": 2, ""deletions"": 2, ""lines"": 4}, ""src/evalbuffer.c"": {""insertions"": 48, ""deletions"": 6, ""lines"": 54}, ""src/evalfunc.c"": {""insertions"": 278, ""deletions"": 33, ""lines"": 311}, ""src/evalwindow.c"": {""insertions"": 68, ""deletions"": 3, ""lines"": 71}, ""src/ex_docmd.c"": {""insertions"": 6, ""deletions"": 1, ""lines"": 7}, ""src/ex_getln.c"": {""insertions"": 15, ""deletions"": 2, ""lines"": 17}, ""src/filepath.c"": {""insertions"": 57, ""deletions"": 5, ""lines"": 62}, ""src/findfile.c"": {""insertions"": 3, ""deletions"": 0, ""lines"": 3}, ""src/float.c"": {""insertions"": 86, ""deletions"": 2, ""lines"": 88}, ""src/fold.c"": {""insertions"": 10, ""deletions"": 0, ""lines"": 10}, ""src/getchar.c"": {""insertions"": 3, ""deletions"": 0, ""lines"": 3}, ""src/indent.c"": {""insertions"": 6, ""deletions"": 0, ""lines"": 6}, ""src/insexpand.c"": {""insertions"": 4, ""deletions"": 4, ""lines"": 8}, ""src/job.c"": {""insertions"": 16, ""deletions"": 2, ""lines"": 18}, ""src/json.c"": {""insertions"": 6, ""deletions"": 0, ""lines"": 6}, ""src/list.c"": {""insertions"": 1, ""deletions"": 4, ""lines"": 5}, ""src/mark.c"": {""insertions"": 3, ""deletions"": 0, ""lines"": 3}, ""src/match.c"": {""insertions"": 22, ""deletions"": 4, ""lines"": 26}, ""src/mbyte.c"": {""insertions"": 9, ""deletions"": 0, ""lines"": 9}, ""src/menu.c"": {""insertions"": 5, ""deletions"": 0, ""lines"": 5}, ""src/misc1.c"": {""insertions"": 7, ""deletions"": 1, ""lines"": 8}, ""src/move.c"": {""insertions"": 6, ""deletions"": 0, ""lines"": 6}, ""src/popupwin.c"": {""insertions"": 45, ""deletions"": 10, ""lines"": 55}, ""src/proto/typval.pro"": {""insertions"": 6, ""deletions"": 1, ""lines"": 7}, ""src/quickfix.c"": {""insertions"": 8, ""deletions"": 0, ""lines"": 8}, ""src/search.c"": {""insertions"": 3, ""deletions"": 0, ""lines"": 3}, ""src/sign.c"": {""insertions"": 18, ""deletions"": 0, ""lines"": 18}, ""src/sound.c"": {""insertions"": 8, ""deletions"": 1, ""lines"": 9}, ""src/strings.c"": {""insertions"": 63, ""deletions"": 2, ""lines"": 65}, ""src/terminal.c"": {""insertions"": 51, ""deletions"": 16, ""lines"": 67}, ""src/testdir/test_assert.vim"": {""insertions"": 1, ""deletions"": 1, ""lines"": 2}, ""src/testdir/test_blob.vim"": {""insertions"": 1, ""deletions"": 1, ""lines"": 2}, ""src/testdir/test_execute_func.vim"": {""insertions"": 1, ""deletions"": 1, ""lines"": 2}, ""src/testdir/test_float_func.vim"": {""insertions"": 1, ""deletions"": 2, ""lines"": 3}, ""src/testdir/test_functions.vim"": {""insertions"": 3, ""deletions"": 6, ""lines"": 9}, ""src/testdir/test_glob2regpat.vim"": {""insertions"": 1, ""deletions"": 2, ""lines"": 3}, ""src/testdir/test_listdict.vim"": {""insertions"": 1, ""deletions"": 1, ""lines"": 2}, ""src/testdir/test_vim9_builtin.vim"": {""insertions"": 482, ""deletions"": 482, ""lines"": 964}, ""src/testdir/test_vim9_script.vim"": {""insertions"": 1, ""deletions"": 1, ""lines"": 2}, ""src/testing.c"": {""insertions"": 57, ""deletions"": 4, ""lines"": 61}, ""src/textprop.c"": {""insertions"": 25, ""deletions"": 1, ""lines"": 26}, ""src/time.c"": {""insertions"": 24, ""deletions"": 0, ""lines"": 24}, ""src/typval.c"": {""insertions"": 96, ""deletions"": 10, ""lines"": 106}, ""src/undo.c"": {""insertions"": 3, ""deletions"": 0, ""lines"": 3}, ""src/version.c"": {""insertions"": 2, ""deletions"": 0, ""lines"": 2}}"
2021-07-27 19:17:32,5d7c2df536c17db4a9c61e0760bdcf78d0db7330,Bram Moolenaar,84,14,98,6,"{""runtime/doc/map.txt"": {""insertions"": 10, ""deletions"": 0, ""lines"": 10}, ""src/misc2.c"": {""insertions"": 10, ""deletions"": 11, ""lines"": 21}, ""src/proto/misc2.pro"": {""insertions"": 1, ""deletions"": 1, ""lines"": 2}, ""src/testdir/test_usercommands.vim"": {""insertions"": 18, ""deletions"": 0, ""lines"": 18}, ""src/usercmd.c"": {""insertions"": 43, ""deletions"": 2, ""lines"": 45}, ""src/version.c"": {""insertions"": 2, ""deletions"": 0, ""lines"": 2}}"
2021-07-26 20:19:10,53ba05b09075f14227f9be831a22ed16f7cc26b2,Gary Johnson,220,41,261,17,"{""runtime/doc/options.txt"": {""insertions"": 5, ""deletions"": 1, ""lines"": 6}, ""src/buffer.c"": {""insertions"": 1, ""deletions"": 0, ""lines"": 1}, ""src/change.c"": {""insertions"": 1, ""deletions"": 1, ""lines"": 2}, ""src/drawscreen.c"": {""insertions"": 4, ""deletions"": 4, ""lines"": 8}, ""src/edit.c"": {""insertions"": 3, ""deletions"": 3, ""lines"": 6}, ""src/misc2.c"": {""insertions"": 12, ""deletions"": 9, ""lines"": 21}, ""src/normal.c"": {""insertions"": 3, ""deletions"": 3, ""lines"": 6}, ""src/ops.c"": {""insertions"": 11, ""deletions"": 5, ""lines"": 16}, ""src/option.c"": {""insertions"": 20, ""deletions"": 1, ""lines"": 21}, ""src/option.h"": {""insertions"": 3, ""deletions"": 0, ""lines"": 3}, ""src/optiondefs.h"": {""insertions"": 2, ""deletions"": 1, ""lines"": 3}, ""src/optionstr.c"": {""insertions"": 25, ""deletions"": 9, ""lines"": 34}, ""src/proto/option.pro"": {""insertions"": 1, ""deletions"": 0, ""lines"": 1}, ""src/register.c"": {""insertions"": 5, ""deletions"": 4, ""lines"": 9}, ""src/structs.h"": {""insertions"": 2, ""deletions"": 0, ""lines"": 2}, ""src/testdir/test_virtualedit.vim"": {""insertions"": 120, ""deletions"": 0, ""lines"": 120}, ""src/version.c"": {""insertions"": 2, ""deletions"": 0, ""lines"": 2}}"
2021-07-26 19:54:04,29b857150c111a455f1a38a8f748243524f692e1,h-east,190,189,379,10,"{""runtime/doc/digraph.txt"": {""insertions"": 1, ""deletions"": 1, ""lines"": 2}, ""runtime/doc/eval.txt"": {""insertions"": 105, ""deletions"": 106, ""lines"": 211}, ""runtime/doc/usr_41.txt"": {""insertions"": 4, ""deletions"": 4, ""lines"": 8}, ""src/digraph.c"": {""insertions"": 24, ""deletions"": 24, ""lines"": 48}, ""src/edit.c"": {""insertions"": 1, ""deletions"": 1, ""lines"": 2}, ""src/errors.h"": {""insertions"": 2, ""deletions"": 2, ""lines"": 4}, ""src/evalfunc.c"": {""insertions"": 8, ""deletions"": 8, ""lines"": 16}, ""src/proto/digraph.pro"": {""insertions"": 6, ""deletions"": 6, ""lines"": 12}, ""src/testdir/test_digraph.vim"": {""insertions"": 37, ""deletions"": 37, ""lines"": 74}, ""src/version.c"": {""insertions"": 2, ""deletions"": 0, ""lines"": 2}}"
2021-07-26 19:11:32,ccb148ac63941feba879ea4678aa4713d81494f2,Bram Moolenaar,3,1,4,2,"{""src/ex_getln.c"": {""insertions"": 1, ""deletions"": 1, ""lines"": 2}, ""src/version.c"": {""insertions"": 2, ""deletions"": 0, ""lines"": 2}}"
2021-07-26 19:10:11,678b207fb111840fec1f0dc43910613ba106b90d,Bram Moolenaar,23,2,25,4,"{""src/eval.c"": {""insertions"": 2, ""deletions"": 1, ""lines"": 3}, ""src/testdir/test_vim9_cmd.vim"": {""insertions"": 14, ""deletions"": 0, ""lines"": 14}, ""src/version.c"": {""insertions"": 2, ""deletions"": 0, ""lines"": 2}, ""src/vim9compile.c"": {""insertions"": 5, ""deletions"": 1, ""lines"": 6}}"
2021-07-25 18:27:06,ff34bee3a2d22f2ff7abd4519270b5518082c33d,Bram Moolenaar,34,1,35,3,"{""src/ex_cmds.h"": {""insertions"": 1, ""deletions"": 1, ""lines"": 2}, ""src/testdir/test_ins_complete.vim"": {""insertions"": 31, ""deletions"": 0, ""lines"": 31}, ""src/version.c"": {""insertions"": 2, ""deletions"": 0, ""lines"": 2}}"
2021-07-25 16:07:00,3c77b6a1ce1d4a06c60bb9fae7eec2775f547d55,Bram Moolenaar,27,3,30,3,"{""src/testdir/test_vim9_func.vim"": {""insertions"": 10, ""deletions"": 1, ""lines"": 11}, ""src/version.c"": {""insertions"": 2, ""deletions"": 0, ""lines"": 2}, ""src/vim9compile.c"": {""insertions"": 15, ""deletions"": 2, ""lines"": 17}}"
2021-07-25 13:57:32,a764e73d4ffc5d046807c757eaacb9b0a5408152,Yegappan Lakshmanan,189,17,206,9,"{""src/evalfunc.c"": {""insertions"": 70, ""deletions"": 10, ""lines"": 80}, ""src/popupwin.c"": {""insertions"": 5, ""deletions"": 1, ""lines"": 6}, ""src/proto/typval.pro"": {""insertions"": 2, ""deletions"": 0, ""lines"": 2}, ""src/testdir/test_assert.vim"": {""insertions"": 3, ""deletions"": 3, ""lines"": 6}, ""src/testdir/test_vim9_builtin.vim"": {""insertions"": 60, ""deletions"": 0, ""lines"": 60}, ""src/testdir/test_vim9_script.vim"": {""insertions"": 2, ""deletions"": 2, ""lines"": 4}, ""src/testing.c"": {""insertions"": 18, ""deletions"": 1, ""lines"": 19}, ""src/typval.c"": {""insertions"": 27, ""deletions"": 0, ""lines"": 27}, ""src/version.c"": {""insertions"": 2, ""deletions"": 0, ""lines"": 2}}"
2021-07-25 13:41:44,2ec28aec9d4f1b9c1c008e36adde9fc82affae0f,Dominique Pelle,9,2,11,2,"{""src/testdir/test_vim9_builtin.vim"": {""insertions"": 7, ""deletions"": 2, ""lines"": 9}, ""src/version.c"": {""insertions"": 2, ""deletions"": 0, ""lines"": 2}}"
2021-07-25 13:08:05,7a4ca32175bef0f9a177052796bd9addd10dc218,Christian Brabandt,39,0,39,4,"{""runtime/doc/editing.txt"": {""insertions"": 6, ""deletions"": 0, ""lines"": 6}, ""src/findfile.c"": {""insertions"": 9, ""deletions"": 0, ""lines"": 9}, ""src/testdir/test_findfile.vim"": {""insertions"": 22, ""deletions"": 0, ""lines"": 22}, ""src/version.c"": {""insertions"": 2, ""deletions"": 0, ""lines"": 2}}"
2021-07-25 12:36:05,8a4c812ede5b01a8e71082c1ff4ebfcbf1bd515f,Christian Brabandt,43,11,54,6,"{""src/bufwrite.c"": {""insertions"": 13, ""deletions"": 4, ""lines"": 17}, ""src/crypt.c"": {""insertions"": 1, ""deletions"": 4, ""lines"": 5}, ""src/proto/undo.pro"": {""insertions"": 1, ""deletions"": 0, ""lines"": 1}, ""src/testdir/test_crypt.vim"": {""insertions"": 4, ""deletions"": 3, ""lines"": 7}, ""src/undo.c"": {""insertions"": 22, ""deletions"": 0, ""lines"": 22}, ""src/version.c"": {""insertions"": 2, ""deletions"": 0, ""lines"": 2}}"
2021-07-25 12:21:11,3ed0d9379683246a77aa8c1a59da7a0ac6395339,Bram Moolenaar,3,1,4,2,"{""src/globals.h"": {""insertions"": 1, ""deletions"": 1, ""lines"": 2}, ""src/version.c"": {""insertions"": 2, ""deletions"": 0, ""lines"": 2}}"
2021-07-25 12:13:53,2eb6fc3b52148f961e804ec2be361d531ff770d8,Bram Moolenaar,135,76,211,8,"{""src/eval.c"": {""insertions"": 7, ""deletions"": 3, ""lines"": 10}, ""src/evalvars.c"": {""insertions"": 1, ""deletions"": 7, ""lines"": 8}, ""src/ex_eval.c"": {""insertions"": 4, ""deletions"": 14, ""lines"": 18}, ""src/structs.h"": {""insertions"": 3, ""deletions"": 0, ""lines"": 3}, ""src/testdir/test_vim9_script.vim"": {""insertions"": 28, ""deletions"": 0, ""lines"": 28}, ""src/userfunc.c"": {""insertions"": 36, ""deletions"": 22, ""lines"": 58}, ""src/version.c"": {""insertions"": 2, ""deletions"": 0, ""lines"": 2}, ""src/vim9script.c"": {""insertions"": 54, ""deletions"": 30, ""lines"": 84}}"
2021-07-24 19:33:26,5bca906b307728fa74a112914dc55b424d512d39,Yegappan Lakshmanan,223,102,325,8,"{""src/change.c"": {""insertions"": 3, ""deletions"": 0, ""lines"": 3}, ""src/evalfunc.c"": {""insertions"": 112, ""deletions"": 77, ""lines"": 189}, ""src/filepath.c"": {""insertions"": 14, ""deletions"": 0, ""lines"": 14}, ""src/sound.c"": {""insertions"": 9, ""deletions"": 0, ""lines"": 9}, ""src/testdir/test_gui.vim"": {""insertions"": 4, ""deletions"": 4, ""lines"": 8}, ""src/testdir/test_vim9_builtin.vim"": {""insertions"": 70, ""deletions"": 14, ""lines"": 84}, ""src/testing.c"": {""insertions"": 9, ""deletions"": 7, ""lines"": 16}, ""src/version.c"": {""insertions"": 2, ""deletions"": 0, ""lines"": 2}}"
2021-07-24 19:19:42,7d60384a00755e5c0112cebeb5e232fc133c9eca,Christian Brabandt,38,16,54,3,"{""nsis/gvim.nsi"": {""insertions"": 11, ""deletions"": 14, ""lines"": 25}, ""runtime/doc/os_win32.txt"": {""insertions"": 25, ""deletions"": 2, ""lines"": 27}, ""src/version.c"": {""insertions"": 2, ""deletions"": 0, ""lines"": 2}}"
2021-07-24 18:51:13,9c9472ff49b09c3d8f747b330eeb1cdb92bab449,Dominique Pelle,48,0,48,2,"{""src/testdir/test_spellfile.vim"": {""insertions"": 46, ""deletions"": 0, ""lines"": 46}, ""src/version.c"": {""insertions"": 2, ""deletions"": 0, ""lines"": 2}}"
2021-07-24 17:32:12,5a9e5845e1539592e94963fcdf5b3ad4fdc59db4,Dominique Pelle,54,44,98,2,"{""src/version.c"": {""insertions"": 2, ""deletions"": 0, ""lines"": 2}, ""src/vim9execute.c"": {""insertions"": 52, ""deletions"": 44, ""lines"": 96}}"
2021-07-24 14:16:15,7973de35ba6840b7e106e2e8a8912522e9a2a960,Yegappan Lakshmanan,165,22,187,10,"{""src/channel.c"": {""insertions"": 7, ""deletions"": 1, ""lines"": 8}, ""src/evalfunc.c"": {""insertions"": 48, ""deletions"": 17, ""lines"": 65}, ""src/evalvars.c"": {""insertions"": 11, ""deletions"": 0, ""lines"": 11}, ""src/if_cscope.c"": {""insertions"": 8, ""deletions"": 0, ""lines"": 8}, ""src/job.c"": {""insertions"": 8, ""deletions"": 0, ""lines"": 8}, ""src/proto/typval.pro"": {""insertions"": 1, ""deletions"": 0, ""lines"": 1}, ""src/testdir/test_vim9_builtin.vim"": {""insertions"": 61, ""deletions"": 3, ""lines"": 64}, ""src/time.c"": {""insertions"": 8, ""deletions"": 1, ""lines"": 9}, ""src/typval.c"": {""insertions"": 11, ""deletions"": 0, ""lines"": 11}, ""src/version.c"": {""insertions"": 2, ""deletions"": 0, ""lines"": 2}}"
2021-07-24 13:44:30,dd0b287c1ec8314034a2dbb14c4267994c47520c,Bram Moolenaar,13,3,16,3,"{""src/testdir/test_vim9_builtin.vim"": {""insertions"": 10, ""deletions"": 2, ""lines"": 12}, ""src/version.c"": {""insertions"": 2, ""deletions"": 0, ""lines"": 2}, ""src/vim9compile.c"": {""insertions"": 1, ""deletions"": 1, ""lines"": 2}}"
2021-07-24 12:14:52,88421d6dc812a2f3b0eab34740f174c9558cb734,Bram Moolenaar,42,1,43,3,"{""src/testdir/test_vim9_func.vim"": {""insertions"": 36, ""deletions"": 0, ""lines"": 36}, ""src/version.c"": {""insertions"": 2, ""deletions"": 0, ""lines"": 2}, ""src/vim9compile.c"": {""insertions"": 4, ""deletions"": 1, ""lines"": 5}}"
2021-07-24 11:57:29,1a3e5747b7df7ddda312bbfd18e04fc2122001fb,Martin Tournoij,45,30,75,14,"{""src/globals.h"": {""insertions"": 1, ""deletions"": 1, ""lines"": 2}, ""src/if_cscope.c"": {""insertions"": 0, ""deletions"": 18, ""lines"": 18}, ""src/if_lua.c"": {""insertions"": 3, ""deletions"": 1, ""lines"": 4}, ""src/if_mzsch.c"": {""insertions"": 2, ""deletions"": 2, ""lines"": 4}, ""src/if_perl.xs"": {""insertions"": 2, ""deletions"": 0, ""lines"": 2}, ""src/if_python.c"": {""insertions"": 3, ""deletions"": 1, ""lines"": 4}, ""src/if_python3.c"": {""insertions"": 3, ""deletions"": 1, ""lines"": 4}, ""src/if_ruby.c"": {""insertions"": 3, ""deletions"": 1, ""lines"": 4}, ""src/if_tcl.c"": {""insertions"": 3, ""deletions"": 1, ""lines"": 4}, ""src/mbyte.c"": {""insertions"": 2, ""deletions"": 1, ""lines"": 3}, ""src/os_win32.c"": {""insertions"": 17, ""deletions"": 1, ""lines"": 18}, ""src/proto/os_win32.pro"": {""insertions"": 1, ""deletions"": 0, ""lines"": 1}, ""src/terminal.c"": {""insertions"": 3, ""deletions"": 2, ""lines"": 5}, ""src/version.c"": {""insertions"": 2, ""deletions"": 0, ""lines"": 2}}"
2021-07-24 11:18:48,5a234eb18e6e43408755bb24e813330306c11629,Bram Moolenaar,9,1,10,3,"{""src/testdir/test_vim9_builtin.vim"": {""insertions"": 6, ""deletions"": 1, ""lines"": 7}, ""src/version.c"": {""insertions"": 2, ""deletions"": 0, ""lines"": 2}, ""src/vim9compile.c"": {""insertions"": 1, ""deletions"": 0, ""lines"": 1}}"
2021-07-23 18:37:56,0ad871dc4dfe1026e14931a55c225616b63f4c5b,Yegappan Lakshmanan,456,152,608,19,"{""src/blob.c"": {""insertions"": 0, ""deletions"": 6, ""lines"": 6}, ""src/cmdhist.c"": {""insertions"": 5, ""deletions"": 0, ""lines"": 5}, ""src/dict.c"": {""insertions"": 0, ""deletions"": 5, ""lines"": 5}, ""src/errors.h"": {""insertions"": 2, ""deletions"": 4, ""lines"": 6}, ""src/evalfunc.c"": {""insertions"": 138, ""deletions"": 82, ""lines"": 220}, ""src/filepath.c"": {""insertions"": 6, ""deletions"": 0, ""lines"": 6}, ""src/globals.h"": {""insertions"": 0, ""deletions"": 1, ""lines"": 1}, ""src/job.c"": {""insertions"": 6, ""deletions"": 0, ""lines"": 6}, ""src/list.c"": {""insertions"": 38, ""deletions"": 6, ""lines"": 44}, ""src/match.c"": {""insertions"": 24, ""deletions"": 2, ""lines"": 26}, ""src/misc1.c"": {""insertions"": 5, ""deletions"": 0, ""lines"": 5}, ""src/popupwin.c"": {""insertions"": 9, ""deletions"": 2, ""lines"": 11}, ""src/proto/typval.pro"": {""insertions"": 2, ""deletions"": 1, ""lines"": 3}, ""src/sign.c"": {""insertions"": 19, ""deletions"": 0, ""lines"": 19}, ""src/terminal.c"": {""insertions"": 15, ""deletions"": 1, ""lines"": 16}, ""src/testdir/test_blob.vim"": {""insertions"": 4, ""deletions"": 4, ""lines"": 8}, ""src/testdir/test_vim9_builtin.vim"": {""insertions"": 140, ""deletions"": 15, ""lines"": 155}, ""src/typval.c"": {""insertions"": 41, ""deletions"": 23, ""lines"": 64}, ""src/version.c"": {""insertions"": 2, ""deletions"": 0, ""lines"": 2}}"
2021-07-23 17:30:19,1b862c466ba4242857eec581f67982d265005ef4,Bram Moolenaar,5,3,8,2,"{""src/version.c"": {""insertions"": 2, ""deletions"": 0, ""lines"": 2}, ""src/vim9compile.c"": {""insertions"": 3, ""deletions"": 3, ""lines"": 6}}"
2021-07-22 19:33:03,c9e7e344ed390d2a22afb88001b6aa80832d2541,Bram Moolenaar,94,1,95,5,"{""src/drawscreen.c"": {""insertions"": 3, ""deletions"": 1, ""lines"": 4}, ""src/testdir/dumps/Test_cursorline_redraw_1.dump"": {""insertions"": 20, ""deletions"": 0, ""lines"": 20}, ""src/testdir/dumps/Test_cursorline_redraw_2.dump"": {""insertions"": 20, ""deletions"": 0, ""lines"": 20}, ""src/testdir/test_cursorline.vim"": {""insertions"": 49, ""deletions"": 0, ""lines"": 49}, ""src/version.c"": {""insertions"": 2, ""deletions"": 0, ""lines"": 2}}"
2021-07-22 17:11:08,cd268017cf79a546a494883b4b026a3cbbd9a8a0,Bram Moolenaar,10,3,13,3,"{""src/evalfunc.c"": {""insertions"": 3, ""deletions"": 1, ""lines"": 4}, ""src/version.c"": {""insertions"": 2, ""deletions"": 0, ""lines"": 2}, ""src/vim9compile.c"": {""insertions"": 5, ""deletions"": 2, ""lines"": 7}}"
2021-07-22 16:48:53,5dd839ce20466eea52e59ecf86456f1ab370d2bd,Bram Moolenaar,127,39,166,4,"{""src/ex_docmd.c"": {""insertions"": 2, ""deletions"": 1, ""lines"": 3}, ""src/testdir/test_listdict.vim"": {""insertions"": 116, ""deletions"": 38, ""lines"": 154}, ""src/version.c"": {""insertions"": 2, ""deletions"": 0, ""lines"": 2}, ""src/vim9execute.c"": {""insertions"": 7, ""deletions"": 0, ""lines"": 7}}"
2021-07-22 13:14:25,2b59df00d80ea8d2c0fcf4f4ae9a018c1790206f,Bram Moolenaar,5,5,10,3,"{""src/eval.c"": {""insertions"": 1, ""deletions"": 2, ""lines"": 3}, ""src/evalvars.c"": {""insertions"": 2, ""deletions"": 3, ""lines"": 5}, ""src/version.c"": {""insertions"": 2, ""deletions"": 0, ""lines"": 2}}"
2021-07-22 12:58:47,7a3fe3e180bdbce8f193abdf399559c5154bdaae,Bram Moolenaar,78,49,127,13,"{""src/dict.c"": {""insertions"": 3, ""deletions"": 3, ""lines"": 6}, ""src/errors.h"": {""insertions"": 6, ""deletions"": 0, ""lines"": 6}, ""src/eval.c"": {""insertions"": 4, ""deletions"": 3, ""lines"": 7}, ""src/if_py_both.h"": {""insertions"": 1, ""deletions"": 1, ""lines"": 2}, ""src/list.c"": {""insertions"": 18, ""deletions"": 13, ""lines"": 31}, ""src/proto/dict.pro"": {""insertions"": 1, ""deletions"": 1, ""lines"": 2}, ""src/proto/vim9type.pro"": {""insertions"": 1, ""deletions"": 1, ""lines"": 2}, ""src/structs.h"": {""insertions"": 3, ""deletions"": 0, ""lines"": 3}, ""src/testdir/test_vim9_builtin.vim"": {""insertions"": 5, ""deletions"": 3, ""lines"": 8}, ""src/version.c"": {""insertions"": 2, ""deletions"": 0, ""lines"": 2}, ""src/vim9compile.c"": {""insertions"": 5, ""deletions"": 11, ""lines"": 16}, ""src/vim9execute.c"": {""insertions"": 7, ""deletions"": 3, ""lines"": 10}, ""src/vim9type.c"": {""insertions"": 22, ""deletions"": 10, ""lines"": 32}}"
2021-07-22 10:26:14,a74901929e999a0052c1ce388ab09359c10cbb0d,Bram Moolenaar,4,2,6,2,"{""src/version.c"": {""insertions"": 2, ""deletions"": 0, ""lines"": 2}, ""src/vim9execute.c"": {""insertions"": 2, ""deletions"": 2, ""lines"": 4}}"
2021-07-22 09:46:59,f674b358fc18cf1641a066cc5de73da69e651024,Maxim Kim,71,8,79,4,"{""runtime/doc/options.txt"": {""insertions"": 3, ""deletions"": 1, ""lines"": 4}, ""src/indent.c"": {""insertions"": 12, ""deletions"": 6, ""lines"": 18}, ""src/testdir/test_breakindent.vim"": {""insertions"": 54, ""deletions"": 1, ""lines"": 55}, ""src/version.c"": {""insertions"": 2, ""deletions"": 0, ""lines"": 2}}"
2021-07-21 20:20:33,d8e44476d84b5f0cc8c4de080a47a3a9af547028,Bram Moolenaar,61,35,96,15,"{""src/edit.c"": {""insertions"": 1, ""deletions"": 1, ""lines"": 2}, ""src/errors.h"": {""insertions"": 33, ""deletions"": 0, ""lines"": 33}, ""src/evalvars.c"": {""insertions"": 3, ""deletions"": 2, ""lines"": 5}, ""src/ex_cmds.c"": {""insertions"": 1, ""deletions"": 1, ""lines"": 2}, ""src/ex_docmd.c"": {""insertions"": 1, ""deletions"": 1, ""lines"": 2}, ""src/globals.h"": {""insertions"": 0, ""deletions"": 8, ""lines"": 8}, ""src/option.c"": {""insertions"": 4, ""deletions"": 4, ""lines"": 8}, ""src/quickfix.c"": {""insertions"": 1, ""deletions"": 1, ""lines"": 2}, ""src/regexp.c"": {""insertions"": 0, ""deletions"": 3, ""lines"": 3}, ""src/regexp_bt.c"": {""insertions"": 8, ""deletions"": 8, ""lines"": 16}, ""src/regexp_nfa.c"": {""insertions"": 4, ""deletions"": 3, ""lines"": 7}, ""src/undo.c"": {""insertions"": 1, ""deletions"": 1, ""lines"": 2}, ""src/version.c"": {""insertions"": 2, ""deletions"": 0, ""lines"": 2}, ""src/vim9compile.c"": {""insertions"": 1, ""deletions"": 1, ""lines"": 2}, ""src/vim9script.c"": {""insertions"": 1, ""deletions"": 1, ""lines"": 2}}"
2021-07-21 19:37:28,05bd9785fd0fd0102ab64554307bff0ec0ae34c1,Bram Moolenaar,57,22,79,3,"{""src/testdir/test_vim9_expr.vim"": {""insertions"": 18, ""deletions"": 11, ""lines"": 29}, ""src/version.c"": {""insertions"": 2, ""deletions"": 0, ""lines"": 2}, ""src/vim9compile.c"": {""insertions"": 37, ""deletions"": 11, ""lines"": 48}}"
2021-07-21 18:38:46,c4c5642513ac41b22b7772cc880c776c69e964c9,Bram Moolenaar,9,2,11,3,"{""src/testdir/test_vim9_func.vim"": {""insertions"": 6, ""deletions"": 0, ""lines"": 6}, ""src/version.c"": {""insertions"": 2, ""deletions"": 0, ""lines"": 2}, ""src/vim9compile.c"": {""insertions"": 1, ""deletions"": 2, ""lines"": 3}}"
2021-07-21 17:09:09,cd9172077bc8c0aafddf2e5367cc0ae2c00c8ff7,Yegappan Lakshmanan,253,139,392,10,"{""src/diff.c"": {""insertions"": 1, ""deletions"": 1, ""lines"": 2}, ""src/evalbuffer.c"": {""insertions"": 11, ""deletions"": 1, ""lines"": 12}, ""src/evalfunc.c"": {""insertions"": 115, ""deletions"": 92, ""lines"": 207}, ""src/job.c"": {""insertions"": 1, ""deletions"": 1, ""lines"": 2}, ""src/proto/typval.pro"": {""insertions"": 3, ""deletions"": 0, ""lines"": 3}, ""src/sign.c"": {""insertions"": 1, ""deletions"": 1, ""lines"": 2}, ""src/terminal.c"": {""insertions"": 36, ""deletions"": 10, ""lines"": 46}, ""src/testdir/test_vim9_builtin.vim"": {""insertions"": 28, ""deletions"": 0, ""lines"": 28}, ""src/typval.c"": {""insertions"": 55, ""deletions"": 33, ""lines"": 88}, ""src/version.c"": {""insertions"": 2, ""deletions"": 0, ""lines"": 2}}"
2021-07-21 16:04:56,189663bdac1156237c49925f77bd197c1bdea12c,Bram Moolenaar,22,4,26,3,"{""src/move.c"": {""insertions"": 4, ""deletions"": 4, ""lines"": 8}, ""src/testdir/test_cursor_func.vim"": {""insertions"": 16, ""deletions"": 0, ""lines"": 16}, ""src/version.c"": {""insertions"": 2, ""deletions"": 0, ""lines"": 2}}"
2021-07-20 20:29:19,11d7e62f1d29fdd7a88b86131b7bbb853f29fe8b,Bram Moolenaar,2,2,4,2,"{""src/errors.h"": {""insertions"": 0, ""deletions"": 2, ""lines"": 2}, ""src/version.c"": {""insertions"": 2, ""deletions"": 0, ""lines"": 2}}"
2021-07-20 20:21:59,63cb6567f0153c35dc75cbc09039ff5d0a7b60e3,Bram Moolenaar,148,90,238,4,"{""src/testdir/test_listdict.vim"": {""insertions"": 121, ""deletions"": 84, ""lines"": 205}, ""src/version.c"": {""insertions"": 2, ""deletions"": 0, ""lines"": 2}, ""src/vim9compile.c"": {""insertions"": 1, ""deletions"": 1, ""lines"": 2}, ""src/vim9execute.c"": {""insertions"": 24, ""deletions"": 5, ""lines"": 29}}"
2021-07-20 19:07:36,e29a27f6f8eef8f00d3c2d4cd9811d81cf3026b3,Bram Moolenaar,127,98,225,29,"{""src/buffer.c"": {""insertions"": 2, ""deletions"": 2, ""lines"": 4}, ""src/debugger.c"": {""insertions"": 1, ""deletions"": 1, ""lines"": 2}, ""src/digraph.c"": {""insertions"": 2, ""deletions"": 2, ""lines"": 4}, ""src/edit.c"": {""insertions"": 1, ""deletions"": 1, ""lines"": 2}, ""src/errors.h"": {""insertions"": 56, ""deletions"": 0, ""lines"": 56}, ""src/ex_cmds.c"": {""insertions"": 5, ""deletions"": 5, ""lines"": 10}, ""src/ex_cmds2.c"": {""insertions"": 1, ""deletions"": 1, ""lines"": 2}, ""src/ex_docmd.c"": {""insertions"": 2, ""deletions"": 2, ""lines"": 4}, ""src/ex_eval.c"": {""insertions"": 4, ""deletions"": 4, ""lines"": 8}, ""src/globals.h"": {""insertions"": 0, ""deletions"": 30, ""lines"": 30}, ""src/gui.c"": {""insertions"": 1, ""deletions"": 1, ""lines"": 2}, ""src/list.c"": {""insertions"": 1, ""deletions"": 1, ""lines"": 2}, ""src/main.c"": {""insertions"": 3, ""deletions"": 3, ""lines"": 6}, ""src/map.c"": {""insertions"": 2, ""deletions"": 1, ""lines"": 3}, ""src/match.c"": {""insertions"": 1, ""deletions"": 1, ""lines"": 2}, ""src/quickfix.c"": {""insertions"": 7, ""deletions"": 7, ""lines"": 14}, ""src/regexp.c"": {""insertions"": 3, ""deletions"": 3, ""lines"": 6}, ""src/regexp_bt.c"": {""insertions"": 6, ""deletions"": 6, ""lines"": 12}, ""src/regexp_nfa.c"": {""insertions"": 2, ""deletions"": 2, ""lines"": 4}, ""src/register.c"": {""insertions"": 5, ""deletions"": 5, ""lines"": 10}, ""src/search.c"": {""insertions"": 3, ""deletions"": 3, ""lines"": 6}, ""src/session.c"": {""insertions"": 1, ""deletions"": 1, ""lines"": 2}, ""src/spell.c"": {""insertions"": 1, ""deletions"": 1, ""lines"": 2}, ""src/syntax.c"": {""insertions"": 2, ""deletions"": 2, ""lines"": 4}, ""src/time.c"": {""insertions"": 3, ""deletions"": 3, ""lines"": 6}, ""src/userfunc.c"": {""insertions"": 1, ""deletions"": 1, ""lines"": 2}, ""src/version.c"": {""insertions"": 2, ""deletions"": 0, ""lines"": 2}, ""src/vim9execute.c"": {""insertions"": 2, ""deletions"": 2, ""lines"": 4}, ""src/window.c"": {""insertions"": 7, ""deletions"": 7, ""lines"": 14}}"
2021-07-20 17:18:44,9fa5dabedc4ed5af85773413e91c2fdbe4cb9f0a,Bram Moolenaar,6,1,7,3,"{""src/ex_docmd.c"": {""insertions"": 1, ""deletions"": 1, ""lines"": 2}, ""src/testdir/test_vim9_script.vim"": {""insertions"": 3, ""deletions"": 0, ""lines"": 3}, ""src/version.c"": {""insertions"": 2, ""deletions"": 0, ""lines"": 2}}"
2021-07-20 15:51:51,83494b4ac61898f687d6ef9dce4bad5802fb8e51,Yegappan Lakshmanan,1417,299,1716,34,"{""src/blob.c"": {""insertions"": 8, ""deletions"": 1, ""lines"": 9}, ""src/channel.c"": {""insertions"": 20, ""deletions"": 1, ""lines"": 21}, ""src/clientserver.c"": {""insertions"": 17, ""deletions"": 2, ""lines"": 19}, ""src/cmdexpand.c"": {""insertions"": 6, ""deletions"": 0, ""lines"": 6}, ""src/cmdhist.c"": {""insertions"": 1, ""deletions"": 2, ""lines"": 3}, ""src/dict.c"": {""insertions"": 5, ""deletions"": 0, ""lines"": 5}, ""src/diff.c"": {""insertions"": 1, ""deletions"": 3, ""lines"": 4}, ""src/errors.h"": {""insertions"": 6, ""deletions"": 0, ""lines"": 6}, ""src/eval.c"": {""insertions"": 9, ""deletions"": 0, ""lines"": 9}, ""src/evalbuffer.c"": {""insertions"": 18, ""deletions"": 0, ""lines"": 18}, ""src/evalfunc.c"": {""insertions"": 385, ""deletions"": 103, ""lines"": 488}, ""src/evalvars.c"": {""insertions"": 32, ""deletions"": 0, ""lines"": 32}, ""src/evalwindow.c"": {""insertions"": 7, ""deletions"": 2, ""lines"": 9}, ""src/filepath.c"": {""insertions"": 26, ""deletions"": 4, ""lines"": 30}, ""src/globals.h"": {""insertions"": 4, ""deletions"": 1, ""lines"": 5}, ""src/insexpand.c"": {""insertions"": 11, ""deletions"": 0, ""lines"": 11}, ""src/job.c"": {""insertions"": 15, ""deletions"": 5, ""lines"": 20}, ""src/list.c"": {""insertions"": 32, ""deletions"": 0, ""lines"": 32}, ""src/map.c"": {""insertions"": 6, ""deletions"": 0, ""lines"": 6}, ""src/match.c"": {""insertions"": 8, ""deletions"": 1, ""lines"": 9}, ""src/proto/typval.pro"": {""insertions"": 14, ""deletions"": 0, ""lines"": 14}, ""src/quickfix.c"": {""insertions"": 15, ""deletions"": 0, ""lines"": 15}, ""src/search.c"": {""insertions"": 18, ""deletions"": 8, ""lines"": 26}, ""src/sign.c"": {""insertions"": 6, ""deletions"": 0, ""lines"": 6}, ""src/strings.c"": {""insertions"": 19, ""deletions"": 6, ""lines"": 25}, ""src/terminal.c"": {""insertions"": 21, ""deletions"": 19, ""lines"": 40}, ""src/testdir/test_blob.vim"": {""insertions"": 0, ""deletions"": 28, ""lines"": 28}, ""src/testdir/test_gui.vim"": {""insertions"": 5, ""deletions"": 5, ""lines"": 10}, ""src/testdir/test_vim9_builtin.vim"": {""insertions"": 459, ""deletions"": 93, ""lines"": 552}, ""src/testing.c"": {""insertions"": 5, ""deletions"": 8, ""lines"": 13}, ""src/textprop.c"": {""insertions"": 26, ""deletions"": 4, ""lines"": 30}, ""src/time.c"": {""insertions"": 7, ""deletions"": 3, ""lines"": 10}, ""src/typval.c"": {""insertions"": 203, ""deletions"": 0, ""lines"": 203}, ""src/version.c"": {""insertions"": 2, ""deletions"": 0, ""lines"": 2}}"
2021-07-19 20:19:29,9bb0dad0d8283c86fddf5b950f4fbb6fb8f12741,Bram Moolenaar,46,2,48,4,"{""src/popupwin.c"": {""insertions"": 2, ""deletions"": 2, ""lines"": 4}, ""src/proto/vim9compile.pro"": {""insertions"": 1, ""deletions"": 0, ""lines"": 1}, ""src/version.c"": {""insertions"": 2, ""deletions"": 0, ""lines"": 2}, ""src/vim9compile.c"": {""insertions"": 41, ""deletions"": 0, ""lines"": 41}}"
2021-07-19 19:45:07,605793500b351ee92483d04b1e03fb8af30dd101,Bram Moolenaar,38,5,43,4,"{""src/errors.h"": {""insertions"": 1, ""deletions"": 1, ""lines"": 2}, ""src/evalvars.c"": {""insertions"": 11, ""deletions"": 4, ""lines"": 15}, ""src/testdir/test_vim9_script.vim"": {""insertions"": 24, ""deletions"": 0, ""lines"": 24}, ""src/version.c"": {""insertions"": 2, ""deletions"": 0, ""lines"": 2}}"
2021-07-19 19:04:23,ac2cd2b08f0fd15e9c3759da043e9b28da80dca8,Bram Moolenaar,24,15,39,3,"{""src/testdir/test_vim9_expr.vim"": {""insertions"": 4, ""deletions"": 0, ""lines"": 4}, ""src/userfunc.c"": {""insertions"": 18, ""deletions"": 15, ""lines"": 33}, ""src/version.c"": {""insertions"": 2, ""deletions"": 0, ""lines"": 2}}"
2021-07-19 18:07:21,6106504e9edc8500131f7a36e59bc146f90180fa,mityu,583,37,620,11,"{""runtime/doc/digraph.txt"": {""insertions"": 3, ""deletions"": 0, ""lines"": 3}, ""runtime/doc/eval.txt"": {""insertions"": 107, ""deletions"": 0, ""lines"": 107}, ""runtime/doc/usr_41.txt"": {""insertions"": 4, ""deletions"": 0, ""lines"": 4}, ""src/digraph.c"": {""insertions"": 353, ""deletions"": 35, ""lines"": 388}, ""src/errors.h"": {""insertions"": 12, ""deletions"": 0, ""lines"": 12}, ""src/evalfunc.c"": {""insertions"": 15, ""deletions"": 0, ""lines"": 15}, ""src/ex_docmd.c"": {""insertions"": 1, ""deletions"": 1, ""lines"": 2}, ""src/globals.h"": {""insertions"": 2, ""deletions"": 0, ""lines"": 2}, ""src/proto/digraph.pro"": {""insertions"": 6, ""deletions"": 0, ""lines"": 6}, ""src/testdir/test_digraph.vim"": {""insertions"": 78, ""deletions"": 1, ""lines"": 79}, ""src/version.c"": {""insertions"": 2, ""deletions"": 0, ""lines"": 2}}"
2021-07-19 08:38:49,98c2eaed27579602e05e7b96aa3a60428a8b9cb2,Bram Moolenaar,7,5,12,3,"{""src/errors.h"": {""insertions"": 2, ""deletions"": 2, ""lines"": 4}, ""src/testdir/test_vim9_builtin.vim"": {""insertions"": 3, ""deletions"": 3, ""lines"": 6}, ""src/version.c"": {""insertions"": 2, ""deletions"": 0, ""lines"": 2}}"
2021-07-18 20:25:29,885971e2f5eabc4108e083086c1d6d0a31a2782f,Bram Moolenaar,34,6,40,3,"{""src/list.c"": {""insertions"": 26, ""deletions"": 6, ""lines"": 32}, ""src/testdir/test_vim9_builtin.vim"": {""insertions"": 6, ""deletions"": 0, ""lines"": 6}, ""src/version.c"": {""insertions"": 2, ""deletions"": 0, ""lines"": 2}}"
2021-07-18 19:44:37,9ff9c7b9741b216d3dc75603e50654088dc5f55b,Dominique Pelle,37,15,52,2,"{""src/testdir/test_vim9_builtin.vim"": {""insertions"": 35, ""deletions"": 15, ""lines"": 50}, ""src/version.c"": {""insertions"": 2, ""deletions"": 0, ""lines"": 2}}"
2021-07-18 19:24:50,f6488547e3c7e41ff2c12dd0b93c9ef04e4c8c6f,Bram Moolenaar,21,14,35,2,"{""src/evalvars.c"": {""insertions"": 19, ""deletions"": 14, ""lines"": 33}, ""src/version.c"": {""insertions"": 2, ""deletions"": 0, ""lines"": 2}}"
2021-07-18 18:40:33,24e9316560bd5c9ea2e5a963335aedff025e7f66,Bram Moolenaar,223,157,380,5,"{""src/errors.h"": {""insertions"": 2, ""deletions"": 0, ""lines"": 2}, ""src/eval.c"": {""insertions"": 2, ""deletions"": 1, ""lines"": 3}, ""src/evalvars.c"": {""insertions"": 162, ""deletions"": 132, ""lines"": 294}, ""src/testdir/test_vim9_script.vim"": {""insertions"": 55, ""deletions"": 24, ""lines"": 79}, ""src/version.c"": {""insertions"": 2, ""deletions"": 0, ""lines"": 2}}"
2021-07-18 16:21:38,4db572eeb2b42819268e934e76c67163316d873f,Bram Moolenaar,25,65,90,5,"{""runtime/doc/vim9.txt"": {""insertions"": 4, ""deletions"": 0, ""lines"": 4}, ""src/testdir/test_vim9_script.vim"": {""insertions"": 8, ""deletions"": 41, ""lines"": 49}, ""src/version.c"": {""insertions"": 2, ""deletions"": 0, ""lines"": 2}, ""src/vim9compile.c"": {""insertions"": 2, ""deletions"": 11, ""lines"": 13}, ""src/vim9script.c"": {""insertions"": 9, ""deletions"": 13, ""lines"": 22}}"
2021-07-18 15:08:50,ad2d4969e1616d3a0354c181e3a09271d5433b3d,Bram Moolenaar,20,2,22,3,"{""src/eval.c"": {""insertions"": 12, ""deletions"": 2, ""lines"": 14}, ""src/testdir/test_vim9_script.vim"": {""insertions"": 6, ""deletions"": 0, ""lines"": 6}, ""src/version.c"": {""insertions"": 2, ""deletions"": 0, ""lines"": 2}}"
2021-07-18 12:43:43,0c35752d04f70408a3c560d5b3edbafcaddff302,Bram Moolenaar,41,4,45,4,"{""src/errors.h"": {""insertions"": 2, ""deletions"": 2, ""lines"": 4}, ""src/testdir/test_vim9_expr.vim"": {""insertions"": 23, ""deletions"": 0, ""lines"": 23}, ""src/typval.c"": {""insertions"": 14, ""deletions"": 2, ""lines"": 16}, ""src/version.c"": {""insertions"": 2, ""deletions"": 0, ""lines"": 2}}"
2021-07-18 11:42:29,c6ba2f9dde6d01c8ab356c239c2259f7d83652a4,Bram Moolenaar,23,0,23,3,"{""src/eval.c"": {""insertions"": 5, ""deletions"": 0, ""lines"": 5}, ""src/testdir/test_vim9_func.vim"": {""insertions"": 16, ""deletions"": 0, ""lines"": 16}, ""src/version.c"": {""insertions"": 2, ""deletions"": 0, ""lines"": 2}}"
2021-07-17 19:24:56,47bc9c333766ee3d45cb18c583a630e4ad53405a,Bram Moolenaar,11,1,12,3,"{""src/testdir/test_vim9_assign.vim"": {""insertions"": 7, ""deletions"": 0, ""lines"": 7}, ""src/version.c"": {""insertions"": 2, ""deletions"": 0, ""lines"": 2}, ""src/vim9compile.c"": {""insertions"": 2, ""deletions"": 1, ""lines"": 3}}"
2021-07-17 17:11:07,a9a7c0c602b231dc37c4b0f62ade0421c84fca03,Yegappan Lakshmanan,329,31,360,11,"{""src/diff.c"": {""insertions"": 9, ""deletions"": 1, ""lines"": 10}, ""src/errors.h"": {""insertions"": 4, ""deletions"": 0, ""lines"": 4}, ""src/evalfunc.c"": {""insertions"": 55, ""deletions"": 22, ""lines"": 77}, ""src/globals.h"": {""insertions"": 1, ""deletions"": 0, ""lines"": 1}, ""src/job.c"": {""insertions"": 7, ""deletions"": 0, ""lines"": 7}, ""src/proto/typval.pro"": {""insertions"": 2, ""deletions"": 0, ""lines"": 2}, ""src/strings.c"": {""insertions"": 12, ""deletions"": 0, ""lines"": 12}, ""src/terminal.c"": {""insertions"": 46, ""deletions"": 5, ""lines"": 51}, ""src/testdir/test_vim9_builtin.vim"": {""insertions"": 151, ""deletions"": 0, ""lines"": 151}, ""src/typval.c"": {""insertions"": 40, ""deletions"": 3, ""lines"": 43}, ""src/version.c"": {""insertions"": 2, ""deletions"": 0, ""lines"": 2}}"
2021-07-16 08:39:28,20c370d9f2ee89cb854054edf71f5004f6efff77,Bram Moolenaar,3,1,4,2,"{""src/testdir/test_vim9_builtin.vim"": {""insertions"": 1, ""deletions"": 1, ""lines"": 2}, ""src/version.c"": {""insertions"": 2, ""deletions"": 0, ""lines"": 2}}"
2021-07-15 21:44:54,f5f1b59d3b98f1a00180cbaf0a12115fb58b573a,Bram Moolenaar,3,1,4,2,"{""src/userfunc.c"": {""insertions"": 1, ""deletions"": 1, ""lines"": 2}, ""src/version.c"": {""insertions"": 2, ""deletions"": 0, ""lines"": 2}}"
2021-07-15 21:15:59,d8cee76b498507c48706f651aeb78b93b5376d00,Bram Moolenaar,3,1,4,2,"{""src/userfunc.c"": {""insertions"": 1, ""deletions"": 1, ""lines"": 2}, ""src/version.c"": {""insertions"": 2, ""deletions"": 0, ""lines"": 2}}"
2021-07-15 20:03:50,5245beb37cb52991a745644c20d7ca1b0138ef2c,Bram Moolenaar,47,6,53,4,"{""src/testdir/test_vim9_expr.vim"": {""insertions"": 2, ""deletions"": 1, ""lines"": 3}, ""src/testdir/test_vim9_func.vim"": {""insertions"": 10, ""deletions"": 0, ""lines"": 10}, ""src/userfunc.c"": {""insertions"": 33, ""deletions"": 5, ""lines"": 38}, ""src/version.c"": {""insertions"": 2, ""deletions"": 0, ""lines"": 2}}"
2021-07-15 17:23:18,378697ac58b8f9705286e36d1805a052e96fb86e,Bram Moolenaar,14,1,15,3,"{""src/testdir/test_vim9_assign.vim"": {""insertions"": 10, ""deletions"": 0, ""lines"": 10}, ""src/version.c"": {""insertions"": 2, ""deletions"": 0, ""lines"": 2}, ""src/vim9compile.c"": {""insertions"": 2, ""deletions"": 1, ""lines"": 3}}"
2021-07-15 16:14:56,547f94f33098b060da9d62c29d9fcbe9bf1e2b11,Bram Moolenaar,18,16,34,2,"{""src/tag.c"": {""insertions"": 16, ""deletions"": 16, ""lines"": 32}, ""src/version.c"": {""insertions"": 2, ""deletions"": 0, ""lines"": 2}}"
2021-07-15 16:09:53,b5841b99e678da187b68c21f46d56a608a0dc10c,Bram Moolenaar,44,1,45,3,"{""src/testdir/test_vim9_script.vim"": {""insertions"": 40, ""deletions"": 0, ""lines"": 40}, ""src/version.c"": {""insertions"": 2, ""deletions"": 0, ""lines"": 2}, ""src/vim9execute.c"": {""insertions"": 2, ""deletions"": 1, ""lines"": 3}}"
2021-07-15 13:40:58,9e60e899ee546a8a35c4cbe0319971719c1839e9,Bram Moolenaar,12,0,12,3,"{""src/testdir/test_vim9_expr.vim"": {""insertions"": 7, ""deletions"": 0, ""lines"": 7}, ""src/version.c"": {""insertions"": 2, ""deletions"": 0, ""lines"": 2}, ""src/vim9compile.c"": {""insertions"": 3, ""deletions"": 0, ""lines"": 3}}"
2021-07-15 12:14:30,0894e0d8087aad4d467fd7b3d87b1930fe661916,Bram Moolenaar,6,1,7,2,"{""src/dosinst.c"": {""insertions"": 4, ""deletions"": 1, ""lines"": 5}, ""src/version.c"": {""insertions"": 2, ""deletions"": 0, ""lines"": 2}}"
2021-07-15 11:13:39,1557b16dad2b1a3466a93d015575cd7fdb4661c9,Wei-Chung Wen,36,0,36,3,"{""src/quickfix.c"": {""insertions"": 1, ""deletions"": 0, ""lines"": 1}, ""src/testdir/test_quickfix.vim"": {""insertions"": 33, ""deletions"": 0, ""lines"": 33}, ""src/version.c"": {""insertions"": 2, ""deletions"": 0, ""lines"": 2}}"
2021-07-15 10:49:58,1a71d31bf34b0b2b08517903826004ec6fd440e5,Yegappan Lakshmanan,780,269,1049,22,"{""runtime/doc/channel.txt"": {""insertions"": 1, ""deletions"": 1, ""lines"": 2}, ""src/clientserver.c"": {""insertions"": 8, ""deletions"": 1, ""lines"": 9}, ""src/cmdhist.c"": {""insertions"": 6, ""deletions"": 0, ""lines"": 6}, ""src/errors.h"": {""insertions"": 2, ""deletions"": 0, ""lines"": 2}, ""src/evalfunc.c"": {""insertions"": 144, ""deletions"": 105, ""lines"": 249}, ""src/evalwindow.c"": {""insertions"": 6, ""deletions"": 0, ""lines"": 6}, ""src/filepath.c"": {""insertions"": 6, ""deletions"": 0, ""lines"": 6}, ""src/globals.h"": {""insertions"": 1, ""deletions"": 0, ""lines"": 1}, ""src/popupwin.c"": {""insertions"": 40, ""deletions"": 10, ""lines"": 50}, ""src/proto/typval.pro"": {""insertions"": 1, ""deletions"": 0, ""lines"": 1}, ""src/sign.c"": {""insertions"": 4, ""deletions"": 0, ""lines"": 4}, ""src/strings.c"": {""insertions"": 23, ""deletions"": 2, ""lines"": 25}, ""src/terminal.c"": {""insertions"": 5, ""deletions"": 0, ""lines"": 5}, ""src/testdir/test_normal.vim"": {""insertions"": 1, ""deletions"": 1, ""lines"": 2}, ""src/testdir/test_reltime.vim"": {""insertions"": 2, ""deletions"": 2, ""lines"": 4}, ""src/testdir/test_vim9_builtin.vim"": {""insertions"": 474, ""deletions"": 131, ""lines"": 605}, ""src/testdir/test_vim9_expr.vim"": {""insertions"": 1, ""deletions"": 1, ""lines"": 2}, ""src/testing.c"": {""insertions"": 12, ""deletions"": 3, ""lines"": 15}, ""src/textprop.c"": {""insertions"": 8, ""deletions"": 1, ""lines"": 9}, ""src/time.c"": {""insertions"": 16, ""deletions"": 11, ""lines"": 27}, ""src/typval.c"": {""insertions"": 17, ""deletions"": 0, ""lines"": 17}, ""src/version.c"": {""insertions"": 2, ""deletions"": 0, ""lines"": 2}}"
2021-07-14 19:00:41,c816a2c22667108fcd61f445de2c926f78ff9fa7,Bram Moolenaar,27,0,27,3,"{""src/testdir/test_vim9_builtin.vim"": {""insertions"": 13, ""deletions"": 0, ""lines"": 13}, ""src/time.c"": {""insertions"": 12, ""deletions"": 0, ""lines"": 12}, ""src/version.c"": {""insertions"": 2, ""deletions"": 0, ""lines"": 2}}"
2021-07-14 18:00:27,4a0b85ad0193ac162e2d8458e4b1c5ad2e2b0193,Christian Brabandt,100,1,101,5,"{""runtime/doc/options.txt"": {""insertions"": 4, ""deletions"": 1, ""lines"": 5}, ""src/indent.c"": {""insertions"": 23, ""deletions"": 0, ""lines"": 23}, ""src/structs.h"": {""insertions"": 1, ""deletions"": 0, ""lines"": 1}, ""src/testdir/test_breakindent.vim"": {""insertions"": 70, ""deletions"": 0, ""lines"": 70}, ""src/version.c"": {""insertions"": 2, ""deletions"": 0, ""lines"": 2}}"
2021-07-13 20:21:44,5bea41dea34bcc73c4efb1b554ad0a2018966ecc,Bram Moolenaar,8,3,11,2,"{""src/change.c"": {""insertions"": 6, ""deletions"": 3, ""lines"": 9}, ""src/version.c"": {""insertions"": 2, ""deletions"": 0, ""lines"": 2}}"
2021-07-13 18:32:29,1840a7b4e3577e617f724c9d07ccc78195cc010a,Bram Moolenaar,11,1,12,3,"{""src/evalfunc.c"": {""insertions"": 4, ""deletions"": 1, ""lines"": 5}, ""src/testdir/test_functions.vim"": {""insertions"": 5, ""deletions"": 0, ""lines"": 5}, ""src/version.c"": {""insertions"": 2, ""deletions"": 0, ""lines"": 2}}"
2021-07-13 17:09:12,16e26a31161d65baca7885c46c43ab4a48399c92,Christian Brabandt,4,2,6,2,"{""src/testdir/test_crypt.vim"": {""insertions"": 2, ""deletions"": 2, ""lines"": 4}, ""src/version.c"": {""insertions"": 2, ""deletions"": 0, ""lines"": 2}}"
2021-07-12 20:15:24,ee41052ccb65f8109f285fc43eed3e232de68375,Dominique Pelle,3,0,3,2,"{""src/testdir/test_vim9_builtin.vim"": {""insertions"": 1, ""deletions"": 0, ""lines"": 1}, ""src/version.c"": {""insertions"": 2, ""deletions"": 0, ""lines"": 2}}"
2021-07-12 19:43:19,042414fa0053388f9a35cad61886405507554068,Dominique Pelle,65,0,65,3,"{""src/testdir/test_options.vim"": {""insertions"": 44, ""deletions"": 0, ""lines"": 44}, ""src/testdir/test_set.vim"": {""insertions"": 19, ""deletions"": 0, ""lines"": 19}, ""src/version.c"": {""insertions"": 2, ""deletions"": 0, ""lines"": 2}}"
2021-07-11 20:04:25,841e498c5d1765eab17bce5242543b47dfc25b41,Yegappan Lakshmanan,21,3,24,3,"{""src/evalfunc.c"": {""insertions"": 4, ""deletions"": 3, ""lines"": 7}, ""src/testdir/test_vim9_builtin.vim"": {""insertions"": 15, ""deletions"": 0, ""lines"": 15}, ""src/version.c"": {""insertions"": 2, ""deletions"": 0, ""lines"": 2}}"
2021-07-11 19:51:17,7b7a118e74d25ff35cd277c2bb5191ae44bb20b2,Tsuyoshi CHO,49,3,52,3,"{""src/misc1.c"": {""insertions"": 18, ""deletions"": 3, ""lines"": 21}, ""src/testdir/test_buffer.vim"": {""insertions"": 29, ""deletions"": 0, ""lines"": 29}, ""src/version.c"": {""insertions"": 2, ""deletions"": 0, ""lines"": 2}}"
2021-07-11 18:59:00,11005b078d2485a306c74f77c9dd158fdd7f3cbe,Bram Moolenaar,11,1,12,3,"{""src/evalvars.c"": {""insertions"": 2, ""deletions"": 1, ""lines"": 3}, ""src/testdir/test_vim9_expr.vim"": {""insertions"": 7, ""deletions"": 0, ""lines"": 7}, ""src/version.c"": {""insertions"": 2, ""deletions"": 0, ""lines"": 2}}"
2021-07-11 18:22:30,ffcfddc759e583471a1ed55e0938d042bf68c507,Bram Moolenaar,30,5,35,3,"{""src/testdir/test_vim9_script.vim"": {""insertions"": 17, ""deletions"": 0, ""lines"": 17}, ""src/version.c"": {""insertions"": 2, ""deletions"": 0, ""lines"": 2}, ""src/vim9compile.c"": {""insertions"": 11, ""deletions"": 5, ""lines"": 16}}"
2021-07-11 17:44:18,c72bdd28ac5fe079825155930af8e792580139bb,Yegappan Lakshmanan,118,21,139,4,"{""src/evalfunc.c"": {""insertions"": 51, ""deletions"": 19, ""lines"": 70}, ""src/testdir/test_vim9_builtin.vim"": {""insertions"": 62, ""deletions"": 2, ""lines"": 64}, ""src/testing.c"": {""insertions"": 3, ""deletions"": 0, ""lines"": 3}, ""src/version.c"": {""insertions"": 2, ""deletions"": 0, ""lines"": 2}}"
2021-07-11 17:12:04,cc7eb2aa7a7f2e6ae41f1e7cf60965c083d8a9e9,Bram Moolenaar,52,4,56,5,"{""src/message.c"": {""insertions"": 20, ""deletions"": 1, ""lines"": 21}, ""src/proto/message.pro"": {""insertions"": 1, ""deletions"": 0, ""lines"": 1}, ""src/testdir/test_usercommands.vim"": {""insertions"": 20, ""deletions"": 2, ""lines"": 22}, ""src/usercmd.c"": {""insertions"": 9, ""deletions"": 1, ""lines"": 10}, ""src/version.c"": {""insertions"": 2, ""deletions"": 0, ""lines"": 2}}"
2021-07-11 16:23:19,5231224e11bf468f5366a7400414368908c40795,Bram Moolenaar,17,1,18,4,"{""src/evalfunc.c"": {""insertions"": 2, ""deletions"": 1, ""lines"": 3}, ""src/testdir/test_vim9_builtin.vim"": {""insertions"": 2, ""deletions"": 0, ""lines"": 2}, ""src/version.c"": {""insertions"": 2, ""deletions"": 0, ""lines"": 2}, ""src/vim9compile.c"": {""insertions"": 11, ""deletions"": 0, ""lines"": 11}}"
2021-07-11 15:55:01,648594eaf703fe9a862cb12a35702a10aff6e5a9,Bram Moolenaar,34,15,49,4,"{""src/testdir/test_vim9_script.vim"": {""insertions"": 13, ""deletions"": 3, ""lines"": 16}, ""src/version.c"": {""insertions"": 2, ""deletions"": 0, ""lines"": 2}, ""src/vim9compile.c"": {""insertions"": 10, ""deletions"": 0, ""lines"": 10}, ""src/vim9execute.c"": {""insertions"": 9, ""deletions"": 12, ""lines"": 21}}"
2021-07-11 14:52:45,c03fe66ade4c79a4eb5fc05d1d549c8f931a04b6,Bram Moolenaar,16,0,16,3,"{""src/eval.c"": {""insertions"": 4, ""deletions"": 0, ""lines"": 4}, ""src/testdir/test_vim9_script.vim"": {""insertions"": 10, ""deletions"": 0, ""lines"": 10}, ""src/version.c"": {""insertions"": 2, ""deletions"": 0, ""lines"": 2}}"
2021-07-11 14:31:51,4ece152ad60c4fbd5b98b849a39b8ad9a987d319,Bram Moolenaar,4,0,4,2,"{""src/testdir/test_vim9_script.vim"": {""insertions"": 2, ""deletions"": 0, ""lines"": 2}, ""src/version.c"": {""insertions"": 2, ""deletions"": 0, ""lines"": 2}}"
2021-07-11 14:01:58,0f1227f7d5a3e368f61d396c1640088c079fef91,Bram Moolenaar,27,2,29,4,"{""src/errors.h"": {""insertions"": 2, ""deletions"": 0, ""lines"": 2}, ""src/eval.c"": {""insertions"": 2, ""deletions"": 0, ""lines"": 2}, ""src/testdir/test_vim9_builtin.vim"": {""insertions"": 21, ""deletions"": 2, ""lines"": 23}, ""src/version.c"": {""insertions"": 2, ""deletions"": 0, ""lines"": 2}}"
2021-07-11 13:26:13,d9162550aa47ca3865a5cadf78ff2212a1d8eca7,Bram Moolenaar,20,0,20,3,"{""src/testdir/test_vim9_script.vim"": {""insertions"": 13, ""deletions"": 0, ""lines"": 13}, ""src/version.c"": {""insertions"": 2, ""deletions"": 0, ""lines"": 2}, ""src/vim9compile.c"": {""insertions"": 5, ""deletions"": 0, ""lines"": 5}}"
2021-07-11 12:55:49,1aeddeb8bd29a69fa118734c7f27d7df1b37801f,Bram Moolenaar,10,1,11,3,"{""src/evalfunc.c"": {""insertions"": 2, ""deletions"": 1, ""lines"": 3}, ""src/testdir/test_vim9_builtin.vim"": {""insertions"": 6, ""deletions"": 0, ""lines"": 6}, ""src/version.c"": {""insertions"": 2, ""deletions"": 0, ""lines"": 2}}"
2021-07-11 12:28:25,de69a7353e9bec552e15dbe3706a9f4e88080fce,Martin Tournoij,23,27,50,4,"{""src/errors.h"": {""insertions"": 2, ""deletions"": 0, ""lines"": 2}, ""src/testdir/test_usercommands.vim"": {""insertions"": 17, ""deletions"": 19, ""lines"": 36}, ""src/usercmd.c"": {""insertions"": 2, ""deletions"": 8, ""lines"": 10}, ""src/version.c"": {""insertions"": 2, ""deletions"": 0, ""lines"": 2}}"
2021-07-10 20:21:40,482d2f37a5ce43157ab1e22c26f389770d0c20cf,Bram Moolenaar,5,3,8,2,"{""src/testdir/test_channel.vim"": {""insertions"": 3, ""deletions"": 3, ""lines"": 6}, ""src/version.c"": {""insertions"": 2, ""deletions"": 0, ""lines"": 2}}"
2021-07-10 19:29:18,a2438132a675be4dde3acbdf03ba1fdb2f09427c,Yegappan Lakshmanan,1673,1627,3300,21,"{""Filelist"": {""insertions"": 2, ""deletions"": 0, ""lines"": 2}, ""src/Make_ami.mak"": {""insertions"": 1, ""deletions"": 0, ""lines"": 1}, ""src/Make_cyg_ming.mak"": {""insertions"": 1, ""deletions"": 0, ""lines"": 1}, ""src/Make_mvc.mak"": {""insertions"": 4, ""deletions"": 0, ""lines"": 4}, ""src/Make_vms.mms"": {""insertions"": 6, ""deletions"": 0, ""lines"": 6}, ""src/Makefile"": {""insertions"": 10, ""deletions"": 0, ""lines"": 10}, ""src/README.md"": {""insertions"": 1, ""deletions"": 0, ""lines"": 1}, ""src/eval.c"": {""insertions"": 3, ""deletions"": 46, ""lines"": 49}, ""src/evalfunc.c"": {""insertions"": 0, ""deletions"": 825, ""lines"": 825}, ""src/mbyte.c"": {""insertions"": 31, ""deletions"": 0, ""lines"": 31}, ""src/misc1.c"": {""insertions"": 2, ""deletions"": 24, ""lines"": 26}, ""src/misc2.c"": {""insertions"": 0, ""deletions"": 706, ""lines"": 706}, ""src/proto.h"": {""insertions"": 1, ""deletions"": 0, ""lines"": 1}, ""src/proto/eval.pro"": {""insertions"": 0, ""deletions"": 3, ""lines"": 3}, ""src/proto/evalfunc.pro"": {""insertions"": 0, ""deletions"": 1, ""lines"": 1}, ""src/proto/mbyte.pro"": {""insertions"": 1, ""deletions"": 0, ""lines"": 1}, ""src/proto/misc1.pro"": {""insertions"": 0, ""deletions"": 1, ""lines"": 1}, ""src/proto/misc2.pro"": {""insertions"": 0, ""deletions"": 21, ""lines"": 21}, ""src/proto/strings.pro"": {""insertions"": 45, ""deletions"": 0, ""lines"": 45}, ""src/strings.c"": {""insertions"": 1563, ""deletions"": 0, ""lines"": 1563}, ""src/version.c"": {""insertions"": 2, ""deletions"": 0, ""lines"": 2}}"
2021-07-10 18:43:59,31e21766d6fb0a386e15ccc8c2192f6a3a210f53,Bram Moolenaar,9,7,16,2,"{""src/testdir/test_debugger.vim"": {""insertions"": 7, ""deletions"": 7, ""lines"": 14}, ""src/version.c"": {""insertions"": 2, ""deletions"": 0, ""lines"": 2}}"
2021-07-10 17:42:03,c323527d67081cfaff22503d1d282495976c7042,Bram Moolenaar,76,15,91,7,"{""src/errors.h"": {""insertions"": 2, ""deletions"": 0, ""lines"": 2}, ""src/ex_eval.c"": {""insertions"": 19, ""deletions"": 2, ""lines"": 21}, ""src/testdir/test_vim9_expr.vim"": {""insertions"": 1, ""deletions"": 1, ""lines"": 2}, ""src/testdir/test_vim9_func.vim"": {""insertions"": 3, ""deletions"": 3, ""lines"": 6}, ""src/testdir/test_vim9_script.vim"": {""insertions"": 17, ""deletions"": 2, ""lines"": 19}, ""src/version.c"": {""insertions"": 2, ""deletions"": 0, ""lines"": 2}, ""src/vim9compile.c"": {""insertions"": 32, ""deletions"": 7, ""lines"": 39}}"
2021-07-10 15:59:48,fe3418abe0dac65e42e85b5a91c5d0c975bc65bb,Dominique Pelle,22,0,22,3,"{""src/testdir/test_cd.vim"": {""insertions"": 16, ""deletions"": 0, ""lines"": 16}, ""src/testdir/test_swap.vim"": {""insertions"": 4, ""deletions"": 0, ""lines"": 4}, ""src/version.c"": {""insertions"": 2, ""deletions"": 0, ""lines"": 2}}"
2021-07-10 11:15:41,5b73992d8f82be7ac4b6f46c17f53ffb9640e5fa,Yegappan Lakshmanan,563,186,749,12,"{""src/channel.c"": {""insertions"": 5, ""deletions"": 0, ""lines"": 5}, ""src/errors.h"": {""insertions"": 2, ""deletions"": 0, ""lines"": 2}, ""src/evalfunc.c"": {""insertions"": 94, ""deletions"": 70, ""lines"": 164}, ""src/proto/typval.pro"": {""insertions"": 1, ""deletions"": 0, ""lines"": 1}, ""src/terminal.c"": {""insertions"": 5, ""deletions"": 0, ""lines"": 5}, ""src/testdir/test_search.vim"": {""insertions"": 6, ""deletions"": 6, ""lines"": 12}, ""src/testdir/test_textprop.vim"": {""insertions"": 1, ""deletions"": 1, ""lines"": 2}, ""src/testdir/test_vim9_builtin.vim"": {""insertions"": 421, ""deletions"": 103, ""lines"": 524}, ""src/testing.c"": {""insertions"": 4, ""deletions"": 1, ""lines"": 5}, ""src/textprop.c"": {""insertions"": 1, ""deletions"": 1, ""lines"": 2}, ""src/typval.c"": {""insertions"": 21, ""deletions"": 4, ""lines"": 25}, ""src/version.c"": {""insertions"": 2, ""deletions"": 0, ""lines"": 2}}"
2021-07-09 17:53:57,9da32e4d578f4e93ef5397f9dd13e2c28b2a2595,Bram Moolenaar,9,1,10,3,"{""src/testdir/test_vim9_builtin.vim"": {""insertions"": 6, ""deletions"": 0, ""lines"": 6}, ""src/version.c"": {""insertions"": 2, ""deletions"": 0, ""lines"": 2}, ""src/vim9type.c"": {""insertions"": 1, ""deletions"": 1, ""lines"": 2}}"
2021-07-09 17:17:55,90fba5627b361dbc970b3afc2eebf7411c49a0cc,Bram Moolenaar,4,1,5,2,"{""src/list.c"": {""insertions"": 2, ""deletions"": 1, ""lines"": 3}, ""src/version.c"": {""insertions"": 2, ""deletions"": 0, ""lines"": 2}}"
2021-07-09 13:54:00,6bcb18253a392cf75d3784953ef9c71de7af9019,Bram Moolenaar,3,1,4,2,"{""src/drawscreen.c"": {""insertions"": 1, ""deletions"": 1, ""lines"": 2}, ""src/version.c"": {""insertions"": 2, ""deletions"": 0, ""lines"": 2}}"
2021-07-08 20:20:50,981217c11f92b37f2baa51492cbe12e85d0ea493,Bram Moolenaar,8,0,8,2,"{""src/testdir/test_channel.vim"": {""insertions"": 6, ""deletions"": 0, ""lines"": 6}, ""src/version.c"": {""insertions"": 2, ""deletions"": 0, ""lines"": 2}}"
2021-07-08 20:02:11,b885a7c72c8fed5f14454633fb3ba9d77fff1c24,Bram Moolenaar,5,3,8,2,"{""src/testdir/test_vim9_script.vim"": {""insertions"": 3, ""deletions"": 3, ""lines"": 6}, ""src/version.c"": {""insertions"": 2, ""deletions"": 0, ""lines"": 2}}"
2021-07-08 19:38:50,c967d57aa9a6bede0f50c6986dcddc1dc035a354,Bram Moolenaar,29,20,49,7,"{""src/eval.c"": {""insertions"": 1, ""deletions"": 1, ""lines"": 2}, ""src/evalvars.c"": {""insertions"": 7, ""deletions"": 6, ""lines"": 13}, ""src/proto/vim9script.pro"": {""insertions"": 1, ""deletions"": 1, ""lines"": 2}, ""src/testdir/test_vim9_script.vim"": {""insertions"": 11, ""deletions"": 3, ""lines"": 14}, ""src/userfunc.c"": {""insertions"": 1, ""deletions"": 1, ""lines"": 2}, ""src/version.c"": {""insertions"": 2, ""deletions"": 0, ""lines"": 2}, ""src/vim9script.c"": {""insertions"": 6, ""deletions"": 8, ""lines"": 14}}"
2021-07-08 18:57:24,f055d4502365f24de6c0f210a06e2c146a75dc4d,Bram Moolenaar,38,9,47,7,"{""src/eval.c"": {""insertions"": 1, ""deletions"": 1, ""lines"": 2}, ""src/evalvars.c"": {""insertions"": 19, ""deletions"": 1, ""lines"": 20}, ""src/proto/vim9script.pro"": {""insertions"": 1, ""deletions"": 1, ""lines"": 2}, ""src/testdir/test_vim9_builtin.vim"": {""insertions"": 7, ""deletions"": 0, ""lines"": 7}, ""src/userfunc.c"": {""insertions"": 1, ""deletions"": 1, ""lines"": 2}, ""src/version.c"": {""insertions"": 2, ""deletions"": 0, ""lines"": 2}, ""src/vim9script.c"": {""insertions"": 7, ""deletions"": 5, ""lines"": 12}}"
2021-07-08 18:53:40,f32f099761e5ae0603149b305a0086e4f4627d81,Bram Moolenaar,13,1,14,3,"{""src/list.c"": {""insertions"": 4, ""deletions"": 1, ""lines"": 5}, ""src/testdir/test_vim9_builtin.vim"": {""insertions"": 7, ""deletions"": 0, ""lines"": 7}, ""src/version.c"": {""insertions"": 2, ""deletions"": 0, ""lines"": 2}}"
2021-07-08 17:22:12,d4ab807d62c1a8262e78deb674c6750183bc030a,Bram Moolenaar,8,0,8,3,"{""src/ex_eval.c"": {""insertions"": 5, ""deletions"": 0, ""lines"": 5}, ""src/testdir/test_vim9_script.vim"": {""insertions"": 1, ""deletions"": 0, ""lines"": 1}, ""src/version.c"": {""insertions"": 2, ""deletions"": 0, ""lines"": 2}}"
2021-07-08 16:05:00,09f688c33aad9692276dfb68842cf0621a0e2002,=?UTF-8?q?Dundar=20G=C3=B6c?=,7,5,12,2,"{""src/regexp_nfa.c"": {""insertions"": 5, ""deletions"": 5, ""lines"": 10}, ""src/version.c"": {""insertions"": 2, ""deletions"": 0, ""lines"": 2}}"
2021-07-08 15:35:36,deb108ba0a8599c1307ddc1507c73e7b60f17d36,Bram Moolenaar,57,1,58,3,"{""src/option.c"": {""insertions"": 16, ""deletions"": 1, ""lines"": 17}, ""src/testdir/test_vim9_script.vim"": {""insertions"": 39, ""deletions"": 0, ""lines"": 39}, ""src/version.c"": {""insertions"": 2, ""deletions"": 0, ""lines"": 2}}"
2021-07-08 14:40:13,1594f313452cf6ca88375d9c8f68605a9c3c8ab5,Bram Moolenaar,25,7,32,4,"{""src/errors.h"": {""insertions"": 2, ""deletions"": 0, ""lines"": 2}, ""src/option.c"": {""insertions"": 7, ""deletions"": 2, ""lines"": 9}, ""src/testdir/test_vim9_script.vim"": {""insertions"": 14, ""deletions"": 5, ""lines"": 19}, ""src/version.c"": {""insertions"": 2, ""deletions"": 0, ""lines"": 2}}"
2021-07-08 11:19:31,30441bb3d5fa73f888b09684db3f54ff5ab48dbc,Bram Moolenaar,33,1,34,5,"{""src/move.c"": {""insertions"": 5, ""deletions"": 1, ""lines"": 6}, ""src/testdir/dumps/Test_listchars_06.dump"": {""insertions"": 10, ""deletions"": 0, ""lines"": 10}, ""src/testdir/dumps/Test_listchars_07.dump"": {""insertions"": 10, ""deletions"": 0, ""lines"": 10}, ""src/testdir/test_listchars.vim"": {""insertions"": 6, ""deletions"": 0, ""lines"": 6}, ""src/version.c"": {""insertions"": 2, ""deletions"": 0, ""lines"": 2}}"
2021-07-08 10:40:05,41fb723ee97baa2f095cde601a5a144b168b7a6b,Bram Moolenaar,87,1,88,8,"{""src/drawline.c"": {""insertions"": 3, ""deletions"": 1, ""lines"": 4}, ""src/testdir/dumps/Test_listchars_01.dump"": {""insertions"": 10, ""deletions"": 0, ""lines"": 10}, ""src/testdir/dumps/Test_listchars_02.dump"": {""insertions"": 10, ""deletions"": 0, ""lines"": 10}, ""src/testdir/dumps/Test_listchars_03.dump"": {""insertions"": 10, ""deletions"": 0, ""lines"": 10}, ""src/testdir/dumps/Test_listchars_04.dump"": {""insertions"": 10, ""deletions"": 0, ""lines"": 10}, ""src/testdir/dumps/Test_listchars_05.dump"": {""insertions"": 10, ""deletions"": 0, ""lines"": 10}, ""src/testdir/test_listchars.vim"": {""insertions"": 32, ""deletions"": 0, ""lines"": 32}, ""src/version.c"": {""insertions"": 2, ""deletions"": 0, ""lines"": 2}}"
2021-07-08 09:37:50,db8647277082a8a69a189ded8bd1408af993b54e,Bram Moolenaar,7,2,9,2,"{""src/testdir/test_crypt.vim"": {""insertions"": 5, ""deletions"": 2, ""lines"": 7}, ""src/version.c"": {""insertions"": 2, ""deletions"": 0, ""lines"": 2}}"
2021-07-07 20:13:08,6a9e5c69cf36676e65ae191264872a3e41bde37f,Bram Moolenaar,3,1,4,2,"{""src/evalfunc.c"": {""insertions"": 1, ""deletions"": 1, ""lines"": 2}, ""src/version.c"": {""insertions"": 2, ""deletions"": 0, ""lines"": 2}}"
2021-07-07 19:55:25,5ede5b231eb2269b0ef335f3cd24e4c4b1d4395b,Bram Moolenaar,9,1,10,3,"{""src/testdir/test_vim9_script.vim"": {""insertions"": 6, ""deletions"": 0, ""lines"": 6}, ""src/version.c"": {""insertions"": 2, ""deletions"": 0, ""lines"": 2}, ""src/vim9compile.c"": {""insertions"": 1, ""deletions"": 1, ""lines"": 2}}"
2021-07-07 19:21:30,efc5db5215b4efc424b2de34613525d729a05c93,Bram Moolenaar,23,3,26,5,"{""src/evalfunc.c"": {""insertions"": 7, ""deletions"": 1, ""lines"": 8}, ""src/globals.h"": {""insertions"": 1, ""deletions"": 0, ""lines"": 1}, ""src/testdir/test_vim9_script.vim"": {""insertions"": 8, ""deletions"": 0, ""lines"": 8}, ""src/version.c"": {""insertions"": 2, ""deletions"": 0, ""lines"": 2}, ""src/vim9compile.c"": {""insertions"": 5, ""deletions"": 2, ""lines"": 7}}"
2021-07-07 18:26:08,90df4b9d423485f7db16e3a65cab4f14edc815ae,Bram Moolenaar,846,194,1040,22,"{"".github/CODEOWNERS"": {""insertions"": 1, ""deletions"": 0, ""lines"": 1}, ""runtime/doc/autocmd.txt"": {""insertions"": 5, ""deletions"": 3, ""lines"": 8}, ""runtime/doc/eval.txt"": {""insertions"": 20, ""deletions"": 4, ""lines"": 24}, ""runtime/doc/gui.txt"": {""insertions"": 3, ""deletions"": 2, ""lines"": 5}, ""runtime/doc/insert.txt"": {""insertions"": 3, ""deletions"": 2, ""lines"": 5}, ""runtime/doc/repeat.txt"": {""insertions"": 2, ""deletions"": 2, ""lines"": 4}, ""runtime/doc/sponsor.txt"": {""insertions"": 3, ""deletions"": 17, ""lines"": 20}, ""runtime/doc/syntax.txt"": {""insertions"": 25, ""deletions"": 3, ""lines"": 28}, ""runtime/doc/tags"": {""insertions"": 5, ""deletions"": 0, ""lines"": 5}, ""runtime/doc/testing.txt"": {""insertions"": 3, ""deletions"": 2, ""lines"": 5}, ""runtime/doc/todo.txt"": {""insertions"": 6, ""deletions"": 7, ""lines"": 13}, ""runtime/doc/version6.txt"": {""insertions"": 2, ""deletions"": 2, ""lines"": 4}, ""runtime/doc/version8.txt"": {""insertions"": 2, ""deletions"": 2, ""lines"": 4}, ""runtime/doc/vim9.txt"": {""insertions"": 47, ""deletions"": 15, ""lines"": 62}, ""runtime/filetype.vim"": {""insertions"": 1, ""deletions"": 1, ""lines"": 2}, ""runtime/ftplugin/jsonc.vim"": {""insertions"": 27, ""deletions"": 0, ""lines"": 27}, ""runtime/indent/jsonc.vim"": {""insertions"": 189, ""deletions"": 0, ""lines"": 189}, ""runtime/indent/pascal.vim"": {""insertions"": 3, ""deletions"": 1, ""lines"": 4}, ""runtime/syntax/go.vim"": {""insertions"": 361, ""deletions"": 83, ""lines"": 444}, ""runtime/syntax/jsonc.vim"": {""insertions"": 44, ""deletions"": 0, ""lines"": 44}, ""runtime/syntax/vim.vim"": {""insertions"": 1, ""deletions"": 1, ""lines"": 2}, ""src/po/it.po"": {""insertions"": 93, ""deletions"": 47, ""lines"": 140}}"
2021-07-07 18:10:43,303215d60cece0462f040035502b5bc95373bd6e,Bram Moolenaar,19,2,21,3,"{""src/testdir/test_debugger.vim"": {""insertions"": 13, ""deletions"": 0, ""lines"": 13}, ""src/version.c"": {""insertions"": 2, ""deletions"": 0, ""lines"": 2}, ""src/vim9execute.c"": {""insertions"": 4, ""deletions"": 2, ""lines"": 6}}"
2021-07-07 17:26:19,b5098060f4acae4dac3203130278c948d670a3d5,Bram Moolenaar,4,1,5,2,"{""src/version.c"": {""insertions"": 2, ""deletions"": 0, ""lines"": 2}, ""src/window.c"": {""insertions"": 2, ""deletions"": 1, ""lines"": 3}}"
2021-07-06 18:15:46,599a6e5b3629d943a795cd69e4d3d19886f86405,=?UTF-8?q?Ola=20S=C3=B6der?=,8,4,12,2,"{""src/memline.c"": {""insertions"": 6, ""deletions"": 4, ""lines"": 10}, ""src/version.c"": {""insertions"": 2, ""deletions"": 0, ""lines"": 2}}"
2021-07-05 20:23:00,442b29c968eff1c8fec1a96418aa47be9cba62ea,Bram Moolenaar,14,7,21,3,"{""src/eval.c"": {""insertions"": 6, ""deletions"": 1, ""lines"": 7}, ""src/testdir/test_vim9_script.vim"": {""insertions"": 6, ""deletions"": 6, ""lines"": 12}, ""src/version.c"": {""insertions"": 2, ""deletions"": 0, ""lines"": 2}}"
2021-07-05 20:03:04,5cb09620c1e0a0178c0dc986230997a8aac0e61a,Bram Moolenaar,6,1,7,2,"{""src/drawscreen.c"": {""insertions"": 4, ""deletions"": 1, ""lines"": 5}, ""src/version.c"": {""insertions"": 2, ""deletions"": 0, ""lines"": 2}}"
2021-07-05 19:41:48,404557e6a60389d09bbf91dd0cf3bae11bd623b9,Bram Moolenaar,22,5,27,4,"{""src/eval.c"": {""insertions"": 9, ""deletions"": 4, ""lines"": 13}, ""src/testdir/test_vim9_script.vim"": {""insertions"": 7, ""deletions"": 0, ""lines"": 7}, ""src/version.c"": {""insertions"": 2, ""deletions"": 0, ""lines"": 2}, ""src/vim9compile.c"": {""insertions"": 4, ""deletions"": 1, ""lines"": 5}}"
2021-07-05 18:15:23,04db26b36000a4677b95403ec94bd11f6cc73975,Bram Moolenaar,183,6,189,6,"{""runtime/doc/pattern.txt"": {""insertions"": 27, ""deletions"": 4, ""lines"": 31}, ""src/errors.h"": {""insertions"": 2, ""deletions"": 0, ""lines"": 2}, ""src/regexp_bt.c"": {""insertions"": 33, ""deletions"": 1, ""lines"": 34}, ""src/regexp_nfa.c"": {""insertions"": 29, ""deletions"": 1, ""lines"": 30}, ""src/testdir/test_regexp_latin.vim"": {""insertions"": 90, ""deletions"": 0, ""lines"": 90}, ""src/version.c"": {""insertions"": 2, ""deletions"": 0, ""lines"": 2}}"
2021-07-05 15:49:02,f6d877975ba93fc9b4bee2c5d2aff88dbf9bea59,Bram Moolenaar,3,1,4,2,"{""src/testdir/check.vim"": {""insertions"": 1, ""deletions"": 1, ""lines"": 2}, ""src/version.c"": {""insertions"": 2, ""deletions"": 0, ""lines"": 2}}"
2021-07-05 12:10:04,d6fa7bd5b900dd363d3a824e0ebe3619a1634df6,Bram Moolenaar,13,3,16,4,"{""src/testdir/check.vim"": {""insertions"": 8, ""deletions"": 0, ""lines"": 8}, ""src/testdir/test_clientserver.vim"": {""insertions"": 1, ""deletions"": 3, ""lines"": 4}, ""src/testdir/test_vim9_builtin.vim"": {""insertions"": 2, ""deletions"": 0, ""lines"": 2}, ""src/version.c"": {""insertions"": 2, ""deletions"": 0, ""lines"": 2}}"
2021-07-04 21:29:30,22f85d04594e1a09936227ef62955a7939d584b4,Bram Moolenaar,14,1,15,3,"{""src/testdir/test_vim9_assign.vim"": {""insertions"": 10, ""deletions"": 0, ""lines"": 10}, ""src/userfunc.c"": {""insertions"": 2, ""deletions"": 1, ""lines"": 3}, ""src/version.c"": {""insertions"": 2, ""deletions"": 0, ""lines"": 2}}"
2021-07-04 20:48:12,6977dba04b68b91410585ada65079651788ca7dc,Bram Moolenaar,25,1,26,3,"{""src/testdir/test_vim9_assign.vim"": {""insertions"": 10, ""deletions"": 0, ""lines"": 10}, ""src/version.c"": {""insertions"": 2, ""deletions"": 0, ""lines"": 2}, ""src/vim9compile.c"": {""insertions"": 13, ""deletions"": 1, ""lines"": 14}}"
2021-07-04 18:20:52,97f227d9c9351f12138d923ffdf9232dc5520bef,Bram Moolenaar,32,3,35,4,"{""src/testdir/test_vim9_assign.vim"": {""insertions"": 6, ""deletions"": 3, ""lines"": 9}, ""src/userfunc.c"": {""insertions"": 11, ""deletions"": 0, ""lines"": 11}, ""src/version.c"": {""insertions"": 2, ""deletions"": 0, ""lines"": 2}, ""src/vim9type.c"": {""insertions"": 13, ""deletions"": 0, ""lines"": 13}}"
2021-07-04 16:28:15,b7480cd8931fa1696265f75c7d4d9fdf0be69e12,Bram Moolenaar,13,1,14,4,"{""src/globals.h"": {""insertions"": 1, ""deletions"": 1, ""lines"": 2}, ""src/testdir/test_vim9_assign.vim"": {""insertions"": 9, ""deletions"": 0, ""lines"": 9}, ""src/version.c"": {""insertions"": 2, ""deletions"": 0, ""lines"": 2}, ""src/vim9type.c"": {""insertions"": 1, ""deletions"": 0, ""lines"": 1}}"
2021-07-04 15:36:54,f33cae605064c8bdb908a8069d936f752572cd76,Bram Moolenaar,15,13,28,2,"{""src/testdir/test_swap.vim"": {""insertions"": 13, ""deletions"": 13, ""lines"": 26}, ""src/version.c"": {""insertions"": 2, ""deletions"": 0, ""lines"": 2}}"
2021-07-04 15:23:25,3777d6e32b22f0a70b774760c24160079e303bad,Bram Moolenaar,14,8,22,2,"{""src/testdir/test_swap.vim"": {""insertions"": 12, ""deletions"": 8, ""lines"": 20}, ""src/version.c"": {""insertions"": 2, ""deletions"": 0, ""lines"": 2}}"
2021-07-04 15:21:04,26e88ec8e23fa04e559044199ccb369aed29e570,Bram Moolenaar,2,0,2,1,"{""src/version.c"": {""insertions"": 2, ""deletions"": 0, ""lines"": 2}}"
2021-07-04 14:50:55,67b17a6fc62156383d24dcbd6e6df34e180d7235,Bram Moolenaar,2,1,3,1,"{""src/proto/float.pro"": {""insertions"": 2, ""deletions"": 1, ""lines"": 3}}"
2021-07-04 13:54:08,7a40ff00edd35cc4313d74a43e7a7b67cd24372d,Bram Moolenaar,35,8,43,7,"{""src/evalfunc.c"": {""insertions"": 12, ""deletions"": 0, ""lines"": 12}, ""src/proto/evalfunc.pro"": {""insertions"": 1, ""deletions"": 1, ""lines"": 2}, ""src/testdir/test_vim9_assign.vim"": {""insertions"": 9, ""deletions"": 0, ""lines"": 9}, ""src/testdir/test_vim9_expr.vim"": {""insertions"": 1, ""deletions"": 1, ""lines"": 2}, ""src/testdir/test_vim9_func.vim"": {""insertions"": 1, ""deletions"": 1, ""lines"": 2}, ""src/version.c"": {""insertions"": 2, ""deletions"": 0, ""lines"": 2}, ""src/vim9type.c"": {""insertions"": 9, ""deletions"": 5, ""lines"": 14}}"
2021-07-04 12:47:30,4197828dc666f2d258594f7f9461534d23cc50e4,Bram Moolenaar,28,6,34,4,"{""src/ex_eval.c"": {""insertions"": 12, ""deletions"": 2, ""lines"": 14}, ""src/structs.h"": {""insertions"": 5, ""deletions"": 4, ""lines"": 9}, ""src/testdir/test_vim9_script.vim"": {""insertions"": 9, ""deletions"": 0, ""lines"": 9}, ""src/version.c"": {""insertions"": 2, ""deletions"": 0, ""lines"": 2}}"
2021-07-04 12:00:55,999db2346b61e6f6e6fde2d0b56f4646a46b727d,Bram Moolenaar,12,2,14,2,"{""src/testdir/test_popupwin.vim"": {""insertions"": 10, ""deletions"": 2, ""lines"": 12}, ""src/version.c"": {""insertions"": 2, ""deletions"": 0, ""lines"": 2}}"
2021-07-04 11:27:11,1d97efce0ce31ddf0dd4c1ae2228ef4caee6880c,Bram Moolenaar,19,0,19,3,"{""src/buffer.c"": {""insertions"": 5, ""deletions"": 0, ""lines"": 5}, ""src/testdir/test_swap.vim"": {""insertions"": 12, ""deletions"": 0, ""lines"": 12}, ""src/version.c"": {""insertions"": 2, ""deletions"": 0, ""lines"": 2}}"
2021-07-04 10:30:06,6c72fd51a899e6f0c272b08b9784d3c7a3cede20,Dominique Pelle,5,3,8,4,"{""src/testdir/test_debugger.vim"": {""insertions"": 1, ""deletions"": 2, ""lines"": 3}, ""src/testdir/test_lambda.vim"": {""insertions"": 1, ""deletions"": 0, ""lines"": 1}, ""src/testdir/test_visual.vim"": {""insertions"": 1, ""deletions"": 1, ""lines"": 2}, ""src/version.c"": {""insertions"": 2, ""deletions"": 0, ""lines"": 2}}"
2021-07-03 20:15:17,b17ab86e7b8712206aa9ea7198c28db969e25936,Bram Moolenaar,43,3,46,4,"{""src/drawscreen.c"": {""insertions"": 30, ""deletions"": 3, ""lines"": 33}, ""src/testdir/dumps/Test_visual_block_with_virtualedit2.dump"": {""insertions"": 8, ""deletions"": 0, ""lines"": 8}, ""src/testdir/test_visual.vim"": {""insertions"": 3, ""deletions"": 0, ""lines"": 3}, ""src/version.c"": {""insertions"": 2, ""deletions"": 0, ""lines"": 2}}"
2021-07-03 19:41:38,c60e959cba03fae9cff9b2674fab646cc70819fc,Dominique Pelle,3,0,3,2,"{""src/testdir/test_popupwin.vim"": {""insertions"": 1, ""deletions"": 0, ""lines"": 1}, ""src/version.c"": {""insertions"": 2, ""deletions"": 0, ""lines"": 2}}"
2021-07-03 19:37:59,fb773a3e0aa9466bb953c29bad0bf4ba34461a40,Bram Moolenaar,15,0,15,3,"{""src/testdir/check.vim"": {""insertions"": 11, ""deletions"": 0, ""lines"": 11}, ""src/testdir/test_gui.vim"": {""insertions"": 2, ""deletions"": 0, ""lines"": 2}, ""src/version.c"": {""insertions"": 2, ""deletions"": 0, ""lines"": 2}}"
2021-07-03 17:27:37,74509239df107b04abe4f30ada12109629c85939,Dominique Pelle,13,2,15,3,"{""runtime/doc/eval.txt"": {""insertions"": 7, ""deletions"": 0, ""lines"": 7}, ""src/testdir/test_vim9_builtin.vim"": {""insertions"": 4, ""deletions"": 2, ""lines"": 6}, ""src/version.c"": {""insertions"": 2, ""deletions"": 0, ""lines"": 2}}"
2021-07-03 16:56:53,e28d9b3bd4de2c7288add83ec35dc001ba280617,Bram Moolenaar,13,4,17,4,"{""src/structs.h"": {""insertions"": 2, ""deletions"": 0, ""lines"": 2}, ""src/testdir/test_vim9_func.vim"": {""insertions"": 6, ""deletions"": 0, ""lines"": 6}, ""src/version.c"": {""insertions"": 2, ""deletions"": 0, ""lines"": 2}, ""src/vim9compile.c"": {""insertions"": 3, ""deletions"": 4, ""lines"": 7}}"
2021-07-03 16:04:11,00aaa512d5e775e0db21e251f43d7afb8fca910f,Bram Moolenaar,8,0,8,2,"{""src/drawscreen.c"": {""insertions"": 6, ""deletions"": 0, ""lines"": 6}, ""src/version.c"": {""insertions"": 2, ""deletions"": 0, ""lines"": 2}}"
2021-07-03 14:33:16,20cc52832067d22a3cd47dfb0805251228c32e7d,Bram Moolenaar,30,31,61,2,"{""src/userfunc.c"": {""insertions"": 28, ""deletions"": 31, ""lines"": 59}, ""src/version.c"": {""insertions"": 2, ""deletions"": 0, ""lines"": 2}}"
2021-07-03 13:08:37,9cee4a1c9c69542ccd73bcd2db05920150856361,Bram Moolenaar,34,1,35,4,"{""src/drawscreen.c"": {""insertions"": 3, ""deletions"": 1, ""lines"": 4}, ""src/testdir/dumps/Test_visual_block_with_virtualedit.dump"": {""insertions"": 8, ""deletions"": 0, ""lines"": 8}, ""src/testdir/test_visual.vim"": {""insertions"": 21, ""deletions"": 0, ""lines"": 21}, ""src/version.c"": {""insertions"": 2, ""deletions"": 0, ""lines"": 2}}"
2021-07-03 11:51:44,fcde67c99fbb6d7294e01b9e87d8d2ae7af31255,Bram Moolenaar,6,0,6,3,"{""runtime/filetype.vim"": {""insertions"": 3, ""deletions"": 0, ""lines"": 3}, ""src/testdir/test_filetype.vim"": {""insertions"": 1, ""deletions"": 0, ""lines"": 1}, ""src/version.c"": {""insertions"": 2, ""deletions"": 0, ""lines"": 2}}"
2021-07-03 11:36:31,6fc016168249360f0524b68f72cf33efd0574d40,Bram Moolenaar,30,0,30,3,"{""src/testdir/test_debugger.vim"": {""insertions"": 16, ""deletions"": 0, ""lines"": 16}, ""src/version.c"": {""insertions"": 2, ""deletions"": 0, ""lines"": 2}, ""src/vim9compile.c"": {""insertions"": 12, ""deletions"": 0, ""lines"": 12}}"
2021-07-03 11:09:37,acbb4b5720fc27b8b07357b763ed4e5a944ae1da,Izhak Jakov,6,0,6,3,"{""runtime/filetype.vim"": {""insertions"": 3, ""deletions"": 0, ""lines"": 3}, ""src/testdir/test_filetype.vim"": {""insertions"": 1, ""deletions"": 0, ""lines"": 1}, ""src/version.c"": {""insertions"": 2, ""deletions"": 0, ""lines"": 2}}"
2021-07-03 09:58:12,a26f56f67502c72d44c61afdede2206cdde47c17,Yegappan Lakshmanan,645,146,791,6,"{""src/evalfunc.c"": {""insertions"": 150, ""deletions"": 103, ""lines"": 253}, ""src/testdir/test_functions.vim"": {""insertions"": 5, ""deletions"": 3, ""lines"": 8}, ""src/testdir/test_glob2regpat.vim"": {""insertions"": 2, ""deletions"": 1, ""lines"": 3}, ""src/testdir/test_vim9_builtin.vim"": {""insertions"": 486, ""deletions"": 32, ""lines"": 518}, ""src/testdir/test_vim9_expr.vim"": {""insertions"": 0, ""deletions"": 7, ""lines"": 7}, ""src/version.c"": {""insertions"": 2, ""deletions"": 0, ""lines"": 2}}"
2021-07-02 18:19:31,72463f883cdfd08e29ab0018ef3889284848d5f1,Christian Brabandt,6,1,7,3,"{""src/mbyte.c"": {""insertions"": 2, ""deletions"": 1, ""lines"": 3}, ""src/testdir/test_functions.vim"": {""insertions"": 2, ""deletions"": 0, ""lines"": 2}, ""src/version.c"": {""insertions"": 2, ""deletions"": 0, ""lines"": 2}}"
2021-07-01 20:11:28,b836f631dba2534efd314a8f77439cebc75acd4e,Bram Moolenaar,27,3,30,4,"{""src/channel.c"": {""insertions"": 8, ""deletions"": 3, ""lines"": 11}, ""src/testdir/test_channel.py"": {""insertions"": 5, ""deletions"": 0, ""lines"": 5}, ""src/testdir/test_channel.vim"": {""insertions"": 12, ""deletions"": 0, ""lines"": 12}, ""src/version.c"": {""insertions"": 2, ""deletions"": 0, ""lines"": 2}}"
2021-06-30 20:01:02,11a632d60bde616feb298d180108819ebb1d04a0,Alisue,5,2,7,2,"{""src/channel.c"": {""insertions"": 3, ""deletions"": 2, ""lines"": 5}, ""src/version.c"": {""insertions"": 2, ""deletions"": 0, ""lines"": 2}}"
2021-06-30 19:30:10,576cb75ceb38ed077938d4a1c1265095050f6105,Yegappan Lakshmanan,25,5,30,2,"{""src/testdir/test_recover.vim"": {""insertions"": 23, ""deletions"": 5, ""lines"": 28}, ""src/version.c"": {""insertions"": 2, ""deletions"": 0, ""lines"": 2}}"
2021-06-30 18:56:00,a3d1b29bd36487167c98b3cefa30f06c529e412d,Mike Williams,118,52,170,10,"{""runtime/doc/eval.txt"": {""insertions"": 9, ""deletions"": 7, ""lines"": 16}, ""runtime/doc/options.txt"": {""insertions"": 13, ""deletions"": 15, ""lines"": 28}, ""runtime/doc/os_dos.txt"": {""insertions"": 52, ""deletions"": 12, ""lines"": 64}, ""runtime/doc/os_win32.txt"": {""insertions"": 1, ""deletions"": 0, ""lines"": 1}, ""src/fileio.c"": {""insertions"": 5, ""deletions"": 2, ""lines"": 7}, ""src/misc2.c"": {""insertions"": 7, ""deletions"": 7, ""lines"": 14}, ""src/option.c"": {""insertions"": 9, ""deletions"": 3, ""lines"": 12}, ""src/os_win32.c"": {""insertions"": 5, ""deletions"": 2, ""lines"": 7}, ""src/testdir/test_shell.vim"": {""insertions"": 15, ""deletions"": 4, ""lines"": 19}, ""src/version.c"": {""insertions"": 2, ""deletions"": 0, ""lines"": 2}}"
2021-06-30 18:39:15,834193afd7195bc96026d2aed696d64f8075cd35,Bram Moolenaar,39,4,43,4,"{""src/testdir/test_vim9_script.vim"": {""insertions"": 19, ""deletions"": 0, ""lines"": 19}, ""src/version.c"": {""insertions"": 2, ""deletions"": 0, ""lines"": 2}, ""src/vim9compile.c"": {""insertions"": 8, ""deletions"": 1, ""lines"": 9}, ""src/vim9execute.c"": {""insertions"": 10, ""deletions"": 3, ""lines"": 13}}"
2021-06-30 17:54:43,d3d8feeb897a6b956fc82c81448b938a53312d71,Bram Moolenaar,57,9,66,3,"{""src/testdir/test_vim9_script.vim"": {""insertions"": 35, ""deletions"": 0, ""lines"": 35}, ""src/version.c"": {""insertions"": 2, ""deletions"": 0, ""lines"": 2}, ""src/vim9execute.c"": {""insertions"": 20, ""deletions"": 9, ""lines"": 29}}"
2021-06-30 10:02:24,3f987b59173926420998ca92eb71688ee3e4a3e3,Bram Moolenaar,32,1,33,3,"{""src/testdir/test_vim9_script.vim"": {""insertions"": 26, ""deletions"": 0, ""lines"": 26}, ""src/version.c"": {""insertions"": 2, ""deletions"": 0, ""lines"": 2}, ""src/vim9execute.c"": {""insertions"": 4, ""deletions"": 1, ""lines"": 5}}"
2021-06-29 18:36:25,80b2ba3e9602e09ab523e78946fbb26da311b68b,=?UTF-8?q?J=C3=BCrgen=20Weigert?=,6,8,14,3,"{""src/testdir/test_xxd.vim"": {""insertions"": 1, ""deletions"": 1, ""lines"": 2}, ""src/version.c"": {""insertions"": 2, ""deletions"": 0, ""lines"": 2}, ""src/xxd/xxd.c"": {""insertions"": 3, ""deletions"": 7, ""lines"": 10}}"
2021-06-29 18:22:32,ea042677ab5cab736540f3164909cac2c685de74,Bram Moolenaar,43,15,58,8,"{""src/edit.c"": {""insertions"": 12, ""deletions"": 3, ""lines"": 15}, ""src/normal.c"": {""insertions"": 4, ""deletions"": 4, ""lines"": 8}, ""src/proto/screen.pro"": {""insertions"": 1, ""deletions"": 1, ""lines"": 2}, ""src/screen.c"": {""insertions"": 12, ""deletions"": 2, ""lines"": 14}, ""src/testdir/dumps/Test_popupwin_atcursor_pos.dump"": {""insertions"": 4, ""deletions"": 4, ""lines"": 8}, ""src/testdir/test_popupwin.vim"": {""insertions"": 7, ""deletions"": 0, ""lines"": 7}, ""src/ui.c"": {""insertions"": 1, ""deletions"": 1, ""lines"": 2}, ""src/version.c"": {""insertions"": 2, ""deletions"": 0, ""lines"": 2}}"
2021-06-29 16:54:35,4067bd3604215b48e4b4201e28f9e401b08418e4,Bram Moolenaar,100,25,125,4,"{""src/ops.c"": {""insertions"": 49, ""deletions"": 20, ""lines"": 69}, ""src/testdir/test_blockedit.vim"": {""insertions"": 48, ""deletions"": 0, ""lines"": 48}, ""src/testdir/test_visual.vim"": {""insertions"": 1, ""deletions"": 5, ""lines"": 6}, ""src/version.c"": {""insertions"": 2, ""deletions"": 0, ""lines"": 2}}"
2021-06-28 19:54:27,7d7bcc6ba01454c1cbb1dcbf5f11c3a4051535d6,Bram Moolenaar,25,1,26,3,"{""src/register.c"": {""insertions"": 3, ""deletions"": 1, ""lines"": 4}, ""src/testdir/test_visual.vim"": {""insertions"": 20, ""deletions"": 0, ""lines"": 20}, ""src/version.c"": {""insertions"": 2, ""deletions"": 0, ""lines"": 2}}"
2021-06-28 18:53:58,127950241e84c822d3c50f46a00d42a70d2d5cb6,Mike Williams,206,49,255,9,"{""runtime/doc/eval.txt"": {""insertions"": 7, ""deletions"": 4, ""lines"": 11}, ""runtime/doc/options.txt"": {""insertions"": 33, ""deletions"": 23, ""lines"": 56}, ""runtime/doc/os_dos.txt"": {""insertions"": 42, ""deletions"": 3, ""lines"": 45}, ""src/fileio.c"": {""insertions"": 3, ""deletions"": 2, ""lines"": 5}, ""src/misc2.c"": {""insertions"": 39, ""deletions"": 10, ""lines"": 49}, ""src/option.c"": {""insertions"": 49, ""deletions"": 4, ""lines"": 53}, ""src/os_win32.c"": {""insertions"": 2, ""deletions"": 1, ""lines"": 3}, ""src/testdir/test_shell.vim"": {""insertions"": 29, ""deletions"": 2, ""lines"": 31}, ""src/version.c"": {""insertions"": 2, ""deletions"": 0, ""lines"": 2}}"
2021-06-27 20:09:59,ffec6dd16a766180429addaa78928c773a3c9832,Yegappan Lakshmanan,43,25,68,3,"{""src/testdir/test_shell.vim"": {""insertions"": 41, ""deletions"": 4, ""lines"": 45}, ""src/testdir/test_startup.vim"": {""insertions"": 0, ""deletions"": 21, ""lines"": 21}, ""src/version.c"": {""insertions"": 2, ""deletions"": 0, ""lines"": 2}}"
2021-06-27 20:03:33,108010aa4720ef023a8ac59004fc0f2bc11125af,Bram Moolenaar,130,109,239,32,"{""src/arglist.c"": {""insertions"": 2, ""deletions"": 2, ""lines"": 4}, ""src/buffer.c"": {""insertions"": 2, ""deletions"": 2, ""lines"": 4}, ""src/channel.c"": {""insertions"": 2, ""deletions"": 2, ""lines"": 4}, ""src/errors.h"": {""insertions"": 38, ""deletions"": 0, ""lines"": 38}, ""src/eval.c"": {""insertions"": 8, ""deletions"": 8, ""lines"": 16}, ""src/evalfunc.c"": {""insertions"": 1, ""deletions"": 1, ""lines"": 2}, ""src/evalvars.c"": {""insertions"": 4, ""deletions"": 4, ""lines"": 8}, ""src/evalwindow.c"": {""insertions"": 3, ""deletions"": 3, ""lines"": 6}, ""src/ex_cmds.c"": {""insertions"": 6, ""deletions"": 6, ""lines"": 12}, ""src/ex_docmd.c"": {""insertions"": 29, ""deletions"": 28, ""lines"": 57}, ""src/ex_getln.c"": {""insertions"": 1, ""deletions"": 1, ""lines"": 2}, ""src/filepath.c"": {""insertions"": 2, ""deletions"": 2, ""lines"": 4}, ""src/fold.c"": {""insertions"": 1, ""deletions"": 1, ""lines"": 2}, ""src/getchar.c"": {""insertions"": 1, ""deletions"": 1, ""lines"": 2}, ""src/globals.h"": {""insertions"": 0, ""deletions"": 20, ""lines"": 20}, ""src/indent.c"": {""insertions"": 1, ""deletions"": 1, ""lines"": 2}, ""src/list.c"": {""insertions"": 1, ""deletions"": 1, ""lines"": 2}, ""src/map.c"": {""insertions"": 1, ""deletions"": 1, ""lines"": 2}, ""src/mark.c"": {""insertions"": 2, ""deletions"": 2, ""lines"": 4}, ""src/normal.c"": {""insertions"": 3, ""deletions"": 3, ""lines"": 6}, ""src/ops.c"": {""insertions"": 1, ""deletions"": 1, ""lines"": 2}, ""src/optionstr.c"": {""insertions"": 2, ""deletions"": 2, ""lines"": 4}, ""src/popupwin.c"": {""insertions"": 1, ""deletions"": 1, ""lines"": 2}, ""src/quickfix.c"": {""insertions"": 3, ""deletions"": 3, ""lines"": 6}, ""src/spellfile.c"": {""insertions"": 2, ""deletions"": 2, ""lines"": 4}, ""src/textprop.c"": {""insertions"": 4, ""deletions"": 4, ""lines"": 8}, ""src/typval.c"": {""insertions"": 1, ""deletions"": 1, ""lines"": 2}, ""src/undo.c"": {""insertions"": 1, ""deletions"": 1, ""lines"": 2}, ""src/userfunc.c"": {""insertions"": 1, ""deletions"": 1, ""lines"": 2}, ""src/version.c"": {""insertions"": 2, ""deletions"": 0, ""lines"": 2}, ""src/vim9compile.c"": {""insertions"": 2, ""deletions"": 2, ""lines"": 4}, ""src/window.c"": {""insertions"": 2, ""deletions"": 2, ""lines"": 4}}"
2021-06-27 19:30:14,d887297ad0164516dd52cdab0308c3626337d124,Christian Brabandt,78,35,113,3,"{""runtime/tools/unicode.vim"": {""insertions"": 21, ""deletions"": 5, ""lines"": 26}, ""src/mbyte.c"": {""insertions"": 55, ""deletions"": 30, ""lines"": 85}, ""src/version.c"": {""insertions"": 2, ""deletions"": 0, ""lines"": 2}}"
2021-06-27 17:02:52,1d1ce613cdc74721499660b1d8911de164e2862d,Bram Moolenaar,14,1,15,4,"{""src/evalfunc.c"": {""insertions"": 7, ""deletions"": 0, ""lines"": 7}, ""src/testdir/test_gui.vim"": {""insertions"": 4, ""deletions"": 0, ""lines"": 4}, ""src/testing.c"": {""insertions"": 1, ""deletions"": 1, ""lines"": 2}, ""src/version.c"": {""insertions"": 2, ""deletions"": 0, ""lines"": 2}}"
2021-06-27 14:29:53,17d868b8b268c9b9670421039d1a772341937add,Bram Moolenaar,31,2,33,3,"{""src/testdir/test_debugger.vim"": {""insertions"": 28, ""deletions"": 1, ""lines"": 29}, ""src/version.c"": {""insertions"": 2, ""deletions"": 0, ""lines"": 2}, ""src/vim9compile.c"": {""insertions"": 1, ""deletions"": 1, ""lines"": 2}}"
2021-06-27 13:35:40,577dc93da9ec78684576bff71328d40f24bd6dd8,Bram Moolenaar,26,2,28,3,"{""src/testdir/test_vim9_script.vim"": {""insertions"": 21, ""deletions"": 0, ""lines"": 21}, ""src/version.c"": {""insertions"": 2, ""deletions"": 0, ""lines"": 2}, ""src/vim9compile.c"": {""insertions"": 3, ""deletions"": 2, ""lines"": 5}}"
2021-06-27 13:18:56,4d8f476176eadfc745bcb8e143460029048f858d,Bram Moolenaar,5057,2577,7634,30,"{""nsis/README.txt"": {""insertions"": 1, ""deletions"": 1, ""lines"": 2}, ""runtime/autoload/rubycomplete.vim"": {""insertions"": 3, ""deletions"": 8, ""lines"": 11}, ""runtime/doc/arabic.txt"": {""insertions"": 8, ""deletions"": 1, ""lines"": 9}, ""runtime/doc/change.txt"": {""insertions"": 8, ""deletions"": 5, ""lines"": 13}, ""runtime/doc/eval.txt"": {""insertions"": 24, ""deletions"": 14, ""lines"": 38}, ""runtime/doc/ft_ps1.txt"": {""insertions"": 1, ""deletions"": 1, ""lines"": 2}, ""runtime/doc/ft_raku.txt"": {""insertions"": 1, ""deletions"": 1, ""lines"": 2}, ""runtime/doc/index.txt"": {""insertions"": 2, ""deletions"": 1, ""lines"": 3}, ""runtime/doc/motion.txt"": {""insertions"": 2, ""deletions"": 2, ""lines"": 4}, ""runtime/doc/options.txt"": {""insertions"": 5, ""deletions"": 3, ""lines"": 8}, ""runtime/doc/repeat.txt"": {""insertions"": 11, ""deletions"": 1, ""lines"": 12}, ""runtime/doc/rileft.txt"": {""insertions"": 2, ""deletions"": 2, ""lines"": 4}, ""runtime/doc/syntax.txt"": {""insertions"": 4, ""deletions"": 4, ""lines"": 8}, ""runtime/doc/tags"": {""insertions"": 17, ""deletions"": 2, ""lines"": 19}, ""runtime/doc/testing.txt"": {""insertions"": 1, ""deletions"": 1, ""lines"": 2}, ""runtime/doc/todo.txt"": {""insertions"": 16, ""deletions"": 6, ""lines"": 22}, ""runtime/doc/vim9.txt"": {""insertions"": 12, ""deletions"": 2, ""lines"": 14}, ""runtime/ftplugin/eruby.vim"": {""insertions"": 2, ""deletions"": 2, ""lines"": 4}, ""runtime/ftplugin/ruby.vim"": {""insertions"": 2, ""deletions"": 2, ""lines"": 4}, ""runtime/gvim.desktop"": {""insertions"": 5, ""deletions"": 1, ""lines"": 6}, ""runtime/indent/ruby.vim"": {""insertions"": 1, ""deletions"": 0, ""lines"": 1}, ""runtime/syntax/8th.vim"": {""insertions"": 1, ""deletions"": 1, ""lines"": 2}, ""runtime/syntax/help.vim"": {""insertions"": 2, ""deletions"": 1, ""lines"": 3}, ""runtime/syntax/redif.vim"": {""insertions"": 2, ""deletions"": 2, ""lines"": 4}, ""runtime/syntax/ruby.vim"": {""insertions"": 10, ""deletions"": 10, ""lines"": 20}, ""runtime/syntax/vim.vim"": {""insertions"": 22, ""deletions"": 17, ""lines"": 39}, ""runtime/vim.desktop"": {""insertions"": 5, ""deletions"": 1, ""lines"": 6}, ""src/po/gvim.desktop.in"": {""insertions"": 0, ""deletions"": 1, ""lines"": 1}, ""src/po/it.po"": {""insertions"": 4887, ""deletions"": 2483, ""lines"": 7370}, ""src/po/vim.desktop.in"": {""insertions"": 0, ""deletions"": 1, ""lines"": 1}}"
2021-06-27 13:04:05,e65081d1b591f16dc6e380a830d87565c5eb7b03,Bram Moolenaar,51,23,74,3,"{""src/eval.c"": {""insertions"": 25, ""deletions"": 8, ""lines"": 33}, ""src/testdir/test_vim9_assign.vim"": {""insertions"": 24, ""deletions"": 15, ""lines"": 39}, ""src/version.c"": {""insertions"": 2, ""deletions"": 0, ""lines"": 2}}"
2021-06-27 12:08:24,65aee0b714e809b9f19862f3decd35055ed4de10,Bram Moolenaar,22,2,24,3,"{""src/bufwrite.c"": {""insertions"": 12, ""deletions"": 2, ""lines"": 14}, ""src/fileio.c"": {""insertions"": 8, ""deletions"": 0, ""lines"": 8}, ""src/version.c"": {""insertions"": 2, ""deletions"": 0, ""lines"": 2}}"
2021-06-27 11:04:00,4cd5c52d64a66ad1984d33462a40e0c6721ca232,Bram Moolenaar,31,4,35,4,"{""src/memline.c"": {""insertions"": 6, ""deletions"": 4, ""lines"": 10}, ""src/structs.h"": {""insertions"": 1, ""deletions"": 0, ""lines"": 1}, ""src/testdir/test_textprop.vim"": {""insertions"": 22, ""deletions"": 0, ""lines"": 22}, ""src/version.c"": {""insertions"": 2, ""deletions"": 0, ""lines"": 2}}"
2021-06-27 10:07:49,054794c20f6322bbd9482c4124041dc0a140c78e,Yegappan Lakshmanan,163,89,252,6,"{""src/testdir/Make_all.mak"": {""insertions"": 2, ""deletions"": 0, ""lines"": 2}, ""src/testdir/test_functions.vim"": {""insertions"": 0, ""deletions"": 25, ""lines"": 25}, ""src/testdir/test_options.vim"": {""insertions"": 0, ""deletions"": 28, ""lines"": 28}, ""src/testdir/test_shell.vim"": {""insertions"": 159, ""deletions"": 0, ""lines"": 159}, ""src/testdir/test_system.vim"": {""insertions"": 0, ""deletions"": 36, ""lines"": 36}, ""src/version.c"": {""insertions"": 2, ""deletions"": 0, ""lines"": 2}}"
2021-06-26 20:22:38,98f9a5f4cbe6061e09bccf6074afe0a88a504219,Bram Moolenaar,8,2,10,3,"{""src/testdir/test_vim9_func.vim"": {""insertions"": 3, ""deletions"": 0, ""lines"": 3}, ""src/userfunc.c"": {""insertions"": 3, ""deletions"": 2, ""lines"": 5}, ""src/version.c"": {""insertions"": 2, ""deletions"": 0, ""lines"": 2}}"
2021-06-26 20:17:35,e3ffaa6b7c2d53ab53da933ec91382d003cf9a12,Bram Moolenaar,22,17,39,2,"{""src/userfunc.c"": {""insertions"": 20, ""deletions"": 17, ""lines"": 37}, ""src/version.c"": {""insertions"": 2, ""deletions"": 0, ""lines"": 2}}"
2021-06-26 19:52:02,015cf103115f9a0380ae3e3e85a77792cfe87d49,Bram Moolenaar,15,1,16,3,"{""src/testdir/test_vim9_func.vim"": {""insertions"": 7, ""deletions"": 0, ""lines"": 7}, ""src/userfunc.c"": {""insertions"": 6, ""deletions"": 1, ""lines"": 7}, ""src/version.c"": {""insertions"": 2, ""deletions"": 0, ""lines"": 2}}"
2021-06-26 19:21:03,307dec4567e0f64a7a4cfc2d5302d2aba26db775,Bram Moolenaar,3,1,4,2,"{""src/version.c"": {""insertions"": 2, ""deletions"": 0, ""lines"": 2}, ""src/vim9.h"": {""insertions"": 1, ""deletions"": 1, ""lines"": 2}}"
2021-06-26 17:25:49,14ded11fcad77ebf41032ec80a95d516ca9acb1c,Bram Moolenaar,9,1,10,3,"{""src/testdir/test_vim9_func.vim"": {""insertions"": 6, ""deletions"": 0, ""lines"": 6}, ""src/userfunc.c"": {""insertions"": 1, ""deletions"": 1, ""lines"": 2}, ""src/version.c"": {""insertions"": 2, ""deletions"": 0, ""lines"": 2}}"
2021-06-26 13:00:59,3a3b10e87a10dd0bc355618dbfc4a0a6c828aad7,Bram Moolenaar,21,2,23,6,"{""src/errors.h"": {""insertions"": 2, ""deletions"": 0, ""lines"": 2}, ""src/eval.c"": {""insertions"": 7, ""deletions"": 1, ""lines"": 8}, ""src/testdir/test_let.vim"": {""insertions"": 1, ""deletions"": 1, ""lines"": 2}, ""src/testdir/test_listdict.vim"": {""insertions"": 3, ""deletions"": 0, ""lines"": 3}, ""src/testdir/test_vim9_assign.vim"": {""insertions"": 6, ""deletions"": 0, ""lines"": 6}, ""src/version.c"": {""insertions"": 2, ""deletions"": 0, ""lines"": 2}}"
2021-06-26 11:59:29,4d5dfe20839e9d13c95eaf4254467f952653b042,Bram Moolenaar,18,3,21,4,"{""src/errors.h"": {""insertions"": 1, ""deletions"": 1, ""lines"": 2}, ""src/testdir/test_vim9_assign.vim"": {""insertions"": 10, ""deletions"": 0, ""lines"": 10}, ""src/version.c"": {""insertions"": 2, ""deletions"": 0, ""lines"": 2}, ""src/vim9compile.c"": {""insertions"": 5, ""deletions"": 2, ""lines"": 7}}"
2021-06-26 11:28:35,13e45d14ba7f590fb243c041bc45e6d4d47c8432,Bram Moolenaar,19,11,30,3,"{""src/testdir/test_vim9_assign.vim"": {""insertions"": 15, ""deletions"": 10, ""lines"": 25}, ""src/version.c"": {""insertions"": 2, ""deletions"": 0, ""lines"": 2}, ""src/vim9compile.c"": {""insertions"": 2, ""deletions"": 1, ""lines"": 3}}"
2021-06-26 11:00:49,ce024c3e20839465dc8c8f79dcccc5414dd8c506,Bram Moolenaar,42,19,61,3,"{""src/testdir/test_vim9_func.vim"": {""insertions"": 17, ""deletions"": 0, ""lines"": 17}, ""src/version.c"": {""insertions"": 2, ""deletions"": 0, ""lines"": 2}, ""src/vim9compile.c"": {""insertions"": 23, ""deletions"": 19, ""lines"": 42}}"
2021-06-26 10:40:56,444d878324525787e55185ce3c3e29a3de9b700a,Bram Moolenaar,16,4,20,3,"{""src/testdir/test_vim9_script.vim"": {""insertions"": 7, ""deletions"": 0, ""lines"": 7}, ""src/version.c"": {""insertions"": 2, ""deletions"": 0, ""lines"": 2}, ""src/vim9compile.c"": {""insertions"": 7, ""deletions"": 4, ""lines"": 11}}"
2021-06-26 10:02:55,f3caeb63d62c08b579e9b5f40b35e8bf64dde87a,Austin Gatlin,60,2,62,4,"{""runtime/autoload/dist/ft.vim"": {""insertions"": 11, ""deletions"": 0, ""lines"": 11}, ""runtime/filetype.vim"": {""insertions"": 9, ""deletions"": 2, ""lines"": 11}, ""src/testdir/test_filetype.vim"": {""insertions"": 38, ""deletions"": 0, ""lines"": 38}, ""src/version.c"": {""insertions"": 2, ""deletions"": 0, ""lines"": 2}}"
2021-06-25 19:54:25,6582e230a0f6592287b1123c5fc3807d6fed997e,Kevin Locke,6,1,7,3,"{""runtime/filetype.vim"": {""insertions"": 3, ""deletions"": 0, ""lines"": 3}, ""src/testdir/test_filetype.vim"": {""insertions"": 1, ""deletions"": 1, ""lines"": 2}, ""src/version.c"": {""insertions"": 2, ""deletions"": 0, ""lines"": 2}}"
2021-06-25 19:31:09,22480d147fe83cb31316d2dabc5c5f249477af15,Bram Moolenaar,23,0,23,5,"{""src/errors.h"": {""insertions"": 2, ""deletions"": 0, ""lines"": 2}, ""src/testdir/test_vim9_assign.vim"": {""insertions"": 6, ""deletions"": 0, ""lines"": 6}, ""src/version.c"": {""insertions"": 2, ""deletions"": 0, ""lines"": 2}, ""src/vim9compile.c"": {""insertions"": 6, ""deletions"": 0, ""lines"": 6}, ""src/vim9script.c"": {""insertions"": 7, ""deletions"": 0, ""lines"": 7}}"
2021-06-25 17:29:30,f3d30842dcc8ef4134da462bd4197ae2e2c6c0c1,Bram Moolenaar,14,4,18,4,"{""src/ex_cmds.h"": {""insertions"": 2, ""deletions"": 2, ""lines"": 4}, ""src/testdir/test_vim9_assign.vim"": {""insertions"": 4, ""deletions"": 0, ""lines"": 4}, ""src/version.c"": {""insertions"": 2, ""deletions"": 0, ""lines"": 2}, ""src/vim9script.c"": {""insertions"": 6, ""deletions"": 2, ""lines"": 8}}"
2021-06-24 19:43:31,b420ac9d20d484ba0ebf3e328069251a63f96996,ola.soder@axis.com,3,1,4,2,"{""src/os_amiga.c"": {""insertions"": 1, ""deletions"": 1, ""lines"": 2}, ""src/version.c"": {""insertions"": 2, ""deletions"": 0, ""lines"": 2}}"
2021-06-24 17:55:27,98703d7f6c9a0ef9e54cb291a92342b9f96db732,Christian Brabandt,5,3,8,4,"{""src/VisVim/README_VisVim.txt"": {""insertions"": 1, ""deletions"": 1, ""lines"": 2}, ""src/evalfunc.c"": {""insertions"": 1, ""deletions"": 1, ""lines"": 2}, ""src/testdir/vim9.vim"": {""insertions"": 1, ""deletions"": 1, ""lines"": 2}, ""src/version.c"": {""insertions"": 2, ""deletions"": 0, ""lines"": 2}}"
2021-06-24 16:50:30,3a62b14077c51c739cdc755356882b40c299f1c0,ola.soder@axis.com,4,2,6,2,"{""src/os_amiga.c"": {""insertions"": 2, ""deletions"": 2, ""lines"": 4}, ""src/version.c"": {""insertions"": 2, ""deletions"": 0, ""lines"": 2}}"
2021-06-23 20:05:27,d415d269130b233c0f198c75cc159bee721aa55c,ola.soder@axis.com,55,6,61,2,"{""src/os_amiga.c"": {""insertions"": 53, ""deletions"": 6, ""lines"": 59}, ""src/version.c"": {""insertions"": 2, ""deletions"": 0, ""lines"": 2}}"
2021-06-23 19:44:06,6738fd2000f0bea4d40f4a8651e0e1f4b0503bb3,Bram Moolenaar,4,2,6,2,"{""src/testdir/test_swap.vim"": {""insertions"": 2, ""deletions"": 2, ""lines"": 4}, ""src/version.c"": {""insertions"": 2, ""deletions"": 0, ""lines"": 2}}"
2021-06-23 19:13:20,44dea9da4b2a21dd1e03f2bd94b4f2679d4613e5,Bram Moolenaar,13,2,15,2,"{""src/os_unix.c"": {""insertions"": 11, ""deletions"": 2, ""lines"": 13}, ""src/version.c"": {""insertions"": 2, ""deletions"": 0, ""lines"": 2}}"
2021-06-23 18:46:52,18d46587b985923ef4b90b19a0cf37a094607fec,Yegappan Lakshmanan,174,5,179,9,"{""runtime/doc/eval.txt"": {""insertions"": 2, ""deletions"": 0, ""lines"": 2}, ""runtime/doc/testing.txt"": {""insertions"": 18, ""deletions"": 3, ""lines"": 21}, ""runtime/doc/usr_41.txt"": {""insertions"": 1, ""deletions"": 0, ""lines"": 1}, ""src/evalfunc.c"": {""insertions"": 2, ""deletions"": 0, ""lines"": 2}, ""src/gui.c"": {""insertions"": 1, ""deletions"": 0, ""lines"": 1}, ""src/proto/testing.pro"": {""insertions"": 1, ""deletions"": 0, ""lines"": 1}, ""src/testdir/test_gui.vim"": {""insertions"": 89, ""deletions"": 0, ""lines"": 89}, ""src/testing.c"": {""insertions"": 58, ""deletions"": 2, ""lines"": 60}, ""src/version.c"": {""insertions"": 2, ""deletions"": 0, ""lines"": 2}}"
2021-06-23 18:20:53,8cec9273d2518f2a9abcbd326722a2eba38d2a13,Bram Moolenaar,48,14,62,6,"{""src/testdir/test_debugger.vim"": {""insertions"": 14, ""deletions"": 1, ""lines"": 15}, ""src/testdir/test_vim9_disassemble.vim"": {""insertions"": 12, ""deletions"": 6, ""lines"": 18}, ""src/version.c"": {""insertions"": 2, ""deletions"": 0, ""lines"": 2}, ""src/vim9.h"": {""insertions"": 8, ""deletions"": 2, ""lines"": 10}, ""src/vim9compile.c"": {""insertions"": 6, ""deletions"": 1, ""lines"": 7}, ""src/vim9execute.c"": {""insertions"": 6, ""deletions"": 4, ""lines"": 10}}"
2021-06-23 13:52:46,cc6504098605f894b557109b618e88913a89914b,ola.soder@axis.com,5,0,5,2,"{""src/os_amiga.c"": {""insertions"": 3, ""deletions"": 0, ""lines"": 3}, ""src/version.c"": {""insertions"": 2, ""deletions"": 0, ""lines"": 2}}"
2021-06-23 13:41:52,8ce3ca8961c5968a02de0a0b98f906695331f254,ichizok,5,3,8,3,"{""src/auto/configure"": {""insertions"": 2, ""deletions"": 2, ""lines"": 4}, ""src/configure.ac"": {""insertions"": 1, ""deletions"": 1, ""lines"": 2}, ""src/version.c"": {""insertions"": 2, ""deletions"": 0, ""lines"": 2}}"
2021-06-22 17:52:27,7237cab8f1d1a4391372cafdb57f2d97f3b32d05,Yegappan Lakshmanan,400,72,472,7,"{""src/evalfunc.c"": {""insertions"": 68, ""deletions"": 64, ""lines"": 132}, ""src/testdir/test_assert.vim"": {""insertions"": 2, ""deletions"": 0, ""lines"": 2}, ""src/testdir/test_gui.vim"": {""insertions"": 62, ""deletions"": 1, ""lines"": 63}, ""src/testdir/test_popupwin.vim"": {""insertions"": 2, ""deletions"": 2, ""lines"": 4}, ""src/testdir/test_vim9_builtin.vim"": {""insertions"": 237, ""deletions"": 0, ""lines"": 237}, ""src/testing.c"": {""insertions"": 27, ""deletions"": 5, ""lines"": 32}, ""src/version.c"": {""insertions"": 2, ""deletions"": 0, ""lines"": 2}}"
2021-06-22 17:32:17,831bdf8622fdfce7f02d48f847005e3909a055a8,Bram Moolenaar,18,2,20,3,"{""src/testdir/test_vim9_func.vim"": {""insertions"": 14, ""deletions"": 0, ""lines"": 14}, ""src/version.c"": {""insertions"": 2, ""deletions"": 0, ""lines"": 2}, ""src/vim9type.c"": {""insertions"": 2, ""deletions"": 2, ""lines"": 4}}"
2021-06-22 16:21:19,ef7be8348fd830e409504a442f3f3ad0931cfbc3,Christian Brabandt,3,1,4,2,"{"".github/workflows/ci.yml"": {""insertions"": 1, ""deletions"": 1, ""lines"": 2}, ""src/version.c"": {""insertions"": 2, ""deletions"": 0, ""lines"": 2}}"
2021-06-21 19:55:18,419a40ac9657e39646b2e0f3f71d7736b0c459d1,Bram Moolenaar,23,4,27,3,"{""src/ex_cmds.c"": {""insertions"": 17, ""deletions"": 4, ""lines"": 21}, ""src/testdir/test_global.vim"": {""insertions"": 4, ""deletions"": 0, ""lines"": 4}, ""src/version.c"": {""insertions"": 2, ""deletions"": 0, ""lines"": 2}}"
2021-06-21 19:08:08,226b28b96150e59375d2bff44e0aadd382b0c3f1,Christian Brabandt,68,21,89,7,"{""src/Make_mvc.mak"": {""insertions"": 9, ""deletions"": 5, ""lines"": 14}, ""src/crypt.c"": {""insertions"": 50, ""deletions"": 11, ""lines"": 61}, ""src/errors.h"": {""insertions"": 1, ""deletions"": 1, ""lines"": 2}, ""src/fileio.c"": {""insertions"": 3, ""deletions"": 1, ""lines"": 4}, ""src/memline.c"": {""insertions"": 2, ""deletions"": 1, ""lines"": 3}, ""src/proto/crypt.pro"": {""insertions"": 1, ""deletions"": 2, ""lines"": 3}, ""src/version.c"": {""insertions"": 2, ""deletions"": 0, ""lines"": 2}}"
2021-06-21 18:48:58,22f17a29cd0b0cc3107dc6cd1d96c62eee52a7d9,Bram Moolenaar,22,1,23,3,"{""src/testdir/test_vim9_func.vim"": {""insertions"": 18, ""deletions"": 0, ""lines"": 18}, ""src/userfunc.c"": {""insertions"": 2, ""deletions"": 1, ""lines"": 3}, ""src/version.c"": {""insertions"": 2, ""deletions"": 0, ""lines"": 2}}"
2021-06-21 18:15:37,cb54bc65625abad9a0af501acac5c70fba17e2cc,Dominique Pelle,9,7,16,3,"{""src/crypt.c"": {""insertions"": 5, ""deletions"": 5, ""lines"": 10}, ""src/errors.h"": {""insertions"": 2, ""deletions"": 2, ""lines"": 4}, ""src/version.c"": {""insertions"": 2, ""deletions"": 0, ""lines"": 2}}"
2021-06-21 17:44:11,035bd1c99f2a8eda5ee886adde4f97ea71fb167f,Bram Moolenaar,96,20,116,7,"{""src/ex_docmd.c"": {""insertions"": 11, ""deletions"": 2, ""lines"": 13}, ""src/testdir/test_vim9_assign.vim"": {""insertions"": 23, ""deletions"": 0, ""lines"": 23}, ""src/testdir/test_vim9_disassemble.vim"": {""insertions"": 31, ""deletions"": 0, ""lines"": 31}, ""src/version.c"": {""insertions"": 2, ""deletions"": 0, ""lines"": 2}, ""src/vim9.h"": {""insertions"": 7, ""deletions"": 0, ""lines"": 7}, ""src/vim9compile.c"": {""insertions"": 14, ""deletions"": 12, ""lines"": 26}, ""src/vim9execute.c"": {""insertions"": 8, ""deletions"": 6, ""lines"": 14}}"
2021-06-21 16:44:26,f1e7449d567c630601aa0cec6c663b791785a668,Yegappan Lakshmanan,337,5,342,9,"{""runtime/doc/eval.txt"": {""insertions"": 2, ""deletions"": 0, ""lines"": 2}, ""runtime/doc/testing.txt"": {""insertions"": 25, ""deletions"": 1, ""lines"": 26}, ""runtime/doc/usr_41.txt"": {""insertions"": 1, ""deletions"": 0, ""lines"": 1}, ""src/evalfunc.c"": {""insertions"": 2, ""deletions"": 0, ""lines"": 2}, ""src/proto/testing.pro"": {""insertions"": 1, ""deletions"": 0, ""lines"": 1}, ""src/testdir/test_gui.vim"": {""insertions"": 223, ""deletions"": 1, ""lines"": 224}, ""src/testdir/test_viminfo.vim"": {""insertions"": 67, ""deletions"": 3, ""lines"": 70}, ""src/testing.c"": {""insertions"": 14, ""deletions"": 0, ""lines"": 14}, ""src/version.c"": {""insertions"": 2, ""deletions"": 0, ""lines"": 2}}"
2021-06-20 18:09:42,2ac4b2536a40e5cd75b4ff7a3d44a282d2f4f008,Bram Moolenaar,27,0,27,3,"{""src/testdir/test_debugger.vim"": {""insertions"": 22, ""deletions"": 0, ""lines"": 22}, ""src/version.c"": {""insertions"": 2, ""deletions"": 0, ""lines"": 2}, ""src/vim9execute.c"": {""insertions"": 3, ""deletions"": 0, ""lines"": 3}}"
2021-06-20 17:28:14,4f8f54280fa728b7d5a63b67d02b60a3b3dce543,Bram Moolenaar,71,6,77,7,"{""src/debugger.c"": {""insertions"": 1, ""deletions"": 1, ""lines"": 2}, ""src/structs.h"": {""insertions"": 5, ""deletions"": 0, ""lines"": 5}, ""src/testdir/test_debugger.vim"": {""insertions"": 25, ""deletions"": 0, ""lines"": 25}, ""src/version.c"": {""insertions"": 2, ""deletions"": 0, ""lines"": 2}, ""src/vim.h"": {""insertions"": 2, ""deletions"": 2, ""lines"": 4}, ""src/vim9.h"": {""insertions"": 1, ""deletions"": 1, ""lines"": 2}, ""src/vim9execute.c"": {""insertions"": 35, ""deletions"": 2, ""lines"": 37}}"
2021-06-20 14:31:00,0d5e1ec37fbe75e18acba6f650c59bf91063108c,shane.xb.qian,38,1,39,2,"{""src/testdir/test_quickfix.vim"": {""insertions"": 36, ""deletions"": 1, ""lines"": 37}, ""src/version.c"": {""insertions"": 2, ""deletions"": 0, ""lines"": 2}}"
2021-06-20 13:03:15,2fb1b89d721682585228f9a6ee7da4b6d3c6634d,Bram Moolenaar,3,1,4,2,"{""src/testdir/test_execute_func.vim"": {""insertions"": 1, ""deletions"": 1, ""lines"": 2}, ""src/version.c"": {""insertions"": 2, ""deletions"": 0, ""lines"": 2}}"
2021-06-20 12:41:01,ca81f0e834640cf3465b3b742e60c12e8a0956f2,Bram Moolenaar,37,1,38,3,"{""src/evalfunc.c"": {""insertions"": 23, ""deletions"": 1, ""lines"": 24}, ""src/testdir/test_vim9_builtin.vim"": {""insertions"": 12, ""deletions"": 0, ""lines"": 12}, ""src/version.c"": {""insertions"": 2, ""deletions"": 0, ""lines"": 2}}"
2021-06-20 12:02:16,f573c6e1ed58d46d694c802eaf5ae3662a952744,Christian Brabandt,820,64,884,29,"{"".github/workflows/ci.yml"": {""insertions"": 2, ""deletions"": 1, ""lines"": 3}, ""runtime/doc/eval.txt"": {""insertions"": 1, ""deletions"": 0, ""lines"": 1}, ""runtime/doc/options.txt"": {""insertions"": 17, ""deletions"": 0, ""lines"": 17}, ""runtime/doc/various.txt"": {""insertions"": 1, ""deletions"": 0, ""lines"": 1}, ""src/INSTALLpc.txt"": {""insertions"": 3, ""deletions"": 0, ""lines"": 3}, ""src/Make_cyg_ming.mak"": {""insertions"": 13, ""deletions"": 2, ""lines"": 15}, ""src/Make_mvc.mak"": {""insertions"": 26, ""deletions"": 3, ""lines"": 29}, ""src/auto/configure"": {""insertions"": 66, ""deletions"": 0, ""lines"": 66}, ""src/blowfish.c"": {""insertions"": 4, ""deletions"": 3, ""lines"": 7}, ""src/bufwrite.c"": {""insertions"": 17, ""deletions"": 2, ""lines"": 19}, ""src/config.h.in"": {""insertions"": 1, ""deletions"": 0, ""lines"": 1}, ""src/configure.ac"": {""insertions"": 37, ""deletions"": 0, ""lines"": 37}, ""src/crypt.c"": {""insertions"": 359, ""deletions"": 26, ""lines"": 385}, ""src/crypt_zip.c"": {""insertions"": 4, ""deletions"": 2, ""lines"": 6}, ""src/errors.h"": {""insertions"": 19, ""deletions"": 0, ""lines"": 19}, ""src/evalfunc.c"": {""insertions"": 7, ""deletions"": 0, ""lines"": 7}, ""src/feature.h"": {""insertions"": 7, ""deletions"": 0, ""lines"": 7}, ""src/fileio.c"": {""insertions"": 38, ""deletions"": 2, ""lines"": 40}, ""src/memline.c"": {""insertions"": 30, ""deletions"": 8, ""lines"": 38}, ""src/option.c"": {""insertions"": 4, ""deletions"": 0, ""lines"": 4}, ""src/optionstr.c"": {""insertions"": 5, ""deletions"": 1, ""lines"": 6}, ""src/proto/blowfish.pro"": {""insertions"": 2, ""deletions"": 2, ""lines"": 4}, ""src/proto/crypt.pro"": {""insertions"": 11, ""deletions"": 3, ""lines"": 14}, ""src/proto/crypt_zip.pro"": {""insertions"": 2, ""deletions"": 2, ""lines"": 4}, ""src/structs.h"": {""insertions"": 3, ""deletions"": 2, ""lines"": 5}, ""src/testdir/samples/crypt_sodium_invalid.txt"": {""insertions"": 0, ""deletions"": 0, ""lines"": 0}, ""src/testdir/test_crypt.vim"": {""insertions"": 126, ""deletions"": 1, ""lines"": 127}, ""src/undo.c"": {""insertions"": 8, ""deletions"": 4, ""lines"": 12}, ""src/version.c"": {""insertions"": 7, ""deletions"": 0, ""lines"": 7}}"
2021-06-20 10:40:08,208f0b48b2c616b29f377a1408290111ed2663f7,Bram Moolenaar,26,3,29,3,"{""src/option.c"": {""insertions"": 4, ""deletions"": 3, ""lines"": 7}, ""src/testdir/test_vim9_script.vim"": {""insertions"": 20, ""deletions"": 0, ""lines"": 20}, ""src/version.c"": {""insertions"": 2, ""deletions"": 0, ""lines"": 2}}"
2021-06-19 19:38:25,2fb749568662c86992aea3b596458b9e470f223d,=?UTF-8?q?Dundar=20G=C3=B6c?=,2,3,5,2,"{""src/ex_docmd.c"": {""insertions"": 0, ""deletions"": 3, ""lines"": 3}, ""src/version.c"": {""insertions"": 2, ""deletions"": 0, ""lines"": 2}}"
2021-06-19 18:45:20,6864efa59636ccede2af24e3f5f92d78d210d77b,thinca,122,38,160,8,"{""runtime/doc/eval.txt"": {""insertions"": 3, ""deletions"": 0, ""lines"": 3}, ""src/quickfix.c"": {""insertions"": 70, ""deletions"": 21, ""lines"": 91}, ""src/testdir/dumps/Test_quickfix_cwindow_1.dump"": {""insertions"": 3, ""deletions"": 3, ""lines"": 6}, ""src/testdir/dumps/Test_quickfix_cwindow_2.dump"": {""insertions"": 3, ""deletions"": 3, ""lines"": 6}, ""src/testdir/test_quickfix.vim"": {""insertions"": 32, ""deletions"": 5, ""lines"": 37}, ""src/testdir/test_tagjump.vim"": {""insertions"": 7, ""deletions"": 6, ""lines"": 13}, ""src/testdir/test_vim9_expr.vim"": {""insertions"": 2, ""deletions"": 0, ""lines"": 2}, ""src/version.c"": {""insertions"": 2, ""deletions"": 0, ""lines"": 2}}"
2021-06-19 16:22:53,ad52f96a2d3169cb1b915c1d4a6ba26ba6e5bd0a,Yegappan Lakshmanan,71,1,72,3,"{""src/quickfix.c"": {""insertions"": 11, ""deletions"": 1, ""lines"": 12}, ""src/testdir/test_quickfix.vim"": {""insertions"": 58, ""deletions"": 0, ""lines"": 58}, ""src/version.c"": {""insertions"": 2, ""deletions"": 0, ""lines"": 2}}"
2021-06-17 20:27:48,59b50c3bee908694ae4ac10b26bfebf99d09d466,Bram Moolenaar,17,2,19,3,"{""src/testdir/test_debugger.vim"": {""insertions"": 5, ""deletions"": 0, ""lines"": 5}, ""src/version.c"": {""insertions"": 2, ""deletions"": 0, ""lines"": 2}, ""src/vim9execute.c"": {""insertions"": 10, ""deletions"": 2, ""lines"": 12}}"
2021-06-17 20:08:30,fae55a9cb0838e4c2e634e55a3468af4a75fbdf2,Bram Moolenaar,24,13,37,8,"{""src/eval.c"": {""insertions"": 10, ""deletions"": 2, ""lines"": 12}, ""src/testdir/test_eval_stuff.vim"": {""insertions"": 1, ""deletions"": 1, ""lines"": 2}, ""src/testdir/test_let.vim"": {""insertions"": 1, ""deletions"": 0, ""lines"": 1}, ""src/testdir/test_vim9_expr.vim"": {""insertions"": 5, ""deletions"": 5, ""lines"": 10}, ""src/testdir/test_vim9_script.vim"": {""insertions"": 3, ""deletions"": 3, ""lines"": 6}, ""src/testdir/test_viminfo.vim"": {""insertions"": 1, ""deletions"": 1, ""lines"": 2}, ""src/testdir/test_vimscript.vim"": {""insertions"": 1, ""deletions"": 1, ""lines"": 2}, ""src/version.c"": {""insertions"": 2, ""deletions"": 0, ""lines"": 2}}"
2021-06-17 19:03:07,74f4a965bc6e2a9c41cce2f644e861168702922f,Bram Moolenaar,33,5,38,5,"{""src/globals.h"": {""insertions"": 3, ""deletions"": 0, ""lines"": 3}, ""src/testdir/test_vim9_assign.vim"": {""insertions"": 13, ""deletions"": 0, ""lines"": 13}, ""src/version.c"": {""insertions"": 2, ""deletions"": 0, ""lines"": 2}, ""src/vim9compile.c"": {""insertions"": 14, ""deletions"": 3, ""lines"": 17}, ""src/vim9execute.c"": {""insertions"": 1, ""deletions"": 2, ""lines"": 3}}"
2021-06-17 11:53:41,6e9695525e212466398a269a54bc4d53625673f0,Dominique Pelle,3,3,6,2,"{""src/version.c"": {""insertions"": 2, ""deletions"": 0, ""lines"": 2}, ""src/vim9execute.c"": {""insertions"": 1, ""deletions"": 3, ""lines"": 4}}"
2021-06-16 20:24:40,4cea536bdf48df459e7ad651dfee006844bbf2c0,Bram Moolenaar,78,31,109,3,"{""src/testdir/test_debugger.vim"": {""insertions"": 29, ""deletions"": 16, ""lines"": 45}, ""src/version.c"": {""insertions"": 2, ""deletions"": 0, ""lines"": 2}, ""src/vim9execute.c"": {""insertions"": 47, ""deletions"": 15, ""lines"": 62}}"
2021-06-16 17:28:34,29f0dc3689eafcf7888e06d57d1cf79e62c5c148,Christian Brabandt,27,2,29,3,"{""src/drawline.c"": {""insertions"": 3, ""deletions"": 2, ""lines"": 5}, ""src/testdir/test_number.vim"": {""insertions"": 22, ""deletions"": 0, ""lines"": 22}, ""src/version.c"": {""insertions"": 2, ""deletions"": 0, ""lines"": 2}}"
2021-06-16 17:19:55,6bc30b05e6081bcaece6d1a7fcfca238ea5a194f,Bram Moolenaar,71,13,84,4,"{""src/testdir/test_debugger.vim"": {""insertions"": 37, ""deletions"": 6, ""lines"": 43}, ""src/version.c"": {""insertions"": 2, ""deletions"": 0, ""lines"": 2}, ""src/vim9compile.c"": {""insertions"": 16, ""deletions"": 2, ""lines"": 18}, ""src/vim9execute.c"": {""insertions"": 16, ""deletions"": 5, ""lines"": 21}}"
2021-06-16 13:53:17,41a7f82dea525b3398bf372cbb9c268455845800,Yegappan Lakshmanan,360,2,362,5,"{""src/register.c"": {""insertions"": 3, ""deletions"": 0, ""lines"": 3}, ""src/testdir/test_fileformat.vim"": {""insertions"": 16, ""deletions"": 0, ""lines"": 16}, ""src/testdir/test_smartindent.vim"": {""insertions"": 23, ""deletions"": 0, ""lines"": 23}, ""src/testdir/test_viminfo.vim"": {""insertions"": 316, ""deletions"": 2, ""lines"": 318}, ""src/version.c"": {""insertions"": 2, ""deletions"": 0, ""lines"": 2}}"
2021-06-16 08:59:36,b90ac5e96e40706ffb039db64b92fcd16fa78c04,Bram Moolenaar,4,1,5,2,"{""src/testdir/test_startup.vim"": {""insertions"": 2, ""deletions"": 1, ""lines"": 3}, ""src/version.c"": {""insertions"": 2, ""deletions"": 0, ""lines"": 2}}"
2021-06-15 21:05:59,55b6b60b691eca7058535006113a1adffda4cabf,Bram Moolenaar,4,1,5,2,"{""src/testdir/test_startup.vim"": {""insertions"": 2, ""deletions"": 1, ""lines"": 3}, ""src/version.c"": {""insertions"": 2, ""deletions"": 0, ""lines"": 2}}"
2021-06-15 20:54:28,61a417b7c1fe858d778c7c47f33f7b4dac19360d,Bram Moolenaar,8,4,12,3,"{""src/testdir/test_functions.vim"": {""insertions"": 3, ""deletions"": 3, ""lines"": 6}, ""src/typval.c"": {""insertions"": 3, ""deletions"": 1, ""lines"": 4}, ""src/version.c"": {""insertions"": 2, ""deletions"": 0, ""lines"": 2}}"
2021-06-15 20:39:11,a97c36310f90ed15dbf5a2ba5bf91fc906e2e724,Bram Moolenaar,27,9,36,3,"{""src/message.c"": {""insertions"": 11, ""deletions"": 9, ""lines"": 20}, ""src/testdir/test_startup.vim"": {""insertions"": 14, ""deletions"": 0, ""lines"": 14}, ""src/version.c"": {""insertions"": 2, ""deletions"": 0, ""lines"": 2}}"
2021-06-15 20:13:27,f57b43c230c23117650c956c1f62546a34500fb6,Bram Moolenaar,71,48,119,7,"{""src/testdir/test_vim9_disassemble.vim"": {""insertions"": 34, ""deletions"": 34, ""lines"": 68}, ""src/testdir/test_vim9_expr.vim"": {""insertions"": 14, ""deletions"": 0, ""lines"": 14}, ""src/typval.c"": {""insertions"": 11, ""deletions"": 5, ""lines"": 16}, ""src/version.c"": {""insertions"": 2, ""deletions"": 0, ""lines"": 2}, ""src/vim9.h"": {""insertions"": 1, ""deletions"": 1, ""lines"": 2}, ""src/vim9compile.c"": {""insertions"": 3, ""deletions"": 3, ""lines"": 6}, ""src/vim9execute.c"": {""insertions"": 6, ""deletions"": 5, ""lines"": 11}}"
2021-06-15 18:06:34,8ac681a280ffae14c30784a54587ad6cb640afbb,Bram Moolenaar,16,1,17,3,"{""src/ex_docmd.c"": {""insertions"": 1, ""deletions"": 1, ""lines"": 2}, ""src/testdir/test_vim9_script.vim"": {""insertions"": 13, ""deletions"": 0, ""lines"": 13}, ""src/version.c"": {""insertions"": 2, ""deletions"": 0, ""lines"": 2}}"
2021-06-15 17:32:40,968a5b62ffd3e08005d907d93eaaf807be466a88,Bram Moolenaar,30,5,35,3,"{""src/testdir/test_debugger.vim"": {""insertions"": 27, ""deletions"": 0, ""lines"": 27}, ""src/version.c"": {""insertions"": 2, ""deletions"": 0, ""lines"": 2}, ""src/vim9execute.c"": {""insertions"": 1, ""deletions"": 5, ""lines"": 6}}"
2021-06-15 17:09:43,affd0bc626560631f1df2e0f68db2f15dbda47e1,Dominique Pelle,3,1,4,2,"{""src/if_tcl.c"": {""insertions"": 1, ""deletions"": 1, ""lines"": 2}, ""src/version.c"": {""insertions"": 2, ""deletions"": 0, ""lines"": 2}}"
2021-06-15 09:27:21,caf1a2f296499bdcf030aca545a04da65ac210a1,Bram Moolenaar,4,0,4,2,"{""src/version.c"": {""insertions"": 2, ""deletions"": 0, ""lines"": 2}, ""src/vim9compile.c"": {""insertions"": 2, ""deletions"": 0, ""lines"": 2}}"
2021-06-15 08:22:17,3b814af7e1e7ca18fe1c8c671b18e5e8c1f9e94c,Bram Moolenaar,3,1,4,2,"{""src/version.c"": {""insertions"": 2, ""deletions"": 0, ""lines"": 2}, ""src/vim9compile.c"": {""insertions"": 1, ""deletions"": 1, ""lines"": 2}}"
2021-06-14 20:08:46,47f6db90895c01259e90108caae9517e894e1f95,Bram Moolenaar,11,0,11,2,"{""src/gui_beval.c"": {""insertions"": 9, ""deletions"": 0, ""lines"": 9}, ""src/version.c"": {""insertions"": 2, ""deletions"": 0, ""lines"": 2}}"
2021-06-14 19:32:21,1b0a9dd413c03054f461a01531e010ad739617a7,Bram Moolenaar,12,6,18,2,"{""src/evalvars.c"": {""insertions"": 10, ""deletions"": 6, ""lines"": 16}, ""src/version.c"": {""insertions"": 2, ""deletions"": 0, ""lines"": 2}}"
2021-06-14 19:08:56,26d711645c12abb29bcaf410b4f02d700f62e799,Bram Moolenaar,17,5,22,2,"{""src/testdir/test_vim9_disassemble.vim"": {""insertions"": 15, ""deletions"": 5, ""lines"": 20}, ""src/version.c"": {""insertions"": 2, ""deletions"": 0, ""lines"": 2}}"
2021-06-14 18:40:37,b69c6fb7b423ddc4578b093cb19257cad459dfae,Bram Moolenaar,113,17,130,7,"{""src/debugger.c"": {""insertions"": 1, ""deletions"": 1, ""lines"": 2}, ""src/proto/vim9execute.pro"": {""insertions"": 1, ""deletions"": 0, ""lines"": 1}, ""src/testdir/test_debugger.vim"": {""insertions"": 9, ""deletions"": 6, ""lines"": 15}, ""src/version.c"": {""insertions"": 2, ""deletions"": 0, ""lines"": 2}, ""src/vim9.h"": {""insertions"": 3, ""deletions"": 1, ""lines"": 4}, ""src/vim9compile.c"": {""insertions"": 47, ""deletions"": 7, ""lines"": 54}, ""src/vim9execute.c"": {""insertions"": 50, ""deletions"": 2, ""lines"": 52}}"
2021-06-14 13:08:30,90478f35a8c78e2e10a4b4a8f135998dc04c91fa,Zdenek Dohnal,20,0,20,2,"{""src/if_python3.c"": {""insertions"": 18, ""deletions"": 0, ""lines"": 18}, ""src/version.c"": {""insertions"": 2, ""deletions"": 0, ""lines"": 2}}"
2021-06-13 19:52:48,2d6d718dde7163c971d37b8f4f1ed8f2d25de130,Yegappan Lakshmanan,127,2,129,7,"{""src/testdir/test_excmd.vim"": {""insertions"": 1, ""deletions"": 1, ""lines"": 2}, ""src/testdir/test_mapping.vim"": {""insertions"": 20, ""deletions"": 0, ""lines"": 20}, ""src/testdir/test_modeline.vim"": {""insertions"": 26, ""deletions"": 0, ""lines"": 26}, ""src/testdir/test_options.vim"": {""insertions"": 17, ""deletions"": 0, ""lines"": 17}, ""src/testdir/test_paste.vim"": {""insertions"": 60, ""deletions"": 0, ""lines"": 60}, ""src/version.c"": {""insertions"": 2, ""deletions"": 0, ""lines"": 2}, ""src/vim9compile.c"": {""insertions"": 1, ""deletions"": 1, ""lines"": 2}}"
2021-06-13 18:27:36,5ffefbb35aba2448099314a9e09714d2f3b2b1bd,Bram Moolenaar,31,3,34,5,"{""src/mbyte.c"": {""insertions"": 1, ""deletions"": 2, ""lines"": 3}, ""src/option.c"": {""insertions"": 19, ""deletions"": 1, ""lines"": 20}, ""src/proto/option.pro"": {""insertions"": 1, ""deletions"": 0, ""lines"": 1}, ""src/testdir/test_options.vim"": {""insertions"": 8, ""deletions"": 0, ""lines"": 8}, ""src/version.c"": {""insertions"": 2, ""deletions"": 0, ""lines"": 2}}"
2021-06-13 17:02:49,2346a6378483c9871016f9fc821ec5cbea638f13,Bram Moolenaar,399,185,584,30,"{""runtime/doc/autocmd.txt"": {""insertions"": 1, ""deletions"": 1, ""lines"": 2}, ""runtime/doc/change.txt"": {""insertions"": 1, ""deletions"": 1, ""lines"": 2}, ""runtime/doc/eval.txt"": {""insertions"": 16, ""deletions"": 16, ""lines"": 32}, ""runtime/doc/filetype.txt"": {""insertions"": 1, ""deletions"": 1, ""lines"": 2}, ""runtime/doc/ft_raku.txt"": {""insertions"": 1, ""deletions"": 1, ""lines"": 2}, ""runtime/doc/help.txt"": {""insertions"": 4, ""deletions"": 1, ""lines"": 5}, ""runtime/doc/motion.txt"": {""insertions"": 7, ""deletions"": 2, ""lines"": 9}, ""runtime/doc/options.txt"": {""insertions"": 1, ""deletions"": 1, ""lines"": 2}, ""runtime/doc/os_vms.txt"": {""insertions"": 3, ""deletions"": 3, ""lines"": 6}, ""runtime/doc/pattern.txt"": {""insertions"": 1, ""deletions"": 1, ""lines"": 2}, ""runtime/doc/pi_netrw.txt"": {""insertions"": 1, ""deletions"": 1, ""lines"": 2}, ""runtime/doc/repeat.txt"": {""insertions"": 5, ""deletions"": 3, ""lines"": 8}, ""runtime/doc/syntax.txt"": {""insertions"": 5, ""deletions"": 5, ""lines"": 10}, ""runtime/doc/tags"": {""insertions"": 8, ""deletions"": 0, ""lines"": 8}, ""runtime/doc/term.txt"": {""insertions"": 2, ""deletions"": 2, ""lines"": 4}, ""runtime/doc/todo.txt"": {""insertions"": 22, ""deletions"": 43, ""lines"": 65}, ""runtime/doc/usr_41.txt"": {""insertions"": 1, ""deletions"": 1, ""lines"": 2}, ""runtime/doc/various.txt"": {""insertions"": 1, ""deletions"": 1, ""lines"": 2}, ""runtime/doc/vim.1"": {""insertions"": 1, ""deletions"": 1, ""lines"": 2}, ""runtime/doc/vim.man"": {""insertions"": 3, ""deletions"": 3, ""lines"": 6}, ""runtime/doc/vim9.txt"": {""insertions"": 8, ""deletions"": 2, ""lines"": 10}, ""runtime/doc/vimdiff.1"": {""insertions"": 3, ""deletions"": 3, ""lines"": 6}, ""runtime/doc/vimdiff.man"": {""insertions"": 10, ""deletions"": 9, ""lines"": 19}, ""runtime/filetype.vim"": {""insertions"": 1, ""deletions"": 1, ""lines"": 2}, ""runtime/gvim.desktop"": {""insertions"": 1, ""deletions"": 0, ""lines"": 1}, ""runtime/indent/html.vim"": {""insertions"": 34, ""deletions"": 29, ""lines"": 63}, ""runtime/syntax/gvpr.vim"": {""insertions"": 85, ""deletions"": 0, ""lines"": 85}, ""runtime/vim.desktop"": {""insertions"": 1, ""deletions"": 0, ""lines"": 1}, ""src/INSTALLpc.txt"": {""insertions"": 2, ""deletions"": 1, ""lines"": 3}, ""src/po/sr.po"": {""insertions"": 169, ""deletions"": 52, ""lines"": 221}}"
2021-06-13 16:38:48,4ee9d8e04daa97a3d0a19d7d2eed76b7721301e6,Bram Moolenaar,53,1,54,6,"{""src/cmdexpand.c"": {""insertions"": 4, ""deletions"": 1, ""lines"": 5}, ""src/proto/vim9execute.pro"": {""insertions"": 2, ""deletions"": 0, ""lines"": 2}, ""src/testdir/test_cmdline.vim"": {""insertions"": 10, ""deletions"": 0, ""lines"": 10}, ""src/version.c"": {""insertions"": 2, ""deletions"": 0, ""lines"": 2}, ""src/vim.h"": {""insertions"": 1, ""deletions"": 0, ""lines"": 1}, ""src/vim9execute.c"": {""insertions"": 34, ""deletions"": 0, ""lines"": 34}}"
2021-06-13 15:20:08,e70e12b32f193addae88ae8df933b04fc234550f,Bram Moolenaar,10,0,10,3,"{""src/cmdexpand.c"": {""insertions"": 2, ""deletions"": 0, ""lines"": 2}, ""src/testdir/test_cmdline.vim"": {""insertions"": 6, ""deletions"": 0, ""lines"": 6}, ""src/version.c"": {""insertions"": 2, ""deletions"": 0, ""lines"": 2}}"
2021-06-13 15:03:06,2e66b0d1373891f40e2561ccd2d3369de1614bcd,kompowiec2,6,1,7,3,"{""runtime/filetype.vim"": {""insertions"": 3, ""deletions"": 0, ""lines"": 3}, ""src/testdir/test_filetype.vim"": {""insertions"": 1, ""deletions"": 1, ""lines"": 2}, ""src/version.c"": {""insertions"": 2, ""deletions"": 0, ""lines"": 2}}"
2021-06-13 13:39:00,c2dec4cac4087af90dd4f64f4912a8e14a5fdd56,Bram Moolenaar,9,0,9,2,"{""src/version.c"": {""insertions"": 2, ""deletions"": 0, ""lines"": 2}, ""src/vim9compile.c"": {""insertions"": 7, ""deletions"": 0, ""lines"": 7}}"
2021-06-13 13:16:01,c3a27bbd53a4653c2d8122a047a4cf2cfc52ed21,Bram Moolenaar,13,3,16,3,"{""src/version.c"": {""insertions"": 2, ""deletions"": 0, ""lines"": 2}, ""src/vim.h"": {""insertions"": 1, ""deletions"": 0, ""lines"": 1}, ""src/vim9.h"": {""insertions"": 10, ""deletions"": 3, ""lines"": 13}}"
2021-06-13 12:33:20,6d1792d4085c9905c9da6ff27065b57cb7cddc57,Bram Moolenaar,6,5,11,2,"{""src/version.c"": {""insertions"": 2, ""deletions"": 0, ""lines"": 2}, ""src/vim9execute.c"": {""insertions"": 4, ""deletions"": 5, ""lines"": 9}}"
2021-06-13 12:15:29,d9f31c13d217b4b97f724774a67a6d1f8640e8ae,Bram Moolenaar,6,2,8,2,"{""src/version.c"": {""insertions"": 2, ""deletions"": 0, ""lines"": 2}, ""src/vim9compile.c"": {""insertions"": 4, ""deletions"": 2, ""lines"": 6}}"
2021-06-13 12:01:26,e99d422bbd3e47620915bf89671673f0711671b4,Bram Moolenaar,196,77,273,11,"{""src/eval.c"": {""insertions"": 1, ""deletions"": 1, ""lines"": 2}, ""src/proto/vim9compile.pro"": {""insertions"": 2, ""deletions"": 2, ""lines"": 4}, ""src/testdir/test_debugger.vim"": {""insertions"": 11, ""deletions"": 10, ""lines"": 21}, ""src/testdir/test_vim9_disassemble.vim"": {""insertions"": 15, ""deletions"": 1, ""lines"": 16}, ""src/userfunc.c"": {""insertions"": 1, ""deletions"": 1, ""lines"": 2}, ""src/version.c"": {""insertions"": 2, ""deletions"": 0, ""lines"": 2}, ""src/vim.h"": {""insertions"": 9, ""deletions"": 2, ""lines"": 11}, ""src/vim9.h"": {""insertions"": 4, ""deletions"": 0, ""lines"": 4}, ""src/vim9compile.c"": {""insertions"": 83, ""deletions"": 42, ""lines"": 125}, ""src/vim9execute.c"": {""insertions"": 67, ""deletions"": 17, ""lines"": 84}, ""src/vim9type.c"": {""insertions"": 1, ""deletions"": 1, ""lines"": 2}}"
2021-06-12 16:30:56,e6174fd58d459722847c76f8c5aa1b08a49c3e0d,Bram Moolenaar,5,1,6,2,"{""src/version.c"": {""insertions"": 2, ""deletions"": 0, ""lines"": 2}, ""src/vim9compile.c"": {""insertions"": 3, ""deletions"": 1, ""lines"": 4}}"
2021-06-12 14:12:16,4a27aefe3b5652ee58b2eb85e9d09b542b087aaa,Bram Moolenaar,6,0,6,1,"{""README.md"": {""insertions"": 6, ""deletions"": 0, ""lines"": 6}}"
2021-06-12 13:58:16,a9931535387e5eb4e6ce62f2a661484de4a1757d,Bram Moolenaar,41,6,47,5,"{""src/eval.c"": {""insertions"": 6, ""deletions"": 2, ""lines"": 8}, ""src/testdir/test_vim9_func.vim"": {""insertions"": 20, ""deletions"": 0, ""lines"": 20}, ""src/userfunc.c"": {""insertions"": 1, ""deletions"": 1, ""lines"": 2}, ""src/version.c"": {""insertions"": 2, ""deletions"": 0, ""lines"": 2}, ""src/vim9compile.c"": {""insertions"": 12, ""deletions"": 3, ""lines"": 15}}"
2021-06-12 12:53:05,742357718000927d652b1a98d313a3950571c8ec,Bram Moolenaar,111,42,153,6,"{""runtime/doc/vim9.txt"": {""insertions"": 64, ""deletions"": 12, ""lines"": 76}, ""src/ex_cmdidxs.h"": {""insertions"": 30, ""deletions"": 30, ""lines"": 60}, ""src/ex_cmds.h"": {""insertions"": 12, ""deletions"": 0, ""lines"": 12}, ""src/testdir/test_vim9_assign.vim"": {""insertions"": 2, ""deletions"": 0, ""lines"": 2}, ""src/version.c"": {""insertions"": 2, ""deletions"": 0, ""lines"": 2}, ""src/vim9script.c"": {""insertions"": 1, ""deletions"": 0, ""lines"": 1}}"
2021-06-12 12:05:41,6654ca702ca64c99965efcad3243ea5f95473252,James McCoy,98,97,195,2,"{""src/testdir/test_recover.vim"": {""insertions"": 96, ""deletions"": 97, ""lines"": 193}, ""src/version.c"": {""insertions"": 2, ""deletions"": 0, ""lines"": 2}}"
2021-06-12 11:59:03,0b71955552c4b18f1853c1769ca64d696f8b60c1,Bram Moolenaar,3,0,3,2,"{""src/testdir/test_popupwin.vim"": {""insertions"": 1, ""deletions"": 0, ""lines"": 1}, ""src/version.c"": {""insertions"": 2, ""deletions"": 0, ""lines"": 2}}"
2021-06-12 11:46:41,5958549760652c173b703613b9cbf09b25a4eddb,Yegappan Lakshmanan,108,1,109,8,"{""src/testdir/test_edit.vim"": {""insertions"": 24, ""deletions"": 0, ""lines"": 24}, ""src/testdir/test_excmd.vim"": {""insertions"": 6, ""deletions"": 0, ""lines"": 6}, ""src/testdir/test_help.vim"": {""insertions"": 10, ""deletions"": 0, ""lines"": 10}, ""src/testdir/test_mksession.vim"": {""insertions"": 13, ""deletions"": 0, ""lines"": 13}, ""src/testdir/test_options.vim"": {""insertions"": 31, ""deletions"": 0, ""lines"": 31}, ""src/testdir/test_vartabs.vim"": {""insertions"": 13, ""deletions"": 0, ""lines"": 13}, ""src/testdir/test_window_cmd.vim"": {""insertions"": 9, ""deletions"": 1, ""lines"": 10}, ""src/version.c"": {""insertions"": 2, ""deletions"": 0, ""lines"": 2}}"
2021-06-12 10:33:48,744aecf8777e86fac6d30f072e90e2de353b8ea1,Bram Moolenaar,3,0,3,2,"{""src/eval.c"": {""insertions"": 1, ""deletions"": 0, ""lines"": 1}, ""src/version.c"": {""insertions"": 2, ""deletions"": 0, ""lines"": 2}}"
2021-06-12 10:16:55,22db0d549f64aa3d8a6e366b70eb8d7e66933b82,Bram Moolenaar,15,1,16,4,"{""src/errors.h"": {""insertions"": 2, ""deletions"": 0, ""lines"": 2}, ""src/eval.c"": {""insertions"": 8, ""deletions"": 0, ""lines"": 8}, ""src/testdir/test_functions.vim"": {""insertions"": 3, ""deletions"": 1, ""lines"": 4}, ""src/version.c"": {""insertions"": 2, ""deletions"": 0, ""lines"": 2}}"
2021-06-11 20:21:24,8de901e1f1b051e02a61ae76ad7c925e4c0642e5,Bram Moolenaar,6,2,8,2,"{""src/scriptfile.c"": {""insertions"": 4, ""deletions"": 2, ""lines"": 6}, ""src/version.c"": {""insertions"": 2, ""deletions"": 0, ""lines"": 2}}"
2021-06-11 20:05:47,f0a4069e3df904ac6bd57718ec06e56c5d7363e4,Bram Moolenaar,43,3,46,5,"{""src/evalvars.c"": {""insertions"": 3, ""deletions"": 2, ""lines"": 5}, ""src/scriptfile.c"": {""insertions"": 3, ""deletions"": 0, ""lines"": 3}, ""src/testdir/test_vim9_func.vim"": {""insertions"": 28, ""deletions"": 0, ""lines"": 28}, ""src/version.c"": {""insertions"": 2, ""deletions"": 0, ""lines"": 2}, ""src/vim9compile.c"": {""insertions"": 7, ""deletions"": 1, ""lines"": 8}}"
2021-06-11 17:07:40,4f135275984722c1b1e9ace72eeeb7ce7e4ec983,Bram Moolenaar,32,12,44,5,"{""src/proto/spell.pro"": {""insertions"": 1, ""deletions"": 1, ""lines"": 2}, ""src/spell.c"": {""insertions"": 22, ""deletions"": 5, ""lines"": 27}, ""src/spellfile.c"": {""insertions"": 3, ""deletions"": 3, ""lines"": 6}, ""src/spellsuggest.c"": {""insertions"": 4, ""deletions"": 3, ""lines"": 7}, ""src/version.c"": {""insertions"": 2, ""deletions"": 0, ""lines"": 2}}"
2021-06-10 19:52:15,3044324e8dccd470bd854cf7d9457232cc9c220e,Yegappan Lakshmanan,166,1,167,4,"{""src/testdir/test_diffmode.vim"": {""insertions"": 118, ""deletions"": 1, ""lines"": 119}, ""src/testdir/test_prompt_buffer.vim"": {""insertions"": 2, ""deletions"": 0, ""lines"": 2}, ""src/testdir/test_recover.vim"": {""insertions"": 44, ""deletions"": 0, ""lines"": 44}, ""src/version.c"": {""insertions"": 2, ""deletions"": 0, ""lines"": 2}}"
2021-06-10 19:07:48,7b4f76c0300f0bd9bf54ca1968fe9ae5e4dbdef4,Bram Moolenaar,155,123,278,4,"{""src/buffer.c"": {""insertions"": 143, ""deletions"": 123, ""lines"": 266}, ""src/testdir/test_popupwin.vim"": {""insertions"": 6, ""deletions"": 0, ""lines"": 6}, ""src/version.c"": {""insertions"": 2, ""deletions"": 0, ""lines"": 2}, ""src/vim.h"": {""insertions"": 4, ""deletions"": 0, ""lines"": 4}}"
2021-06-10 17:39:11,544a38e44db0f25ec4fa7a2a4666cf28a2336f33,Christian Brabandt,99,8,107,8,"{""runtime/doc/change.txt"": {""insertions"": 12, ""deletions"": 1, ""lines"": 13}, ""runtime/doc/index.txt"": {""insertions"": 1, ""deletions"": 0, ""lines"": 1}, ""src/normal.c"": {""insertions"": 3, ""deletions"": 0, ""lines"": 3}, ""src/ops.c"": {""insertions"": 3, ""deletions"": 0, ""lines"": 3}, ""src/register.c"": {""insertions"": 20, ""deletions"": 6, ""lines"": 26}, ""src/structs.h"": {""insertions"": 3, ""deletions"": 1, ""lines"": 4}, ""src/testdir/test_visual.vim"": {""insertions"": 55, ""deletions"": 0, ""lines"": 55}, ""src/version.c"": {""insertions"": 2, ""deletions"": 0, ""lines"": 2}}"
2021-06-10 16:50:55,31e299c08f250b126b2c2c0ecce12ee563b70fdc,Zdenek Dohnal,10,2,12,3,"{""src/auto/configure"": {""insertions"": 4, ""deletions"": 1, ""lines"": 5}, ""src/configure.ac"": {""insertions"": 4, ""deletions"": 1, ""lines"": 5}, ""src/version.c"": {""insertions"": 2, ""deletions"": 0, ""lines"": 2}}"
2021-06-10 16:43:25,a42e6e0082a6d564dbfa55317d4a698ac12ae898,Bram Moolenaar,12,0,12,3,"{""src/evalvars.c"": {""insertions"": 1, ""deletions"": 0, ""lines"": 1}, ""src/testdir/test_vimscript.vim"": {""insertions"": 9, ""deletions"": 0, ""lines"": 9}, ""src/version.c"": {""insertions"": 2, ""deletions"": 0, ""lines"": 2}}"
2021-06-09 18:50:46,54656015d384a96ef814dfcf2a18e47f5ba3df14,Bram Moolenaar,5,0,5,2,"{""src/eval.c"": {""insertions"": 3, ""deletions"": 0, ""lines"": 3}, ""src/version.c"": {""insertions"": 2, ""deletions"": 0, ""lines"": 2}}"
2021-06-09 17:30:03,c04f2a4cd40f32120b7a94fdea7bfa62e8640041,Bram Moolenaar,99,46,145,4,"{""src/structs.h"": {""insertions"": 1, ""deletions"": 1, ""lines"": 2}, ""src/testdir/test_vim9_func.vim"": {""insertions"": 13, ""deletions"": 0, ""lines"": 13}, ""src/version.c"": {""insertions"": 2, ""deletions"": 0, ""lines"": 2}, ""src/vim9execute.c"": {""insertions"": 83, ""deletions"": 45, ""lines"": 128}}"
2021-06-09 10:33:40,e3f50ad640fb30f27027f85a616280288bbc14ca,Bram Moolenaar,3,0,3,2,"{""src/memline.c"": {""insertions"": 1, ""deletions"": 0, ""lines"": 1}, ""src/version.c"": {""insertions"": 2, ""deletions"": 0, ""lines"": 2}}"
2021-06-08 20:01:53,b55d618f193d9f413612d8d4e62758056e842e46,Bram Moolenaar,26,0,26,4,"{""src/errors.h"": {""insertions"": 2, ""deletions"": 0, ""lines"": 2}, ""src/testdir/test_vim9_func.vim"": {""insertions"": 16, ""deletions"": 0, ""lines"": 16}, ""src/version.c"": {""insertions"": 2, ""deletions"": 0, ""lines"": 2}, ""src/vim9compile.c"": {""insertions"": 6, ""deletions"": 0, ""lines"": 6}}"
2021-06-08 18:46:45,a733042b124357225e4081e10ef28591236c6077,Bram Moolenaar,11,3,14,4,"{""src/eval.c"": {""insertions"": 3, ""deletions"": 2, ""lines"": 5}, ""src/testdir/test_vim9_expr.vim"": {""insertions"": 4, ""deletions"": 0, ""lines"": 4}, ""src/version.c"": {""insertions"": 2, ""deletions"": 0, ""lines"": 2}, ""src/vim9compile.c"": {""insertions"": 2, ""deletions"": 1, ""lines"": 3}}"
2021-06-08 18:13:31,445f11d5bcfddfa194ebd12b029228c7e957f94c,Bram Moolenaar,15,3,18,5,"{""src/gui.c"": {""insertions"": 4, ""deletions"": 1, ""lines"": 5}, ""src/keymap.h"": {""insertions"": 3, ""deletions"": 2, ""lines"": 5}, ""src/term.c"": {""insertions"": 4, ""deletions"": 0, ""lines"": 4}, ""src/version.c"": {""insertions"": 2, ""deletions"": 0, ""lines"": 2}, ""src/vim.h"": {""insertions"": 2, ""deletions"": 0, ""lines"": 2}}"
2021-06-08 16:32:36,dc73b4b75de0134db3dffa6e631daf6cae817545,K.Takata,6,4,10,2,"{""src/os_win32.c"": {""insertions"": 4, ""deletions"": 4, ""lines"": 8}, ""src/version.c"": {""insertions"": 2, ""deletions"": 0, ""lines"": 2}}"
2021-06-07 20:04:52,c41badb748bbaa78cbadfcda9ca965e8a283fb9b,Bram Moolenaar,23,10,33,8,"{""src/debugger.c"": {""insertions"": 1, ""deletions"": 1, ""lines"": 2}, ""src/evalfunc.c"": {""insertions"": 1, ""deletions"": 1, ""lines"": 2}, ""src/ex_docmd.c"": {""insertions"": 1, ""deletions"": 1, ""lines"": 2}, ""src/getchar.c"": {""insertions"": 3, ""deletions"": 2, ""lines"": 5}, ""src/proto/getchar.pro"": {""insertions"": 1, ""deletions"": 1, ""lines"": 2}, ""src/proto/ui.pro"": {""insertions"": 1, ""deletions"": 1, ""lines"": 2}, ""src/ui.c"": {""insertions"": 13, ""deletions"": 3, ""lines"": 16}, ""src/version.c"": {""insertions"": 2, ""deletions"": 0, ""lines"": 2}}"
2021-06-07 18:41:22,8cf02e5cf8fb14a5009f12e7af0a47617a0ce88d,Yegappan Lakshmanan,102,0,102,2,"{""src/testdir/test_recover.vim"": {""insertions"": 100, ""deletions"": 0, ""lines"": 100}, ""src/version.c"": {""insertions"": 2, ""deletions"": 0, ""lines"": 2}}"
2021-06-07 18:28:45,2f9c209ba089d81fd727122bbe0ae1da00585d80,Dominique Pelle,13,14,27,3,"{""src/sound.c"": {""insertions"": 2, ""deletions"": 3, ""lines"": 5}, ""src/testdir/test_sound.vim"": {""insertions"": 9, ""deletions"": 11, ""lines"": 20}, ""src/version.c"": {""insertions"": 2, ""deletions"": 0, ""lines"": 2}}"
2021-06-07 16:50:01,f7a023e580c695e86f68228adcf5c9e6ea00a4d5,Bram Moolenaar,4,1,5,3,"{""runtime/doc/usr_41.txt"": {""insertions"": 1, ""deletions"": 0, ""lines"": 1}, ""src/testdir/test_function_lists.vim"": {""insertions"": 1, ""deletions"": 1, ""lines"": 2}, ""src/version.c"": {""insertions"": 2, ""deletions"": 0, ""lines"": 2}}"
2021-06-07 16:29:17,3a7503c34c65ed15cc08deb5b54aaf2ea51525b4,Bram Moolenaar,70,5,75,6,"{""runtime/doc/eval.txt"": {""insertions"": 18, ""deletions"": 1, ""lines"": 19}, ""src/evalfunc.c"": {""insertions"": 3, ""deletions"": 1, ""lines"": 4}, ""src/getchar.c"": {""insertions"": 39, ""deletions"": 3, ""lines"": 42}, ""src/proto/getchar.pro"": {""insertions"": 1, ""deletions"": 0, ""lines"": 1}, ""src/testdir/test_functions.vim"": {""insertions"": 7, ""deletions"": 0, ""lines"": 7}, ""src/version.c"": {""insertions"": 2, ""deletions"": 0, ""lines"": 2}}"
2021-06-06 20:02:16,f05d2fc539c389c3b8142d9fb06fb0443de14902,Bram Moolenaar,44,27,71,3,"{""src/ex_cmdidxs.h"": {""insertions"": 27, ""deletions"": 27, ""lines"": 54}, ""src/ex_cmds.h"": {""insertions"": 15, ""deletions"": 0, ""lines"": 15}, ""src/version.c"": {""insertions"": 2, ""deletions"": 0, ""lines"": 2}}"
2021-06-06 19:38:09,e729ce294f9756165020ad86e3b98b4112e1a6ab,Bram Moolenaar,63,5,68,6,"{""src/ex_cmds.c"": {""insertions"": 24, ""deletions"": 0, ""lines"": 24}, ""src/ex_docmd.c"": {""insertions"": 8, ""deletions"": 2, ""lines"": 10}, ""src/proto/ex_cmds.pro"": {""insertions"": 1, ""deletions"": 0, ""lines"": 1}, ""src/testdir/test_vim9_cmd.vim"": {""insertions"": 8, ""deletions"": 0, ""lines"": 8}, ""src/version.c"": {""insertions"": 2, ""deletions"": 0, ""lines"": 2}, ""src/vim9compile.c"": {""insertions"": 20, ""deletions"": 3, ""lines"": 23}}"
2021-06-06 18:15:53,6db7b6375a3ea3afef5295b1366896902012e640,Brennon M,4,2,6,3,"{""runtime/filetype.vim"": {""insertions"": 1, ""deletions"": 1, ""lines"": 2}, ""src/testdir/test_filetype.vim"": {""insertions"": 1, ""deletions"": 1, ""lines"": 2}, ""src/version.c"": {""insertions"": 2, ""deletions"": 0, ""lines"": 2}}"
2021-06-06 15:34:13,518df27ebe23033a25304d3826187c27bfa53c01,Bram Moolenaar,9,1,10,2,"{""src/version.c"": {""insertions"": 2, ""deletions"": 0, ""lines"": 2}, ""src/vim9execute.c"": {""insertions"": 7, ""deletions"": 1, ""lines"": 8}}"
2021-06-06 15:12:46,99285550a9957e2c8669f183557944c6513c4875,Yegappan Lakshmanan,39,7,46,3,"{""src/testdir/test_recover.vim"": {""insertions"": 36, ""deletions"": 6, ""lines"": 42}, ""src/testdir/test_swap.vim"": {""insertions"": 1, ""deletions"": 1, ""lines"": 2}, ""src/version.c"": {""insertions"": 2, ""deletions"": 0, ""lines"": 2}}"
2021-06-06 15:02:53,2067733b5c76e996238af938af36b8196366b7ce,Bram Moolenaar,182,15,197,7,"{""src/testdir/test_vim9_disassemble.vim"": {""insertions"": 17, ""deletions"": 0, ""lines"": 17}, ""src/testdir/test_vim9_func.vim"": {""insertions"": 28, ""deletions"": 0, ""lines"": 28}, ""src/userfunc.c"": {""insertions"": 37, ""deletions"": 4, ""lines"": 41}, ""src/version.c"": {""insertions"": 2, ""deletions"": 0, ""lines"": 2}, ""src/vim9.h"": {""insertions"": 1, ""deletions"": 0, ""lines"": 1}, ""src/vim9compile.c"": {""insertions"": 45, ""deletions"": 11, ""lines"": 56}, ""src/vim9execute.c"": {""insertions"": 52, ""deletions"": 0, ""lines"": 52}}"
2021-06-06 13:07:09,c64ed2b714e605930e7c4102d4e80a2b1d9ff9bf,Dominique Pelle,38,3,41,2,"{""src/testdir/test_sound.vim"": {""insertions"": 36, ""deletions"": 3, ""lines"": 39}, ""src/version.c"": {""insertions"": 2, ""deletions"": 0, ""lines"": 2}}"
2021-06-06 12:14:39,3cfa5b16b06bcc034f6de77070fa779d698ab5e9,Bram Moolenaar,46,19,65,12,"{""src/evalfunc.c"": {""insertions"": 3, ""deletions"": 2, ""lines"": 5}, ""src/filepath.c"": {""insertions"": 3, ""deletions"": 1, ""lines"": 4}, ""src/findfile.c"": {""insertions"": 1, ""deletions"": 1, ""lines"": 2}, ""src/float.c"": {""insertions"": 1, ""deletions"": 1, ""lines"": 2}, ""src/json.c"": {""insertions"": 10, ""deletions"": 1, ""lines"": 11}, ""src/testdir/test_eval_stuff.vim"": {""insertions"": 1, ""deletions"": 1, ""lines"": 2}, ""src/testdir/test_execute_func.vim"": {""insertions"": 4, ""deletions"": 2, ""lines"": 6}, ""src/testdir/test_float_func.vim"": {""insertions"": 4, ""deletions"": 1, ""lines"": 5}, ""src/testdir/test_functions.vim"": {""insertions"": 10, ""deletions"": 5, ""lines"": 15}, ""src/testdir/test_glob2regpat.vim"": {""insertions"": 4, ""deletions"": 1, ""lines"": 5}, ""src/testdir/test_listdict.vim"": {""insertions"": 3, ""deletions"": 3, ""lines"": 6}, ""src/version.c"": {""insertions"": 2, ""deletions"": 0, ""lines"": 2}}"
2021-06-06 10:33:49,7a2217bedd223df4c8bbebe731bf0b5fe8532533,Bram Moolenaar,17,2,19,3,"{""src/testdir/test_substitute.vim"": {""insertions"": 8, ""deletions"": 0, ""lines"": 8}, ""src/typval.c"": {""insertions"": 7, ""deletions"": 2, ""lines"": 9}, ""src/version.c"": {""insertions"": 2, ""deletions"": 0, ""lines"": 2}}"
2021-06-06 10:07:54,f5bfa8faa7bbe025c10148d37e8b47217a430a3b,Bram Moolenaar,4,0,4,2,"{""src/eval.c"": {""insertions"": 2, ""deletions"": 0, ""lines"": 2}, ""src/version.c"": {""insertions"": 2, ""deletions"": 0, ""lines"": 2}}"
2021-06-05 19:36:19,2752360646545a9ae4853d2d5ca91cdb07c14eea,Bram Moolenaar,10,1,11,3,"{""src/testdir/test_vim9_cmd.vim"": {""insertions"": 7, ""deletions"": 0, ""lines"": 7}, ""src/version.c"": {""insertions"": 2, ""deletions"": 0, ""lines"": 2}, ""src/vim9execute.c"": {""insertions"": 1, ""deletions"": 1, ""lines"": 2}}"
2021-06-05 18:59:22,59b262362f26b3aaea1eeb0078adc33eed59863e,Yegappan Lakshmanan,217,1,218,6,"{""src/termlib.c"": {""insertions"": 1, ""deletions"": 1, ""lines"": 2}, ""src/testdir/test_excmd.vim"": {""insertions"": 8, ""deletions"": 0, ""lines"": 8}, ""src/testdir/test_recover.vim"": {""insertions"": 127, ""deletions"": 0, ""lines"": 127}, ""src/testdir/test_swap.vim"": {""insertions"": 75, ""deletions"": 0, ""lines"": 75}, ""src/testdir/test_visual.vim"": {""insertions"": 4, ""deletions"": 0, ""lines"": 4}, ""src/version.c"": {""insertions"": 2, ""deletions"": 0, ""lines"": 2}}"
2021-06-05 18:51:38,1328bde9d406aa1292e92673fa8a026889424e79,Bram Moolenaar,76,34,110,9,"{""src/channel.c"": {""insertions"": 18, ""deletions"": 0, ""lines"": 18}, ""src/eval.c"": {""insertions"": 2, ""deletions"": 1, ""lines"": 3}, ""src/job.c"": {""insertions"": 30, ""deletions"": 0, ""lines"": 30}, ""src/proto/channel.pro"": {""insertions"": 1, ""deletions"": 0, ""lines"": 1}, ""src/proto/job.pro"": {""insertions"": 1, ""deletions"": 0, ""lines"": 1}, ""src/testdir/test_vim9_builtin.vim"": {""insertions"": 11, ""deletions"": 1, ""lines"": 12}, ""src/typval.c"": {""insertions"": 9, ""deletions"": 31, ""lines"": 40}, ""src/version.c"": {""insertions"": 2, ""deletions"": 0, ""lines"": 2}, ""src/vim9execute.c"": {""insertions"": 2, ""deletions"": 1, ""lines"": 3}}"
2021-06-05 16:49:38,c6d71532dda0b3a244907bb5d1826f9340f7571d,Bram Moolenaar,4,1,5,2,"{""src/version.c"": {""insertions"": 2, ""deletions"": 0, ""lines"": 2}, ""src/vim9execute.c"": {""insertions"": 2, ""deletions"": 1, ""lines"": 3}}"
2021-06-05 16:15:09,8da6d6db340069b3307e6bce3cdd40441197efce,Bram Moolenaar,23,0,23,4,"{""src/errors.h"": {""insertions"": 4, ""deletions"": 0, ""lines"": 4}, ""src/testdir/test_vim9_builtin.vim"": {""insertions"": 9, ""deletions"": 0, ""lines"": 9}, ""src/version.c"": {""insertions"": 2, ""deletions"": 0, ""lines"": 2}, ""src/vim9execute.c"": {""insertions"": 8, ""deletions"": 0, ""lines"": 8}}"
2021-06-05 15:10:55,b288ba9f1dd29ba34f236e3099f779d5ab130227,Bram Moolenaar,30,5,35,3,"{""src/testdir/test_vim9_cmd.vim"": {""insertions"": 4, ""deletions"": 0, ""lines"": 4}, ""src/version.c"": {""insertions"": 2, ""deletions"": 0, ""lines"": 2}, ""src/vim9execute.c"": {""insertions"": 24, ""deletions"": 5, ""lines"": 29}}"
2021-06-05 14:25:32,4f2417ffeedbb687a59a36547e8143724a86bb31,K.Takata,57,6,63,2,"{""src/gui_w32.c"": {""insertions"": 55, ""deletions"": 6, ""lines"": 61}, ""src/version.c"": {""insertions"": 2, ""deletions"": 0, ""lines"": 2}}"
2021-06-05 14:07:37,84e9ade826e7a6a03e0ff5cd9a35b48c4d88367e,Bram Moolenaar,5,0,5,2,"{""src/gui_gtk.c"": {""insertions"": 3, ""deletions"": 0, ""lines"": 3}, ""src/version.c"": {""insertions"": 2, ""deletions"": 0, ""lines"": 2}}"
2021-06-04 19:57:57,21492743e80c6740bac65a91311c28bede8ef2f8,Bram Moolenaar,12,0,12,3,"{""src/normal.c"": {""insertions"": 1, ""deletions"": 0, ""lines"": 1}, ""src/testdir/test_visual.vim"": {""insertions"": 9, ""deletions"": 0, ""lines"": 9}, ""src/version.c"": {""insertions"": 2, ""deletions"": 0, ""lines"": 2}}"
2021-06-04 19:09:55,56cddb38790ba535919524d9d2f32dbec9f3f07a,Dominique Pelle,11,5,16,2,"{""src/testdir/test_popup.vim"": {""insertions"": 9, ""deletions"": 5, ""lines"": 14}, ""src/version.c"": {""insertions"": 2, ""deletions"": 0, ""lines"": 2}}"
2021-06-04 19:00:32,5fa9b24440d677c1aa00084d0cf84638b1e1a0d5,Bram Moolenaar,104,34,138,6,"{""src/testdir/test_vim9_disassemble.vim"": {""insertions"": 2, ""deletions"": 2, ""lines"": 4}, ""src/testdir/test_vim9_expr.vim"": {""insertions"": 19, ""deletions"": 0, ""lines"": 19}, ""src/version.c"": {""insertions"": 2, ""deletions"": 0, ""lines"": 2}, ""src/vim9.h"": {""insertions"": 16, ""deletions"": 2, ""lines"": 18}, ""src/vim9compile.c"": {""insertions"": 28, ""deletions"": 15, ""lines"": 43}, ""src/vim9execute.c"": {""insertions"": 37, ""deletions"": 15, ""lines"": 52}}"
2021-06-04 17:17:07,6c4c404c580fadd69e39297a6cb4b214f2fcb6d6,Bram Moolenaar,14,8,22,2,"{""src/register.c"": {""insertions"": 12, ""deletions"": 8, ""lines"": 20}, ""src/version.c"": {""insertions"": 2, ""deletions"": 0, ""lines"": 2}}"
2021-06-04 16:33:49,24951a67c24e75ec4ff7506f8e2e789ccd786e89,Bram Moolenaar,6,3,9,2,"{""src/register.c"": {""insertions"": 4, ""deletions"": 3, ""lines"": 7}, ""src/version.c"": {""insertions"": 2, ""deletions"": 0, ""lines"": 2}}"
2021-06-04 15:11:47,6e0b553fa12fc5ad5d8ee3d8457e7cb16f38b56f,Bram Moolenaar,12,7,19,4,"{""src/clipboard.c"": {""insertions"": 1, ""deletions"": 1, ""lines"": 2}, ""src/mbyte.c"": {""insertions"": 0, ""deletions"": 2, ""lines"": 2}, ""src/register.c"": {""insertions"": 9, ""deletions"": 4, ""lines"": 13}, ""src/version.c"": {""insertions"": 2, ""deletions"": 0, ""lines"": 2}}"
2021-06-03 20:11:08,4f3c57f7980592b25f483e5953799c010a8ae196,Bram Moolenaar,18,9,27,4,"{""src/mouse.c"": {""insertions"": 5, ""deletions"": 5, ""lines"": 10}, ""src/normal.c"": {""insertions"": 10, ""deletions"": 4, ""lines"": 14}, ""src/proto/normal.pro"": {""insertions"": 1, ""deletions"": 0, ""lines"": 1}, ""src/version.c"": {""insertions"": 2, ""deletions"": 0, ""lines"": 2}}"
2021-06-03 19:56:10,5072b47a223fb044041b8e7db59a17b3b1d8a625,Bram Moolenaar,10,2,12,3,"{""src/scriptfile.c"": {""insertions"": 5, ""deletions"": 2, ""lines"": 7}, ""src/testdir/test_vim9_script.vim"": {""insertions"": 3, ""deletions"": 0, ""lines"": 3}, ""src/version.c"": {""insertions"": 2, ""deletions"": 0, ""lines"": 2}}"
2021-06-03 18:34:57,85eee5b969485142b54337cadadd65a38e7d7396,Bram Moolenaar,12,1,13,4,"{""src/mouse.c"": {""insertions"": 8, ""deletions"": 1, ""lines"": 9}, ""src/normal.c"": {""insertions"": 1, ""deletions"": 0, ""lines"": 1}, ""src/proto/mouse.pro"": {""insertions"": 1, ""deletions"": 0, ""lines"": 1}, ""src/version.c"": {""insertions"": 2, ""deletions"": 0, ""lines"": 2}}"
2021-06-02 17:22:45,0a808598e4edb3f1a167ac8c5c1f9084af625c4d,Bram Moolenaar,3,1,4,2,"{""src/Makefile"": {""insertions"": 1, ""deletions"": 1, ""lines"": 2}, ""src/version.c"": {""insertions"": 2, ""deletions"": 0, ""lines"": 2}}"
2021-06-02 15:07:18,01c798c31a94a50ad0c4a022fc21c1a31553be21,Yegappan Lakshmanan,544,547,1091,14,"{""Filelist"": {""insertions"": 2, ""deletions"": 0, ""lines"": 2}, ""src/Make_ami.mak"": {""insertions"": 1, ""deletions"": 0, ""lines"": 1}, ""src/Make_cyg_ming.mak"": {""insertions"": 1, ""deletions"": 0, ""lines"": 1}, ""src/Make_mvc.mak"": {""insertions"": 4, ""deletions"": 0, ""lines"": 4}, ""src/Make_vms.mms"": {""insertions"": 5, ""deletions"": 0, ""lines"": 5}, ""src/Makefile"": {""insertions"": 22, ""deletions"": 7, ""lines"": 29}, ""src/README.md"": {""insertions"": 1, ""deletions"": 0, ""lines"": 1}, ""src/eval.c"": {""insertions"": 0, ""deletions"": 37, ""lines"": 37}, ""src/evalfunc.c"": {""insertions"": 0, ""deletions"": 502, ""lines"": 502}, ""src/float.c"": {""insertions"": 477, ""deletions"": 0, ""lines"": 477}, ""src/proto.h"": {""insertions"": 1, ""deletions"": 0, ""lines"": 1}, ""src/proto/eval.pro"": {""insertions"": 0, ""deletions"": 1, ""lines"": 1}, ""src/proto/float.pro"": {""insertions"": 28, ""deletions"": 0, ""lines"": 28}, ""src/version.c"": {""insertions"": 2, ""deletions"": 0, ""lines"": 2}}"
2021-06-02 14:49:32,a83d06026d0e0dad873de296bff97707ad2faff3,Bram Moolenaar,16,12,28,2,"{""src/testdir/test_startup.vim"": {""insertions"": 14, ""deletions"": 12, ""lines"": 26}, ""src/version.c"": {""insertions"": 2, ""deletions"": 0, ""lines"": 2}}"
2021-06-02 14:47:53,c3cb1c92a335be818971acd89f631e82aa30ad3f,Bram Moolenaar,34,0,34,4,"{""src/errors.h"": {""insertions"": 2, ""deletions"": 0, ""lines"": 2}, ""src/testdir/test_vim9_func.vim"": {""insertions"": 9, ""deletions"": 0, ""lines"": 9}, ""src/version.c"": {""insertions"": 2, ""deletions"": 0, ""lines"": 2}, ""src/vim9compile.c"": {""insertions"": 21, ""deletions"": 0, ""lines"": 21}}"
2021-06-02 13:28:15,0f37e3561db95b0ef0b636588bbd30297e377384,Bram Moolenaar,22,1,23,3,"{""src/scriptfile.c"": {""insertions"": 2, ""deletions"": 1, ""lines"": 3}, ""src/testdir/test_vim9_script.vim"": {""insertions"": 18, ""deletions"": 0, ""lines"": 18}, ""src/version.c"": {""insertions"": 2, ""deletions"": 0, ""lines"": 2}}"
2021-06-02 13:08:50,a2e468fcac7523ae6a0ab65db5196684801fa2d1,K.Takata,2,2,4,2,"{""src/main.c"": {""insertions"": 0, ""deletions"": 2, ""lines"": 2}, ""src/version.c"": {""insertions"": 2, ""deletions"": 0, ""lines"": 2}}"
2021-06-02 12:56:39,eecf2b35a146d7d5512f2525ad631d796e19edac,K.Takata,30,28,58,4,"{""src/eval.c"": {""insertions"": 0, ""deletions"": 27, ""lines"": 27}, ""src/evalfunc.c"": {""insertions"": 27, ""deletions"": 0, ""lines"": 27}, ""src/proto/evalfunc.pro"": {""insertions"": 1, ""deletions"": 1, ""lines"": 2}, ""src/version.c"": {""insertions"": 2, ""deletions"": 0, ""lines"": 2}}"
2021-06-02 11:28:16,eeec2548785b2dd245a31ab25d7bde0f88ea1a6d,K.Takata,80,90,170,43,"{""src/arabic.c"": {""insertions"": 1, ""deletions"": 3, ""lines"": 4}, ""src/blowfish.c"": {""insertions"": 0, ""deletions"": 2, ""lines"": 2}, ""src/cindent.c"": {""insertions"": 1, ""deletions"": 1, ""lines"": 2}, ""src/cmdexpand.c"": {""insertions"": 1, ""deletions"": 1, ""lines"": 2}, ""src/cmdhist.c"": {""insertions"": 1, ""deletions"": 1, ""lines"": 2}, ""src/dosinst.c"": {""insertions"": 2, ""deletions"": 3, ""lines"": 5}, ""src/eval.c"": {""insertions"": 1, ""deletions"": 1, ""lines"": 2}, ""src/evalfunc.c"": {""insertions"": 2, ""deletions"": 2, ""lines"": 4}, ""src/ex_docmd.c"": {""insertions"": 3, ""deletions"": 3, ""lines"": 6}, ""src/fileio.c"": {""insertions"": 1, ""deletions"": 1, ""lines"": 2}, ""src/gui_athena.c"": {""insertions"": 1, ""deletions"": 1, ""lines"": 2}, ""src/gui_gtk_x11.c"": {""insertions"": 3, ""deletions"": 3, ""lines"": 6}, ""src/gui_haiku.cc"": {""insertions"": 1, ""deletions"": 1, ""lines"": 2}, ""src/gui_photon.c"": {""insertions"": 0, ""deletions"": 1, ""lines"": 1}, ""src/gui_w32.c"": {""insertions"": 2, ""deletions"": 2, ""lines"": 4}, ""src/gui_xmebw.c"": {""insertions"": 1, ""deletions"": 1, ""lines"": 2}, ""src/hardcopy.c"": {""insertions"": 12, ""deletions"": 14, ""lines"": 26}, ""src/help.c"": {""insertions"": 1, ""deletions"": 1, ""lines"": 2}, ""src/highlight.c"": {""insertions"": 2, ""deletions"": 2, ""lines"": 4}, ""src/if_mzsch.c"": {""insertions"": 1, ""deletions"": 1, ""lines"": 2}, ""src/macros.h"": {""insertions"": 3, ""deletions"": 0, ""lines"": 3}, ""src/main.c"": {""insertions"": 3, ""deletions"": 3, ""lines"": 6}, ""src/map.c"": {""insertions"": 2, ""deletions"": 3, ""lines"": 5}, ""src/mbyte.c"": {""insertions"": 3, ""deletions"": 3, ""lines"": 6}, ""src/memline.c"": {""insertions"": 1, ""deletions"": 1, ""lines"": 2}, ""src/menu.c"": {""insertions"": 1, ""deletions"": 1, ""lines"": 2}, ""src/misc2.c"": {""insertions"": 1, ""deletions"": 2, ""lines"": 3}, ""src/normal.c"": {""insertions"": 1, ""deletions"": 1, ""lines"": 2}, ""src/ops.c"": {""insertions"": 1, ""deletions"": 1, ""lines"": 2}, ""src/option.c"": {""insertions"": 2, ""deletions"": 3, ""lines"": 5}, ""src/optiondefs.h"": {""insertions"": 1, ""deletions"": 1, ""lines"": 2}, ""src/os_win32.c"": {""insertions"": 5, ""deletions"": 6, ""lines"": 11}, ""src/popupwin.c"": {""insertions"": 2, ""deletions"": 4, ""lines"": 6}, ""src/quickfix.c"": {""insertions"": 1, ""deletions"": 1, ""lines"": 2}, ""src/regexp.c"": {""insertions"": 1, ""deletions"": 1, ""lines"": 2}, ""src/screen.c"": {""insertions"": 2, ""deletions"": 2, ""lines"": 4}, ""src/search.c"": {""insertions"": 1, ""deletions"": 1, ""lines"": 2}, ""src/syntax.c"": {""insertions"": 1, ""deletions"": 1, ""lines"": 2}, ""src/term.c"": {""insertions"": 1, ""deletions"": 1, ""lines"": 2}, ""src/terminal.c"": {""insertions"": 1, ""deletions"": 1, ""lines"": 2}, ""src/time.c"": {""insertions"": 1, ""deletions"": 2, ""lines"": 3}, ""src/usercmd.c"": {""insertions"": 2, ""deletions"": 2, ""lines"": 4}, ""src/version.c"": {""insertions"": 6, ""deletions"": 4, ""lines"": 10}}"
2021-06-02 09:49:23,b54abeeafb074248597878a874fed9a66b114c06,Bram Moolenaar,13,4,17,3,"{""src/dict.c"": {""insertions"": 3, ""deletions"": 2, ""lines"": 5}, ""src/testdir/test_functions.vim"": {""insertions"": 8, ""deletions"": 2, ""lines"": 10}, ""src/version.c"": {""insertions"": 2, ""deletions"": 0, ""lines"": 2}}"
2021-06-01 19:21:55,6f1d2aa437744a7cb0206fdaa543a788c5a56c79,Bram Moolenaar,28,6,34,5,"{""src/dict.c"": {""insertions"": 18, ""deletions"": 0, ""lines"": 18}, ""src/eval.c"": {""insertions"": 2, ""deletions"": 6, ""lines"": 8}, ""src/proto/dict.pro"": {""insertions"": 1, ""deletions"": 0, ""lines"": 1}, ""src/testdir/test_functions.vim"": {""insertions"": 5, ""deletions"": 0, ""lines"": 5}, ""src/version.c"": {""insertions"": 2, ""deletions"": 0, ""lines"": 2}}"
2021-06-01 18:48:40,6a43b37b760347b9a1bedf12e41b458000922969,Bram Moolenaar,2,5,7,2,"{""src/os_unix.c"": {""insertions"": 0, ""deletions"": 5, ""lines"": 5}, ""src/version.c"": {""insertions"": 2, ""deletions"": 0, ""lines"": 2}}"
2021-05-31 20:15:26,3d9c4eefe656ee8bf58c0496a48bd56bac180056,Bram Moolenaar,17,0,17,3,"{""src/eval.c"": {""insertions"": 7, ""deletions"": 0, ""lines"": 7}, ""src/testdir/test_functions.vim"": {""insertions"": 8, ""deletions"": 0, ""lines"": 8}, ""src/version.c"": {""insertions"": 2, ""deletions"": 0, ""lines"": 2}}"
2021-05-31 18:04:07,bb162367ac77db877586086d7456685f2aeb8754,Dominique Pelle,58,0,58,2,"{""src/testdir/test_spellfile.vim"": {""insertions"": 56, ""deletions"": 0, ""lines"": 56}, ""src/version.c"": {""insertions"": 2, ""deletions"": 0, ""lines"": 2}}"
2021-05-31 17:23:01,2ac7184d34cd01e2b76bd1f704fd6a4b4af10239,Yegappan Lakshmanan,166,1,167,5,"{""src/ops.c"": {""insertions"": 2, ""deletions"": 1, ""lines"": 3}, ""src/testdir/test_netbeans.vim"": {""insertions"": 40, ""deletions"": 0, ""lines"": 40}, ""src/testdir/test_normal.vim"": {""insertions"": 30, ""deletions"": 0, ""lines"": 30}, ""src/testdir/test_visual.vim"": {""insertions"": 92, ""deletions"": 0, ""lines"": 92}, ""src/version.c"": {""insertions"": 2, ""deletions"": 0, ""lines"": 2}}"
2021-05-31 16:40:49,ef8706fb84cfe8bd58b1b26b0742e42caf09655b,K.Takata,11,3,14,3,"{""runtime/doc/options.txt"": {""insertions"": 4, ""deletions"": 3, ""lines"": 7}, ""src/mbyte.c"": {""insertions"": 5, ""deletions"": 0, ""lines"": 5}, ""src/version.c"": {""insertions"": 2, ""deletions"": 0, ""lines"": 2}}"
2021-05-30 20:17:25,2fa9384ca1b600b934bec81a72c5fb7ce757503a,Christian Brabandt,56,10,66,8,"{""runtime/doc/change.txt"": {""insertions"": 8, ""deletions"": 0, ""lines"": 8}, ""runtime/doc/index.txt"": {""insertions"": 2, ""deletions"": 0, ""lines"": 2}, ""src/normal.c"": {""insertions"": 8, ""deletions"": 2, ""lines"": 10}, ""src/register.c"": {""insertions"": 12, ""deletions"": 7, ""lines"": 19}, ""src/testdir/test_normal.vim"": {""insertions"": 1, ""deletions"": 1, ""lines"": 2}, ""src/testdir/test_visual.vim"": {""insertions"": 22, ""deletions"": 0, ""lines"": 22}, ""src/version.c"": {""insertions"": 2, ""deletions"": 0, ""lines"": 2}, ""src/vim.h"": {""insertions"": 1, ""deletions"": 0, ""lines"": 1}}"
2021-05-30 18:54:13,d2ea7cf10a4d026ebd402594d656af7d5c811c24,Bram Moolenaar,320,223,543,91,"{""runtime/doc/autocmd.txt"": {""insertions"": 5, ""deletions"": 4, ""lines"": 9}, ""runtime/doc/cmdline.txt"": {""insertions"": 2, ""deletions"": 2, ""lines"": 4}, ""runtime/doc/diff.txt"": {""insertions"": 6, ""deletions"": 4, ""lines"": 10}, ""runtime/doc/editing.txt"": {""insertions"": 4, ""deletions"": 4, ""lines"": 8}, ""runtime/doc/ft_sql.txt"": {""insertions"": 1, ""deletions"": 1, ""lines"": 2}, ""runtime/doc/if_tcl.txt"": {""insertions"": 4, ""deletions"": 4, ""lines"": 8}, ""runtime/doc/index.txt"": {""insertions"": 3, ""deletions"": 3, ""lines"": 6}, ""runtime/doc/options.txt"": {""insertions"": 3, ""deletions"": 1, ""lines"": 4}, ""runtime/doc/quickfix.txt"": {""insertions"": 3, ""deletions"": 2, ""lines"": 5}, ""runtime/doc/spell.txt"": {""insertions"": 3, ""deletions"": 3, ""lines"": 6}, ""runtime/doc/syntax.txt"": {""insertions"": 9, ""deletions"": 1, ""lines"": 10}, ""runtime/doc/tags"": {""insertions"": 4, ""deletions"": 1, ""lines"": 5}, ""runtime/doc/textprop.txt"": {""insertions"": 4, ""deletions"": 3, ""lines"": 7}, ""runtime/doc/todo.txt"": {""insertions"": 34, ""deletions"": 4, ""lines"": 38}, ""runtime/doc/usr_08.txt"": {""insertions"": 2, ""deletions"": 2, ""lines"": 4}, ""runtime/doc/usr_09.txt"": {""insertions"": 1, ""deletions"": 1, ""lines"": 2}, ""runtime/doc/version6.txt"": {""insertions"": 2, ""deletions"": 2, ""lines"": 4}, ""runtime/doc/vim9.txt"": {""insertions"": 4, ""deletions"": 3, ""lines"": 7}, ""runtime/doc/visual.txt"": {""insertions"": 2, ""deletions"": 2, ""lines"": 4}, ""runtime/indent/python.vim"": {""insertions"": 2, ""deletions"": 2, ""lines"": 4}, ""runtime/pack/dist/opt/termdebug/plugin/termdebug.vim"": {""insertions"": 36, ""deletions"": 10, ""lines"": 46}, ""runtime/syntax/c.vim"": {""insertions"": 4, ""deletions"": 1, ""lines"": 5}, ""runtime/syntax/cpp.vim"": {""insertions"": 27, ""deletions"": 13, ""lines"": 40}, ""runtime/syntax/sh.vim"": {""insertions"": 25, ""deletions"": 21, ""lines"": 46}, ""runtime/syntax/vim.vim"": {""insertions"": 38, ""deletions"": 37, ""lines"": 75}, ""runtime/tutor/tutor"": {""insertions"": 2, ""deletions"": 2, ""lines"": 4}, ""runtime/tutor/tutor.bar"": {""insertions"": 1, ""deletions"": 1, ""lines"": 2}, ""runtime/tutor/tutor.bar.utf-8"": {""insertions"": 1, ""deletions"": 1, ""lines"": 2}, ""runtime/tutor/tutor.bg.utf-8"": {""insertions"": 2, ""deletions"": 2, ""lines"": 4}, ""runtime/tutor/tutor.ca"": {""insertions"": 2, ""deletions"": 2, ""lines"": 4}, ""runtime/tutor/tutor.ca.utf-8"": {""insertions"": 2, ""deletions"": 2, ""lines"": 4}, ""runtime/tutor/tutor.cs"": {""insertions"": 2, ""deletions"": 2, ""lines"": 4}, ""runtime/tutor/tutor.cs.cp1250"": {""insertions"": 2, ""deletions"": 2, ""lines"": 4}, ""runtime/tutor/tutor.cs.utf-8"": {""insertions"": 2, ""deletions"": 2, ""lines"": 4}, ""runtime/tutor/tutor.da"": {""insertions"": 1, ""deletions"": 1, ""lines"": 2}, ""runtime/tutor/tutor.da.utf-8"": {""insertions"": 1, ""deletions"": 1, ""lines"": 2}, ""runtime/tutor/tutor.de"": {""insertions"": 1, ""deletions"": 1, ""lines"": 2}, ""runtime/tutor/tutor.de.utf-8"": {""insertions"": 1, ""deletions"": 1, ""lines"": 2}, ""runtime/tutor/tutor.el"": {""insertions"": 2, ""deletions"": 2, ""lines"": 4}, ""runtime/tutor/tutor.el.cp737"": {""insertions"": 2, ""deletions"": 2, ""lines"": 4}, ""runtime/tutor/tutor.el.utf-8"": {""insertions"": 2, ""deletions"": 2, ""lines"": 4}, ""runtime/tutor/tutor.eo"": {""insertions"": 1, ""deletions"": 1, ""lines"": 2}, ""runtime/tutor/tutor.eo.utf-8"": {""insertions"": 1, ""deletions"": 1, ""lines"": 2}, ""runtime/tutor/tutor.fr"": {""insertions"": 1, ""deletions"": 1, ""lines"": 2}, ""runtime/tutor/tutor.fr.utf-8"": {""insertions"": 1, ""deletions"": 1, ""lines"": 2}, ""runtime/tutor/tutor.hr"": {""insertions"": 1, ""deletions"": 1, ""lines"": 2}, ""runtime/tutor/tutor.hr.cp1250"": {""insertions"": 1, ""deletions"": 1, ""lines"": 2}, ""runtime/tutor/tutor.hr.utf-8"": {""insertions"": 1, ""deletions"": 1, ""lines"": 2}, ""runtime/tutor/tutor.hu"": {""insertions"": 2, ""deletions"": 2, ""lines"": 4}, ""runtime/tutor/tutor.hu.cp1250"": {""insertions"": 2, ""deletions"": 2, ""lines"": 4}, ""runtime/tutor/tutor.hu.utf-8"": {""insertions"": 2, ""deletions"": 2, ""lines"": 4}, ""runtime/tutor/tutor.it"": {""insertions"": 1, ""deletions"": 1, ""lines"": 2}, ""runtime/tutor/tutor.it.utf-8"": {""insertions"": 1, ""deletions"": 1, ""lines"": 2}, ""runtime/tutor/tutor.ja.euc"": {""insertions"": 2, ""deletions"": 2, ""lines"": 4}, ""runtime/tutor/tutor.ja.sjis"": {""insertions"": 2, ""deletions"": 2, ""lines"": 4}, ""runtime/tutor/tutor.ja.utf-8"": {""insertions"": 2, ""deletions"": 2, ""lines"": 4}, ""runtime/tutor/tutor.ko"": {""insertions"": 2, ""deletions"": 2, ""lines"": 4}, ""runtime/tutor/tutor.ko.euc"": {""insertions"": 2, ""deletions"": 2, ""lines"": 4}, ""runtime/tutor/tutor.ko.utf-8"": {""insertions"": 2, ""deletions"": 2, ""lines"": 4}, ""runtime/tutor/tutor.lv.utf-8"": {""insertions"": 2, ""deletions"": 2, ""lines"": 4}, ""runtime/tutor/tutor.nb"": {""insertions"": 1, ""deletions"": 1, ""lines"": 2}, ""runtime/tutor/tutor.nb.utf-8"": {""insertions"": 1, ""deletions"": 1, ""lines"": 2}, ""runtime/tutor/tutor.nl"": {""insertions"": 1, ""deletions"": 1, ""lines"": 2}, ""runtime/tutor/tutor.nl.utf-8"": {""insertions"": 1, ""deletions"": 1, ""lines"": 2}, ""runtime/tutor/tutor.no"": {""insertions"": 1, ""deletions"": 1, ""lines"": 2}, ""runtime/tutor/tutor.no.utf-8"": {""insertions"": 1, ""deletions"": 1, ""lines"": 2}, ""runtime/tutor/tutor.pl"": {""insertions"": 1, ""deletions"": 1, ""lines"": 2}, ""runtime/tutor/tutor.pl.cp1250"": {""insertions"": 1, ""deletions"": 1, ""lines"": 2}, ""runtime/tutor/tutor.pl.utf-8"": {""insertions"": 1, ""deletions"": 1, ""lines"": 2}, ""runtime/tutor/tutor.pt"": {""insertions"": 1, ""deletions"": 1, ""lines"": 2}, ""runtime/tutor/tutor.pt.utf-8"": {""insertions"": 2, ""deletions"": 2, ""lines"": 4}, ""runtime/tutor/tutor.ru"": {""insertions"": 1, ""deletions"": 1, ""lines"": 2}, ""runtime/tutor/tutor.ru.cp1251"": {""insertions"": 1, ""deletions"": 1, ""lines"": 2}, ""runtime/tutor/tutor.ru.utf-8"": {""insertions"": 1, ""deletions"": 1, ""lines"": 2}, ""runtime/tutor/tutor.sk"": {""insertions"": 1, ""deletions"": 1, ""lines"": 2}, ""runtime/tutor/tutor.sk.cp1250"": {""insertions"": 1, ""deletions"": 1, ""lines"": 2}, ""runtime/tutor/tutor.sk.utf-8"": {""insertions"": 1, ""deletions"": 1, ""lines"": 2}, ""runtime/tutor/tutor.sr.cp1250"": {""insertions"": 1, ""deletions"": 1, ""lines"": 2}, ""runtime/tutor/tutor.sr.utf-8"": {""insertions"": 1, ""deletions"": 1, ""lines"": 2}, ""runtime/tutor/tutor.sv"": {""insertions"": 2, ""deletions"": 2, ""lines"": 4}, ""runtime/tutor/tutor.sv.utf-8"": {""insertions"": 2, ""deletions"": 2, ""lines"": 4}, ""runtime/tutor/tutor.tr.iso9"": {""insertions"": 1, ""deletions"": 1, ""lines"": 2}, ""runtime/tutor/tutor.tr.utf-8"": {""insertions"": 1, ""deletions"": 1, ""lines"": 2}, ""runtime/tutor/tutor.uk.utf-8"": {""insertions"": 2, ""deletions"": 2, ""lines"": 4}, ""runtime/tutor/tutor.utf-8"": {""insertions"": 2, ""deletions"": 2, ""lines"": 4}, ""runtime/tutor/tutor.vi.utf-8"": {""insertions"": 2, ""deletions"": 2, ""lines"": 4}, ""runtime/tutor/tutor.zh.big5"": {""insertions"": 1, ""deletions"": 1, ""lines"": 2}, ""runtime/tutor/tutor.zh.euc"": {""insertions"": 1, ""deletions"": 1, ""lines"": 2}, ""runtime/tutor/tutor.zh.utf-8"": {""insertions"": 1, ""deletions"": 1, ""lines"": 2}, ""runtime/tutor/tutor.zh_cn.utf-8"": {""insertions"": 1, ""deletions"": 1, ""lines"": 2}, ""runtime/tutor/tutor.zh_tw.utf-8"": {""insertions"": 1, ""deletions"": 1, ""lines"": 2}}"
2021-05-30 17:29:41,6ef5ab59043681a51e8ca2ab0a1e4ff8f0f4bb47,Wez Furlong,29,7,36,2,"{""src/os_win32.c"": {""insertions"": 27, ""deletions"": 7, ""lines"": 34}, ""src/version.c"": {""insertions"": 2, ""deletions"": 0, ""lines"": 2}}"
2021-05-30 16:04:19,f883d9027c750967b115b82de984ee449ab17aa8,K.Takata,19,5,24,6,"{""runtime/doc/options.txt"": {""insertions"": 2, ""deletions"": 1, ""lines"": 3}, ""src/mbyte.c"": {""insertions"": 1, ""deletions"": 1, ""lines"": 2}, ""src/option.c"": {""insertions"": 8, ""deletions"": 1, ""lines"": 9}, ""src/option.h"": {""insertions"": 5, ""deletions"": 1, ""lines"": 6}, ""src/testdir/test_writefile.vim"": {""insertions"": 1, ""deletions"": 1, ""lines"": 2}, ""src/version.c"": {""insertions"": 2, ""deletions"": 0, ""lines"": 2}}"
2021-05-30 14:43:11,e71c0ebe2cee4a4916c49e206733200299e4c065,Bram Moolenaar,35,1,36,4,"{""src/regexp.c"": {""insertions"": 4, ""deletions"": 1, ""lines"": 5}, ""src/testdir/dumps/Test_hlsearch_block_visual_match.dump"": {""insertions"": 9, ""deletions"": 0, ""lines"": 9}, ""src/testdir/test_search.vim"": {""insertions"": 20, ""deletions"": 0, ""lines"": 20}, ""src/version.c"": {""insertions"": 2, ""deletions"": 0, ""lines"": 2}}"
2021-05-30 12:21:57,0b49648486c5857047433c11d0871f79b53613a5,Bram Moolenaar,3,0,3,2,"{""src/testdir/test_cmdline.vim"": {""insertions"": 1, ""deletions"": 0, ""lines"": 1}, ""src/version.c"": {""insertions"": 2, ""deletions"": 0, ""lines"": 2}}"
2021-05-30 12:02:05,e0a7658bc8048aa29ff5c26b377dc5c6816fe422,Bram Moolenaar,5,3,8,2,"{""src/version.c"": {""insertions"": 2, ""deletions"": 0, ""lines"": 2}, ""src/vim.h"": {""insertions"": 3, ""deletions"": 3, ""lines"": 6}}"
2021-05-30 11:54:03,e5b4486c4279a9674a9bb76130b4db53fb9303a0,Bram Moolenaar,37,0,37,5,"{""src/errors.h"": {""insertions"": 2, ""deletions"": 0, ""lines"": 2}, ""src/terminal.c"": {""insertions"": 7, ""deletions"": 0, ""lines"": 7}, ""src/testdir/dumps/Test_cmdwin_no_terminal.dump"": {""insertions"": 12, ""deletions"": 0, ""lines"": 12}, ""src/testdir/test_cmdline.vim"": {""insertions"": 14, ""deletions"": 0, ""lines"": 14}, ""src/version.c"": {""insertions"": 2, ""deletions"": 0, ""lines"": 2}}"
2021-05-29 20:34:19,28cf44f761a7bf261bcd0760a1c5f61070f69595,Dominique Pelle,3,0,3,2,"{""src/term.c"": {""insertions"": 1, ""deletions"": 0, ""lines"": 1}, ""src/version.c"": {""insertions"": 2, ""deletions"": 0, ""lines"": 2}}"
2021-05-29 20:25:17,a5787c3742b43a8e662045a4e38c7a6ba957acbf,Bram Moolenaar,14,11,25,2,"{""src/testdir/test_startup.vim"": {""insertions"": 12, ""deletions"": 11, ""lines"": 23}, ""src/version.c"": {""insertions"": 2, ""deletions"": 0, ""lines"": 2}}"
2021-05-29 17:53:50,1d3a14ecf0cdde026984894c592dc140a2b46887,Christian Brabandt,26,3,29,5,"{""runtime/doc/starting.txt"": {""insertions"": 1, ""deletions"": 1, ""lines"": 2}, ""src/errors.h"": {""insertions"": 2, ""deletions"": 0, ""lines"": 2}, ""src/main.c"": {""insertions"": 8, ""deletions"": 2, ""lines"": 10}, ""src/testdir/test_startup.vim"": {""insertions"": 13, ""deletions"": 0, ""lines"": 13}, ""src/version.c"": {""insertions"": 2, ""deletions"": 0, ""lines"": 2}}"
2021-05-29 17:18:01,74ede80aeb272ac81d41a256057c4f250372dd00,Bram Moolenaar,38,3,41,3,"{""src/normal.c"": {""insertions"": 11, ""deletions"": 0, ""lines"": 11}, ""src/testdir/test_normal.vim"": {""insertions"": 25, ""deletions"": 3, ""lines"": 28}, ""src/version.c"": {""insertions"": 2, ""deletions"": 0, ""lines"": 2}}"
2021-05-29 15:56:37,a06e345af5b8261c072c95b0446e67cfda439848,Bram Moolenaar,25,0,25,3,"{""src/drawline.c"": {""insertions"": 6, ""deletions"": 0, ""lines"": 6}, ""src/testdir/test_display.vim"": {""insertions"": 17, ""deletions"": 0, ""lines"": 17}, ""src/version.c"": {""insertions"": 2, ""deletions"": 0, ""lines"": 2}}"
2021-05-29 15:29:33,5a6cfb3ff2f2f422a3732f3855616c89dd19c19d,Dominique Pelle,95,2,97,2,"{""src/testdir/test_spellfile.vim"": {""insertions"": 93, ""deletions"": 2, ""lines"": 95}, ""src/version.c"": {""insertions"": 2, ""deletions"": 0, ""lines"": 2}}"
2021-05-29 14:30:12,3e72dcad8b752a42b6eaf71213e3f5d534175256,Bram Moolenaar,167,12,179,6,"{""src/testdir/test_cpoptions.vim"": {""insertions"": 1, ""deletions"": 0, ""lines"": 1}, ""src/testdir/test_increment.vim"": {""insertions"": 17, ""deletions"": 0, ""lines"": 17}, ""src/testdir/test_normal.vim"": {""insertions"": 31, ""deletions"": 0, ""lines"": 31}, ""src/testdir/test_virtualedit.vim"": {""insertions"": 27, ""deletions"": 0, ""lines"": 27}, ""src/testdir/test_visual.vim"": {""insertions"": 89, ""deletions"": 12, ""lines"": 101}, ""src/version.c"": {""insertions"": 2, ""deletions"": 0, ""lines"": 2}}"
2021-05-29 12:30:43,1174b018a6d705ddb8c04f3d21f78ae760aa0856,Bram Moolenaar,31,8,39,3,"{""src/ex_docmd.c"": {""insertions"": 8, ""deletions"": 8, ""lines"": 16}, ""src/testdir/test_writefile.vim"": {""insertions"": 21, ""deletions"": 0, ""lines"": 21}, ""src/version.c"": {""insertions"": 2, ""deletions"": 0, ""lines"": 2}}"
2021-05-29 10:42:47,f89be8de14cc9055d12f7b0f2c270a5bc09fc86c,K.Takata,16,6,22,2,"{""ci/appveyor.bat"": {""insertions"": 14, ""deletions"": 6, ""lines"": 20}, ""src/version.c"": {""insertions"": 2, ""deletions"": 0, ""lines"": 2}}"
2021-05-29 10:21:58,3552e742898cd57adaf9b8ce32a9056271eab8d2,Bram Moolenaar,9,5,14,4,"{""src/ex_docmd.c"": {""insertions"": 2, ""deletions"": 2, ""lines"": 4}, ""src/gui.c"": {""insertions"": 3, ""deletions"": 2, ""lines"": 5}, ""src/proto/ex_docmd.pro"": {""insertions"": 2, ""deletions"": 1, ""lines"": 3}, ""src/version.c"": {""insertions"": 2, ""deletions"": 0, ""lines"": 2}}"
2021-05-28 19:06:08,d0edaf9dc253e619ccc321ceaac321aee11c1ea5,Bram Moolenaar,39,19,58,6,"{""src/eval.c"": {""insertions"": 3, ""deletions"": 0, ""lines"": 3}, ""src/proto/vim9script.pro"": {""insertions"": 1, ""deletions"": 0, ""lines"": 1}, ""src/testdir/test_vim9_assign.vim"": {""insertions"": 7, ""deletions"": 0, ""lines"": 7}, ""src/version.c"": {""insertions"": 2, ""deletions"": 0, ""lines"": 2}, ""src/vim9compile.c"": {""insertions"": 2, ""deletions"": 17, ""lines"": 19}, ""src/vim9script.c"": {""insertions"": 24, ""deletions"": 2, ""lines"": 26}}"
2021-05-28 16:32:12,dc3275a1ac73b6c4d0c9d2e238ea80b477705b6f,Dominique Pelle,68,0,68,2,"{""src/testdir/test_spellfile.vim"": {""insertions"": 66, ""deletions"": 0, ""lines"": 66}, ""src/version.c"": {""insertions"": 2, ""deletions"": 0, ""lines"": 2}}"
2021-05-28 15:52:40,4ac198c61cb3097d4839d5a697cc8b2b256ac575,mityu,63,9,72,4,"{""src/eval.c"": {""insertions"": 10, ""deletions"": 7, ""lines"": 17}, ""src/testdir/test_vim9_expr.vim"": {""insertions"": 50, ""deletions"": 1, ""lines"": 51}, ""src/version.c"": {""insertions"": 2, ""deletions"": 0, ""lines"": 2}, ""src/vim9compile.c"": {""insertions"": 1, ""deletions"": 1, ""lines"": 2}}"
2021-05-28 13:49:34,2c4a1d0a619b0f1e0f7dac98681da6fee58c6a44,K.Takata,17,1,18,2,"{""src/time.c"": {""insertions"": 15, ""deletions"": 1, ""lines"": 16}, ""src/version.c"": {""insertions"": 2, ""deletions"": 0, ""lines"": 2}}"
2021-05-28 12:12:14,bc869874fedf094129831836f131c64f10d98854,Ralf Schandl,69,8,77,5,"{""src/message_test.c"": {""insertions"": 32, ""deletions"": 0, ""lines"": 32}, ""src/popupwin.c"": {""insertions"": 20, ""deletions"": 8, ""lines"": 28}, ""src/testdir/dumps/Test_popupwin_multibytetitle.dump"": {""insertions"": 10, ""deletions"": 0, ""lines"": 10}, ""src/testdir/test_popupwin.vim"": {""insertions"": 5, ""deletions"": 0, ""lines"": 5}, ""src/version.c"": {""insertions"": 2, ""deletions"": 0, ""lines"": 2}}"
2021-05-28 11:50:17,89dcb4dce369de22fba13b9c3c63f11f8d42650b,mityu,11,2,13,3,"{""src/eval.c"": {""insertions"": 1, ""deletions"": 1, ""lines"": 2}, ""src/testdir/test_vim9_expr.vim"": {""insertions"": 8, ""deletions"": 1, ""lines"": 9}, ""src/version.c"": {""insertions"": 2, ""deletions"": 0, ""lines"": 2}}"
2021-05-27 16:05:14,543467136f001708f4c63376ac5d18adde82db30,ichizok,32,1,33,2,"{""src/if_perl.xs"": {""insertions"": 30, ""deletions"": 1, ""lines"": 31}, ""src/version.c"": {""insertions"": 2, ""deletions"": 0, ""lines"": 2}}"
2021-05-26 20:32:10,840f91f110c4790a145e76eec453326445290f21,Bram Moolenaar,29,2,31,4,"{""src/memline.c"": {""insertions"": 7, ""deletions"": 2, ""lines"": 9}, ""src/structs.h"": {""insertions"": 1, ""deletions"": 0, ""lines"": 1}, ""src/testdir/test_textprop.vim"": {""insertions"": 19, ""deletions"": 0, ""lines"": 19}, ""src/version.c"": {""insertions"": 2, ""deletions"": 0, ""lines"": 2}}"
2021-05-26 19:49:18,c512599b22aac7305b171566c2f595e0ae85b885,K.Takata,4,2,6,3,"{""Makefile"": {""insertions"": 1, ""deletions"": 1, ""lines"": 2}, ""src/testdir/Makefile"": {""insertions"": 1, ""deletions"": 1, ""lines"": 2}, ""src/version.c"": {""insertions"": 2, ""deletions"": 0, ""lines"": 2}}"
2021-05-26 19:10:11,7d840e9ac7529ec144e103d2a13abce8aa8c1ff1,Bram Moolenaar,50,7,57,4,"{""src/ex_docmd.c"": {""insertions"": 21, ""deletions"": 5, ""lines"": 26}, ""src/testdir/test_vim9_builtin.vim"": {""insertions"": 23, ""deletions"": 0, ""lines"": 23}, ""src/testdir/test_vim9_script.vim"": {""insertions"": 4, ""deletions"": 2, ""lines"": 6}, ""src/version.c"": {""insertions"": 2, ""deletions"": 0, ""lines"": 2}}"
2021-05-26 17:49:09,4c8e8c6e19b75d632b042aa0ba0a2ab769b2162e,Bram Moolenaar,9,3,12,3,"{""src/ex_docmd.c"": {""insertions"": 6, ""deletions"": 3, ""lines"": 9}, ""src/testdir/test_cmdline.vim"": {""insertions"": 1, ""deletions"": 0, ""lines"": 1}, ""src/version.c"": {""insertions"": 2, ""deletions"": 0, ""lines"": 2}}"
2021-05-25 18:14:00,34fcb697240c1bc9e69417ed75db3b1a83479724,Yegappan Lakshmanan,53,0,53,9,"{""src/testdir/test_expr.vim"": {""insertions"": 1, ""deletions"": 0, ""lines"": 1}, ""src/testdir/test_functions.vim"": {""insertions"": 7, ""deletions"": 0, ""lines"": 7}, ""src/testdir/test_listdict.vim"": {""insertions"": 5, ""deletions"": 0, ""lines"": 5}, ""src/testdir/test_registers.vim"": {""insertions"": 9, ""deletions"": 0, ""lines"": 9}, ""src/testdir/test_user_func.vim"": {""insertions"": 10, ""deletions"": 0, ""lines"": 10}, ""src/testdir/test_vim9_builtin.vim"": {""insertions"": 8, ""deletions"": 0, ""lines"": 8}, ""src/testdir/test_vim9_expr.vim"": {""insertions"": 3, ""deletions"": 0, ""lines"": 3}, ""src/testdir/test_vim9_func.vim"": {""insertions"": 8, ""deletions"": 0, ""lines"": 8}, ""src/version.c"": {""insertions"": 2, ""deletions"": 0, ""lines"": 2}}"
2021-05-24 20:56:15,872bee557e5f8ab0e4a523a6a845868a2801b17e,Bram Moolenaar,54,17,71,4,"{""src/regexp_bt.c"": {""insertions"": 16, ""deletions"": 4, ""lines"": 20}, ""src/regexp_nfa.c"": {""insertions"": 19, ""deletions"": 11, ""lines"": 30}, ""src/testdir/test_search.vim"": {""insertions"": 17, ""deletions"": 2, ""lines"": 19}, ""src/version.c"": {""insertions"": 2, ""deletions"": 0, ""lines"": 2}}"
2021-05-24 17:37:26,1e469c72ee2914fcffbcd49258036acdabd6f500,Dominique Pelle,15,1,16,2,"{""src/testdir/test_cscope.vim"": {""insertions"": 13, ""deletions"": 1, ""lines"": 14}, ""src/version.c"": {""insertions"": 2, ""deletions"": 0, ""lines"": 2}}"
2021-05-24 16:48:27,e97c7c962ca0fd7cad0d157f1762eb5cc5887fca,matveyt,23,17,40,9,"{"".gitignore"": {""insertions"": 0, ""deletions"": 1, ""lines"": 1}, "".hgignore"": {""insertions"": 0, ""deletions"": 1, ""lines"": 1}, ""Filelist"": {""insertions"": 1, ""deletions"": 1, ""lines"": 2}, ""Makefile"": {""insertions"": 2, ""deletions"": 2, ""lines"": 4}, ""src/Make_cyg_ming.mak"": {""insertions"": 8, ""deletions"": 8, ""lines"": 16}, ""src/Make_mvc.mak"": {""insertions"": 3, ""deletions"": 3, ""lines"": 6}, ""src/version.c"": {""insertions"": 2, ""deletions"": 0, ""lines"": 2}, ""src/{gvim.exe.mnf => vim.manifest}"": {""insertions"": 6, ""deletions"": 0, ""lines"": 6}, ""src/vim.rc"": {""insertions"": 1, ""deletions"": 1, ""lines"": 2}}"
2021-05-24 13:45:29,15bbb8f4f38d25d491d7dff83ef0552e2d442d5d,Bram Moolenaar,6,0,6,2,"{""src/userfunc.c"": {""insertions"": 4, ""deletions"": 0, ""lines"": 4}, ""src/version.c"": {""insertions"": 2, ""deletions"": 0, ""lines"": 2}}"
2021-05-24 13:15:47,611728f80604dd56960e8c197e5749d203c8feb1,Yegappan Lakshmanan,49,2,51,8,"{""src/testdir/test_const.vim"": {""insertions"": 21, ""deletions"": 1, ""lines"": 22}, ""src/testdir/test_functions.vim"": {""insertions"": 4, ""deletions"": 0, ""lines"": 4}, ""src/testdir/test_python2.vim"": {""insertions"": 2, ""deletions"": 0, ""lines"": 2}, ""src/testdir/test_python3.vim"": {""insertions"": 2, ""deletions"": 0, ""lines"": 2}, ""src/testdir/test_user_func.vim"": {""insertions"": 8, ""deletions"": 1, ""lines"": 9}, ""src/testdir/test_vim9_expr.vim"": {""insertions"": 3, ""deletions"": 0, ""lines"": 3}, ""src/testdir/test_vim9_func.vim"": {""insertions"": 7, ""deletions"": 0, ""lines"": 7}, ""src/version.c"": {""insertions"": 2, ""deletions"": 0, ""lines"": 2}}"
2021-05-24 12:20:53,ad5c178a191cf2cf37a27c2a789d7afda3879831,glacambre,10,3,13,3,"{""src/diff.c"": {""insertions"": 4, ""deletions"": 2, ""lines"": 6}, ""src/testdir/test_diffmode.vim"": {""insertions"": 4, ""deletions"": 1, ""lines"": 5}, ""src/version.c"": {""insertions"": 2, ""deletions"": 0, ""lines"": 2}}"
2021-05-23 09:18:50,f5409dbf66f4e4a0461d3f2079c1bffacbf12392,Marcin Szamotulski,4,2,6,3,"{""runtime/filetype.vim"": {""insertions"": 1, ""deletions"": 1, ""lines"": 2}, ""src/testdir/test_filetype.vim"": {""insertions"": 1, ""deletions"": 1, ""lines"": 2}, ""src/version.c"": {""insertions"": 2, ""deletions"": 0, ""lines"": 2}}"
2021-05-22 19:40:39,b777da9be8eb421982e567702db3195475383dec,Bram Moolenaar,14,0,14,3,"{""src/testdir/test_vim9_script.vim"": {""insertions"": 6, ""deletions"": 0, ""lines"": 6}, ""src/version.c"": {""insertions"": 2, ""deletions"": 0, ""lines"": 2}, ""src/vim9compile.c"": {""insertions"": 6, ""deletions"": 0, ""lines"": 6}}"
2021-05-22 15:12:46,1e615669c0f1f4125001b2c01c30b00d8c68035e,Yegappan Lakshmanan,100,0,100,6,"{""src/testdir/dumps/Test_pum_rightleft_01.dump"": {""insertions"": 8, ""deletions"": 0, ""lines"": 8}, ""src/testdir/dumps/Test_pum_rightleft_02.dump"": {""insertions"": 7, ""deletions"": 0, ""lines"": 7}, ""src/testdir/dumps/Test_pum_scrollbar_01.dump"": {""insertions"": 7, ""deletions"": 0, ""lines"": 7}, ""src/testdir/dumps/Test_pum_scrollbar_02.dump"": {""insertions"": 7, ""deletions"": 0, ""lines"": 7}, ""src/testdir/test_popup.vim"": {""insertions"": 69, ""deletions"": 0, ""lines"": 69}, ""src/version.c"": {""insertions"": 2, ""deletions"": 0, ""lines"": 2}}"
2021-05-21 09:43:58,23c0192166760b0d73bd39252ca72e3cfe596f6e,Bram Moolenaar,4,2,6,3,"{""src/auto/configure"": {""insertions"": 1, ""deletions"": 1, ""lines"": 2}, ""src/configure.ac"": {""insertions"": 1, ""deletions"": 1, ""lines"": 2}, ""src/version.c"": {""insertions"": 2, ""deletions"": 0, ""lines"": 2}}"
2021-05-20 19:14:20,5cf94577cf2045fec87344d7d89422fe6dfce62f,=?UTF-8?q?Luka=20Marku=C5=A1i=C4=87?=,12,1,13,3,"{""src/misc1.c"": {""insertions"": 6, ""deletions"": 1, ""lines"": 7}, ""src/testdir/test_functions.vim"": {""insertions"": 4, ""deletions"": 0, ""lines"": 4}, ""src/version.c"": {""insertions"": 2, ""deletions"": 0, ""lines"": 2}}"
2021-05-20 09:54:10,4eb1914e1bd870a7ea829cae150e1f9fdc3df7b1,matveyt,5,1,6,2,"{""src/os_win32.c"": {""insertions"": 3, ""deletions"": 1, ""lines"": 4}, ""src/version.c"": {""insertions"": 2, ""deletions"": 0, ""lines"": 2}}"
2021-05-19 15:15:04,46aa6f93acb5d932d2893606d980a6b4b8a9594c,Yegappan Lakshmanan,72,3,75,5,"{""src/testdir/test_buffer.vim"": {""insertions"": 20, ""deletions"": 0, ""lines"": 20}, ""src/testdir/test_cmdline.vim"": {""insertions"": 29, ""deletions"": 1, ""lines"": 30}, ""src/testdir/test_functions.vim"": {""insertions"": 1, ""deletions"": 0, ""lines"": 1}, ""src/testdir/test_writefile.vim"": {""insertions"": 20, ""deletions"": 2, ""lines"": 22}, ""src/version.c"": {""insertions"": 2, ""deletions"": 0, ""lines"": 2}}"
2021-05-18 22:16:14,56c9fd01076bc62b55c8cb89d8a66f6136e52f3a,Dominique Pelle,14,4,18,3,"{""src/testdir/test_python2.vim"": {""insertions"": 6, ""deletions"": 2, ""lines"": 8}, ""src/testdir/test_python3.vim"": {""insertions"": 6, ""deletions"": 2, ""lines"": 8}, ""src/version.c"": {""insertions"": 2, ""deletions"": 0, ""lines"": 2}}"
2021-05-18 19:46:31,4781d6fd8670af415c3b78f00d70036af85bd286,Dominique Pelle,21,20,41,8,"{""src/charset.c"": {""insertions"": 2, ""deletions"": 4, ""lines"": 6}, ""src/evalfunc.c"": {""insertions"": 3, ""deletions"": 3, ""lines"": 6}, ""src/ex_docmd.c"": {""insertions"": 2, ""deletions"": 2, ""lines"": 4}, ""src/json.c"": {""insertions"": 1, ""deletions"": 1, ""lines"": 2}, ""src/ops.c"": {""insertions"": 5, ""deletions"": 4, ""lines"": 9}, ""src/tag.c"": {""insertions"": 1, ""deletions"": 1, ""lines"": 2}, ""src/version.c"": {""insertions"": 2, ""deletions"": 0, ""lines"": 2}, ""src/vim9compile.c"": {""insertions"": 5, ""deletions"": 5, ""lines"": 10}}"
2021-05-18 19:38:45,796139ae3ac89e27ee96dce3c7fdb87d8c839f53,Bram Moolenaar,12,1,13,3,"{""src/ex_getln.c"": {""insertions"": 4, ""deletions"": 1, ""lines"": 5}, ""src/testdir/test_cmdline.vim"": {""insertions"": 6, ""deletions"": 0, ""lines"": 6}, ""src/version.c"": {""insertions"": 2, ""deletions"": 0, ""lines"": 2}}"
2021-05-18 17:19:03,485b62710004431a16feb4eb861365d082304a08,Bram Moolenaar,27,3,30,2,"{""src/testdir/test_diffmode.vim"": {""insertions"": 25, ""deletions"": 3, ""lines"": 28}, ""src/version.c"": {""insertions"": 2, ""deletions"": 0, ""lines"": 2}}"
2021-05-18 15:49:59,cbe178e3dc4ad45d9b2ed5e713e7c4cc88bf8b8b,Bram Moolenaar,67,57,124,3,"{""src/testdir/test_vim9_builtin.vim"": {""insertions"": 4, ""deletions"": 1, ""lines"": 5}, ""src/version.c"": {""insertions"": 2, ""deletions"": 0, ""lines"": 2}, ""src/vim9execute.c"": {""insertions"": 61, ""deletions"": 56, ""lines"": 117}}"
2021-05-18 13:32:11,082a3bf961efd3668d06e3137cb1ad27c3998d07,Bram Moolenaar,3,1,4,2,"{""src/globals.h"": {""insertions"": 1, ""deletions"": 1, ""lines"": 2}, ""src/version.c"": {""insertions"": 2, ""deletions"": 0, ""lines"": 2}}"
2021-05-18 13:09:18,ecb664501d3b04d124fca69029b275c520401d40,Bram Moolenaar,21,8,29,4,"{""src/eval.c"": {""insertions"": 10, ""deletions"": 2, ""lines"": 12}, ""src/structs.h"": {""insertions"": 2, ""deletions"": 0, ""lines"": 2}, ""src/userfunc.c"": {""insertions"": 7, ""deletions"": 6, ""lines"": 13}, ""src/version.c"": {""insertions"": 2, ""deletions"": 0, ""lines"": 2}}"
2021-05-18 11:40:33,d87c21a918d8d611750f22d68fc638bf7a79b1d5,Bram Moolenaar,6,1,7,2,"{""src/userfunc.c"": {""insertions"": 4, ""deletions"": 1, ""lines"": 5}, ""src/version.c"": {""insertions"": 2, ""deletions"": 0, ""lines"": 2}}"
2021-05-18 09:47:44,074f84c01fbe70554feb6a71c0d9cacf2ef77ca5,Bram Moolenaar,102,7,109,3,"{""src/testdir/test_vim9_func.vim"": {""insertions"": 14, ""deletions"": 0, ""lines"": 14}, ""src/userfunc.c"": {""insertions"": 86, ""deletions"": 7, ""lines"": 93}, ""src/version.c"": {""insertions"": 2, ""deletions"": 0, ""lines"": 2}}"
2021-05-16 22:22:06,965c04486c9364ded99b49c86f4c41228503df1f,Bram Moolenaar,10,8,18,2,"{""src/textprop.c"": {""insertions"": 8, ""deletions"": 8, ""lines"": 16}, ""src/version.c"": {""insertions"": 2, ""deletions"": 0, ""lines"": 2}}"
2021-05-16 22:15:18,fc643e6016af80ed5be4570db5c26a6410f52d16,Bram Moolenaar,11,1,12,2,"{""src/textprop.c"": {""insertions"": 9, ""deletions"": 1, ""lines"": 10}, ""src/version.c"": {""insertions"": 2, ""deletions"": 0, ""lines"": 2}}"
2021-05-16 22:01:42,3b1373b193ce5fbf25e852277a4ecc98688c7bb8,Bram Moolenaar,95,7,102,5,"{""src/testdir/test_vim9_expr.vim"": {""insertions"": 15, ""deletions"": 0, ""lines"": 15}, ""src/version.c"": {""insertions"": 2, ""deletions"": 0, ""lines"": 2}, ""src/vim9.h"": {""insertions"": 1, ""deletions"": 0, ""lines"": 1}, ""src/vim9compile.c"": {""insertions"": 52, ""deletions"": 7, ""lines"": 59}, ""src/vim9execute.c"": {""insertions"": 25, ""deletions"": 0, ""lines"": 25}}"
2021-05-16 18:18:57,1764faa38645a559172e9a31f08447385835de81,Bram Moolenaar,6,2,8,4,"{""src/change.c"": {""insertions"": 1, ""deletions"": 1, ""lines"": 2}, ""src/proto/change.pro"": {""insertions"": 1, ""deletions"": 0, ""lines"": 1}, ""src/textprop.c"": {""insertions"": 2, ""deletions"": 1, ""lines"": 3}, ""src/version.c"": {""insertions"": 2, ""deletions"": 0, ""lines"": 2}}"
2021-05-16 18:06:59,dcfc311198b174468c007ec4b5b22b33c2c11c92,Bram Moolenaar,3,1,4,2,"{""src/testdir/test_tcl.vim"": {""insertions"": 1, ""deletions"": 1, ""lines"": 2}, ""src/version.c"": {""insertions"": 2, ""deletions"": 0, ""lines"": 2}}"
2021-05-16 14:19:37,6b02b38ed06879f5e6befe2140aee11a6ad66884,Bram Moolenaar,4,2,6,2,"{""src/testdir/test_ex_mode.vim"": {""insertions"": 2, ""deletions"": 2, ""lines"": 4}, ""src/version.c"": {""insertions"": 2, ""deletions"": 0, ""lines"": 2}}"
2021-05-16 13:24:49,ff65288aa89dcd50760ad942d58baff70c6e93e6,Bram Moolenaar,23,4,27,5,"{""src/globals.h"": {""insertions"": 1, ""deletions"": 1, ""lines"": 2}, ""src/testdir/test_vim9_builtin.vim"": {""insertions"": 14, ""deletions"": 0, ""lines"": 14}, ""src/version.c"": {""insertions"": 2, ""deletions"": 0, ""lines"": 2}, ""src/vim9compile.c"": {""insertions"": 3, ""deletions"": 2, ""lines"": 5}, ""src/vim9execute.c"": {""insertions"": 3, ""deletions"": 1, ""lines"": 4}}"
2021-05-16 10:39:47,3ec3217f0491e9ba8aa8ea02f7e454cd19a287ef,Bram Moolenaar,243,74,317,19,"{"".github/CODEOWNERS"": {""insertions"": 17, ""deletions"": 5, ""lines"": 22}, ""runtime/doc/cmdline.txt"": {""insertions"": 6, ""deletions"": 4, ""lines"": 10}, ""runtime/doc/eval.txt"": {""insertions"": 6, ""deletions"": 1, ""lines"": 7}, ""runtime/doc/map.txt"": {""insertions"": 17, ""deletions"": 1, ""lines"": 18}, ""runtime/doc/options.txt"": {""insertions"": 1, ""deletions"": 1, ""lines"": 2}, ""runtime/doc/pattern.txt"": {""insertions"": 35, ""deletions"": 1, ""lines"": 36}, ""runtime/doc/quickfix.txt"": {""insertions"": 3, ""deletions"": 3, ""lines"": 6}, ""runtime/doc/repeat.txt"": {""insertions"": 14, ""deletions"": 5, ""lines"": 19}, ""runtime/doc/starting.txt"": {""insertions"": 2, ""deletions"": 2, ""lines"": 4}, ""runtime/doc/tags"": {""insertions"": 4, ""deletions"": 1, ""lines"": 5}, ""runtime/doc/todo.txt"": {""insertions"": 22, ""deletions"": 8, ""lines"": 30}, ""runtime/doc/version7.txt"": {""insertions"": 2, ""deletions"": 2, ""lines"": 4}, ""runtime/doc/version8.txt"": {""insertions"": 2, ""deletions"": 2, ""lines"": 4}, ""runtime/ftplugin/meson.vim"": {""insertions"": 1, ""deletions"": 0, ""lines"": 1}, ""runtime/ftplugin/systemverilog.vim"": {""insertions"": 34, ""deletions"": 1, ""lines"": 35}, ""runtime/indent/meson.vim"": {""insertions"": 1, ""deletions"": 0, ""lines"": 1}, ""runtime/pack/dist/opt/termdebug/plugin/termdebug.vim"": {""insertions"": 4, ""deletions"": 2, ""lines"": 6}, ""runtime/syntax/dts.vim"": {""insertions"": 51, ""deletions"": 3, ""lines"": 54}, ""runtime/syntax/meson.vim"": {""insertions"": 21, ""deletions"": 32, ""lines"": 53}}"
2021-05-15 21:21:05,50157ef1c2e36d8696e79fd688bdd08312196bc6,Bram Moolenaar,21,2,23,3,"{""src/ex_cmds.c"": {""insertions"": 18, ""deletions"": 1, ""lines"": 19}, ""src/testdir/test_writefile.vim"": {""insertions"": 1, ""deletions"": 1, ""lines"": 2}, ""src/version.c"": {""insertions"": 2, ""deletions"": 0, ""lines"": 2}}"
2021-05-15 18:06:58,0820f4de5872bfbdc25bf6cba6ec5646dbcec156,Bram Moolenaar,14,3,17,3,"{""src/eval.c"": {""insertions"": 10, ""deletions"": 2, ""lines"": 12}, ""src/testdir/test_method.vim"": {""insertions"": 2, ""deletions"": 1, ""lines"": 3}, ""src/version.c"": {""insertions"": 2, ""deletions"": 0, ""lines"": 2}}"
2021-05-15 15:23:28,30e3de21fc36153c5f7c9cf9db90bcc60dd67fb9,shadmansaleh,106,5,111,5,"{""runtime/doc/options.txt"": {""insertions"": 12, ""deletions"": 0, ""lines"": 12}, ""src/buffer.c"": {""insertions"": 69, ""deletions"": 4, ""lines"": 73}, ""src/optionstr.c"": {""insertions"": 3, ""deletions"": 1, ""lines"": 4}, ""src/testdir/test_statusline.vim"": {""insertions"": 20, ""deletions"": 0, ""lines"": 20}, ""src/version.c"": {""insertions"": 2, ""deletions"": 0, ""lines"": 2}}"
2021-05-15 13:09:06,d832c3c56ec7043322ad3e99897e312700fa1d3e,Bram Moolenaar,8,3,11,2,"{""src/ex_getln.c"": {""insertions"": 6, ""deletions"": 3, ""lines"": 9}, ""src/version.c"": {""insertions"": 2, ""deletions"": 0, ""lines"": 2}}"
2021-05-15 12:25:37,761ead497feff5fd259c9f6ca76d184bb8755373,Natanael Copa,8,2,10,3,"{""src/auto/configure"": {""insertions"": 3, ""deletions"": 1, ""lines"": 4}, ""src/configure.ac"": {""insertions"": 3, ""deletions"": 1, ""lines"": 4}, ""src/version.c"": {""insertions"": 2, ""deletions"": 0, ""lines"": 2}}"
2021-05-15 11:19:16,847fe7d750001a46a09b97ad57286612d0be8100,Bram Moolenaar,32,3,35,3,"{""src/ex_getln.c"": {""insertions"": 11, ""deletions"": 3, ""lines"": 14}, ""src/testdir/test_cmdline.vim"": {""insertions"": 19, ""deletions"": 0, ""lines"": 19}, ""src/version.c"": {""insertions"": 2, ""deletions"": 0, ""lines"": 2}}"
2021-05-13 18:23:10,71c6f7a665eb467054fbf319989d97c252af28d2,obcat,50,0,50,2,"{""src/testdir/test_cmdline.vim"": {""insertions"": 48, ""deletions"": 0, ""lines"": 48}, ""src/version.c"": {""insertions"": 2, ""deletions"": 0, ""lines"": 2}}"
2021-05-13 16:33:16,36f96a515109dc1fad279571a645c0f0d65f2de4,Yegappan Lakshmanan,214,0,214,3,"{""src/testdir/test_startup.vim"": {""insertions"": 15, ""deletions"": 0, ""lines"": 15}, ""src/testdir/test_writefile.vim"": {""insertions"": 197, ""deletions"": 0, ""lines"": 197}, ""src/version.c"": {""insertions"": 2, ""deletions"": 0, ""lines"": 2}}"
2021-05-13 12:55:55,fe8ebdbe5c4e116311c0c0d5937b89ded5c92d01,Dominique Pelle,18,8,26,5,"{""src/eval.c"": {""insertions"": 7, ""deletions"": 4, ""lines"": 11}, ""src/evalfunc.c"": {""insertions"": 4, ""deletions"": 4, ""lines"": 8}, ""src/testdir/test_functions.vim"": {""insertions"": 4, ""deletions"": 0, ""lines"": 4}, ""src/testdir/test_listdict.vim"": {""insertions"": 1, ""deletions"": 0, ""lines"": 1}, ""src/version.c"": {""insertions"": 2, ""deletions"": 0, ""lines"": 2}}"
2021-05-10 21:49:39,588cf7547bafaff46a82bc125d05d24a1cedf827,Dominique Pelle,31,2,33,3,"{""src/testdir/test_arabic.vim"": {""insertions"": 8, ""deletions"": 0, ""lines"": 8}, ""src/testdir/test_perl.vim"": {""insertions"": 21, ""deletions"": 2, ""lines"": 23}, ""src/version.c"": {""insertions"": 2, ""deletions"": 0, ""lines"": 2}}"
2021-05-09 21:19:22,68db996b621b98066fb7ab7028ed5c6aaa3954a8,Bram Moolenaar,65,9,74,9,"{""src/errors.h"": {""insertions"": 4, ""deletions"": 0, ""lines"": 4}, ""src/eval.c"": {""insertions"": 14, ""deletions"": 5, ""lines"": 19}, ""src/evalfunc.c"": {""insertions"": 2, ""deletions"": 1, ""lines"": 3}, ""src/globals.h"": {""insertions"": 0, ""deletions"": 1, ""lines"": 1}, ""src/testdir/test_vim9_cmd.vim"": {""insertions"": 23, ""deletions"": 0, ""lines"": 23}, ""src/typval.c"": {""insertions"": 2, ""deletions"": 1, ""lines"": 3}, ""src/version.c"": {""insertions"": 2, ""deletions"": 0, ""lines"": 2}, ""src/vim9compile.c"": {""insertions"": 16, ""deletions"": 0, ""lines"": 16}, ""src/vim9execute.c"": {""insertions"": 2, ""deletions"": 1, ""lines"": 3}}"
2021-05-08 18:09:24,918b08957c51ae079f8f456198f8a1869a3d2a4c,Bram Moolenaar,4,2,6,2,"{""src/terminal.c"": {""insertions"": 2, ""deletions"": 2, ""lines"": 4}, ""src/version.c"": {""insertions"": 2, ""deletions"": 0, ""lines"": 2}}"
2021-05-07 18:43:54,24f720998f852dd1ba861ec67d56625a507b915e,Bram Moolenaar,6,1,7,2,"{""src/typval.c"": {""insertions"": 4, ""deletions"": 1, ""lines"": 5}, ""src/version.c"": {""insertions"": 2, ""deletions"": 0, ""lines"": 2}}"
2021-05-07 17:44:21,f06ab6ba388c1ac907adbbde95b63769f67bc59b,Bram Moolenaar,29,2,31,3,"{""src/testdir/test_vim9_builtin.vim"": {""insertions"": 21, ""deletions"": 0, ""lines"": 21}, ""src/version.c"": {""insertions"": 2, ""deletions"": 0, ""lines"": 2}, ""src/vim9compile.c"": {""insertions"": 6, ""deletions"": 2, ""lines"": 8}}"
2021-05-07 15:55:55,f18332fb9e2e4208a97d800f096b02c6681780e7,Bram Moolenaar,235,17,252,18,"{""src/eval.c"": {""insertions"": 13, ""deletions"": 0, ""lines"": 13}, ""src/evalfunc.c"": {""insertions"": 3, ""deletions"": 0, ""lines"": 3}, ""src/evalvars.c"": {""insertions"": 1, ""deletions"": 0, ""lines"": 1}, ""src/if_py_both.h"": {""insertions"": 1, ""deletions"": 0, ""lines"": 1}, ""src/json.c"": {""insertions"": 1, ""deletions"": 0, ""lines"": 1}, ""src/proto/vim9execute.pro"": {""insertions"": 1, ""deletions"": 0, ""lines"": 1}, ""src/structs.h"": {""insertions"": 3, ""deletions"": 0, ""lines"": 3}, ""src/testdir/test_vim9_builtin.vim"": {""insertions"": 14, ""deletions"": 0, ""lines"": 14}, ""src/testdir/test_vim9_disassemble.vim"": {""insertions"": 29, ""deletions"": 0, ""lines"": 29}, ""src/testing.c"": {""insertions"": 1, ""deletions"": 0, ""lines"": 1}, ""src/typval.c"": {""insertions"": 11, ""deletions"": 0, ""lines"": 11}, ""src/version.c"": {""insertions"": 2, ""deletions"": 0, ""lines"": 2}, ""src/vim.h"": {""insertions"": 1, ""deletions"": 0, ""lines"": 1}, ""src/vim9.h"": {""insertions"": 2, ""deletions"": 0, ""lines"": 2}, ""src/vim9compile.c"": {""insertions"": 90, ""deletions"": 17, ""lines"": 107}, ""src/vim9execute.c"": {""insertions"": 59, ""deletions"": 0, ""lines"": 59}, ""src/vim9type.c"": {""insertions"": 2, ""deletions"": 0, ""lines"": 2}, ""src/viminfo.c"": {""insertions"": 1, ""deletions"": 0, ""lines"": 1}}"
2021-05-07 13:00:17,e08795e1ecf0b85751e9f41021603c39ef026d92,matveyt,5,3,8,2,"{""src/os_win32.c"": {""insertions"": 3, ""deletions"": 3, ""lines"": 6}, ""src/version.c"": {""insertions"": 2, ""deletions"": 0, ""lines"": 2}}"
2021-05-06 19:04:55,261417b872e6449fe1ca4e7d10f1cfd9736ea453,Bram Moolenaar,45,21,66,3,"{""src/testdir/test_vim9_expr.vim"": {""insertions"": 22, ""deletions"": 0, ""lines"": 22}, ""src/version.c"": {""insertions"": 2, ""deletions"": 0, ""lines"": 2}, ""src/vim9compile.c"": {""insertions"": 21, ""deletions"": 21, ""lines"": 42}}"
2021-05-06 16:46:35,56318369750066718b880afa69e7ae3843d0410b,Natanael Copa,9,4,13,3,"{""runtime/doc/options.txt"": {""insertions"": 3, ""deletions"": 3, ""lines"": 6}, ""src/option.c"": {""insertions"": 4, ""deletions"": 1, ""lines"": 5}, ""src/version.c"": {""insertions"": 2, ""deletions"": 0, ""lines"": 2}}"
2021-05-06 15:45:22,e3e598e82b79a2ab5ba5e312d54e65c940e2e809,Liam Beguin,4,1,5,3,"{""runtime/filetype.vim"": {""insertions"": 1, ""deletions"": 0, ""lines"": 1}, ""src/testdir/test_filetype.vim"": {""insertions"": 1, ""deletions"": 1, ""lines"": 2}, ""src/version.c"": {""insertions"": 2, ""deletions"": 0, ""lines"": 2}}"
2021-05-06 15:36:55,6d37e8e3baafba460bd2d051170d213c1ba9a523,Dominique Pelle,49,0,49,7,"{""src/testdir/test_excmd.vim"": {""insertions"": 6, ""deletions"": 0, ""lines"": 6}, ""src/testdir/test_functions.vim"": {""insertions"": 2, ""deletions"": 0, ""lines"": 2}, ""src/testdir/test_options.vim"": {""insertions"": 28, ""deletions"": 0, ""lines"": 28}, ""src/testdir/test_startup.vim"": {""insertions"": 7, ""deletions"": 0, ""lines"": 7}, ""src/testdir/test_syntax.vim"": {""insertions"": 3, ""deletions"": 0, ""lines"": 3}, ""src/testdir/test_vim9_cmd.vim"": {""insertions"": 1, ""deletions"": 0, ""lines"": 1}, ""src/version.c"": {""insertions"": 2, ""deletions"": 0, ""lines"": 2}}"
2021-05-05 20:51:39,b7c978154e0816f4dcfae8a06b4ba1bfb7f796f6,Bram Moolenaar,18,1,19,4,"{""src/tag.c"": {""insertions"": 1, ""deletions"": 1, ""lines"": 2}, ""src/version.c"": {""insertions"": 2, ""deletions"": 0, ""lines"": 2}, ""src/vim9compile.c"": {""insertions"": 7, ""deletions"": 0, ""lines"": 7}, ""src/vim9execute.c"": {""insertions"": 8, ""deletions"": 0, ""lines"": 8}}"
2021-05-05 20:40:56,dc3e2e65c9dddcace4b24f0f364883d7ce448efb,Bram Moolenaar,3,0,3,2,"{""src/version.c"": {""insertions"": 2, ""deletions"": 0, ""lines"": 2}, ""src/vim9compile.c"": {""insertions"": 1, ""deletions"": 0, ""lines"": 1}}"
2021-05-05 19:31:39,5f7d4c049e934dbc8d2c3f2720797c10ee3c55c2,Bram Moolenaar,205,53,258,8,"{""src/proto/quickfix.pro"": {""insertions"": 3, ""deletions"": 0, ""lines"": 3}, ""src/quickfix.c"": {""insertions"": 69, ""deletions"": 53, ""lines"": 122}, ""src/testdir/test_quickfix.vim"": {""insertions"": 16, ""deletions"": 0, ""lines"": 16}, ""src/testdir/test_vim9_disassemble.vim"": {""insertions"": 19, ""deletions"": 0, ""lines"": 19}, ""src/version.c"": {""insertions"": 2, ""deletions"": 0, ""lines"": 2}, ""src/vim9.h"": {""insertions"": 16, ""deletions"": 0, ""lines"": 16}, ""src/vim9compile.c"": {""insertions"": 43, ""deletions"": 0, ""lines"": 43}, ""src/vim9execute.c"": {""insertions"": 37, ""deletions"": 0, ""lines"": 37}}"
2021-05-05 17:58:17,3a00659db740ebcf0be6153b47a5734eea4a18ba,Bram Moolenaar,5,1,6,2,"{""src/getchar.c"": {""insertions"": 3, ""deletions"": 1, ""lines"": 4}, ""src/version.c"": {""insertions"": 2, ""deletions"": 0, ""lines"": 2}}"
2021-05-04 19:56:28,1ad72c8eb601d681c84b47380fc31b6d23602d51,Bram Moolenaar,5,2,7,2,"{""src/normal.c"": {""insertions"": 3, ""deletions"": 2, ""lines"": 5}, ""src/version.c"": {""insertions"": 2, ""deletions"": 0, ""lines"": 2}}"
2021-05-03 19:40:26,02795104442764cd162c2213c7d942a8ddc0a691,Bram Moolenaar,9,0,9,2,"{""src/testdir/test_vim9_builtin.vim"": {""insertions"": 7, ""deletions"": 0, ""lines"": 7}, ""src/version.c"": {""insertions"": 2, ""deletions"": 0, ""lines"": 2}}"
2021-05-03 18:40:38,ad431995721b2a886f789e2ea7db4c84b732eb18,Bram Moolenaar,27,7,34,4,"{""src/optionstr.c"": {""insertions"": 4, ""deletions"": 1, ""lines"": 5}, ""src/proto/terminal.pro"": {""insertions"": 3, ""deletions"": 2, ""lines"": 5}, ""src/terminal.c"": {""insertions"": 18, ""deletions"": 4, ""lines"": 22}, ""src/version.c"": {""insertions"": 2, ""deletions"": 0, ""lines"": 2}}"
2021-05-03 18:01:45,df36514a6455342e178af693553ef9df9fcf8c83,Bram Moolenaar,16,5,21,5,"{""src/regexp_bt.c"": {""insertions"": 1, ""deletions"": 1, ""lines"": 2}, ""src/regexp_nfa.c"": {""insertions"": 1, ""deletions"": 1, ""lines"": 2}, ""src/testdir/test_exec_while_if.vim"": {""insertions"": 3, ""deletions"": 3, ""lines"": 6}, ""src/testdir/test_substitute.vim"": {""insertions"": 9, ""deletions"": 0, ""lines"": 9}, ""src/version.c"": {""insertions"": 2, ""deletions"": 0, ""lines"": 2}}"
2021-05-03 17:49:51,97a6c6a1fb6043fd6520fbaaafc6970334186167,Bram Moolenaar,3,1,4,2,"{""src/fileio.c"": {""insertions"": 1, ""deletions"": 1, ""lines"": 2}, ""src/version.c"": {""insertions"": 2, ""deletions"": 0, ""lines"": 2}}"
2021-05-03 17:08:37,5f8ed7408aaf477215bcfde3e487e24b9e6ad870,Dominique Pelle,4,2,6,2,"{""src/testdir/test_mksession.vim"": {""insertions"": 2, ""deletions"": 2, ""lines"": 4}, ""src/version.c"": {""insertions"": 2, ""deletions"": 0, ""lines"": 2}}"
2021-05-03 16:57:05,551c1aed65817558ac1ece541c246ea585645807,Bram Moolenaar,4,2,6,3,"{""src/map.c"": {""insertions"": 1, ""deletions"": 1, ""lines"": 2}, ""src/quickfix.c"": {""insertions"": 1, ""deletions"": 1, ""lines"": 2}, ""src/version.c"": {""insertions"": 2, ""deletions"": 0, ""lines"": 2}}"
2021-05-02 18:16:24,2bf6034e5caf36b319148f46ba9a12e36c3bd41d,Dominique Pelle,57,0,57,2,"{""src/testdir/test_excmd.vim"": {""insertions"": 55, ""deletions"": 0, ""lines"": 55}, ""src/version.c"": {""insertions"": 2, ""deletions"": 0, ""lines"": 2}}"
2021-05-02 17:15:05,1bb0da25a6581cd09d6df91f11ce866dc775597b,Bram Moolenaar,18,4,22,4,"{""Filelist"": {""insertions"": 2, ""deletions"": 2, ""lines"": 4}, ""src/testdir/shared.vim"": {""insertions"": 2, ""deletions"": 0, ""lines"": 2}, ""src/testdir/test_function_lists.vim"": {""insertions"": 12, ""deletions"": 2, ""lines"": 14}, ""src/version.c"": {""insertions"": 2, ""deletions"": 0, ""lines"": 2}}"
2021-05-02 15:19:11,4c295027a426986566cd7a76c47a6d3a529727e7,Bram Moolenaar,425,198,623,20,"{"".github/CODEOWNERS"": {""insertions"": 4, ""deletions"": 0, ""lines"": 4}, ""nsis/lang/english.nsi"": {""insertions"": 1, ""deletions"": 1, ""lines"": 2}, ""runtime/autoload/syntaxcomplete.vim"": {""insertions"": 99, ""deletions"": 49, ""lines"": 148}, ""runtime/doc/autocmd.txt"": {""insertions"": 9, ""deletions"": 2, ""lines"": 11}, ""runtime/doc/eval.txt"": {""insertions"": 5, ""deletions"": 2, ""lines"": 7}, ""runtime/doc/gui.txt"": {""insertions"": 6, ""deletions"": 1, ""lines"": 7}, ""runtime/doc/index.txt"": {""insertions"": 1, ""deletions"": 1, ""lines"": 2}, ""runtime/doc/map.txt"": {""insertions"": 7, ""deletions"": 4, ""lines"": 11}, ""runtime/doc/options.txt"": {""insertions"": 3, ""deletions"": 2, ""lines"": 5}, ""runtime/doc/quickfix.txt"": {""insertions"": 17, ""deletions"": 8, ""lines"": 25}, ""runtime/doc/tags"": {""insertions"": 4, ""deletions"": 0, ""lines"": 4}, ""runtime/doc/todo.txt"": {""insertions"": 19, ""deletions"": 32, ""lines"": 51}, ""runtime/doc/usr_02.txt"": {""insertions"": 2, ""deletions"": 2, ""lines"": 4}, ""runtime/doc/vim9.txt"": {""insertions"": 55, ""deletions"": 38, ""lines"": 93}, ""runtime/ftplugin/fpcmake.vim"": {""insertions"": 25, ""deletions"": 0, ""lines"": 25}, ""runtime/ftplugin/pascal.vim"": {""insertions"": 41, ""deletions"": 11, ""lines"": 52}, ""runtime/indent/make.vim"": {""insertions"": 2, ""deletions"": 2, ""lines"": 4}, ""runtime/syntax/conf.vim"": {""insertions"": 3, ""deletions"": 3, ""lines"": 6}, ""runtime/syntax/fpcmake.vim"": {""insertions"": 58, ""deletions"": 0, ""lines"": 58}, ""runtime/syntax/pascal.vim"": {""insertions"": 64, ""deletions"": 40, ""lines"": 104}}"
2021-05-02 11:59:46,5f628a12e5c7ebd1145ae1c089d1be1751b700c1,Bram Moolenaar,3,1,4,2,"{""nsis/gvim.nsi"": {""insertions"": 1, ""deletions"": 1, ""lines"": 2}, ""src/version.c"": {""insertions"": 2, ""deletions"": 0, ""lines"": 2}}"
2021-05-01 20:41:39,4a22897591dc8ff64560bef693af49f171faf557,Bram Moolenaar,16,5,21,4,"{""nsis/README.txt"": {""insertions"": 3, ""deletions"": 0, ""lines"": 3}, ""nsis/gvim.nsi"": {""insertions"": 7, ""deletions"": 2, ""lines"": 9}, ""src/main.c"": {""insertions"": 4, ""deletions"": 3, ""lines"": 7}, ""src/version.c"": {""insertions"": 2, ""deletions"": 0, ""lines"": 2}}"
2021-05-01 15:46:03,3d0e7a956afb6f913466e96bd462eff0c92ad4c6,Bram Moolenaar,21,0,21,4,"{""src/globals.h"": {""insertions"": 1, ""deletions"": 0, ""lines"": 1}, ""src/main.c"": {""insertions"": 14, ""deletions"": 0, ""lines"": 14}, ""src/os_win32.c"": {""insertions"": 4, ""deletions"": 0, ""lines"": 4}, ""src/version.c"": {""insertions"": 2, ""deletions"": 0, ""lines"": 2}}"
2021-04-30 19:37:51,b6c2e9a010ebd7db586081957e634903d4972fa1,Bram Moolenaar,27,3,30,3,"{""src/session.c"": {""insertions"": 11, ""deletions"": 3, ""lines"": 14}, ""src/testdir/test_mksession.vim"": {""insertions"": 14, ""deletions"": 0, ""lines"": 14}, ""src/version.c"": {""insertions"": 2, ""deletions"": 0, ""lines"": 2}}"
2021-04-30 17:43:11,4934ed34c3e2090d1963c89c629cd3ce81d3ecd1,Bram Moolenaar,25,1,26,3,"{""src/map.c"": {""insertions"": 14, ""deletions"": 1, ""lines"": 15}, ""src/testdir/test_mapping.vim"": {""insertions"": 9, ""deletions"": 0, ""lines"": 9}, ""src/version.c"": {""insertions"": 2, ""deletions"": 0, ""lines"": 2}}"
2021-04-29 18:18:45,aeed2a6359e9ca692e1397884c3678685132d360,Bram Moolenaar,10,0,10,3,"{""src/terminal.c"": {""insertions"": 1, ""deletions"": 0, ""lines"": 1}, ""src/testdir/test_terminal.vim"": {""insertions"": 7, ""deletions"": 0, ""lines"": 7}, ""src/version.c"": {""insertions"": 2, ""deletions"": 0, ""lines"": 2}}"
2021-04-28 18:40:44,227c58a486d2459e7bf6ed2c917ede7e324e3570,Bram Moolenaar,28,7,35,5,"{""src/ex_docmd.c"": {""insertions"": 5, ""deletions"": 2, ""lines"": 7}, ""src/testdir/test_vim9_assign.vim"": {""insertions"": 2, ""deletions"": 2, ""lines"": 4}, ""src/testdir/test_vim9_func.vim"": {""insertions"": 3, ""deletions"": 3, ""lines"": 6}, ""src/testdir/test_vim9_script.vim"": {""insertions"": 16, ""deletions"": 0, ""lines"": 16}, ""src/version.c"": {""insertions"": 2, ""deletions"": 0, ""lines"": 2}}"
2021-04-28 18:00:40,03717bf6a27d753fe8f9d713d66594fb1940515f,Bram Moolenaar,23,3,26,3,"{""src/eval.c"": {""insertions"": 14, ""deletions"": 3, ""lines"": 17}, ""src/testdir/test_vim9_expr.vim"": {""insertions"": 7, ""deletions"": 0, ""lines"": 7}, ""src/version.c"": {""insertions"": 2, ""deletions"": 0, ""lines"": 2}}"
2021-04-27 18:06:57,b80d2fb0e7b9adec4cff1bc4e2d30635cb70502e,Bram Moolenaar,11,0,11,2,"{""src/popupmenu.c"": {""insertions"": 9, ""deletions"": 0, ""lines"": 9}, ""src/version.c"": {""insertions"": 2, ""deletions"": 0, ""lines"": 2}}"
2021-04-26 19:39:25,b06b50dfa06e1cbefd634e2735e7cd5ddd5b911c,Bram Moolenaar,4,2,6,2,"{""src/version.c"": {""insertions"": 2, ""deletions"": 0, ""lines"": 2}, ""src/vim9execute.c"": {""insertions"": 2, ""deletions"": 2, ""lines"": 4}}"
2021-04-26 19:17:52,bb01a1ef3a093cdb36877ba73474719c531dc8cb,Yegappan Lakshmanan,160,62,222,8,"{""runtime/doc/quickfix.txt"": {""insertions"": 4, ""deletions"": 4, ""lines"": 8}, ""src/ex_cmds.c"": {""insertions"": 4, ""deletions"": 2, ""lines"": 6}, ""src/proto/search.pro"": {""insertions"": 1, ""deletions"": 0, ""lines"": 1}, ""src/quickfix.c"": {""insertions"": 80, ""deletions"": 33, ""lines"": 113}, ""src/search.c"": {""insertions"": 17, ""deletions"": 21, ""lines"": 38}, ""src/testdir/test_quickfix.vim"": {""insertions"": 48, ""deletions"": 2, ""lines"": 50}, ""src/version.c"": {""insertions"": 2, ""deletions"": 0, ""lines"": 2}, ""src/vim.h"": {""insertions"": 4, ""deletions"": 0, ""lines"": 4}}"
2021-04-26 18:32:59,5930ddcd25c3c31a323cdb1b74c228958e124527,Bram Moolenaar,15,11,26,4,"{""src/testdir/test_vim9_cmd.vim"": {""insertions"": 4, ""deletions"": 0, ""lines"": 4}, ""src/version.c"": {""insertions"": 2, ""deletions"": 0, ""lines"": 2}, ""src/vim9.h"": {""insertions"": 6, ""deletions"": 4, ""lines"": 10}, ""src/vim9execute.c"": {""insertions"": 3, ""deletions"": 7, ""lines"": 10}}"
2021-04-25 14:35:55,b98cec28d95b2184c64a0646458c1e62deb2524b,Bram Moolenaar,21,8,29,4,"{""src/errors.h"": {""insertions"": 2, ""deletions"": 2, ""lines"": 4}, ""src/ex_docmd.c"": {""insertions"": 4, ""deletions"": 1, ""lines"": 5}, ""src/testdir/test_vim9_cmd.vim"": {""insertions"": 13, ""deletions"": 5, ""lines"": 18}, ""src/version.c"": {""insertions"": 2, ""deletions"": 0, ""lines"": 2}}"
2021-04-25 12:48:49,d386e923c751f389b2ac038ff2cb7b40035f8cc6,Bram Moolenaar,30,1,31,3,"{""src/testdir/test_vim9_cmd.vim"": {""insertions"": 22, ""deletions"": 1, ""lines"": 23}, ""src/version.c"": {""insertions"": 2, ""deletions"": 0, ""lines"": 2}, ""src/vim9execute.c"": {""insertions"": 6, ""deletions"": 0, ""lines"": 6}}"
2021-04-25 11:54:42,dc4c2309f2af347068edd60548269018f476dab9,Bram Moolenaar,17,0,17,3,"{""src/testdir/test_vim9_func.vim"": {""insertions"": 10, ""deletions"": 0, ""lines"": 10}, ""src/version.c"": {""insertions"": 2, ""deletions"": 0, ""lines"": 2}, ""src/vim9compile.c"": {""insertions"": 5, ""deletions"": 0, ""lines"": 5}}"
2021-04-24 18:43:56,730bf300202d82eff575581abc915b804275f18d,Bram Moolenaar,11,3,14,2,"{""src/testdir/test_vim9_assign.vim"": {""insertions"": 9, ""deletions"": 3, ""lines"": 12}, ""src/version.c"": {""insertions"": 2, ""deletions"": 0, ""lines"": 2}}"
2021-04-24 18:37:03,340c59ec6f9635e8cbf61db7996d68f61b48679f,Bram Moolenaar,3,0,3,2,"{""src/ex_docmd.c"": {""insertions"": 1, ""deletions"": 0, ""lines"": 1}, ""src/version.c"": {""insertions"": 2, ""deletions"": 0, ""lines"": 2}}"
2021-04-24 17:08:24,bdc0f1c6986e5d64f647e0924a4de795b47c549a,Bram Moolenaar,97,27,124,10,"{""src/eval.c"": {""insertions"": 3, ""deletions"": 0, ""lines"": 3}, ""src/ex_cmdidxs.h"": {""insertions"": 1, ""deletions"": 1, ""lines"": 2}, ""src/ex_cmds.h"": {""insertions"": 8, ""deletions"": 0, ""lines"": 8}, ""src/ex_docmd.c"": {""insertions"": 7, ""deletions"": 0, ""lines"": 7}, ""src/proto/vim9script.pro"": {""insertions"": 1, ""deletions"": 0, ""lines"": 1}, ""src/testdir/test_vim9_assign.vim"": {""insertions"": 16, ""deletions"": 0, ""lines"": 16}, ""src/testdir/test_vim9_expr.vim"": {""insertions"": 0, ""deletions"": 13, ""lines"": 13}, ""src/version.c"": {""insertions"": 2, ""deletions"": 0, ""lines"": 2}, ""src/vim9compile.c"": {""insertions"": 37, ""deletions"": 13, ""lines"": 50}, ""src/vim9script.c"": {""insertions"": 22, ""deletions"": 0, ""lines"": 22}}"
2021-04-24 12:15:41,96cf4ba8fb96e5778192d2dab7458b9a7da0a49d,Bram Moolenaar,64,28,92,11,"{""runtime/doc/index.txt"": {""insertions"": 1, ""deletions"": 0, ""lines"": 1}, ""runtime/doc/vim9.txt"": {""insertions"": 7, ""deletions"": 2, ""lines"": 9}, ""src/ex_cmdidxs.h"": {""insertions"": 16, ""deletions"": 16, ""lines"": 32}, ""src/ex_cmds.h"": {""insertions"": 3, ""deletions"": 0, ""lines"": 3}, ""src/ex_docmd.c"": {""insertions"": 11, ""deletions"": 0, ""lines"": 11}, ""src/structs.h"": {""insertions"": 1, ""deletions"": 0, ""lines"": 1}, ""src/testdir/test_vim9_assign.vim"": {""insertions"": 8, ""deletions"": 8, ""lines"": 16}, ""src/testdir/test_vim9_func.vim"": {""insertions"": 8, ""deletions"": 0, ""lines"": 8}, ""src/version.c"": {""insertions"": 2, ""deletions"": 0, ""lines"": 2}, ""src/vim9compile.c"": {""insertions"": 4, ""deletions"": 0, ""lines"": 4}, ""src/vim9script.c"": {""insertions"": 3, ""deletions"": 2, ""lines"": 5}}"
2021-04-24 11:12:38,7ba1e4d363164e32a93cceab64b42e8c6d89e9f3,Bram Moolenaar,43,6,49,3,"{""src/map.c"": {""insertions"": 20, ""deletions"": 6, ""lines"": 26}, ""src/testdir/test_maparg.vim"": {""insertions"": 21, ""deletions"": 0, ""lines"": 21}, ""src/version.c"": {""insertions"": 2, ""deletions"": 0, ""lines"": 2}}"
2021-04-23 19:01:34,e0c03c8e107f109eadab145e18544d8e74a6976e,Bram Moolenaar,43,10,53,5,"{""src/drawscreen.c"": {""insertions"": 8, ""deletions"": 0, ""lines"": 8}, ""src/globals.h"": {""insertions"": 4, ""deletions"": 0, ""lines"": 4}, ""src/popupmenu.c"": {""insertions"": 28, ""deletions"": 10, ""lines"": 38}, ""src/proto/popupmenu.pro"": {""insertions"": 1, ""deletions"": 0, ""lines"": 1}, ""src/version.c"": {""insertions"": 2, ""deletions"": 0, ""lines"": 2}}"
2021-04-23 17:32:23,a6aa16423fdd0518ec9f3074b0d32b1d651d41e8,Bram Moolenaar,15,2,17,3,"{""src/eval.c"": {""insertions"": 3, ""deletions"": 2, ""lines"": 5}, ""src/testdir/test_vim9_func.vim"": {""insertions"": 10, ""deletions"": 0, ""lines"": 10}, ""src/version.c"": {""insertions"": 2, ""deletions"": 0, ""lines"": 2}}"
2021-04-23 16:06:48,f6d9935a13a7b37272ad71761d3d86b7f40c3d5f,Bram Moolenaar,6,0,6,3,"{""runtime/filetype.vim"": {""insertions"": 3, ""deletions"": 0, ""lines"": 3}, ""src/testdir/test_filetype.vim"": {""insertions"": 1, ""deletions"": 0, ""lines"": 1}, ""src/version.c"": {""insertions"": 2, ""deletions"": 0, ""lines"": 2}}"
2021-04-22 19:39:30,9f28416e54cefe8b6a2382d078c78f1d469e60cd,Bram Moolenaar,31,0,31,3,"{""src/drawscreen.c"": {""insertions"": 7, ""deletions"": 0, ""lines"": 7}, ""src/testdir/test_timers.vim"": {""insertions"": 22, ""deletions"": 0, ""lines"": 22}, ""src/version.c"": {""insertions"": 2, ""deletions"": 0, ""lines"": 2}}"
2021-04-21 16:09:37,11e3c5ba820325b69cb56f70e13c21d7b8808d33,Bram Moolenaar,2367,2410,4777,24,"{""runtime/doc/Makefile"": {""insertions"": 2, ""deletions"": 0, ""lines"": 2}, ""runtime/doc/ft_raku.txt"": {""insertions"": 126, ""deletions"": 0, ""lines"": 126}, ""runtime/doc/options.txt"": {""insertions"": 1, ""deletions"": 1, ""lines"": 2}, ""runtime/doc/tags"": {""insertions"": 3, ""deletions"": 0, ""lines"": 3}, ""runtime/doc/todo.txt"": {""insertions"": 10, ""deletions"": 21, ""lines"": 31}, ""runtime/doc/usr_12.txt"": {""insertions"": 3, ""deletions"": 3, ""lines"": 6}, ""runtime/doc/usr_41.txt"": {""insertions"": 15, ""deletions"": 7, ""lines"": 22}, ""runtime/ftplugin/perl6.vim"": {""insertions"": 0, ""deletions"": 77, ""lines"": 77}, ""runtime/ftplugin/r.vim"": {""insertions"": 2, ""deletions"": 2, ""lines"": 4}, ""runtime/ftplugin/raku.vim"": {""insertions"": 127, ""deletions"": 0, ""lines"": 127}, ""runtime/ftplugin/rhelp.vim"": {""insertions"": 2, ""deletions"": 2, ""lines"": 4}, ""runtime/ftplugin/rmd.vim"": {""insertions"": 2, ""deletions"": 2, ""lines"": 4}, ""runtime/ftplugin/rnoweb.vim"": {""insertions"": 2, ""deletions"": 2, ""lines"": 4}, ""runtime/ftplugin/rrst.vim"": {""insertions"": 2, ""deletions"": 2, ""lines"": 4}, ""runtime/indent/{perl6.vim => raku.vim}"": {""insertions"": 8, ""deletions"": 13, ""lines"": 21}, ""runtime/indent/rmd.vim"": {""insertions"": 25, ""deletions"": 7, ""lines"": 32}, ""runtime/indent/vim.vim"": {""insertions"": 3, ""deletions"": 2, ""lines"": 5}, ""runtime/syntax/perl6.vim"": {""insertions"": 0, ""deletions"": 2242, ""lines"": 2242}, ""runtime/syntax/r.vim"": {""insertions"": 27, ""deletions"": 11, ""lines"": 38}, ""runtime/syntax/raku.vim"": {""insertions"": 1971, ""deletions"": 0, ""lines"": 1971}, ""runtime/syntax/rmd.vim"": {""insertions"": 32, ""deletions"": 12, ""lines"": 44}, ""runtime/syntax/rnoweb.vim"": {""insertions"": 2, ""deletions"": 2, ""lines"": 4}, ""runtime/tutor/tutor.tr.iso9"": {""insertions"": 1, ""deletions"": 1, ""lines"": 2}, ""src/INSTALL"": {""insertions"": 1, ""deletions"": 1, ""lines"": 2}}"
2021-04-21 15:57:26,459fbdbf9216bc7b4721fc192e08b35039036caa,Bram Moolenaar,101,9,110,3,"{""src/eval.c"": {""insertions"": 83, ""deletions"": 2, ""lines"": 85}, ""src/testdir/test_vim9_expr.vim"": {""insertions"": 16, ""deletions"": 7, ""lines"": 23}, ""src/version.c"": {""insertions"": 2, ""deletions"": 0, ""lines"": 2}}"
2021-04-21 14:00:10,a369c3d9c1217cd932bc3d1751a8cff1f5aef1e4,Bram Moolenaar,44,25,69,3,"{""src/testdir/test_vim9_cmd.vim"": {""insertions"": 5, ""deletions"": 0, ""lines"": 5}, ""src/version.c"": {""insertions"": 2, ""deletions"": 0, ""lines"": 2}, ""src/vim9compile.c"": {""insertions"": 37, ""deletions"": 25, ""lines"": 62}}"
2021-04-21 13:11:42,2d5f385cee3668c44089edcb9d60b0b5d751ee5d,Bram Moolenaar,31,0,31,4,"{""src/drawline.c"": {""insertions"": 3, ""deletions"": 0, ""lines"": 3}, ""src/testdir/dumps/Test_hlsearch_visual_1.dump"": {""insertions"": 6, ""deletions"": 0, ""lines"": 6}, ""src/testdir/test_search.vim"": {""insertions"": 20, ""deletions"": 0, ""lines"": 20}, ""src/version.c"": {""insertions"": 2, ""deletions"": 0, ""lines"": 2}}"
2021-04-21 12:24:24,753bcf8c7d7cf7b9e1572a80cc513a67020814ac,Bram Moolenaar,64,13,77,3,"{""src/testdir/test_vim9_cmd.vim"": {""insertions"": 25, ""deletions"": 0, ""lines"": 25}, ""src/version.c"": {""insertions"": 2, ""deletions"": 0, ""lines"": 2}, ""src/vim9compile.c"": {""insertions"": 37, ""deletions"": 13, ""lines"": 50}}"
2021-04-21 10:19:35,169502fb0beb7eb21f72d6c4590483c069353b53,Bram Moolenaar,7,3,10,2,"{""src/version.c"": {""insertions"": 2, ""deletions"": 0, ""lines"": 2}, ""src/vim9compile.c"": {""insertions"": 5, ""deletions"": 3, ""lines"": 8}}"
2021-04-21 09:57:59,16678eb50f7fcb7138600bd0364edb2c9def8cb8,Bram Moolenaar,4,0,4,3,"{""src/auto/configure"": {""insertions"": 1, ""deletions"": 0, ""lines"": 1}, ""src/configure.ac"": {""insertions"": 1, ""deletions"": 0, ""lines"": 1}, ""src/version.c"": {""insertions"": 2, ""deletions"": 0, ""lines"": 2}}"
2021-04-21 09:30:48,d23f8bde5cd16b7752cc4a73da106673839ed824,Bram Moolenaar,9,6,15,3,"{""src/Make_mvc.mak"": {""insertions"": 1, ""deletions"": 1, ""lines"": 2}, ""src/os_win32.c"": {""insertions"": 6, ""deletions"": 5, ""lines"": 11}, ""src/version.c"": {""insertions"": 2, ""deletions"": 0, ""lines"": 2}}"
2021-04-20 20:16:39,9ce47ec0b65f81358febacbd9b808ac8ef7af85c,Bram Moolenaar,25,2,27,3,"{""src/testdir/test_vim9_disassemble.vim"": {""insertions"": 4, ""deletions"": 2, ""lines"": 6}, ""src/version.c"": {""insertions"": 2, ""deletions"": 0, ""lines"": 2}, ""src/vim9execute.c"": {""insertions"": 19, ""deletions"": 0, ""lines"": 19}}"
2021-04-20 19:49:35,5c787fb7928c4cc1e7d6eec0be1bbd63d903cc8d,Bram Moolenaar,5,5,10,2,"{""src/version.c"": {""insertions"": 2, ""deletions"": 0, ""lines"": 2}, ""src/vim9compile.c"": {""insertions"": 3, ""deletions"": 5, ""lines"": 8}}"
2021-04-20 19:14:09,63276685f90fca8b1a0be3a6734759fa82b7be0c,Bram Moolenaar,6,4,10,2,"{""runtime/scripts.vim"": {""insertions"": 4, ""deletions"": 4, ""lines"": 8}, ""src/version.c"": {""insertions"": 2, ""deletions"": 0, ""lines"": 2}}"
2021-04-20 19:10:48,8238f08838c0b481d0b14a741bc03f2e45c211d3,Bram Moolenaar,60,38,98,3,"{""src/testdir/test_vim9_cmd.vim"": {""insertions"": 6, ""deletions"": 0, ""lines"": 6}, ""src/version.c"": {""insertions"": 2, ""deletions"": 0, ""lines"": 2}, ""src/vim9compile.c"": {""insertions"": 52, ""deletions"": 38, ""lines"": 90}}"
2021-04-20 18:21:23,3f88e71fa2b8b1fc97f3c218989474ea8687d197,Bram Moolenaar,7,6,13,3,"{""runtime/filetype.vim"": {""insertions"": 3, ""deletions"": 3, ""lines"": 6}, ""src/testdir/test_filetype.vim"": {""insertions"": 2, ""deletions"": 3, ""lines"": 5}, ""src/version.c"": {""insertions"": 2, ""deletions"": 0, ""lines"": 2}}"
2021-04-20 08:33:28,6d4c1c7ba816294408097d72717366a97781655d,Bram Moolenaar,6,2,8,2,"{""src/os_win32.c"": {""insertions"": 4, ""deletions"": 2, ""lines"": 6}, ""src/version.c"": {""insertions"": 2, ""deletions"": 0, ""lines"": 2}}"
2021-04-19 19:06:31,4f2df37a0d297a0f40ff15f8ce31285c7b529bcd,Bram Moolenaar,11,2,13,2,"{""src/version.c"": {""insertions"": 2, ""deletions"": 0, ""lines"": 2}, ""src/vim9compile.c"": {""insertions"": 9, ""deletions"": 2, ""lines"": 11}}"
2021-04-19 18:50:03,2d1c57ed3dd25c44b41b9ddd4cf63c01ae89007e,Bram Moolenaar,335,97,432,9,"{""src/errors.h"": {""insertions"": 4, ""deletions"": 0, ""lines"": 4}, ""src/evalvars.c"": {""insertions"": 37, ""deletions"": 3, ""lines"": 40}, ""src/proto/evalvars.pro"": {""insertions"": 5, ""deletions"": 1, ""lines"": 6}, ""src/testdir/test_vim9_cmd.vim"": {""insertions"": 18, ""deletions"": 0, ""lines"": 18}, ""src/testdir/test_vim9_disassemble.vim"": {""insertions"": 27, ""deletions"": 0, ""lines"": 27}, ""src/version.c"": {""insertions"": 2, ""deletions"": 0, ""lines"": 2}, ""src/vim9.h"": {""insertions"": 3, ""deletions"": 0, ""lines"": 3}, ""src/vim9compile.c"": {""insertions"": 201, ""deletions"": 93, ""lines"": 294}, ""src/vim9execute.c"": {""insertions"": 38, ""deletions"": 0, ""lines"": 38}}"
2021-04-19 14:48:48,4c13721482d7786f92f5a56e43b0f5c499264b7e,Bram Moolenaar,1070,779,1849,11,"{""src/ex_cmds.c"": {""insertions"": 24, ""deletions"": 12, ""lines"": 36}, ""src/globals.h"": {""insertions"": 3, ""deletions"": 0, ""lines"": 3}, ""src/proto/ex_cmds.pro"": {""insertions"": 1, ""deletions"": 0, ""lines"": 1}, ""src/proto/vim9execute.pro"": {""insertions"": 1, ""deletions"": 0, ""lines"": 1}, ""src/regexp.c"": {""insertions"": 3, ""deletions"": 0, ""lines"": 3}, ""src/testdir/test_vim9_cmd.vim"": {""insertions"": 22, ""deletions"": 0, ""lines"": 22}, ""src/testdir/test_vim9_disassemble.vim"": {""insertions"": 19, ""deletions"": 0, ""lines"": 19}, ""src/version.c"": {""insertions"": 2, ""deletions"": 0, ""lines"": 2}, ""src/vim9.h"": {""insertions"": 13, ""deletions"": 2, ""lines"": 15}, ""src/vim9compile.c"": {""insertions"": 92, ""deletions"": 0, ""lines"": 92}, ""src/vim9execute.c"": {""insertions"": 890, ""deletions"": 765, ""lines"": 1655}}"
2021-04-18 14:08:52,e8209b91b9974da95899b51dba4058b411d04d5b,Bram Moolenaar,4,16,20,3,"{""src/eval.c"": {""insertions"": 1, ""deletions"": 15, ""lines"": 16}, ""src/testdir/test_blob.vim"": {""insertions"": 1, ""deletions"": 1, ""lines"": 2}, ""src/version.c"": {""insertions"": 2, ""deletions"": 0, ""lines"": 2}}"
2021-04-18 13:48:04,39211cba723a2cb58a97c7e08826713164b86efc,Bram Moolenaar,255,103,358,4,"{""src/list.c"": {""insertions"": 33, ""deletions"": 21, ""lines"": 54}, ""src/testdir/test_blob.vim"": {""insertions"": 210, ""deletions"": 82, ""lines"": 292}, ""src/testdir/test_vim9_builtin.vim"": {""insertions"": 10, ""deletions"": 0, ""lines"": 10}, ""src/version.c"": {""insertions"": 2, ""deletions"": 0, ""lines"": 2}}"
2021-04-18 12:12:31,b7c21afef14bba0208f2c40d47c050a004eb2f34,Bram Moolenaar,101,20,121,6,"{""src/evalvars.c"": {""insertions"": 6, ""deletions"": 0, ""lines"": 6}, ""src/list.c"": {""insertions"": 19, ""deletions"": 8, ""lines"": 27}, ""src/testdir/test_blob.vim"": {""insertions"": 44, ""deletions"": 12, ""lines"": 56}, ""src/testdir/test_vim9_builtin.vim"": {""insertions"": 26, ""deletions"": 0, ""lines"": 26}, ""src/version.c"": {""insertions"": 2, ""deletions"": 0, ""lines"": 2}, ""src/vim9execute.c"": {""insertions"": 4, ""deletions"": 0, ""lines"": 4}}"
2021-04-18 11:15:58,d551d6c268e435e2fbba22775510fbd0a54477f6,Bram Moolenaar,72,33,105,4,"{""src/testdir/test_blob.vim"": {""insertions"": 29, ""deletions"": 26, ""lines"": 55}, ""src/version.c"": {""insertions"": 2, ""deletions"": 0, ""lines"": 2}, ""src/vim9compile.c"": {""insertions"": 5, ""deletions"": 4, ""lines"": 9}, ""src/vim9execute.c"": {""insertions"": 36, ""deletions"": 3, ""lines"": 39}}"
2021-04-17 19:22:49,f7e92aae1581203306a340b4c0059cc74adea9d6,Bram Moolenaar,5,2,7,2,"{""src/blob.c"": {""insertions"": 3, ""deletions"": 2, ""lines"": 5}, ""src/version.c"": {""insertions"": 2, ""deletions"": 0, ""lines"": 2}}"
2021-04-17 19:04:34,d23b714d8b9ed8e16ef553098acc6da0979e94fc,Bram Moolenaar,15,8,23,4,"{""runtime/doc/options.txt"": {""insertions"": 1, ""deletions"": 1, ""lines"": 2}, ""src/option.c"": {""insertions"": 2, ""deletions"": 1, ""lines"": 3}, ""src/testdir/test_mksession.vim"": {""insertions"": 10, ""deletions"": 6, ""lines"": 16}, ""src/version.c"": {""insertions"": 2, ""deletions"": 0, ""lines"": 2}}"
2021-04-17 18:44:56,51e933261b984db014e858d79387a826d2626fb6,Bram Moolenaar,233,96,329,8,"{""src/blob.c"": {""insertions"": 23, ""deletions"": 3, ""lines"": 26}, ""src/errors.h"": {""insertions"": 2, ""deletions"": 0, ""lines"": 2}, ""src/proto/blob.pro"": {""insertions"": 2, ""deletions"": 1, ""lines"": 3}, ""src/testdir/test_blob.vim"": {""insertions"": 147, ""deletions"": 69, ""lines"": 216}, ""src/testdir/test_vim9_disassemble.vim"": {""insertions"": 13, ""deletions"": 3, ""lines"": 16}, ""src/version.c"": {""insertions"": 2, ""deletions"": 0, ""lines"": 2}, ""src/vim9compile.c"": {""insertions"": 13, ""deletions"": 6, ""lines"": 19}, ""src/vim9execute.c"": {""insertions"": 31, ""deletions"": 14, ""lines"": 45}}"
2021-04-17 16:38:54,0995c81f2ffe276669daa004f7778ecc6f5ee09d,Bram Moolenaar,65,28,93,3,"{""src/session.c"": {""insertions"": 45, ""deletions"": 28, ""lines"": 73}, ""src/testdir/test_mksession.vim"": {""insertions"": 18, ""deletions"": 0, ""lines"": 18}, ""src/version.c"": {""insertions"": 2, ""deletions"": 0, ""lines"": 2}}"
2021-04-17 15:59:19,c70fe460b09f6182a13e4385f3232df4fdcd0741,Bram Moolenaar,46,5,51,5,"{""src/structs.h"": {""insertions"": 1, ""deletions"": 1, ""lines"": 2}, ""src/testdir/test_vim9_script.vim"": {""insertions"": 31, ""deletions"": 0, ""lines"": 31}, ""src/version.c"": {""insertions"": 2, ""deletions"": 0, ""lines"": 2}, ""src/vim9compile.c"": {""insertions"": 8, ""deletions"": 0, ""lines"": 8}, ""src/vim9execute.c"": {""insertions"": 4, ""deletions"": 4, ""lines"": 8}}"
2021-04-17 14:38:50,6c7cc347af4f4bc1bf180d80ef81413f89e78f56,Bram Moolenaar,6,1,7,3,"{""src/testdir/test_vim9_script.vim"": {""insertions"": 2, ""deletions"": 0, ""lines"": 2}, ""src/version.c"": {""insertions"": 2, ""deletions"": 0, ""lines"": 2}, ""src/vim9script.c"": {""insertions"": 2, ""deletions"": 1, ""lines"": 3}}"
2021-04-17 14:31:09,56994d215815139207f3c5ce02a1720e44e93c09,Bram Moolenaar,761,170,931,29,"{"".github/CODEOWNERS"": {""insertions"": 7, ""deletions"": 0, ""lines"": 7}, ""README.md"": {""insertions"": 17, ""deletions"": 12, ""lines"": 29}, ""READMEdir/README_mac.txt"": {""insertions"": 6, ""deletions"": 22, ""lines"": 28}, ""runtime/compiler/cm3.vim"": {""insertions"": 26, ""deletions"": 0, ""lines"": 26}, ""runtime/doc/options.txt"": {""insertions"": 1, ""deletions"": 1, ""lines"": 2}, ""runtime/doc/tags"": {""insertions"": 5, ""deletions"": 0, ""lines"": 5}, ""runtime/doc/todo.txt"": {""insertions"": 20, ""deletions"": 8, ""lines"": 28}, ""runtime/doc/vim.1"": {""insertions"": 4, ""deletions"": 0, ""lines"": 4}, ""runtime/doc/vim.man"": {""insertions"": 4, ""deletions"": 0, ""lines"": 4}, ""runtime/doc/vim9.txt"": {""insertions"": 3, ""deletions"": 2, ""lines"": 5}, ""runtime/doc/windows.txt"": {""insertions"": 4, ""deletions"": 4, ""lines"": 8}, ""runtime/filetype.vim"": {""insertions"": 1, ""deletions"": 1, ""lines"": 2}, ""runtime/ftplugin/gprof.vim"": {""insertions"": 2, ""deletions"": 2, ""lines"": 4}, ""runtime/ftplugin/m3build.vim"": {""insertions"": 24, ""deletions"": 0, ""lines"": 24}, ""runtime/ftplugin/m3quake.vim"": {""insertions"": 33, ""deletions"": 0, ""lines"": 33}, ""runtime/ftplugin/modula2.vim"": {""insertions"": 39, ""deletions"": 0, ""lines"": 39}, ""runtime/ftplugin/modula3.vim"": {""insertions"": 38, ""deletions"": 0, ""lines"": 38}, ""runtime/ftplugin/vim.vim"": {""insertions"": 5, ""deletions"": 5, ""lines"": 10}, ""runtime/lang/menu_fr_fr.latin1.vim"": {""insertions"": 31, ""deletions"": 19, ""lines"": 50}, ""runtime/plugin/matchparen.vim"": {""insertions"": 2, ""deletions"": 2, ""lines"": 4}, ""runtime/syntax/gprof.vim"": {""insertions"": 3, ""deletions"": 3, ""lines"": 6}, ""runtime/syntax/hollywood.vim"": {""insertions"": 6, ""deletions"": 7, ""lines"": 13}, ""runtime/syntax/m3build.vim"": {""insertions"": 177, ""deletions"": 0, ""lines"": 177}, ""runtime/syntax/m3quake.vim"": {""insertions"": 74, ""deletions"": 0, ""lines"": 74}, ""runtime/syntax/modula3.vim"": {""insertions"": 75, ""deletions"": 38, ""lines"": 113}, ""runtime/syntax/psl.vim"": {""insertions"": 83, ""deletions"": 0, ""lines"": 83}, ""runtime/syntax/ratpoison.vim"": {""insertions"": 15, ""deletions"": 7, ""lines"": 22}, ""runtime/tutor/tutor.tr.utf-8"": {""insertions"": 1, ""deletions"": 1, ""lines"": 2}, ""src/INSTALLmac.txt"": {""insertions"": 55, ""deletions"": 36, ""lines"": 91}}"
2021-04-17 12:06:39,112a006417a0d4700ff39ddba3bb5e985ae9770f,Bram Moolenaar,10,4,14,3,"{""runtime/filetype.vim"": {""insertions"": 7, ""deletions"": 4, ""lines"": 11}, ""src/testdir/test_filetype.vim"": {""insertions"": 1, ""deletions"": 0, ""lines"": 1}, ""src/version.c"": {""insertions"": 2, ""deletions"": 0, ""lines"": 2}}"
2021-04-16 17:58:22,635bd60804966803490287e97460ecdc91d5fe0a,Bram Moolenaar,46,3,49,8,"{""runtime/doc/options.txt"": {""insertions"": 1, ""deletions"": 0, ""lines"": 1}, ""src/option.c"": {""insertions"": 3, ""deletions"": 0, ""lines"": 3}, ""src/option.h"": {""insertions"": 1, ""deletions"": 0, ""lines"": 1}, ""src/optionstr.c"": {""insertions"": 3, ""deletions"": 2, ""lines"": 5}, ""src/session.c"": {""insertions"": 9, ""deletions"": 1, ""lines"": 10}, ""src/testdir/test_mksession.vim"": {""insertions"": 26, ""deletions"": 0, ""lines"": 26}, ""src/version.c"": {""insertions"": 2, ""deletions"": 0, ""lines"": 2}, ""src/vim.h"": {""insertions"": 1, ""deletions"": 0, ""lines"": 1}}"
2021-04-15 20:13:39,aa1959bd5e82350bb4a82d9a5188c29d70706ec4,Bram Moolenaar,17,1,18,3,"{""src/ex_docmd.c"": {""insertions"": 3, ""deletions"": 1, ""lines"": 4}, ""src/testdir/test_vim9_assign.vim"": {""insertions"": 12, ""deletions"": 0, ""lines"": 12}, ""src/version.c"": {""insertions"": 2, ""deletions"": 0, ""lines"": 2}}"
2021-04-15 19:48:32,fe090eb58fad1aaf83267d0b4ace9f024a5ba2bc,Bram Moolenaar,35,5,40,3,"{""src/testdir/test_vim9_script.vim"": {""insertions"": 12, ""deletions"": 0, ""lines"": 12}, ""src/version.c"": {""insertions"": 2, ""deletions"": 0, ""lines"": 2}, ""src/vim9compile.c"": {""insertions"": 21, ""deletions"": 5, ""lines"": 26}}"
2021-04-15 12:29:17,6bc00699c5049c40761d212bef1b490e2af7944c,Bram Moolenaar,10,2,12,3,"{""runtime/filetype.vim"": {""insertions"": 6, ""deletions"": 2, ""lines"": 8}, ""src/testdir/test_filetype.vim"": {""insertions"": 2, ""deletions"": 0, ""lines"": 2}, ""src/version.c"": {""insertions"": 2, ""deletions"": 0, ""lines"": 2}}"
2021-04-15 11:42:21,f387f5dfbc5accbfbbbb87486f6af42a82acaa7d,Bram Moolenaar,3,1,4,2,"{""src/version.c"": {""insertions"": 2, ""deletions"": 0, ""lines"": 2}, ""src/vim9compile.c"": {""insertions"": 1, ""deletions"": 1, ""lines"": 2}}"
2021-04-14 19:30:06,bd6406f15db210b78fa24dece3bd021a7ac085dc,Bram Moolenaar,6,5,11,5,"{""src/blob.c"": {""insertions"": 1, ""deletions"": 1, ""lines"": 2}, ""src/eval.c"": {""insertions"": 1, ""deletions"": 2, ""lines"": 3}, ""src/proto/blob.pro"": {""insertions"": 1, ""deletions"": 1, ""lines"": 2}, ""src/version.c"": {""insertions"": 2, ""deletions"": 0, ""lines"": 2}, ""src/vim9execute.c"": {""insertions"": 1, ""deletions"": 1, ""lines"": 2}}"
2021-04-14 18:54:07,b1419268901b194b295b7cea18a1d0968f9dddfc,Bram Moolenaar,3,1,4,2,"{""src/version.c"": {""insertions"": 2, ""deletions"": 0, ""lines"": 2}, ""src/vim9compile.c"": {""insertions"": 1, ""deletions"": 1, ""lines"": 2}}"
2021-04-14 18:35:23,0e3ff1919603ee4c4a347fdf761dbdbdeb068015,Bram Moolenaar,140,24,164,8,"{""src/blob.c"": {""insertions"": 30, ""deletions"": 0, ""lines"": 30}, ""src/errors.h"": {""insertions"": 2, ""deletions"": 0, ""lines"": 2}, ""src/eval.c"": {""insertions"": 4, ""deletions"": 12, ""lines"": 16}, ""src/proto/blob.pro"": {""insertions"": 2, ""deletions"": 0, ""lines"": 2}, ""src/testdir/test_blob.vim"": {""insertions"": 41, ""deletions"": 10, ""lines"": 51}, ""src/testdir/vim9.vim"": {""insertions"": 47, ""deletions"": 0, ""lines"": 47}, ""src/version.c"": {""insertions"": 2, ""deletions"": 0, ""lines"": 2}, ""src/vim9execute.c"": {""insertions"": 12, ""deletions"": 2, ""lines"": 14}}"
2021-04-14 15:06:43,b47bed2f7ada4dfae78f76f27473b83507e40315,Bram Moolenaar,20,0,20,3,"{""src/testdir/test_functions.vim"": {""insertions"": 9, ""deletions"": 0, ""lines"": 9}, ""src/userfunc.c"": {""insertions"": 9, ""deletions"": 0, ""lines"": 9}, ""src/version.c"": {""insertions"": 2, ""deletions"": 0, ""lines"": 2}}"
2021-04-14 11:30:46,a3589a0d6cdb314e70421c0f2e5a2d1abf68e597,Bram Moolenaar,18,9,27,3,"{""src/evalvars.c"": {""insertions"": 1, ""deletions"": 1, ""lines"": 2}, ""src/testdir/test_vim9_script.vim"": {""insertions"": 15, ""deletions"": 8, ""lines"": 23}, ""src/version.c"": {""insertions"": 2, ""deletions"": 0, ""lines"": 2}}"
2021-04-14 10:40:00,f62d73933af7830301989eb8162ce94a80e61fbf,Bram Moolenaar,51,0,51,3,"{""src/testdir/test_vim9_disassemble.vim"": {""insertions"": 39, ""deletions"": 0, ""lines"": 39}, ""src/version.c"": {""insertions"": 2, ""deletions"": 0, ""lines"": 2}, ""src/vim9compile.c"": {""insertions"": 10, ""deletions"": 0, ""lines"": 10}}"
2021-04-14 09:15:08,2e240bd428c0033d16f201d7f837636412358199,Bram Moolenaar,28,4,32,3,"{""src/syntax.c"": {""insertions"": 9, ""deletions"": 4, ""lines"": 13}, ""src/testdir/test_syntax.vim"": {""insertions"": 17, ""deletions"": 0, ""lines"": 17}, ""src/version.c"": {""insertions"": 2, ""deletions"": 0, ""lines"": 2}}"
2021-04-13 19:48:03,f6a8d420a8d2924737f713de046947dcb487550c,Bram Moolenaar,41,12,53,6,"{""src/eval.c"": {""insertions"": 9, ""deletions"": 4, ""lines"": 13}, ""src/evalvars.c"": {""insertions"": 20, ""deletions"": 7, ""lines"": 27}, ""src/testdir/test_vim9_script.vim"": {""insertions"": 8, ""deletions"": 0, ""lines"": 8}, ""src/version.c"": {""insertions"": 2, ""deletions"": 0, ""lines"": 2}, ""src/vim.h"": {""insertions"": 1, ""deletions"": 0, ""lines"": 1}, ""src/vim9compile.c"": {""insertions"": 1, ""deletions"": 1, ""lines"": 2}}"
2021-04-13 18:53:13,f2253963c28e4791092620df6a6bb238c33168df,Bram Moolenaar,112,85,197,8,"{""src/list.c"": {""insertions"": 2, ""deletions"": 2, ""lines"": 4}, ""src/proto/vim9script.pro"": {""insertions"": 1, ""deletions"": 1, ""lines"": 2}, ""src/proto/vim9type.pro"": {""insertions"": 1, ""deletions"": 1, ""lines"": 2}, ""src/testdir/test_vim9_script.vim"": {""insertions"": 83, ""deletions"": 68, ""lines"": 151}, ""src/version.c"": {""insertions"": 2, ""deletions"": 0, ""lines"": 2}, ""src/vim.h"": {""insertions"": 1, ""deletions"": 0, ""lines"": 1}, ""src/vim9script.c"": {""insertions"": 6, ""deletions"": 3, ""lines"": 9}, ""src/vim9type.c"": {""insertions"": 16, ""deletions"": 10, ""lines"": 26}}"
2021-04-12 20:02:36,f48b2fa33cda94e963f6fa8b78f344385c9ebea6,Bram Moolenaar,30,0,30,3,"{""src/testdir/test_vim9_func.vim"": {""insertions"": 24, ""deletions"": 0, ""lines"": 24}, ""src/userfunc.c"": {""insertions"": 4, ""deletions"": 0, ""lines"": 4}, ""src/version.c"": {""insertions"": 2, ""deletions"": 0, ""lines"": 2}}"
2021-04-12 19:21:02,68452177ca4cda4a9d5f93892e437447cf9404c8,Bram Moolenaar,258,98,356,11,"{""src/blob.c"": {""insertions"": 22, ""deletions"": 0, ""lines"": 22}, ""src/errors.h"": {""insertions"": 2, ""deletions"": 0, ""lines"": 2}, ""src/eval.c"": {""insertions"": 2, ""deletions"": 13, ""lines"": 15}, ""src/ex_docmd.c"": {""insertions"": 12, ""deletions"": 9, ""lines"": 21}, ""src/proto/blob.pro"": {""insertions"": 1, ""deletions"": 0, ""lines"": 1}, ""src/testdir/test_blob.vim"": {""insertions"": 70, ""deletions"": 60, ""lines"": 130}, ""src/testdir/vim9.vim"": {""insertions"": 35, ""deletions"": 0, ""lines"": 35}, ""src/version.c"": {""insertions"": 2, ""deletions"": 0, ""lines"": 2}, ""src/vim9.h"": {""insertions"": 2, ""deletions"": 0, ""lines"": 2}, ""src/vim9compile.c"": {""insertions"": 48, ""deletions"": 16, ""lines"": 64}, ""src/vim9execute.c"": {""insertions"": 62, ""deletions"": 0, ""lines"": 62}}"
2021-04-11 18:26:34,cfc3023cb6ce5aaec13f49bc4b821feb05e3fb03,Bram Moolenaar,142,72,214,8,"{""src/blob.c"": {""insertions"": 77, ""deletions"": 0, ""lines"": 77}, ""src/eval.c"": {""insertions"": 2, ""deletions"": 62, ""lines"": 64}, ""src/proto/blob.pro"": {""insertions"": 1, ""deletions"": 0, ""lines"": 1}, ""src/testdir/test_vim9_expr.vim"": {""insertions"": 20, ""deletions"": 0, ""lines"": 20}, ""src/version.c"": {""insertions"": 2, ""deletions"": 0, ""lines"": 2}, ""src/vim9.h"": {""insertions"": 2, ""deletions"": 0, ""lines"": 2}, ""src/vim9compile.c"": {""insertions"": 15, ""deletions"": 3, ""lines"": 18}, ""src/vim9execute.c"": {""insertions"": 23, ""deletions"": 7, ""lines"": 30}}"
2021-04-11 16:24:46,af8ea0d066d31cf3cd0a39c5c49ce0342728588d,Bram Moolenaar,24,5,29,4,"{""src/testdir/test_vim9_disassemble.vim"": {""insertions"": 4, ""deletions"": 4, ""lines"": 8}, ""src/testdir/test_vim9_expr.vim"": {""insertions"": 17, ""deletions"": 0, ""lines"": 17}, ""src/version.c"": {""insertions"": 2, ""deletions"": 0, ""lines"": 2}, ""src/vim9compile.c"": {""insertions"": 1, ""deletions"": 1, ""lines"": 2}}"
2021-04-11 11:29:18,09f067fca38c9f89ad088e8c096c4df3998575e2,Bram Moolenaar,52,4,56,6,"{""src/drawscreen.c"": {""insertions"": 3, ""deletions"": 2, ""lines"": 5}, ""src/ex_docmd.c"": {""insertions"": 4, ""deletions"": 1, ""lines"": 5}, ""src/gui.c"": {""insertions"": 5, ""deletions"": 0, ""lines"": 5}, ""src/proto/term.pro"": {""insertions"": 3, ""deletions"": 0, ""lines"": 3}, ""src/term.c"": {""insertions"": 35, ""deletions"": 1, ""lines"": 36}, ""src/version.c"": {""insertions"": 2, ""deletions"": 0, ""lines"": 2}}"
2021-04-10 20:35:43,f93bbd026205f36915312193784f987ad49fb114,Bram Moolenaar,46,22,68,7,"{""runtime/doc/vim9.txt"": {""insertions"": 12, ""deletions"": 7, ""lines"": 19}, ""src/eval.c"": {""insertions"": 1, ""deletions"": 1, ""lines"": 2}, ""src/evalvars.c"": {""insertions"": 7, ""deletions"": 5, ""lines"": 12}, ""src/testdir/test_vim9_assign.vim"": {""insertions"": 8, ""deletions"": 0, ""lines"": 8}, ""src/version.c"": {""insertions"": 2, ""deletions"": 0, ""lines"": 2}, ""src/vim.h"": {""insertions"": 5, ""deletions"": 4, ""lines"": 9}, ""src/vim9compile.c"": {""insertions"": 11, ""deletions"": 5, ""lines"": 16}}"
2021-04-10 19:46:05,e8e307818495d1a5d821df9bd4bde83add0520e5,Bram Moolenaar,3,4,7,2,"{""src/typval.c"": {""insertions"": 1, ""deletions"": 4, ""lines"": 5}, ""src/version.c"": {""insertions"": 2, ""deletions"": 0, ""lines"": 2}}"
2021-04-10 19:38:38,fed9e830fcffa90cf73dd125a27d27ed7eafbd68,Bram Moolenaar,6,2,8,2,"{""src/userfunc.c"": {""insertions"": 4, ""deletions"": 2, ""lines"": 6}, ""src/version.c"": {""insertions"": 2, ""deletions"": 0, ""lines"": 2}}"
2021-04-10 19:01:38,da479c7597a61c4d50c842df21c9294bd9bf1037,Bram Moolenaar,8,0,8,3,"{""src/testdir/test_vim9_func.vim"": {""insertions"": 2, ""deletions"": 0, ""lines"": 2}, ""src/version.c"": {""insertions"": 2, ""deletions"": 0, ""lines"": 2}, ""src/vim9compile.c"": {""insertions"": 4, ""deletions"": 0, ""lines"": 4}}"
2021-04-10 18:52:43,fe95b94ffa75c4925ad16c43f94092f2b1d35fc6,Bram Moolenaar,3,1,4,2,"{""src/testdir/test_vim9_script.vim"": {""insertions"": 1, ""deletions"": 1, ""lines"": 2}, ""src/version.c"": {""insertions"": 2, ""deletions"": 0, ""lines"": 2}}"
2021-04-10 18:46:48,c4297697761230489a025b3e39b992cca845b1b3,Bram Moolenaar,3,1,4,2,"{""src/version.c"": {""insertions"": 2, ""deletions"": 0, ""lines"": 2}, ""src/vim9execute.c"": {""insertions"": 1, ""deletions"": 1, ""lines"": 2}}"
2021-04-10 18:10:26,bb8a7ce0a1bcfafca715275dbadc2ead612f82dd,Bram Moolenaar,27,4,31,4,"{""src/testdir/test_vim9_builtin.vim"": {""insertions"": 2, ""deletions"": 2, ""lines"": 4}, ""src/testdir/test_vim9_func.vim"": {""insertions"": 13, ""deletions"": 2, ""lines"": 15}, ""src/version.c"": {""insertions"": 2, ""deletions"": 0, ""lines"": 2}, ""src/vim9execute.c"": {""insertions"": 10, ""deletions"": 0, ""lines"": 10}}"
2021-04-10 16:21:30,87795939d01932b0d8155fd69c7494fa51c523f3,Bram Moolenaar,3,1,4,2,"{""src/userfunc.c"": {""insertions"": 1, ""deletions"": 1, ""lines"": 2}, ""src/version.c"": {""insertions"": 2, ""deletions"": 0, ""lines"": 2}}"
2021-04-10 15:46:52,51e7e78de7320a734ddc2d7931e767bccaf7e6f2,Bram Moolenaar,15,11,26,2,"{""src/userfunc.c"": {""insertions"": 13, ""deletions"": 11, ""lines"": 24}, ""src/version.c"": {""insertions"": 2, ""deletions"": 0, ""lines"": 2}}"
2021-04-10 15:18:09,962c43bf0d6a33b905f2acd920d3701476ebb5c9,Bram Moolenaar,86,5,91,7,"{""runtime/doc/vim9.txt"": {""insertions"": 25, ""deletions"": 4, ""lines"": 29}, ""src/errors.h"": {""insertions"": 2, ""deletions"": 0, ""lines"": 2}, ""src/eval.c"": {""insertions"": 6, ""deletions"": 1, ""lines"": 7}, ""src/evalvars.c"": {""insertions"": 5, ""deletions"": 0, ""lines"": 5}, ""src/testdir/test_vim9_func.vim"": {""insertions"": 35, ""deletions"": 0, ""lines"": 35}, ""src/version.c"": {""insertions"": 2, ""deletions"": 0, ""lines"": 2}, ""src/vim9compile.c"": {""insertions"": 11, ""deletions"": 0, ""lines"": 11}}"
2021-04-10 12:03:43,599410cb3cb19946cd6df22441da5de003e114bb,Bram Moolenaar,27,1,28,5,"{""src/globals.h"": {""insertions"": 3, ""deletions"": 0, ""lines"": 3}, ""src/message.c"": {""insertions"": 3, ""deletions"": 0, ""lines"": 3}, ""src/testdir/test_vim9_func.vim"": {""insertions"": 14, ""deletions"": 0, ""lines"": 14}, ""src/version.c"": {""insertions"": 2, ""deletions"": 0, ""lines"": 2}, ""src/vim9compile.c"": {""insertions"": 5, ""deletions"": 1, ""lines"": 6}}"
2021-04-10 11:33:48,701cc6ca9e940665a9424541f989bb38c853a498,Bram Moolenaar,34,13,47,5,"{""src/structs.h"": {""insertions"": 5, ""deletions"": 4, ""lines"": 9}, ""src/testdir/test_vim9_func.vim"": {""insertions"": 15, ""deletions"": 1, ""lines"": 16}, ""src/version.c"": {""insertions"": 2, ""deletions"": 0, ""lines"": 2}, ""src/vim9compile.c"": {""insertions"": 11, ""deletions"": 8, ""lines"": 19}, ""src/vim9execute.c"": {""insertions"": 1, ""deletions"": 0, ""lines"": 1}}"
2021-04-09 20:12:44,1088b69451c739c698cf4c2003c2b994458ad18b,Bram Moolenaar,5,1,6,3,"{""src/testdir/test_vim9_func.vim"": {""insertions"": 2, ""deletions"": 0, ""lines"": 2}, ""src/version.c"": {""insertions"": 2, ""deletions"": 0, ""lines"": 2}, ""src/vim9compile.c"": {""insertions"": 1, ""deletions"": 1, ""lines"": 2}}"
2021-04-09 18:24:31,2a38908b05c1d3973a8edbeb5b3e05a11332faf0,Bram Moolenaar,68,31,99,7,"{""src/errors.h"": {""insertions"": 2, ""deletions"": 0, ""lines"": 2}, ""src/testdir/test_vim9_func.vim"": {""insertions"": 19, ""deletions"": 2, ""lines"": 21}, ""src/testdir/test_vim9_script.vim"": {""insertions"": 3, ""deletions"": 3, ""lines"": 6}, ""src/userfunc.c"": {""insertions"": 38, ""deletions"": 23, ""lines"": 61}, ""src/version.c"": {""insertions"": 2, ""deletions"": 0, ""lines"": 2}, ""src/vim9compile.c"": {""insertions"": 3, ""deletions"": 2, ""lines"": 5}, ""src/vim9execute.c"": {""insertions"": 1, ""deletions"": 1, ""lines"": 2}}"
2021-04-09 15:24:52,767034c5b82ba8999d9fed2f997436e6e3e99419,Bram Moolenaar,13,5,18,4,"{""src/testdir/test_vim9_func.vim"": {""insertions"": 7, ""deletions"": 2, ""lines"": 9}, ""src/testdir/test_vim9_script.vim"": {""insertions"": 1, ""deletions"": 1, ""lines"": 2}, ""src/userfunc.c"": {""insertions"": 3, ""deletions"": 2, ""lines"": 5}, ""src/version.c"": {""insertions"": 2, ""deletions"": 0, ""lines"": 2}}"
2021-04-08 18:10:10,dcae51facc4d6de1edd62f0242b40972be841103,Bram Moolenaar,24,1,25,3,"{""src/list.c"": {""insertions"": 8, ""deletions"": 1, ""lines"": 9}, ""src/testdir/test_listdict.vim"": {""insertions"": 14, ""deletions"": 0, ""lines"": 14}, ""src/version.c"": {""insertions"": 2, ""deletions"": 0, ""lines"": 2}}"
2021-04-08 16:27:53,d8db8383926cb8729417d9515cbfaf455dbbd8d1,Bram Moolenaar,27,11,38,5,"{""src/ex_getln.c"": {""insertions"": 12, ""deletions"": 3, ""lines"": 15}, ""src/testdir/dumps/Test_statusline_mode_1.dump"": {""insertions"": 4, ""deletions"": 2, ""lines"": 6}, ""src/testdir/dumps/Test_statusline_mode_2.dump"": {""insertions"": 4, ""deletions"": 2, ""lines"": 6}, ""src/testdir/test_statusline.vim"": {""insertions"": 5, ""deletions"": 4, ""lines"": 9}, ""src/version.c"": {""insertions"": 2, ""deletions"": 0, ""lines"": 2}}"
2021-04-08 16:05:03,175a41c13f3e27e30c662f2f418c5a347dbc645d,Bram Moolenaar,3,2,5,2,"{""src/version.c"": {""insertions"": 2, ""deletions"": 0, ""lines"": 2}, ""src/vim9execute.c"": {""insertions"": 1, ""deletions"": 2, ""lines"": 3}}"
2021-04-07 19:58:16,fa5963880df1d11613594ab78c0a68f894d34aa3,Bram Moolenaar,43,8,51,3,"{""src/testdir/test_vim9_expr.vim"": {""insertions"": 23, ""deletions"": 0, ""lines"": 23}, ""src/version.c"": {""insertions"": 2, ""deletions"": 0, ""lines"": 2}, ""src/vim9compile.c"": {""insertions"": 18, ""deletions"": 8, ""lines"": 26}}"
2021-04-07 19:21:13,15e5e53ef29a457126f7c699931ab5842431f2ea,Bram Moolenaar,25,16,41,4,"{""src/proto/vim9compile.pro"": {""insertions"": 0, ""deletions"": 1, ""lines"": 1}, ""src/testdir/test_vim9_expr.vim"": {""insertions"": 15, ""deletions"": 0, ""lines"": 15}, ""src/version.c"": {""insertions"": 2, ""deletions"": 0, ""lines"": 2}, ""src/vim9compile.c"": {""insertions"": 8, ""deletions"": 15, ""lines"": 23}}"
2021-04-07 19:07:20,130cbfc31235c6cb52ffe718ea0a5bb50fbbc9fd,Bram Moolenaar,619,68,687,30,"{"".github/CODEOWNERS"": {""insertions"": 7, ""deletions"": 0, ""lines"": 7}, ""runtime/compiler/powershell.vim"": {""insertions"": 84, ""deletions"": 0, ""lines"": 84}, ""runtime/doc/Makefile"": {""insertions"": 2, ""deletions"": 0, ""lines"": 2}, ""runtime/doc/cmdline.txt"": {""insertions"": 3, ""deletions"": 1, ""lines"": 4}, ""runtime/doc/editing.txt"": {""insertions"": 2, ""deletions"": 2, ""lines"": 4}, ""runtime/doc/eval.txt"": {""insertions"": 8, ""deletions"": 5, ""lines"": 13}, ""runtime/doc/ft_ps1.txt"": {""insertions"": 64, ""deletions"": 0, ""lines"": 64}, ""runtime/doc/gui_w32.txt"": {""insertions"": 2, ""deletions"": 2, ""lines"": 4}, ""runtime/doc/if_lua.txt"": {""insertions"": 1, ""deletions"": 1, ""lines"": 2}, ""runtime/doc/mbyte.txt"": {""insertions"": 2, ""deletions"": 2, ""lines"": 4}, ""runtime/doc/options.txt"": {""insertions"": 18, ""deletions"": 10, ""lines"": 28}, ""runtime/doc/os_win32.txt"": {""insertions"": 2, ""deletions"": 2, ""lines"": 4}, ""runtime/doc/syntax.txt"": {""insertions"": 1, ""deletions"": 1, ""lines"": 2}, ""runtime/doc/tags"": {""insertions"": 9, ""deletions"": 0, ""lines"": 9}, ""runtime/doc/testing.txt"": {""insertions"": 1, ""deletions"": 1, ""lines"": 2}, ""runtime/doc/todo.txt"": {""insertions"": 5, ""deletions"": 10, ""lines"": 15}, ""runtime/doc/usr_02.txt"": {""insertions"": 1, ""deletions"": 1, ""lines"": 2}, ""runtime/doc/version5.txt"": {""insertions"": 3, ""deletions"": 3, ""lines"": 6}, ""runtime/doc/version6.txt"": {""insertions"": 2, ""deletions"": 2, ""lines"": 4}, ""runtime/doc/vim9.txt"": {""insertions"": 27, ""deletions"": 9, ""lines"": 36}, ""runtime/ftplugin/fortran.vim"": {""insertions"": 11, ""deletions"": 4, ""lines"": 15}, ""runtime/ftplugin/ps1.vim"": {""insertions"": 59, ""deletions"": 0, ""lines"": 59}, ""runtime/ftplugin/ps1xml.vim"": {""insertions"": 34, ""deletions"": 0, ""lines"": 34}, ""runtime/indent/ps1.vim"": {""insertions"": 17, ""deletions"": 0, ""lines"": 17}, ""runtime/plugin/matchparen.vim"": {""insertions"": 4, ""deletions"": 3, ""lines"": 7}, ""runtime/syntax/fortran.vim"": {""insertions"": 13, ""deletions"": 6, ""lines"": 19}, ""runtime/syntax/nasm.vim"": {""insertions"": 3, ""deletions"": 2, ""lines"": 5}, ""runtime/syntax/ps1.vim"": {""insertions"": 182, ""deletions"": 0, ""lines"": 182}, ""runtime/syntax/ps1xml.vim"": {""insertions"": 51, ""deletions"": 0, ""lines"": 51}, ""src/po/fr.po"": {""insertions"": 1, ""deletions"": 1, ""lines"": 2}}"
2021-04-07 18:11:12,125ed2745c0a0570c1f81f249aebb023b2deef1b,Bram Moolenaar,29,13,42,5,"{""ci/if_ver-1.vim"": {""insertions"": 1, ""deletions"": 1, ""lines"": 2}, ""runtime/doc/if_lua.txt"": {""insertions"": 2, ""deletions"": 0, ""lines"": 2}, ""src/if_lua.c"": {""insertions"": 23, ""deletions"": 0, ""lines"": 23}, ""src/testdir/test_lua.vim"": {""insertions"": 1, ""deletions"": 12, ""lines"": 13}, ""src/version.c"": {""insertions"": 2, ""deletions"": 0, ""lines"": 2}}"
2021-04-07 17:42:57,e5b0b98a90acf420bb611fc99534982c98d0645b,Bram Moolenaar,6,0,6,3,"{""src/ex_cmds.c"": {""insertions"": 1, ""deletions"": 0, ""lines"": 1}, ""src/testdir/test_ex_mode.vim"": {""insertions"": 3, ""deletions"": 0, ""lines"": 3}, ""src/version.c"": {""insertions"": 2, ""deletions"": 0, ""lines"": 2}}"
2021-04-07 17:00:25,8dddc1f0e2e9eeb29fc59477b515bcd6bb1243ec,Bram Moolenaar,11,0,11,2,"{""src/mbyte.c"": {""insertions"": 9, ""deletions"": 0, ""lines"": 9}, ""src/version.c"": {""insertions"": 2, ""deletions"": 0, ""lines"": 2}}"
2021-04-06 19:29:32,c9605f0595173bca0f158f2782de950ac6bed147,Bram Moolenaar,3,0,3,2,"{""src/version.c"": {""insertions"": 2, ""deletions"": 0, ""lines"": 2}, ""src/vim9compile.c"": {""insertions"": 1, ""deletions"": 0, ""lines"": 1}}"
2021-04-06 19:17:27,643ce6c0c694667a2afd24bb39d8e9d36d94d7a9,Bram Moolenaar,40,11,51,3,"{""src/testdir/test_vim9_assign.vim"": {""insertions"": 35, ""deletions"": 0, ""lines"": 35}, ""src/version.c"": {""insertions"": 2, ""deletions"": 0, ""lines"": 2}, ""src/vim9compile.c"": {""insertions"": 3, ""deletions"": 11, ""lines"": 14}}"
2021-04-06 18:21:59,e3d1f4c982bd0fe05496448d7868268c75ff7bfb,Bram Moolenaar,20,4,24,5,"{""src/charset.c"": {""insertions"": 10, ""deletions"": 0, ""lines"": 10}, ""src/misc2.c"": {""insertions"": 3, ""deletions"": 3, ""lines"": 6}, ""src/proto/charset.pro"": {""insertions"": 1, ""deletions"": 0, ""lines"": 1}, ""src/testdir/test_mapping.vim"": {""insertions"": 4, ""deletions"": 1, ""lines"": 5}, ""src/version.c"": {""insertions"": 2, ""deletions"": 0, ""lines"": 2}}"
2021-04-06 18:18:29,e9b8b78e046b40b877c999432c4698edb3413d5d,Bram Moolenaar,3,1,4,2,"{""src/testdir/test_user_func.vim"": {""insertions"": 1, ""deletions"": 1, ""lines"": 2}, ""src/version.c"": {""insertions"": 2, ""deletions"": 0, ""lines"": 2}}"
2021-04-06 17:01:03,86cdb8a4bd1abff40b5f80c3c4149b33cbaab990,Bram Moolenaar,22,0,22,3,"{""src/testdir/test_vim9_func.vim"": {""insertions"": 9, ""deletions"": 0, ""lines"": 9}, ""src/userfunc.c"": {""insertions"": 11, ""deletions"": 0, ""lines"": 11}, ""src/version.c"": {""insertions"": 2, ""deletions"": 0, ""lines"": 2}}"
2021-04-05 20:27:37,e8c4660a55364a5d3e395652d1202b8702666823,Bram Moolenaar,50,7,57,5,"{""src/ex_docmd.c"": {""insertions"": 6, ""deletions"": 2, ""lines"": 8}, ""src/ex_eval.c"": {""insertions"": 1, ""deletions"": 0, ""lines"": 1}, ""src/structs.h"": {""insertions"": 2, ""deletions"": 1, ""lines"": 3}, ""src/testdir/test_vim9_func.vim"": {""insertions"": 39, ""deletions"": 4, ""lines"": 43}, ""src/version.c"": {""insertions"": 2, ""deletions"": 0, ""lines"": 2}}"
2021-04-05 19:05:26,0d351a04e137b5c25dd558476182e4cbc81a287d,Bram Moolenaar,6,0,6,2,"{""src/testdir/test_vim9_assign.vim"": {""insertions"": 4, ""deletions"": 0, ""lines"": 4}, ""src/version.c"": {""insertions"": 2, ""deletions"": 0, ""lines"": 2}}"
2021-04-05 18:59:41,58fb7c39a04aabfa399ae4f2142ee0728bc22483,Bram Moolenaar,3,1,4,2,"{""src/testdir/test_let.vim"": {""insertions"": 1, ""deletions"": 1, ""lines"": 2}, ""src/version.c"": {""insertions"": 2, ""deletions"": 0, ""lines"": 2}}"
2021-04-05 18:51:00,b9c0cd897ab4ad54f514187e89719c0241393f8b,Bram Moolenaar,61,31,92,4,"{""src/eval.c"": {""insertions"": 1, ""deletions"": 1, ""lines"": 2}, ""src/testdir/test_vim9_assign.vim"": {""insertions"": 13, ""deletions"": 0, ""lines"": 13}, ""src/version.c"": {""insertions"": 2, ""deletions"": 0, ""lines"": 2}, ""src/vim9compile.c"": {""insertions"": 45, ""deletions"": 30, ""lines"": 75}}"
2021-04-05 17:41:21,2927c07b0ec627c13e863e1b84bec831743bce12,Bram Moolenaar,49,20,69,3,"{""src/testdir/test_vim9_expr.vim"": {""insertions"": 1, ""deletions"": 3, ""lines"": 4}, ""src/version.c"": {""insertions"": 2, ""deletions"": 0, ""lines"": 2}, ""src/vim9compile.c"": {""insertions"": 46, ""deletions"": 17, ""lines"": 63}}"
2021-04-05 16:20:45,01ac0a1f664c5b1ffd5c9ef196d4b47edf2fd494,Bram Moolenaar,8,0,8,2,"{""src/gui_gtk.c"": {""insertions"": 6, ""deletions"": 0, ""lines"": 6}, ""src/version.c"": {""insertions"": 2, ""deletions"": 0, ""lines"": 2}}"
2021-04-05 15:11:17,e42939af87be3adad8c08ceb454e3a31114d7165,Bram Moolenaar,195,118,313,3,"{""src/testdir/test_vim9_assign.vim"": {""insertions"": 40, ""deletions"": 3, ""lines"": 43}, ""src/version.c"": {""insertions"": 2, ""deletions"": 0, ""lines"": 2}, ""src/vim9compile.c"": {""insertions"": 153, ""deletions"": 115, ""lines"": 268}}"
2021-04-05 13:38:51,0865b15bc6d869d56713f674d66ad3d0509bf4b9,Bram Moolenaar,26,0,26,2,"{""src/testdir/test_vim9_func.vim"": {""insertions"": 24, ""deletions"": 0, ""lines"": 24}, ""src/version.c"": {""insertions"": 2, ""deletions"": 0, ""lines"": 2}}"
2021-04-05 12:13:20,ce5b06a6a972dcc36e460782e10e21a09b227b5d,Bram Moolenaar,29,2,31,2,"{""src/gui_gtk.c"": {""insertions"": 27, ""deletions"": 2, ""lines"": 29}, ""src/version.c"": {""insertions"": 2, ""deletions"": 0, ""lines"": 2}}"
2021-04-05 11:59:53,0b94e297afd072c51bf2eed12c7ffe3978d93399,Bram Moolenaar,790,466,1256,4,"{""src/regexp_bt.c"": {""insertions"": 385, ""deletions"": 219, ""lines"": 604}, ""src/regexp_nfa.c"": {""insertions"": 399, ""deletions"": 243, ""lines"": 642}, ""src/testdir/test_regexp_utf8.vim"": {""insertions"": 4, ""deletions"": 4, ""lines"": 8}, ""src/version.c"": {""insertions"": 2, ""deletions"": 0, ""lines"": 2}}"
2021-04-05 11:36:34,886e5e737d0b2eea755c415a86997ca3b7fe5349,Bram Moolenaar,7,1,8,3,"{""src/testdir/test_vim9_builtin.vim"": {""insertions"": 3, ""deletions"": 0, ""lines"": 3}, ""src/testdir/test_vim9_expr.vim"": {""insertions"": 2, ""deletions"": 1, ""lines"": 3}, ""src/version.c"": {""insertions"": 2, ""deletions"": 0, ""lines"": 2}}"
2021-04-05 11:10:43,409da842db9dc24d88e415e518c02c05ac7de760,Bram Moolenaar,10,6,16,3,"{""runtime/filetype.vim"": {""insertions"": 6, ""deletions"": 4, ""lines"": 10}, ""src/testdir/test_filetype.vim"": {""insertions"": 2, ""deletions"": 2, ""lines"": 4}, ""src/version.c"": {""insertions"": 2, ""deletions"": 0, ""lines"": 2}}"
2021-04-05 10:47:25,68ffe8cade5e0c52680c00cb9f3f87104fbe653a,Bram Moolenaar,122,0,122,2,"{""src/testdir/test_fold.vim"": {""insertions"": 120, ""deletions"": 0, ""lines"": 120}, ""src/version.c"": {""insertions"": 2, ""deletions"": 0, ""lines"": 2}}"
2021-04-04 19:55:23,f2dd9cb9958962302d33fab8fe6439645a2d1e1b,Bram Moolenaar,7,3,10,2,"{""src/eval.c"": {""insertions"": 5, ""deletions"": 3, ""lines"": 8}, ""src/version.c"": {""insertions"": 2, ""deletions"": 0, ""lines"": 2}}"
2021-04-04 19:26:04,3c49e74e18993915a779cafe4af3749b39fd3e2a,Bram Moolenaar,28,13,41,3,"{""src/normal.c"": {""insertions"": 10, ""deletions"": 2, ""lines"": 12}, ""src/testdir/test_fold.vim"": {""insertions"": 16, ""deletions"": 11, ""lines"": 27}, ""src/version.c"": {""insertions"": 2, ""deletions"": 0, ""lines"": 2}}"
2021-04-04 18:49:50,90193e6140e5e7f1945e3e144a95697b0e16237a,Bram Moolenaar,756,737,1493,6,"{""src/eval.c"": {""insertions"": 13, ""deletions"": 6, ""lines"": 19}, ""src/testdir/test_vim9_expr.vim"": {""insertions"": 709, ""deletions"": 726, ""lines"": 1435}, ""src/testdir/vim9.vim"": {""insertions"": 20, ""deletions"": 0, ""lines"": 20}, ""src/version.c"": {""insertions"": 2, ""deletions"": 0, ""lines"": 2}, ""src/vim9compile.c"": {""insertions"": 2, ""deletions"": 2, ""lines"": 4}, ""src/vim9execute.c"": {""insertions"": 10, ""deletions"": 3, ""lines"": 13}}"
2021-04-04 13:57:12,26af8e54ff0d423b7258ef84d175c8570740629a,Bram Moolenaar,20,6,26,2,"{""src/gui_gtk.c"": {""insertions"": 18, ""deletions"": 6, ""lines"": 24}, ""src/version.c"": {""insertions"": 2, ""deletions"": 0, ""lines"": 2}}"
2021-04-04 13:28:59,3a6aadb3289be5114db6cce1c8c18b3f5f14d17c,Bram Moolenaar,6,4,10,3,"{""src/testdir/term_util.vim"": {""insertions"": 2, ""deletions"": 2, ""lines"": 4}, ""src/testdir/test_mksession.vim"": {""insertions"": 2, ""deletions"": 2, ""lines"": 4}, ""src/version.c"": {""insertions"": 2, ""deletions"": 0, ""lines"": 2}}"
2021-04-04 13:05:22,ceb06194337f1a9d30cd12edb7b0dc51830b9cb7,Bram Moolenaar,6,1,7,2,"{""src/insexpand.c"": {""insertions"": 4, ""deletions"": 1, ""lines"": 5}, ""src/version.c"": {""insertions"": 2, ""deletions"": 0, ""lines"": 2}}"
2021-04-03 19:47:07,a7511c0f4f779140e8b893be506ecffd0ededf04,Bram Moolenaar,33,8,41,3,"{""src/testdir/test_vim9_expr.vim"": {""insertions"": 22, ""deletions"": 8, ""lines"": 30}, ""src/version.c"": {""insertions"": 2, ""deletions"": 0, ""lines"": 2}, ""src/vim9compile.c"": {""insertions"": 9, ""deletions"": 0, ""lines"": 9}}"
2021-04-03 19:01:01,77709b194c71eb02f765521f31b463593bd07cda,Bram Moolenaar,14,1,15,3,"{""src/testdir/test_vim9_assign.vim"": {""insertions"": 8, ""deletions"": 0, ""lines"": 8}, ""src/version.c"": {""insertions"": 2, ""deletions"": 0, ""lines"": 2}, ""src/vim9compile.c"": {""insertions"": 4, ""deletions"": 1, ""lines"": 5}}"
2021-04-03 18:13:30,440cf096fad7bf628974abc344343b823d79a006,Bram Moolenaar,13,7,20,2,"{""src/insexpand.c"": {""insertions"": 11, ""deletions"": 7, ""lines"": 18}, ""src/version.c"": {""insertions"": 2, ""deletions"": 0, ""lines"": 2}}"
2021-04-03 17:32:44,6e50ec2f0af85940e40ed3f897bfcfa445adbb0e,Bram Moolenaar,10,1,11,3,"{""src/testdir/test_vim9_assign.vim"": {""insertions"": 2, ""deletions"": 1, ""lines"": 3}, ""src/version.c"": {""insertions"": 2, ""deletions"": 0, ""lines"": 2}, ""src/vim9execute.c"": {""insertions"": 6, ""deletions"": 0, ""lines"": 6}}"
2021-04-03 17:07:05,c17ba791a9edfa12926ce29f1eef39044bee5ab7,Bram Moolenaar,4,2,6,2,"{""src/testdir/test_compiler.vim"": {""insertions"": 2, ""deletions"": 2, ""lines"": 4}, ""src/version.c"": {""insertions"": 2, ""deletions"": 0, ""lines"": 2}}"
2021-04-03 15:33:52,26f201345dadef2a048db5aea804f6c1b54f1a0b,Bram Moolenaar,6,4,10,3,"{""src/auto/configure"": {""insertions"": 2, ""deletions"": 2, ""lines"": 4}, ""src/configure.ac"": {""insertions"": 2, ""deletions"": 2, ""lines"": 4}, ""src/version.c"": {""insertions"": 2, ""deletions"": 0, ""lines"": 2}}"
2021-04-03 15:22:29,6437475ffb421d6ac35572aa779ff24b70c5206b,Bram Moolenaar,4,2,6,2,"{""src/testdir/test_terminal.vim"": {""insertions"": 2, ""deletions"": 2, ""lines"": 4}, ""src/version.c"": {""insertions"": 2, ""deletions"": 0, ""lines"": 2}}"
2021-04-03 15:18:52,c48f2dc0be158531511adc3065b52bdd1e64acf7,Bram Moolenaar,3,1,4,2,"{""src/testdir/test_lua.vim"": {""insertions"": 1, ""deletions"": 1, ""lines"": 2}, ""src/version.c"": {""insertions"": 2, ""deletions"": 0, ""lines"": 2}}"
2021-04-03 13:35:50,b9c6b6fb73711f64943340b2c3f0bdf8744451b6,Bram Moolenaar,11,1,12,2,"{""src/testdir/test_lua.vim"": {""insertions"": 9, ""deletions"": 1, ""lines"": 10}, ""src/version.c"": {""insertions"": 2, ""deletions"": 0, ""lines"": 2}}"
2021-04-03 13:15:47,0df603014589c663f4b49dc6fd36c3b99db1718f,Bram Moolenaar,3,0,3,2,"{""runtime/doc/usr_41.txt"": {""insertions"": 1, ""deletions"": 0, ""lines"": 1}, ""src/version.c"": {""insertions"": 2, ""deletions"": 0, ""lines"": 2}}"
2021-04-03 12:13:33,f65ed86f6f60e1b73f4203206cd3df024b7d61f3,Bram Moolenaar,54,25,79,2,"{""src/testdir/test_lua.vim"": {""insertions"": 52, ""deletions"": 25, ""lines"": 77}, ""src/version.c"": {""insertions"": 2, ""deletions"": 0, ""lines"": 2}}"
2021-04-03 11:19:26,1e6bbfb5607c82d872070219c26e2aae20db68ed,Bram Moolenaar,35,4,39,3,"{""src/autocmd.c"": {""insertions"": 6, ""deletions"": 4, ""lines"": 10}, ""src/testdir/test_terminal.vim"": {""insertions"": 27, ""deletions"": 0, ""lines"": 27}, ""src/version.c"": {""insertions"": 2, ""deletions"": 0, ""lines"": 2}}"
2021-04-02 16:55:57,5b8cabfef7c3707f3e53e13844d90e5a217e1e84,Bram Moolenaar,42,5,47,8,"{""runtime/doc/eval.txt"": {""insertions"": 1, ""deletions"": 0, ""lines"": 1}, ""runtime/doc/testing.txt"": {""insertions"": 10, ""deletions"": 1, ""lines"": 11}, ""src/evalfunc.c"": {""insertions"": 2, ""deletions"": 0, ""lines"": 2}, ""src/proto/testing.pro"": {""insertions"": 1, ""deletions"": 0, ""lines"": 1}, ""src/search.c"": {""insertions"": 2, ""deletions"": 0, ""lines"": 2}, ""src/testdir/test_textformat.vim"": {""insertions"": 8, ""deletions"": 0, ""lines"": 8}, ""src/testing.c"": {""insertions"": 16, ""deletions"": 4, ""lines"": 20}, ""src/version.c"": {""insertions"": 2, ""deletions"": 0, ""lines"": 2}}"
2021-04-02 12:44:02,dcf29ac87f4d7a62c503ba6de0d92c7779446bf2,Bram Moolenaar,17,2,19,3,"{""src/testdir/test_vim9_assign.vim"": {""insertions"": 12, ""deletions"": 2, ""lines"": 14}, ""src/version.c"": {""insertions"": 2, ""deletions"": 0, ""lines"": 2}, ""src/vim9execute.c"": {""insertions"": 3, ""deletions"": 0, ""lines"": 3}}"
2021-04-02 12:35:15,f5906aa7807e9a14159cbc09a141138a2a068ab2,Bram Moolenaar,20,0,20,3,"{""src/testdir/test_vim9_assign.vim"": {""insertions"": 11, ""deletions"": 0, ""lines"": 11}, ""src/version.c"": {""insertions"": 2, ""deletions"": 0, ""lines"": 2}, ""src/vim9execute.c"": {""insertions"": 7, ""deletions"": 0, ""lines"": 7}}"
2021-04-02 11:30:59,3fa5e64e0ed55de718e48d0268edc360b2352bc1,Bram Moolenaar,6,4,10,3,"{""src/auto/configure"": {""insertions"": 2, ""deletions"": 2, ""lines"": 4}, ""src/configure.ac"": {""insertions"": 2, ""deletions"": 2, ""lines"": 4}, ""src/version.c"": {""insertions"": 2, ""deletions"": 0, ""lines"": 2}}"
2021-04-02 11:00:15,ef38bcf05196ad7e795dd77b4922fa9db58fc310,Bram Moolenaar,10,1,11,3,"{""runtime/filetype.vim"": {""insertions"": 5, ""deletions"": 0, ""lines"": 5}, ""src/testdir/test_filetype.vim"": {""insertions"": 3, ""deletions"": 1, ""lines"": 4}, ""src/version.c"": {""insertions"": 2, ""deletions"": 0, ""lines"": 2}}"
2021-04-01 19:57:46,160a2b4dac198f31fbcff9d696548e011c4602c1,Bram Moolenaar,4,0,4,2,"{""src/ex_getln.c"": {""insertions"": 2, ""deletions"": 0, ""lines"": 2}, ""src/version.c"": {""insertions"": 2, ""deletions"": 0, ""lines"": 2}}"
2021-04-01 19:38:53,ca51cc0a335d0c449784440501c7d46ee8f84ce4,Bram Moolenaar,6,3,9,3,"{""src/testdir/test_vim9_script.vim"": {""insertions"": 3, ""deletions"": 2, ""lines"": 5}, ""src/version.c"": {""insertions"": 2, ""deletions"": 0, ""lines"": 2}, ""src/vim9compile.c"": {""insertions"": 1, ""deletions"": 1, ""lines"": 2}}"
2021-04-01 17:42:48,d877a5700fe9d5b92562514924549316382384aa,Bram Moolenaar,27,2,29,4,"{""src/testdir/test_vim9_assign.vim"": {""insertions"": 18, ""deletions"": 0, ""lines"": 18}, ""src/version.c"": {""insertions"": 2, ""deletions"": 0, ""lines"": 2}, ""src/vim9compile.c"": {""insertions"": 3, ""deletions"": 1, ""lines"": 4}, ""src/vim9execute.c"": {""insertions"": 4, ""deletions"": 1, ""lines"": 5}}"
2021-04-01 16:47:14,ce0b75711afb3ff260967a0843bca46ec09604b5,Bram Moolenaar,42,0,42,5,"{""src/ex_getln.c"": {""insertions"": 9, ""deletions"": 0, ""lines"": 9}, ""src/testdir/dumps/Test_statusline_mode_1.dump"": {""insertions"": 5, ""deletions"": 0, ""lines"": 5}, ""src/testdir/dumps/Test_statusline_mode_2.dump"": {""insertions"": 5, ""deletions"": 0, ""lines"": 5}, ""src/testdir/test_statusline.vim"": {""insertions"": 21, ""deletions"": 0, ""lines"": 21}, ""src/version.c"": {""insertions"": 2, ""deletions"": 0, ""lines"": 2}}"
2021-04-01 14:16:18,49c51b825a7435a750e64f7f0ebd09166e8559df,Bram Moolenaar,35,2,37,6,"{""src/drawscreen.c"": {""insertions"": 1, ""deletions"": 1, ""lines"": 2}, ""src/proto/drawscreen.pro"": {""insertions"": 1, ""deletions"": 0, ""lines"": 1}, ""src/screen.c"": {""insertions"": 1, ""deletions"": 1, ""lines"": 2}, ""src/testdir/dumps/Test_winbar_not_visible_custom_statusline.dump"": {""insertions"": 10, ""deletions"": 0, ""lines"": 10}, ""src/testdir/test_winbar.vim"": {""insertions"": 20, ""deletions"": 0, ""lines"": 20}, ""src/version.c"": {""insertions"": 2, ""deletions"": 0, ""lines"": 2}}"
2021-04-01 11:39:51,5c504f680e63120fea36becfabb8d939d4449e34,Bram Moolenaar,254,18,272,4,"{""src/testdir/test_fold.vim"": {""insertions"": 204, ""deletions"": 18, ""lines"": 222}, ""src/testdir/test_mksession.vim"": {""insertions"": 31, ""deletions"": 0, ""lines"": 31}, ""src/testdir/test_source.vim"": {""insertions"": 17, ""deletions"": 0, ""lines"": 17}, ""src/version.c"": {""insertions"": 2, ""deletions"": 0, ""lines"": 2}}"
2021-04-01 11:17:50,b91d3f857fb6aadbbc01f80f775967bb40d361de,Bram Moolenaar,4,0,4,2,"{""src/version.c"": {""insertions"": 2, ""deletions"": 0, ""lines"": 2}, ""src/vim9script.c"": {""insertions"": 2, ""deletions"": 0, ""lines"": 2}}"
2021-04-01 10:57:57,529fb5a5f62378bbaac00e1ed9b9c32c6e20c1b9,Bram Moolenaar,35,4,39,4,"{""src/testdir/test_vim9_script.vim"": {""insertions"": 17, ""deletions"": 0, ""lines"": 17}, ""src/version.c"": {""insertions"": 2, ""deletions"": 0, ""lines"": 2}, ""src/vim9compile.c"": {""insertions"": 8, ""deletions"": 2, ""lines"": 10}, ""src/vim9script.c"": {""insertions"": 8, ""deletions"": 2, ""lines"": 10}}"
2021-03-31 19:47:33,12be734faffe1da04dfa9098e73abaa864204bc5,Bram Moolenaar,9,6,15,2,"{""src/evalvars.c"": {""insertions"": 7, ""deletions"": 6, ""lines"": 13}, ""src/version.c"": {""insertions"": 2, ""deletions"": 0, ""lines"": 2}}"
2021-03-31 19:07:24,e535db86e76db5e8fcd2fa8ad54050e171e8adc3,Bram Moolenaar,57,7,64,5,"{""src/evalvars.c"": {""insertions"": 6, ""deletions"": 4, ""lines"": 10}, ""src/proto/vim9script.pro"": {""insertions"": 1, ""deletions"": 0, ""lines"": 1}, ""src/testdir/test_vim9_script.vim"": {""insertions"": 29, ""deletions"": 0, ""lines"": 29}, ""src/version.c"": {""insertions"": 2, ""deletions"": 0, ""lines"": 2}, ""src/vim9script.c"": {""insertions"": 19, ""deletions"": 3, ""lines"": 22}}"
2021-03-31 18:07:33,dad4473f02e1fec86d43a2fc094536a4b27d3b25,Bram Moolenaar,275,239,514,28,"{"".github/CODEOWNERS"": {""insertions"": 5, ""deletions"": 1, ""lines"": 6}, ""runtime/doc/autocmd.txt"": {""insertions"": 6, ""deletions"": 4, ""lines"": 10}, ""runtime/doc/eval.txt"": {""insertions"": 14, ""deletions"": 7, ""lines"": 21}, ""runtime/doc/index.txt"": {""insertions"": 2, ""deletions"": 1, ""lines"": 3}, ""runtime/doc/map.txt"": {""insertions"": 3, ""deletions"": 3, ""lines"": 6}, ""runtime/doc/motion.txt"": {""insertions"": 39, ""deletions"": 33, ""lines"": 72}, ""runtime/doc/options.txt"": {""insertions"": 7, ""deletions"": 7, ""lines"": 14}, ""runtime/doc/quickref.txt"": {""insertions"": 1, ""deletions"": 1, ""lines"": 2}, ""runtime/doc/syntax.txt"": {""insertions"": 3, ""deletions"": 2, ""lines"": 5}, ""runtime/doc/tags"": {""insertions"": 7, ""deletions"": 0, ""lines"": 7}, ""runtime/doc/textprop.txt"": {""insertions"": 3, ""deletions"": 3, ""lines"": 6}, ""runtime/doc/todo.txt"": {""insertions"": 26, ""deletions"": 57, ""lines"": 83}, ""runtime/doc/usr_41.txt"": {""insertions"": 1, ""deletions"": 1, ""lines"": 2}, ""runtime/doc/various.txt"": {""insertions"": 2, ""deletions"": 2, ""lines"": 4}, ""runtime/doc/version7.txt"": {""insertions"": 1, ""deletions"": 1, ""lines"": 2}, ""runtime/doc/version8.txt"": {""insertions"": 1, ""deletions"": 1, ""lines"": 2}, ""runtime/doc/vim9.txt"": {""insertions"": 23, ""deletions"": 25, ""lines"": 48}, ""runtime/doc/windows.txt"": {""insertions"": 3, ""deletions"": 3, ""lines"": 6}, ""runtime/filetype.vim"": {""insertions"": 1, ""deletions"": 1, ""lines"": 2}, ""runtime/ftplugin/lisp.vim"": {""insertions"": 1, ""deletions"": 1, ""lines"": 2}, ""runtime/indent/cdl.vim"": {""insertions"": 8, ""deletions"": 4, ""lines"": 12}, ""runtime/syntax/dot.vim"": {""insertions"": 75, ""deletions"": 51, ""lines"": 126}, ""runtime/syntax/groff.vim"": {""insertions"": 2, ""deletions"": 2, ""lines"": 4}, ""runtime/syntax/javascript.vim"": {""insertions"": 2, ""deletions"": 1, ""lines"": 3}, ""runtime/syntax/nroff.vim"": {""insertions"": 19, ""deletions"": 19, ""lines"": 38}, ""runtime/syntax/sshconfig.vim"": {""insertions"": 9, ""deletions"": 3, ""lines"": 12}, ""runtime/syntax/sshdconfig.vim"": {""insertions"": 7, ""deletions"": 2, ""lines"": 9}, ""runtime/syntax/sudoers.vim"": {""insertions"": 4, ""deletions"": 3, ""lines"": 7}}"
2021-03-30 20:12:12,ae0f151ddf76dcbb233cff02282deb4f98a355ec,Bram Moolenaar,57,6,63,4,"{""src/drawscreen.c"": {""insertions"": 25, ""deletions"": 6, ""lines"": 31}, ""src/testdir/dumps/Test_winbar_not_visible.dump"": {""insertions"": 10, ""deletions"": 0, ""lines"": 10}, ""src/testdir/test_winbar.vim"": {""insertions"": 20, ""deletions"": 0, ""lines"": 20}, ""src/version.c"": {""insertions"": 2, ""deletions"": 0, ""lines"": 2}}"
2021-03-30 18:54:28,82820d9bf14ba5374c24fff2ed6e577a67c6ddf2,Bram Moolenaar,4,0,4,2,"{""src/testdir/test_terminal3.vim"": {""insertions"": 2, ""deletions"": 0, ""lines"": 2}, ""src/version.c"": {""insertions"": 2, ""deletions"": 0, ""lines"": 2}}"
2021-03-29 20:14:55,38a3bfa9a2931729a5e0c28dc087f745b68988ef,Bram Moolenaar,170,65,235,9,"{""runtime/doc/vim9.txt"": {""insertions"": 58, ""deletions"": 1, ""lines"": 59}, ""src/structs.h"": {""insertions"": 0, ""deletions"": 2, ""lines"": 2}, ""src/testdir/test_vim9_disassemble.vim"": {""insertions"": 11, ""deletions"": 4, ""lines"": 15}, ""src/testdir/test_vim9_func.vim"": {""insertions"": 19, ""deletions"": 2, ""lines"": 21}, ""src/userfunc.c"": {""insertions"": 0, ""deletions"": 9, ""lines"": 9}, ""src/version.c"": {""insertions"": 2, ""deletions"": 0, ""lines"": 2}, ""src/vim9.h"": {""insertions"": 8, ""deletions"": 0, ""lines"": 8}, ""src/vim9compile.c"": {""insertions"": 37, ""deletions"": 9, ""lines"": 46}, ""src/vim9execute.c"": {""insertions"": 35, ""deletions"": 38, ""lines"": 73}}"
2021-03-29 19:06:04,9ea7e55ab9eacbdcfde76627fdc070a9cb4d1d45,Bram Moolenaar,4,0,4,2,"{""src/errors.h"": {""insertions"": 2, ""deletions"": 0, ""lines"": 2}, ""src/version.c"": {""insertions"": 2, ""deletions"": 0, ""lines"": 2}}"
2021-03-29 18:49:05,8b9abfd86c736ed3f298dfa8b50a962c118b3983,Bram Moolenaar,145,2,147,11,"{""runtime/doc/options.txt"": {""insertions"": 9, ""deletions"": 0, ""lines"": 9}, ""runtime/doc/quickref.txt"": {""insertions"": 1, ""deletions"": 0, ""lines"": 1}, ""runtime/optwin.vim"": {""insertions"": 2, ""deletions"": 0, ""lines"": 2}, ""src/charset.c"": {""insertions"": 2, ""deletions"": 1, ""lines"": 3}, ""src/feature.h"": {""insertions"": 6, ""deletions"": 0, ""lines"": 6}, ""src/option.h"": {""insertions"": 3, ""deletions"": 0, ""lines"": 3}, ""src/optiondefs.h"": {""insertions"": 9, ""deletions"": 0, ""lines"": 9}, ""src/terminal.c"": {""insertions"": 74, ""deletions"": 1, ""lines"": 75}, ""src/testdir/check.vim"": {""insertions"": 8, ""deletions"": 0, ""lines"": 8}, ""src/testdir/test_terminal3.vim"": {""insertions"": 29, ""deletions"": 0, ""lines"": 29}, ""src/version.c"": {""insertions"": 2, ""deletions"": 0, ""lines"": 2}}"
2021-03-29 18:10:26,9dbe701fe19597ad59c0e0c70a05927b587bea9f,Bram Moolenaar,15,2,17,3,"{""src/gui_motif.c"": {""insertions"": 7, ""deletions"": 2, ""lines"": 9}, ""src/gui_x11.c"": {""insertions"": 6, ""deletions"": 0, ""lines"": 6}, ""src/version.c"": {""insertions"": 2, ""deletions"": 0, ""lines"": 2}}"
2021-03-28 19:14:06,3215466af9abfc9fbbfba81d166d625176993486,Bram Moolenaar,32,2,34,3,"{""src/evalvars.c"": {""insertions"": 4, ""deletions"": 2, ""lines"": 6}, ""src/testdir/test_vim9_assign.vim"": {""insertions"": 26, ""deletions"": 0, ""lines"": 26}, ""src/version.c"": {""insertions"": 2, ""deletions"": 0, ""lines"": 2}}"
2021-03-28 18:38:34,b2cb6c8bbd215177ed05c1d952e7ef2ad8f7ef4b,Bram Moolenaar,97,10,107,4,"{""src/errors.h"": {""insertions"": 2, ""deletions"": 0, ""lines"": 2}, ""src/testdir/test_vim9_cmd.vim"": {""insertions"": 38, ""deletions"": 0, ""lines"": 38}, ""src/version.c"": {""insertions"": 2, ""deletions"": 0, ""lines"": 2}, ""src/vim9compile.c"": {""insertions"": 55, ""deletions"": 10, ""lines"": 65}}"
2021-03-28 14:26:41,f6bdd82c7e2076dbacb764a5d288189d61c68451,Bram Moolenaar,4,1,5,2,"{""src/typval.c"": {""insertions"": 2, ""deletions"": 1, ""lines"": 3}, ""src/version.c"": {""insertions"": 2, ""deletions"": 0, ""lines"": 2}}"
2021-03-28 13:46:16,b2ac7d0663ef31a335c50c6afca042ed9ace5059,Bram Moolenaar,7,1,8,3,"{""src/testdir/test_vim9_builtin.vim"": {""insertions"": 4, ""deletions"": 0, ""lines"": 4}, ""src/typval.c"": {""insertions"": 1, ""deletions"": 1, ""lines"": 2}, ""src/version.c"": {""insertions"": 2, ""deletions"": 0, ""lines"": 2}}"
2021-03-28 13:29:43,df749a2b9cab579b8c0ca6ca91889aa03d2da704,Bram Moolenaar,10,3,13,4,"{""src/cmdexpand.c"": {""insertions"": 3, ""deletions"": 2, ""lines"": 5}, ""src/ex_docmd.c"": {""insertions"": 1, ""deletions"": 1, ""lines"": 2}, ""src/testdir/test_cmdline.vim"": {""insertions"": 4, ""deletions"": 0, ""lines"": 4}, ""src/version.c"": {""insertions"": 2, ""deletions"": 0, ""lines"": 2}}"
2021-03-27 21:20:21,f49a1fcdb952ca270f108fcc27bb8ad6922e0807,Bram Moolenaar,84,53,137,3,"{""src/ex_docmd.c"": {""insertions"": 76, ""deletions"": 47, ""lines"": 123}, ""src/testdir/test_vim9_builtin.vim"": {""insertions"": 6, ""deletions"": 6, ""lines"": 12}, ""src/version.c"": {""insertions"": 2, ""deletions"": 0, ""lines"": 2}}"
2021-03-27 21:07:29,24f21fdfca294fec25861343f8928f6480da95f4,Bram Moolenaar,32,1,33,4,"{""runtime/doc/textprop.txt"": {""insertions"": 2, ""deletions"": 0, ""lines"": 2}, ""src/testdir/test_textprop.vim"": {""insertions"": 19, ""deletions"": 0, ""lines"": 19}, ""src/textprop.c"": {""insertions"": 9, ""deletions"": 1, ""lines"": 10}, ""src/version.c"": {""insertions"": 2, ""deletions"": 0, ""lines"": 2}}"
2021-03-27 20:23:30,c580943965fc9b006ec233bdee4ea5380f5594ea,Bram Moolenaar,54,0,54,6,"{""src/channel.c"": {""insertions"": 5, ""deletions"": 0, ""lines"": 5}, ""src/eval.c"": {""insertions"": 3, ""deletions"": 0, ""lines"": 3}, ""src/evalfunc.c"": {""insertions"": 9, ""deletions"": 0, ""lines"": 9}, ""src/filepath.c"": {""insertions"": 4, ""deletions"": 0, ""lines"": 4}, ""src/testdir/test_vim9_builtin.vim"": {""insertions"": 31, ""deletions"": 0, ""lines"": 31}, ""src/version.c"": {""insertions"": 2, ""deletions"": 0, ""lines"": 2}}"
2021-03-27 18:09:02,7b45d46cf7db0d2d7a4defc2d81b233a2c672b74,Bram Moolenaar,5,1,6,3,"{""src/evalbuffer.c"": {""insertions"": 2, ""deletions"": 0, ""lines"": 2}, ""src/testdir/test_vim9_builtin.vim"": {""insertions"": 1, ""deletions"": 1, ""lines"": 2}, ""src/version.c"": {""insertions"": 2, ""deletions"": 0, ""lines"": 2}}"
2021-03-27 17:59:25,32105ae88f3aa6a6af30336f0bc9f8eb81292cd7,Bram Moolenaar,58,29,87,7,"{""src/evalfunc.c"": {""insertions"": 9, ""deletions"": 2, ""lines"": 11}, ""src/filepath.c"": {""insertions"": 14, ""deletions"": 14, ""lines"": 28}, ""src/mbyte.c"": {""insertions"": 1, ""deletions"": 1, ""lines"": 2}, ""src/proto/typval.pro"": {""insertions"": 2, ""deletions"": 2, ""lines"": 4}, ""src/testdir/test_vim9_builtin.vim"": {""insertions"": 20, ""deletions"": 0, ""lines"": 20}, ""src/typval.c"": {""insertions"": 10, ""deletions"": 10, ""lines"": 20}, ""src/version.c"": {""insertions"": 2, ""deletions"": 0, ""lines"": 2}}"
2021-03-27 14:40:11,79efa2e3b3cdab8c21d95ba4ed9cb573566af531,Bram Moolenaar,11,4,15,2,"{""src/userfunc.c"": {""insertions"": 9, ""deletions"": 4, ""lines"": 13}, ""src/version.c"": {""insertions"": 2, ""deletions"": 0, ""lines"": 2}}"
2021-03-27 11:11:33,7007e31bde75b6360a1b54c7572e4f855458f37d,Bram Moolenaar,50,10,60,4,"{""src/main.c"": {""insertions"": 15, ""deletions"": 6, ""lines"": 21}, ""src/os_unix.c"": {""insertions"": 7, ""deletions"": 4, ""lines"": 11}, ""src/testdir/test_startup.vim"": {""insertions"": 26, ""deletions"": 0, ""lines"": 26}, ""src/version.c"": {""insertions"": 2, ""deletions"": 0, ""lines"": 2}}"
2021-03-26 21:15:26,bb5d87c8504588be9c9d2fecc5b6455a2b2f6201,Bram Moolenaar,5,1,6,2,"{""src/eval.c"": {""insertions"": 3, ""deletions"": 1, ""lines"": 4}, ""src/version.c"": {""insertions"": 2, ""deletions"": 0, ""lines"": 2}}"
2021-03-26 20:27:52,ccc25aa285498d572a735bba5afd22aec9f605f4,Bram Moolenaar,15,3,18,3,"{""src/evalvars.c"": {""insertions"": 5, ""deletions"": 2, ""lines"": 7}, ""src/testdir/test_vim9_assign.vim"": {""insertions"": 8, ""deletions"": 1, ""lines"": 9}, ""src/version.c"": {""insertions"": 2, ""deletions"": 0, ""lines"": 2}}"
2021-03-26 19:56:45,c61cb8bfe1ec2cc50e6edd195cae2a3cd93d6590,Bram Moolenaar,3,1,4,2,"{""src/testdir/test_eval_stuff.vim"": {""insertions"": 1, ""deletions"": 1, ""lines"": 2}, ""src/version.c"": {""insertions"": 2, ""deletions"": 0, ""lines"": 2}}"
2021-03-26 19:41:29,74e54fcb447e5db32f9c2df34c0554bbecdccca2,Bram Moolenaar,163,32,195,9,"{""runtime/doc/eval.txt"": {""insertions"": 11, ""deletions"": 3, ""lines"": 14}, ""src/errors.h"": {""insertions"": 2, ""deletions"": 0, ""lines"": 2}, ""src/eval.c"": {""insertions"": 34, ""deletions"": 4, ""lines"": 38}, ""src/testdir/test_vim9_disassemble.vim"": {""insertions"": 1, ""deletions"": 2, ""lines"": 3}, ""src/testdir/test_vim9_script.vim"": {""insertions"": 27, ""deletions"": 1, ""lines"": 28}, ""src/testdir/test_vimscript.vim"": {""insertions"": 20, ""deletions"": 0, ""lines"": 20}, ""src/version.c"": {""insertions"": 2, ""deletions"": 0, ""lines"": 2}, ""src/vim9compile.c"": {""insertions"": 7, ""deletions"": 3, ""lines"": 10}, ""src/vim9execute.c"": {""insertions"": 59, ""deletions"": 19, ""lines"": 78}}"
2021-03-26 17:49:22,522eefd9a247c574a51bfe9bf73467a8dc3bac42,Bram Moolenaar,40,7,47,3,"{""src/ex_eval.c"": {""insertions"": 31, ""deletions"": 7, ""lines"": 38}, ""src/testdir/test_vim9_script.vim"": {""insertions"": 7, ""deletions"": 0, ""lines"": 7}, ""src/version.c"": {""insertions"": 2, ""deletions"": 0, ""lines"": 2}}"
2021-03-26 16:24:34,a2b3e7dc9201fb3d8782c6b4ab53862160e254da,Bram Moolenaar,24,9,33,3,"{""src/testdir/test_regexp_latin.vim"": {""insertions"": 10, ""deletions"": 1, ""lines"": 11}, ""src/testdir/test_startup.vim"": {""insertions"": 12, ""deletions"": 8, ""lines"": 20}, ""src/version.c"": {""insertions"": 2, ""deletions"": 0, ""lines"": 2}}"
2021-03-26 13:14:18,0a1a6a1aa4004d0e4d64cc375540156b8bd92a87,Bram Moolenaar,14,2,16,3,"{""src/term.c"": {""insertions"": 3, ""deletions"": 2, ""lines"": 5}, ""src/testdir/test_startup.vim"": {""insertions"": 9, ""deletions"": 0, ""lines"": 9}, ""src/version.c"": {""insertions"": 2, ""deletions"": 0, ""lines"": 2}}"
2021-03-26 12:34:05,ff871400461183010d3ab98f3f326e4bb75e221b,Bram Moolenaar,21,3,24,2,"{""src/version.c"": {""insertions"": 2, ""deletions"": 0, ""lines"": 2}, ""src/vim9execute.c"": {""insertions"": 19, ""deletions"": 3, ""lines"": 22}}"
2021-03-25 21:22:30,3a0f092ac0dbdd4ce71f9c4abe020e89f13df36c,Bram Moolenaar,5,1,6,2,"{""src/errors.h"": {""insertions"": 3, ""deletions"": 1, ""lines"": 4}, ""src/version.c"": {""insertions"": 2, ""deletions"": 0, ""lines"": 2}}"
2021-03-25 21:15:28,fa984418e7becd8e7d6543cd3ea25f605e9ac97f,Bram Moolenaar,131,25,156,8,"{""src/ex_docmd.c"": {""insertions"": 27, ""deletions"": 0, ""lines"": 27}, ""src/ex_eval.c"": {""insertions"": 17, ""deletions"": 0, ""lines"": 17}, ""src/proto/ex_docmd.pro"": {""insertions"": 2, ""deletions"": 0, ""lines"": 2}, ""src/testdir/test_vim9_builtin.vim"": {""insertions"": 3, ""deletions"": 3, ""lines"": 6}, ""src/testdir/test_vim9_cmd.vim"": {""insertions"": 49, ""deletions"": 0, ""lines"": 49}, ""src/testdir/test_vim9_disassemble.vim"": {""insertions"": 6, ""deletions"": 6, ""lines"": 12}, ""src/version.c"": {""insertions"": 2, ""deletions"": 0, ""lines"": 2}, ""src/vim9compile.c"": {""insertions"": 25, ""deletions"": 16, ""lines"": 41}}"
2021-03-25 20:12:15,a91a71322dc2e6a1640e73b6da1f1a2f94f39a54,Bram Moolenaar,192,41,233,4,"{""src/testdir/test_vim9_disassemble.vim"": {""insertions"": 89, ""deletions"": 15, ""lines"": 104}, ""src/version.c"": {""insertions"": 2, ""deletions"": 0, ""lines"": 2}, ""src/vim9compile.c"": {""insertions"": 76, ""deletions"": 16, ""lines"": 92}, ""src/vim9execute.c"": {""insertions"": 25, ""deletions"": 10, ""lines"": 35}}"
2021-03-24 21:00:56,2fecb53115e25de6203363be8018ee676ad1422b,Bram Moolenaar,127,45,172,4,"{""src/testdir/test_vim9_func.vim"": {""insertions"": 23, ""deletions"": 0, ""lines"": 23}, ""src/version.c"": {""insertions"": 2, ""deletions"": 0, ""lines"": 2}, ""src/vim9.h"": {""insertions"": 4, ""deletions"": 2, ""lines"": 6}, ""src/vim9execute.c"": {""insertions"": 98, ""deletions"": 43, ""lines"": 141}}"
2021-03-24 19:08:12,1ff89deeaa07a161afbe91f57c340f3758d34f49,Bram Moolenaar,26,4,30,3,"{""src/testdir/test_vim9_cmd.vim"": {""insertions"": 21, ""deletions"": 0, ""lines"": 21}, ""src/version.c"": {""insertions"": 2, ""deletions"": 0, ""lines"": 2}, ""src/window.c"": {""insertions"": 3, ""deletions"": 4, ""lines"": 7}}"
2021-03-23 18:22:12,c54f347d63bcca97ead673d01ac6b59914bb04e5,Bram Moolenaar,10,0,10,2,"{""src/testdir/test_terminal2.vim"": {""insertions"": 8, ""deletions"": 0, ""lines"": 8}, ""src/version.c"": {""insertions"": 2, ""deletions"": 0, ""lines"": 2}}"
2021-03-23 15:25:09,f4a2ed071447ad4984fad55b9d1671b55140ae1c,Bram Moolenaar,4,0,4,2,"{""src/testdir/test_terminal.vim"": {""insertions"": 2, ""deletions"": 0, ""lines"": 2}, ""src/version.c"": {""insertions"": 2, ""deletions"": 0, ""lines"": 2}}"
2021-03-22 21:21:26,f28f2ac425600b88da0bdcc12a82cd620f575681,Bram Moolenaar,76,42,118,7,"{""src/errors.h"": {""insertions"": 4, ""deletions"": 0, ""lines"": 4}, ""src/filepath.c"": {""insertions"": 16, ""deletions"": 11, ""lines"": 27}, ""src/mbyte.c"": {""insertions"": 1, ""deletions"": 1, ""lines"": 2}, ""src/proto/typval.pro"": {""insertions"": 2, ""deletions"": 2, ""lines"": 4}, ""src/testdir/test_vim9_builtin.vim"": {""insertions"": 40, ""deletions"": 23, ""lines"": 63}, ""src/typval.c"": {""insertions"": 11, ""deletions"": 5, ""lines"": 16}, ""src/version.c"": {""insertions"": 2, ""deletions"": 0, ""lines"": 2}}"
2021-03-22 19:49:02,49f1e9ec3e7f4e1b3572367d02a83c2b6ebbed97,Bram Moolenaar,57,7,64,5,"{""src/errors.h"": {""insertions"": 2, ""deletions"": 0, ""lines"": 2}, ""src/testdir/test_vim9_expr.vim"": {""insertions"": 33, ""deletions"": 0, ""lines"": 33}, ""src/testdir/test_vim9_func.vim"": {""insertions"": 10, ""deletions"": 0, ""lines"": 10}, ""src/userfunc.c"": {""insertions"": 10, ""deletions"": 7, ""lines"": 17}, ""src/version.c"": {""insertions"": 2, ""deletions"": 0, ""lines"": 2}}"
2021-03-22 18:43:34,da1dbed0dfac00952b42982f8fffa42c4f5ed0c8,Bram Moolenaar,6,1,7,2,"{""src/textprop.c"": {""insertions"": 4, ""deletions"": 1, ""lines"": 5}, ""src/version.c"": {""insertions"": 2, ""deletions"": 0, ""lines"": 2}}"
2021-03-22 18:37:06,1f448d906b3c516e5864dc5bae3ddbf3664ee649,Bram Moolenaar,83,1,84,6,"{""src/testdir/test_edit.vim"": {""insertions"": 27, ""deletions"": 0, ""lines"": 27}, ""src/testdir/test_functions.vim"": {""insertions"": 1, ""deletions"": 1, ""lines"": 2}, ""src/testdir/test_mapping.vim"": {""insertions"": 10, ""deletions"": 0, ""lines"": 10}, ""src/testdir/test_termcodes.vim"": {""insertions"": 34, ""deletions"": 0, ""lines"": 34}, ""src/testdir/test_undo.vim"": {""insertions"": 9, ""deletions"": 0, ""lines"": 9}, ""src/version.c"": {""insertions"": 2, ""deletions"": 0, ""lines"": 2}}"
2021-03-22 17:22:30,e98f60a5912d30db289231aed7d3a1d74beaae20,Bram Moolenaar,13,1,14,3,"{""src/testdir/test_vim9_expr.vim"": {""insertions"": 5, ""deletions"": 0, ""lines"": 5}, ""src/userfunc.c"": {""insertions"": 6, ""deletions"": 1, ""lines"": 7}, ""src/version.c"": {""insertions"": 2, ""deletions"": 0, ""lines"": 2}}"
2021-03-22 16:30:47,2cec027af461095f96dec3bfd036c267f790b0f4,Bram Moolenaar,5,2,7,2,"{""src/testdir/test_display.vim"": {""insertions"": 3, ""deletions"": 2, ""lines"": 5}, ""src/version.c"": {""insertions"": 2, ""deletions"": 0, ""lines"": 2}}"
2021-03-22 16:11:15,f1387285e2ebe5cb3688d729fc6fd01a169a76c1,Bram Moolenaar,8,10,18,3,"{""src/evalfunc.c"": {""insertions"": 1, ""deletions"": 1, ""lines"": 2}, ""src/testdir/test_listchars.vim"": {""insertions"": 5, ""deletions"": 9, ""lines"": 14}, ""src/version.c"": {""insertions"": 2, ""deletions"": 0, ""lines"": 2}}"
2021-03-22 15:45:35,5ea79a2599d35f75e1ae8a75d2711c754c4cb7c4,Bram Moolenaar,5,1,6,2,"{""src/ui.c"": {""insertions"": 3, ""deletions"": 1, ""lines"": 4}, ""src/version.c"": {""insertions"": 2, ""deletions"": 0, ""lines"": 2}}"
2021-03-22 15:19:45,4c86830fc578bcb47a51cf0983da5388cdbfe6cc,Bram Moolenaar,54,32,86,9,"{""runtime/doc/eval.txt"": {""insertions"": 6, ""deletions"": 1, ""lines"": 7}, ""src/eval.c"": {""insertions"": 6, ""deletions"": 0, ""lines"": 6}, ""src/ex_cmdidxs.h"": {""insertions"": 23, ""deletions"": 23, ""lines"": 46}, ""src/ex_cmds.h"": {""insertions"": 3, ""deletions"": 0, ""lines"": 3}, ""src/proto/ui.pro"": {""insertions"": 2, ""deletions"": 2, ""lines"": 4}, ""src/term.c"": {""insertions"": 1, ""deletions"": 1, ""lines"": 2}, ""src/testdir/runtest.vim"": {""insertions"": 1, ""deletions"": 1, ""lines"": 2}, ""src/ui.c"": {""insertions"": 10, ""deletions"": 4, ""lines"": 14}, ""src/version.c"": {""insertions"": 2, ""deletions"": 0, ""lines"": 2}}"
2021-03-21 21:29:54,09f8b3a02200a1900a8bb41d7436f9d17ebd2d1b,Bram Moolenaar,4,1,5,2,"{""src/textprop.c"": {""insertions"": 2, ""deletions"": 1, ""lines"": 3}, ""src/version.c"": {""insertions"": 2, ""deletions"": 0, ""lines"": 2}}"
2021-03-21 21:12:34,67da21a14726b106b49744f9773eba132fedd5f2,Bram Moolenaar,26,9,35,6,"{""src/eval.c"": {""insertions"": 2, ""deletions"": 2, ""lines"": 4}, ""src/globals.h"": {""insertions"": 2, ""deletions"": 1, ""lines"": 3}, ""src/structs.h"": {""insertions"": 3, ""deletions"": 0, ""lines"": 3}, ""src/userfunc.c"": {""insertions"": 7, ""deletions"": 6, ""lines"": 13}, ""src/version.c"": {""insertions"": 2, ""deletions"": 0, ""lines"": 2}, ""src/vim9compile.c"": {""insertions"": 10, ""deletions"": 0, ""lines"": 10}}"
2021-03-21 19:53:29,7a6eaa06f98cef61d2131c25b4b47b8262cb8f59,Bram Moolenaar,660,449,1109,7,"{""src/errors.h"": {""insertions"": 4, ""deletions"": 0, ""lines"": 4}, ""src/misc2.c"": {""insertions"": 3, ""deletions"": 2, ""lines"": 5}, ""src/proto/vim9compile.pro"": {""insertions"": 1, ""deletions"": 0, ""lines"": 1}, ""src/testdir/test_vim9_expr.vim"": {""insertions"": 19, ""deletions"": 0, ""lines"": 19}, ""src/userfunc.c"": {""insertions"": 621, ""deletions"": 443, ""lines"": 1064}, ""src/version.c"": {""insertions"": 2, ""deletions"": 0, ""lines"": 2}, ""src/vim9compile.c"": {""insertions"": 10, ""deletions"": 4, ""lines"": 14}}"
2021-03-21 13:49:57,f90c855c71863296859780f7b4e0386e96f1c465,Bram Moolenaar,29,8,37,4,"{""runtime/doc/tagsrch.txt"": {""insertions"": 10, ""deletions"": 4, ""lines"": 14}, ""src/tag.c"": {""insertions"": 4, ""deletions"": 3, ""lines"": 7}, ""src/testdir/test_tagfunc.vim"": {""insertions"": 13, ""deletions"": 1, ""lines"": 14}, ""src/version.c"": {""insertions"": 2, ""deletions"": 0, ""lines"": 2}}"
2021-03-21 13:39:19,196a1f740981e878091fa124a400d1fc4bfa2bb0,Bram Moolenaar,14,1,15,3,"{""src/screen.c"": {""insertions"": 6, ""deletions"": 1, ""lines"": 7}, ""src/testdir/test_fold.vim"": {""insertions"": 6, ""deletions"": 0, ""lines"": 6}, ""src/version.c"": {""insertions"": 2, ""deletions"": 0, ""lines"": 2}}"
2021-03-20 21:16:56,c5cf369e9543ff065e2e1da91da3218c223840e2,Bram Moolenaar,25,0,25,3,"{""src/testdir/test_clientserver.vim"": {""insertions"": 8, ""deletions"": 0, ""lines"": 8}, ""src/testdir/test_startup.vim"": {""insertions"": 15, ""deletions"": 0, ""lines"": 15}, ""src/version.c"": {""insertions"": 2, ""deletions"": 0, ""lines"": 2}}"
2021-03-20 18:55:35,a0c8aea479ca055ce43ba2984a9933f6c48e6161,Bram Moolenaar,31,9,40,3,"{""src/evalwindow.c"": {""insertions"": 14, ""deletions"": 7, ""lines"": 21}, ""src/testdir/test_window_cmd.vim"": {""insertions"": 15, ""deletions"": 2, ""lines"": 17}, ""src/version.c"": {""insertions"": 2, ""deletions"": 0, ""lines"": 2}}"
2021-03-20 15:44:25,592f57f5fec1064cc276a0d7992cc543bed04fd5,Bram Moolenaar,3,1,4,2,"{""src/testdir/Makefile"": {""insertions"": 1, ""deletions"": 1, ""lines"": 2}, ""src/version.c"": {""insertions"": 2, ""deletions"": 0, ""lines"": 2}}"
2021-03-20 14:00:01,a0399efa72380115a3eb650544dd64e459476bd2,Bram Moolenaar,12,5,17,5,"{""src/errors.h"": {""insertions"": 1, ""deletions"": 1, ""lines"": 2}, ""src/ex_docmd.c"": {""insertions"": 2, ""deletions"": 1, ""lines"": 3}, ""src/testdir/test_vim9_expr.vim"": {""insertions"": 4, ""deletions"": 0, ""lines"": 4}, ""src/version.c"": {""insertions"": 2, ""deletions"": 0, ""lines"": 2}, ""src/vim9script.c"": {""insertions"": 3, ""deletions"": 3, ""lines"": 6}}"
2021-03-20 12:29:38,5c7a299c1652b28977c30e3e3a5ab93c65e7f7ed,Bram Moolenaar,15,7,22,4,"{""src/eval.c"": {""insertions"": 7, ""deletions"": 2, ""lines"": 9}, ""src/ex_docmd.c"": {""insertions"": 2, ""deletions"": 1, ""lines"": 3}, ""src/testdir/test_vim9_expr.vim"": {""insertions"": 4, ""deletions"": 4, ""lines"": 8}, ""src/version.c"": {""insertions"": 2, ""deletions"": 0, ""lines"": 2}}"
2021-03-20 11:49:15,4355894869355c185e7810e67d52802453576e81,Bram Moolenaar,2,12,14,4,"{""src/testdir/check.vim"": {""insertions"": 0, ""deletions"": 9, ""lines"": 9}, ""src/testdir/test_excmd.vim"": {""insertions"": 0, ""deletions"": 1, ""lines"": 1}, ""src/testdir/test_help.vim"": {""insertions"": 0, ""deletions"": 2, ""lines"": 2}, ""src/version.c"": {""insertions"": 2, ""deletions"": 0, ""lines"": 2}}"
2021-03-20 11:36:46,240014321b0aa5d6eb00a70865fa9935fd888d60,Bram Moolenaar,15,5,20,2,"{""src/gui_gtk_x11.c"": {""insertions"": 13, ""deletions"": 5, ""lines"": 18}, ""src/version.c"": {""insertions"": 2, ""deletions"": 0, ""lines"": 2}}"
2021-03-19 19:27:40,af125866db46405fdaf99ac4e43b630d196a4aa4,Bram Moolenaar,6,1,7,3,"{""runtime/filetype.vim"": {""insertions"": 3, ""deletions"": 0, ""lines"": 3}, ""src/testdir/test_filetype.vim"": {""insertions"": 1, ""deletions"": 1, ""lines"": 2}, ""src/version.c"": {""insertions"": 2, ""deletions"": 0, ""lines"": 2}}"
2021-03-19 19:19:12,74b99f6ab6e0265ebee4ed496845f28e0904318d,Bram Moolenaar,6,1,7,3,"{""runtime/filetype.vim"": {""insertions"": 3, ""deletions"": 0, ""lines"": 3}, ""src/testdir/test_filetype.vim"": {""insertions"": 1, ""deletions"": 1, ""lines"": 2}, ""src/version.c"": {""insertions"": 2, ""deletions"": 0, ""lines"": 2}}"
2021-03-19 13:38:12,17709e280ac5ba234b04641cde88d38e3522cedf,Bram Moolenaar,49,31,80,5,"{""src/testdir/test_edit.vim"": {""insertions"": 2, ""deletions"": 1, ""lines"": 3}, ""src/testdir/test_excmd.vim"": {""insertions"": 11, ""deletions"": 7, ""lines"": 18}, ""src/testdir/test_help.vim"": {""insertions"": 31, ""deletions"": 23, ""lines"": 54}, ""src/testdir/test_writefile.vim"": {""insertions"": 3, ""deletions"": 0, ""lines"": 3}, ""src/version.c"": {""insertions"": 2, ""deletions"": 0, ""lines"": 2}}"
2021-03-18 21:28:57,a555e6fcb6ec97b5ab30b20a340b228f4d820f14,Bram Moolenaar,85,62,147,5,"{""src/gui_beval.c"": {""insertions"": 1, ""deletions"": 1, ""lines"": 2}, ""src/gui_gtk_x11.c"": {""insertions"": 79, ""deletions"": 58, ""lines"": 137}, ""src/gui_xim.c"": {""insertions"": 1, ""deletions"": 1, ""lines"": 2}, ""src/proto/gui_gtk_x11.pro"": {""insertions"": 2, ""deletions"": 2, ""lines"": 4}, ""src/version.c"": {""insertions"": 2, ""deletions"": 0, ""lines"": 2}}"
2021-03-18 21:15:04,108cf0153c5770e343aec9e2390acdaa4a0b149a,Bram Moolenaar,33,16,49,6,"{""src/list.c"": {""insertions"": 2, ""deletions"": 2, ""lines"": 4}, ""src/proto/vim9type.pro"": {""insertions"": 1, ""deletions"": 1, ""lines"": 2}, ""src/testdir/test_vimscript.vim"": {""insertions"": 7, ""deletions"": 0, ""lines"": 7}, ""src/version.c"": {""insertions"": 2, ""deletions"": 0, ""lines"": 2}, ""src/vim9script.c"": {""insertions"": 1, ""deletions"": 1, ""lines"": 2}, ""src/vim9type.c"": {""insertions"": 20, ""deletions"": 12, ""lines"": 32}}"
2021-03-18 20:37:55,4b3e1964d85a25ac7b2202094d1abf27ab93cc23,Bram Moolenaar,43,10,53,7,"{""src/errors.h"": {""insertions"": 2, ""deletions"": 0, ""lines"": 2}, ""src/proto/vim9script.pro"": {""insertions"": 1, ""deletions"": 0, ""lines"": 1}, ""src/testdir/test_vim9_expr.vim"": {""insertions"": 4, ""deletions"": 2, ""lines"": 6}, ""src/testdir/test_vim9_script.vim"": {""insertions"": 1, ""deletions"": 1, ""lines"": 2}, ""src/version.c"": {""insertions"": 2, ""deletions"": 0, ""lines"": 2}, ""src/vim9compile.c"": {""insertions"": 14, ""deletions"": 5, ""lines"": 19}, ""src/vim9script.c"": {""insertions"": 19, ""deletions"": 2, ""lines"": 21}}"
2021-03-17 20:29:29,5f91e74bf968c9033474086b2d9cb457281c8aa6,Bram Moolenaar,17,0,17,2,"{""src/testdir/test_vim9_func.vim"": {""insertions"": 15, ""deletions"": 0, ""lines"": 15}, ""src/version.c"": {""insertions"": 2, ""deletions"": 0, ""lines"": 2}}"
2021-03-17 19:56:38,3f32788000258aabe078b426e3d71962bee9d2d1,Bram Moolenaar,14,2,16,3,"{""src/testdir/test_vim9_assign.vim"": {""insertions"": 7, ""deletions"": 0, ""lines"": 7}, ""src/version.c"": {""insertions"": 2, ""deletions"": 0, ""lines"": 2}, ""src/vim9compile.c"": {""insertions"": 5, ""deletions"": 2, ""lines"": 7}}"
2021-03-17 17:42:08,8863bda25df821fc79bebf9dc73c79776ae5f675,Bram Moolenaar,38,16,54,4,"{""src/testdir/test_vim9_disassemble.vim"": {""insertions"": 2, ""deletions"": 2, ""lines"": 4}, ""src/testdir/test_vim9_func.vim"": {""insertions"": 19, ""deletions"": 1, ""lines"": 20}, ""src/version.c"": {""insertions"": 2, ""deletions"": 0, ""lines"": 2}, ""src/vim9compile.c"": {""insertions"": 15, ""deletions"": 13, ""lines"": 28}}"
2021-03-17 16:46:00,3e1916947d5b29f67af554ce3b874b03a84c9093,Bram Moolenaar,41,4,45,4,"{""runtime/doc/vim9.txt"": {""insertions"": 3, ""deletions"": 1, ""lines"": 4}, ""src/scriptfile.c"": {""insertions"": 27, ""deletions"": 0, ""lines"": 27}, ""src/testdir/test_vim9_script.vim"": {""insertions"": 9, ""deletions"": 3, ""lines"": 12}, ""src/version.c"": {""insertions"": 2, ""deletions"": 0, ""lines"": 2}}"
2021-03-17 14:23:16,a4c81bea38d1f3e372a4191ab0bd7d664cba1428,Bram Moolenaar,3,1,4,2,"{""src/testdir/test_vim9_script.vim"": {""insertions"": 1, ""deletions"": 1, ""lines"": 2}, ""src/version.c"": {""insertions"": 2, ""deletions"": 0, ""lines"": 2}}"
2021-03-17 14:03:04,c970e4225b68ff8650ff23df09e04246c147fca3,Bram Moolenaar,65,9,74,4,"{""src/testdir/test_vim9_script.vim"": {""insertions"": 29, ""deletions"": 0, ""lines"": 29}, ""src/userfunc.c"": {""insertions"": 22, ""deletions"": 8, ""lines"": 30}, ""src/version.c"": {""insertions"": 2, ""deletions"": 0, ""lines"": 2}, ""src/vim9execute.c"": {""insertions"": 12, ""deletions"": 1, ""lines"": 13}}"
2021-03-17 12:39:33,6ccfd99b923cc3452a6e6450dfdd7e31ea602dfd,Bram Moolenaar,3,1,4,2,"{""src/testdir/test_mapping.vim"": {""insertions"": 1, ""deletions"": 1, ""lines"": 2}, ""src/version.c"": {""insertions"": 2, ""deletions"": 0, ""lines"": 2}}"
2021-03-17 12:28:05,18b7d86d7fa997bbb02a069dafacb32a0f73ca1e,Bram Moolenaar,40,0,40,3,"{""runtime/doc/map.txt"": {""insertions"": 14, ""deletions"": 0, ""lines"": 14}, ""src/testdir/test_mapping.vim"": {""insertions"": 24, ""deletions"": 0, ""lines"": 24}, ""src/version.c"": {""insertions"": 2, ""deletions"": 0, ""lines"": 2}}"
2021-03-17 11:27:23,f8c52e8d08de3fdf48db877d7d53d2d68c6ceb7b,Bram Moolenaar,36,7,43,4,"{""src/main.c"": {""insertions"": 3, ""deletions"": 0, ""lines"": 3}, ""src/testdir/check.vim"": {""insertions"": 25, ""deletions"": 0, ""lines"": 25}, ""src/testdir/test_startup.vim"": {""insertions"": 6, ""deletions"": 7, ""lines"": 13}, ""src/version.c"": {""insertions"": 2, ""deletions"": 0, ""lines"": 2}}"
2021-03-16 20:17:16,1e448465e1281eeb379f75fe848cbb47fe1be1d9,Bram Moolenaar,6,1,7,2,"{""src/testdir/test_selectmode.vim"": {""insertions"": 4, ""deletions"": 1, ""lines"": 5}, ""src/version.c"": {""insertions"": 2, ""deletions"": 0, ""lines"": 2}}"
2021-03-16 12:23:30,321481299757cdd43baeed33f4c5ba543fdfc7f7,Bram Moolenaar,5,1,6,2,"{""src/testdir/test_startup.vim"": {""insertions"": 3, ""deletions"": 1, ""lines"": 4}, ""src/version.c"": {""insertions"": 2, ""deletions"": 0, ""lines"": 2}}"
2021-03-15 17:36:20,f4fcedc59d4cc5ae6b5270a933e8377030283c1c,Bram Moolenaar,59,0,59,6,"{""src/testdir/test_functions.vim"": {""insertions"": 8, ""deletions"": 0, ""lines"": 8}, ""src/testdir/test_messages.vim"": {""insertions"": 11, ""deletions"": 0, ""lines"": 11}, ""src/testdir/test_paste.vim"": {""insertions"": 14, ""deletions"": 0, ""lines"": 14}, ""src/testdir/test_registers.vim"": {""insertions"": 10, ""deletions"": 0, ""lines"": 10}, ""src/testdir/test_undo.vim"": {""insertions"": 14, ""deletions"": 0, ""lines"": 14}, ""src/version.c"": {""insertions"": 2, ""deletions"": 0, ""lines"": 2}}"
2021-03-14 18:46:45,02b4d9b18a03549b68e364e428392b7a62766c74,Bram Moolenaar,49,13,62,4,"{""runtime/doc/eval.txt"": {""insertions"": 16, ""deletions"": 10, ""lines"": 26}, ""src/evalfunc.c"": {""insertions"": 23, ""deletions"": 3, ""lines"": 26}, ""src/testdir/test_expr_utf8.vim"": {""insertions"": 8, ""deletions"": 0, ""lines"": 8}, ""src/version.c"": {""insertions"": 2, ""deletions"": 0, ""lines"": 2}}"
2021-03-14 18:02:09,70ce8a1561c5396e4c4381f76a005cbb97646f80,Bram Moolenaar,59,15,74,5,"{""runtime/doc/eval.txt"": {""insertions"": 18, ""deletions"": 1, ""lines"": 19}, ""runtime/doc/usr_41.txt"": {""insertions"": 2, ""deletions"": 1, ""lines"": 3}, ""src/evalfunc.c"": {""insertions"": 29, ""deletions"": 12, ""lines"": 41}, ""src/testdir/test_utf8.vim"": {""insertions"": 8, ""deletions"": 1, ""lines"": 9}, ""src/version.c"": {""insertions"": 2, ""deletions"": 0, ""lines"": 2}}"
2021-03-14 17:40:19,0289a093a4d65c6280a3be118d1d3696d1aa74da,Bram Moolenaar,54,16,70,4,"{""runtime/doc/vim9.txt"": {""insertions"": 9, ""deletions"": 5, ""lines"": 14}, ""src/testdir/test_vim9_expr.vim"": {""insertions"": 29, ""deletions"": 0, ""lines"": 29}, ""src/version.c"": {""insertions"": 2, ""deletions"": 0, ""lines"": 2}, ""src/vim9execute.c"": {""insertions"": 14, ""deletions"": 11, ""lines"": 25}}"
2021-03-14 15:20:37,240309c9bfa8a0d2f154712f8e0dd33589f181d3,Bram Moolenaar,146,14,160,2,"{""src/testdir/test_startup.vim"": {""insertions"": 144, ""deletions"": 14, ""lines"": 158}, ""src/version.c"": {""insertions"": 2, ""deletions"": 0, ""lines"": 2}}"
2021-03-14 12:21:35,77b10ffad4ebad15022614be4db2745f6a90f405,Bram Moolenaar,76,29,105,7,"{""src/evalvars.c"": {""insertions"": 20, ""deletions"": 10, ""lines"": 30}, ""src/ex_docmd.c"": {""insertions"": 3, ""deletions"": 3, ""lines"": 6}, ""src/proto/evalvars.pro"": {""insertions"": 1, ""deletions"": 1, ""lines"": 2}, ""src/proto/ex_docmd.pro"": {""insertions"": 1, ""deletions"": 1, ""lines"": 2}, ""src/testdir/test_vim9_cmd.vim"": {""insertions"": 30, ""deletions"": 5, ""lines"": 35}, ""src/version.c"": {""insertions"": 2, ""deletions"": 0, ""lines"": 2}, ""src/vim9compile.c"": {""insertions"": 19, ""deletions"": 9, ""lines"": 28}}"
2021-03-14 11:13:33,2e34c34be1393027a761ecbccd8f267d52ca7bc1,Bram Moolenaar,32,3,35,3,"{""src/testdir/test_vim9_script.vim"": {""insertions"": 25, ""deletions"": 0, ""lines"": 25}, ""src/version.c"": {""insertions"": 2, ""deletions"": 0, ""lines"": 2}, ""src/vim9execute.c"": {""insertions"": 5, ""deletions"": 3, ""lines"": 8}}"
2021-03-13 21:11:51,6bce5856b5fc4d4eb8f75298382251ecda659ac3,Bram Moolenaar,4,2,6,2,"{""src/testdir/test_memory_usage.vim"": {""insertions"": 2, ""deletions"": 2, ""lines"": 4}, ""src/version.c"": {""insertions"": 2, ""deletions"": 0, ""lines"": 2}}"
2021-03-13 20:24:56,93e1cae739c32baf28954b64718bab009c6ee2ac,Bram Moolenaar,26,2,28,3,"{""src/testdir/test_vim9_builtin.vim"": {""insertions"": 20, ""deletions"": 0, ""lines"": 20}, ""src/version.c"": {""insertions"": 2, ""deletions"": 0, ""lines"": 2}, ""src/vim9type.c"": {""insertions"": 4, ""deletions"": 2, ""lines"": 6}}"
2021-03-13 20:14:18,edba70703b6eaee3365ddfd82e4ba56ee08486f8,Bram Moolenaar,4,1,5,2,"{""src/version.c"": {""insertions"": 2, ""deletions"": 0, ""lines"": 2}, ""src/vim9compile.c"": {""insertions"": 2, ""deletions"": 1, ""lines"": 3}}"
2021-03-13 20:07:21,6508880d6ca98486efb9ab947c651a2b73a6e795,Bram Moolenaar,9,0,9,4,"{""src/ex_docmd.c"": {""insertions"": 4, ""deletions"": 0, ""lines"": 4}, ""src/testdir/test_vim9_script.vim"": {""insertions"": 2, ""deletions"": 0, ""lines"": 2}, ""src/version.c"": {""insertions"": 2, ""deletions"": 0, ""lines"": 2}, ""src/vim9script.c"": {""insertions"": 1, ""deletions"": 0, ""lines"": 1}}"
2021-03-13 19:57:19,cb4e80fab9b1ee67249bde4f784526f900cda70c,Bram Moolenaar,129,23,152,10,"{""src/errors.h"": {""insertions"": 2, ""deletions"": 0, ""lines"": 2}, ""src/eval.c"": {""insertions"": 60, ""deletions"": 2, ""lines"": 62}, ""src/evalvars.c"": {""insertions"": 28, ""deletions"": 12, ""lines"": 40}, ""src/proto/evalvars.pro"": {""insertions"": 1, ""deletions"": 1, ""lines"": 2}, ""src/proto/vim9script.pro"": {""insertions"": 1, ""deletions"": 1, ""lines"": 2}, ""src/testdir/test_vim9_script.vim"": {""insertions"": 22, ""deletions"": 2, ""lines"": 24}, ""src/version.c"": {""insertions"": 2, ""deletions"": 0, ""lines"": 2}, ""src/vim.h"": {""insertions"": 5, ""deletions"": 0, ""lines"": 5}, ""src/vim9execute.c"": {""insertions"": 1, ""deletions"": 1, ""lines"": 2}, ""src/vim9script.c"": {""insertions"": 7, ""deletions"": 4, ""lines"": 11}}"
2021-03-13 14:47:56,41cd80335cf318c15c8b0139f53ab5e8a02561ef,Bram Moolenaar,27,5,32,3,"{""src/autocmd.c"": {""insertions"": 16, ""deletions"": 4, ""lines"": 20}, ""src/testdir/test_autocmd.vim"": {""insertions"": 9, ""deletions"": 1, ""lines"": 10}, ""src/version.c"": {""insertions"": 2, ""deletions"": 0, ""lines"": 2}}"
2021-03-13 13:29:05,9e813b3dea94a8952b732a224fa31beba6e85973,Bram Moolenaar,25,2,27,3,"{""src/testdir/test_options.vim"": {""insertions"": 21, ""deletions"": 0, ""lines"": 21}, ""src/version.c"": {""insertions"": 2, ""deletions"": 0, ""lines"": 2}, ""src/window.c"": {""insertions"": 2, ""deletions"": 2, ""lines"": 4}}"
2021-03-13 12:52:33,0756f757edba755b75e0c9c612ab2f7e673def84,Bram Moolenaar,18,1,19,3,"{""src/session.c"": {""insertions"": 2, ""deletions"": 1, ""lines"": 3}, ""src/testdir/test_mksession.vim"": {""insertions"": 14, ""deletions"": 0, ""lines"": 14}, ""src/version.c"": {""insertions"": 2, ""deletions"": 0, ""lines"": 2}}"
2021-03-13 12:30:03,0de8e2d6a3fae61c4d9dfdd6f16fc5040d994f6c,Bram Moolenaar,4,1,5,2,"{""Filelist"": {""insertions"": 2, ""deletions"": 1, ""lines"": 3}, ""src/version.c"": {""insertions"": 2, ""deletions"": 0, ""lines"": 2}}"
2021-03-13 12:28:13,c8cdf0f80b3cfd88a4490d80572062c1fd1a96ca,Bram Moolenaar,327,92,419,16,"{""runtime/doc/change.txt"": {""insertions"": 13, ""deletions"": 5, ""lines"": 18}, ""runtime/doc/eval.txt"": {""insertions"": 15, ""deletions"": 9, ""lines"": 24}, ""runtime/doc/filetype.txt"": {""insertions"": 8, ""deletions"": 1, ""lines"": 9}, ""runtime/doc/repeat.txt"": {""insertions"": 3, ""deletions"": 3, ""lines"": 6}, ""runtime/doc/sign.txt"": {""insertions"": 18, ""deletions"": 2, ""lines"": 20}, ""runtime/doc/syntax.txt"": {""insertions"": 4, ""deletions"": 4, ""lines"": 8}, ""runtime/doc/tags"": {""insertions"": 2, ""deletions"": 0, ""lines"": 2}, ""runtime/doc/testing.txt"": {""insertions"": 2, ""deletions"": 1, ""lines"": 3}, ""runtime/doc/todo.txt"": {""insertions"": 40, ""deletions"": 15, ""lines"": 55}, ""runtime/doc/various.txt"": {""insertions"": 2, ""deletions"": 2, ""lines"": 4}, ""runtime/doc/vim9.txt"": {""insertions"": 4, ""deletions"": 2, ""lines"": 6}, ""runtime/filetype.vim"": {""insertions"": 1, ""deletions"": 1, ""lines"": 2}, ""runtime/ftplugin/poke.vim"": {""insertions"": 32, ""deletions"": 0, ""lines"": 32}, ""runtime/syntax/html.vim"": {""insertions"": 25, ""deletions"": 44, ""lines"": 69}, ""runtime/syntax/poke.vim"": {""insertions"": 151, ""deletions"": 0, ""lines"": 151}, ""src/INSTALL"": {""insertions"": 7, ""deletions"": 3, ""lines"": 10}}"
2021-03-13 12:14:04,6fd367a97c8653a2d734a38252c7d68d4b2ebaa7,Bram Moolenaar,38,0,38,6,"{""src/testdir/test_fileformat.vim"": {""insertions"": 9, ""deletions"": 0, ""lines"": 9}, ""src/testdir/test_normal.vim"": {""insertions"": 7, ""deletions"": 0, ""lines"": 7}, ""src/testdir/test_sleep.vim"": {""insertions"": 1, ""deletions"": 0, ""lines"": 1}, ""src/testdir/test_textformat.vim"": {""insertions"": 15, ""deletions"": 0, ""lines"": 15}, ""src/testdir/test_viminfo.vim"": {""insertions"": 4, ""deletions"": 0, ""lines"": 4}, ""src/version.c"": {""insertions"": 2, ""deletions"": 0, ""lines"": 2}}"
2021-03-12 21:16:41,c80f647512b001fb6952ed10d076d56c3d4b84e0,Bram Moolenaar,6,0,6,3,"{""runtime/filetype.vim"": {""insertions"": 3, ""deletions"": 0, ""lines"": 3}, ""src/testdir/test_filetype.vim"": {""insertions"": 1, ""deletions"": 0, ""lines"": 1}, ""src/version.c"": {""insertions"": 2, ""deletions"": 0, ""lines"": 2}}"
2021-03-11 19:04:04,12bce95887f7c5f07a7bdb7b4485b53d074ccc0a,Bram Moolenaar,20,1,21,3,"{""src/testdir/test_vim9_func.vim"": {""insertions"": 8, ""deletions"": 0, ""lines"": 8}, ""src/version.c"": {""insertions"": 2, ""deletions"": 0, ""lines"": 2}, ""src/vim9compile.c"": {""insertions"": 10, ""deletions"": 1, ""lines"": 11}}"
2021-03-10 21:27:48,776b954622b45125dfdcb4a61243ca90956b0825,Bram Moolenaar,15,2,17,3,"{""src/testdir/runtest.vim"": {""insertions"": 5, ""deletions"": 0, ""lines"": 5}, ""src/testdir/test_recover.vim"": {""insertions"": 8, ""deletions"": 2, ""lines"": 10}, ""src/version.c"": {""insertions"": 2, ""deletions"": 0, ""lines"": 2}}"
2021-03-10 20:55:46,23b32a8d6bd9ec83c0c6632b7a8bfa544ac0a2f1,Bram Moolenaar,8,3,11,4,"{""src/memline.c"": {""insertions"": 5, ""deletions"": 2, ""lines"": 7}, ""src/testdir/Make_all.mak"": {""insertions"": 1, ""deletions"": 0, ""lines"": 1}, ""src/testdir/test_alot.vim"": {""insertions"": 0, ""deletions"": 1, ""lines"": 1}, ""src/version.c"": {""insertions"": 2, ""deletions"": 0, ""lines"": 2}}"
2021-03-10 20:46:39,6635ae1437e6e343c0514524a8dfb19d9525b908,Bram Moolenaar,14,3,17,3,"{""src/testdir/check.vim"": {""insertions"": 9, ""deletions"": 1, ""lines"": 10}, ""src/testdir/test_recover.vim"": {""insertions"": 3, ""deletions"": 2, ""lines"": 5}, ""src/version.c"": {""insertions"": 2, ""deletions"": 0, ""lines"": 2}}"
2021-03-10 20:26:37,f52f0606ed9ea19bcfc3a8343af9958f2d99eaf7,Bram Moolenaar,147,16,163,8,"{""src/auto/configure"": {""insertions"": 29, ""deletions"": 0, ""lines"": 29}, ""src/config.h.in"": {""insertions"": 1, ""deletions"": 0, ""lines"": 1}, ""src/configure.ac"": {""insertions"": 14, ""deletions"": 0, ""lines"": 14}, ""src/globals.h"": {""insertions"": 1, ""deletions"": 0, ""lines"": 1}, ""src/memline.c"": {""insertions"": 29, ""deletions"": 7, ""lines"": 36}, ""src/testdir/test_recover.vim"": {""insertions"": 68, ""deletions"": 9, ""lines"": 77}, ""src/testing.c"": {""insertions"": 3, ""deletions"": 0, ""lines"": 3}, ""src/version.c"": {""insertions"": 2, ""deletions"": 0, ""lines"": 2}}"
2021-03-10 18:04:07,c23555de346c53f8f6c478635c2d9e5f2992dd7f,Bram Moolenaar,3,1,4,2,"{""src/version.c"": {""insertions"": 2, ""deletions"": 0, ""lines"": 2}, ""src/vim9compile.c"": {""insertions"": 1, ""deletions"": 1, ""lines"": 2}}"
2021-03-10 17:43:09,d345fb921678613ffc66a8afc82bc0e815c72312,Bram Moolenaar,7,1,8,3,"{""src/testdir/test_vim9_expr.vim"": {""insertions"": 3, ""deletions"": 0, ""lines"": 3}, ""src/version.c"": {""insertions"": 2, ""deletions"": 0, ""lines"": 2}, ""src/vim9compile.c"": {""insertions"": 2, ""deletions"": 1, ""lines"": 3}}"
2021-03-10 15:08:26,7ad67d1150a1e48371d64e2919591c38b80e7cfc,Bram Moolenaar,16,1,17,3,"{""src/evalfunc.c"": {""insertions"": 1, ""deletions"": 1, ""lines"": 2}, ""src/testdir/test_vim9_builtin.vim"": {""insertions"": 13, ""deletions"": 0, ""lines"": 13}, ""src/version.c"": {""insertions"": 2, ""deletions"": 0, ""lines"": 2}}"
2021-03-10 13:00:18,ffb7dcdb773c250a6acf45d5670a508be9248cb6,Bram Moolenaar,19,15,34,2,"{""src/testdir/test_vim9_script.vim"": {""insertions"": 17, ""deletions"": 15, ""lines"": 32}, ""src/version.c"": {""insertions"": 2, ""deletions"": 0, ""lines"": 2}}"
2021-03-10 12:40:08,37294bd6a2afbf0fc8a1c34cbe102336b0bd0a82,Bram Moolenaar,55,9,64,8,"{""src/option.c"": {""insertions"": 7, ""deletions"": 4, ""lines"": 11}, ""src/optionstr.c"": {""insertions"": 6, ""deletions"": 3, ""lines"": 9}, ""src/scriptfile.c"": {""insertions"": 1, ""deletions"": 1, ""lines"": 2}, ""src/testdir/dumps/Test_vim9_no_redraw.dump"": {""insertions"": 6, ""deletions"": 0, ""lines"": 6}, ""src/testdir/test_vim9_script.vim"": {""insertions"": 31, ""deletions"": 0, ""lines"": 31}, ""src/version.c"": {""insertions"": 2, ""deletions"": 0, ""lines"": 2}, ""src/vim.h"": {""insertions"": 1, ""deletions"": 0, ""lines"": 1}, ""src/vim9script.c"": {""insertions"": 1, ""deletions"": 1, ""lines"": 2}}"
2021-03-08 20:47:13,e3ffcd9902efc756178900d9bd972c74a09c3fcd,Bram Moolenaar,13,2,15,3,"{""src/testdir/test_vim9_script.vim"": {""insertions"": 6, ""deletions"": 0, ""lines"": 6}, ""src/version.c"": {""insertions"": 2, ""deletions"": 0, ""lines"": 2}, ""src/vim9execute.c"": {""insertions"": 5, ""deletions"": 2, ""lines"": 7}}"
2021-03-08 19:47:14,d00a7fb81aff367c5dd5d86fb3883f1e7a58fed5,Bram Moolenaar,4,1,5,2,"{""src/evalvars.c"": {""insertions"": 2, ""deletions"": 1, ""lines"": 3}, ""src/version.c"": {""insertions"": 2, ""deletions"": 0, ""lines"": 2}}"
2021-03-08 18:50:24,86c3a2162c2e78b4f0b87b47779cc1452990ee1b,Bram Moolenaar,16,0,16,3,"{""src/if_lua.c"": {""insertions"": 5, ""deletions"": 0, ""lines"": 5}, ""src/testdir/test_lua.vim"": {""insertions"": 9, ""deletions"": 0, ""lines"": 9}, ""src/version.c"": {""insertions"": 2, ""deletions"": 0, ""lines"": 2}}"
2021-03-08 18:04:05,9355ae41497cbcce58ddd79f9125eb3e9dfe0a43,Bram Moolenaar,3,1,4,2,"{""src/drawline.c"": {""insertions"": 1, ""deletions"": 1, ""lines"": 2}, ""src/version.c"": {""insertions"": 2, ""deletions"": 0, ""lines"": 2}}"
2021-03-06 21:33:12,608d78fb45077fbaf6dc880b754a1d8a54ac9999,Bram Moolenaar,21,1,22,3,"{""src/testdir/test_vim9_func.vim"": {""insertions"": 17, ""deletions"": 0, ""lines"": 17}, ""src/userfunc.c"": {""insertions"": 2, ""deletions"": 1, ""lines"": 3}, ""src/version.c"": {""insertions"": 2, ""deletions"": 0, ""lines"": 2}}"
2021-03-06 20:01:09,6914e87d3c0387fdcbb117a39e1f6d1fac0ee2e3,Bram Moolenaar,43,3,46,3,"{""src/testdir/test_vim9_cmd.vim"": {""insertions"": 19, ""deletions"": 0, ""lines"": 19}, ""src/version.c"": {""insertions"": 2, ""deletions"": 0, ""lines"": 2}, ""src/vim9compile.c"": {""insertions"": 22, ""deletions"": 3, ""lines"": 25}}"
2021-03-06 18:26:46,04947cc6ed313b6b99889c27d008c68a373df634,Bram Moolenaar,46,0,46,3,"{""src/testdir/test_vim9_func.vim"": {""insertions"": 24, ""deletions"": 0, ""lines"": 24}, ""src/version.c"": {""insertions"": 2, ""deletions"": 0, ""lines"": 2}, ""src/vim9execute.c"": {""insertions"": 20, ""deletions"": 0, ""lines"": 20}}"
2021-03-06 17:18:19,a974953443775dd938cf9a8c195e3de9e4514f4f,Bram Moolenaar,14,1,15,3,"{""src/eval.c"": {""insertions"": 1, ""deletions"": 1, ""lines"": 2}, ""src/testdir/test_vim9_expr.vim"": {""insertions"": 11, ""deletions"": 0, ""lines"": 11}, ""src/version.c"": {""insertions"": 2, ""deletions"": 0, ""lines"": 2}}"
