date,hexsha,author,insertions,deletions,lines,files,files_json
2021-02-14 13:07:34,2379f87eb48a4ee6a1d0fc7df964e12a3efe4fd5,Bram Moolenaar,4,0,4,2,"{""src/ex_docmd.c"": {""insertions"": 2, ""deletions"": 0, ""lines"": 2}, ""src/version.c"": {""insertions"": 2, ""deletions"": 0, ""lines"": 2}}"
2021-02-14 12:30:01,9979fcd72ed671ec2c98800587c3a6996adb27d4,Bram Moolenaar,4,1,5,2,"{""src/version.c"": {""insertions"": 2, ""deletions"": 0, ""lines"": 2}, ""src/vim9script.c"": {""insertions"": 2, ""deletions"": 1, ""lines"": 3}}"
2021-02-14 12:17:22,03dfde2b5f81f06639ec8697cdd32ad50d8509fd,Bram Moolenaar,9,13,22,4,"{""src/testdir/term_util.vim"": {""insertions"": 4, ""deletions"": 0, ""lines"": 4}, ""src/testdir/test_vim9_func.vim"": {""insertions"": 2, ""deletions"": 12, ""lines"": 14}, ""src/testdir/test_vim9_script.vim"": {""insertions"": 1, ""deletions"": 1, ""lines"": 2}, ""src/version.c"": {""insertions"": 2, ""deletions"": 0, ""lines"": 2}}"
2021-02-14 11:57:36,39f3b1411068ff187b4f9f482b2d6b2c1e7a7268,Bram Moolenaar,56,18,74,15,"{""runtime/doc/repeat.txt"": {""insertions"": 3, ""deletions"": 1, ""lines"": 4}, ""runtime/doc/vim9.txt"": {""insertions"": 7, ""deletions"": 0, ""lines"": 7}, ""src/errors.h"": {""insertions"": 2, ""deletions"": 0, ""lines"": 2}, ""src/ex_cmdidxs.h"": {""insertions"": 6, ""deletions"": 6, ""lines"": 12}, ""src/ex_cmds.h"": {""insertions"": 3, ""deletions"": 0, ""lines"": 3}, ""src/ex_docmd.c"": {""insertions"": 13, ""deletions"": 2, ""lines"": 15}, ""src/structs.h"": {""insertions"": 1, ""deletions"": 0, ""lines"": 1}, ""src/testdir/dumps/Test_wildmenu_1.dump"": {""insertions"": 2, ""deletions"": 2, ""lines"": 4}, ""src/testdir/dumps/Test_wildmenu_2.dump"": {""insertions"": 2, ""deletions"": 2, ""lines"": 4}, ""src/testdir/dumps/Test_wildmenu_3.dump"": {""insertions"": 2, ""deletions"": 2, ""lines"": 4}, ""src/testdir/dumps/Test_wildmenu_4.dump"": {""insertions"": 1, ""deletions"": 1, ""lines"": 2}, ""src/testdir/test_cmdline.vim"": {""insertions"": 1, ""deletions"": 1, ""lines"": 2}, ""src/testdir/test_quickfix.vim"": {""insertions"": 1, ""deletions"": 1, ""lines"": 2}, ""src/testdir/test_vim9_cmd.vim"": {""insertions"": 10, ""deletions"": 0, ""lines"": 10}, ""src/version.c"": {""insertions"": 2, ""deletions"": 0, ""lines"": 2}}"
2021-02-13 20:31:18,10ccfb2a17e736ace054b19dc712544b4e961671,Bram Moolenaar,26,1,27,3,"{""src/popupwin.c"": {""insertions"": 5, ""deletions"": 1, ""lines"": 6}, ""src/testdir/test_popupwin.vim"": {""insertions"": 19, ""deletions"": 0, ""lines"": 19}, ""src/version.c"": {""insertions"": 2, ""deletions"": 0, ""lines"": 2}}"
2021-02-13 17:33:02,8d4be8901139f698c7919fd697d82abb1ce41911,Bram Moolenaar,4,3,7,2,"{""src/version.c"": {""insertions"": 2, ""deletions"": 0, ""lines"": 2}, ""src/vim9execute.c"": {""insertions"": 2, ""deletions"": 3, ""lines"": 5}}"
2021-02-13 17:24:23,a98f8a230596d8fb44cc68321de72980a21428cb,Bram Moolenaar,41,10,51,9,"{""runtime/doc/options.txt"": {""insertions"": 3, ""deletions"": 1, ""lines"": 4}, ""runtime/doc/todo.txt"": {""insertions"": 0, ""deletions"": 2, ""lines"": 2}, ""runtime/doc/windows.txt"": {""insertions"": 6, ""deletions"": 4, ""lines"": 10}, ""src/drawscreen.c"": {""insertions"": 2, ""deletions"": 2, ""lines"": 4}, ""src/globals.h"": {""insertions"": 1, ""deletions"": 0, ""lines"": 1}, ""src/optiondefs.h"": {""insertions"": 1, ""deletions"": 1, ""lines"": 2}, ""src/screen.c"": {""insertions"": 4, ""deletions"": 0, ""lines"": 4}, ""src/testdir/test_display.vim"": {""insertions"": 22, ""deletions"": 0, ""lines"": 22}, ""src/version.c"": {""insertions"": 2, ""deletions"": 0, ""lines"": 2}}"
2021-02-13 17:14:48,942db23c9cb7532d68048530d749eb84ca94d0cd,Bram Moolenaar,312,218,530,33,"{""runtime/autoload/clojurecomplete.vim"": {""insertions"": 9, ""deletions"": 8, ""lines"": 17}, ""runtime/autoload/phpcomplete.vim"": {""insertions"": 38, ""deletions"": 55, ""lines"": 93}, ""runtime/doc/diff.txt"": {""insertions"": 1, ""deletions"": 1, ""lines"": 2}, ""runtime/doc/eval.txt"": {""insertions"": 5, ""deletions"": 1, ""lines"": 6}, ""runtime/doc/indent.txt"": {""insertions"": 4, ""deletions"": 4, ""lines"": 8}, ""runtime/doc/index.txt"": {""insertions"": 2, ""deletions"": 1, ""lines"": 3}, ""runtime/doc/options.txt"": {""insertions"": 14, ""deletions"": 8, ""lines"": 22}, ""runtime/doc/popup.txt"": {""insertions"": 3, ""deletions"": 2, ""lines"": 5}, ""runtime/doc/quickfix.txt"": {""insertions"": 7, ""deletions"": 1, ""lines"": 8}, ""runtime/doc/starting.txt"": {""insertions"": 12, ""deletions"": 4, ""lines"": 16}, ""runtime/doc/tags"": {""insertions"": 6, ""deletions"": 0, ""lines"": 6}, ""runtime/doc/terminal.txt"": {""insertions"": 24, ""deletions"": 5, ""lines"": 29}, ""runtime/doc/todo.txt"": {""insertions"": 24, ""deletions"": 32, ""lines"": 56}, ""runtime/doc/usr_41.txt"": {""insertions"": 1, ""deletions"": 1, ""lines"": 2}, ""runtime/doc/version6.txt"": {""insertions"": 1, ""deletions"": 1, ""lines"": 2}, ""runtime/doc/vim9.txt"": {""insertions"": 1, ""deletions"": 1, ""lines"": 2}, ""runtime/doc/windows.txt"": {""insertions"": 4, ""deletions"": 2, ""lines"": 6}, ""runtime/ftplugin/clojure.vim"": {""insertions"": 8, ""deletions"": 23, ""lines"": 31}, ""runtime/ftplugin/vim.vim"": {""insertions"": 2, ""deletions"": 2, ""lines"": 4}, ""runtime/indent/clojure.vim"": {""insertions"": 55, ""deletions"": 19, ""lines"": 74}, ""runtime/indent/html.vim"": {""insertions"": 4, ""deletions"": 4, ""lines"": 8}, ""runtime/indent/ruby.vim"": {""insertions"": 15, ""deletions"": 6, ""lines"": 21}, ""runtime/indent/testdir/html.ok"": {""insertions"": 1, ""deletions"": 1, ""lines"": 2}, ""runtime/indent/testdir/vim.in"": {""insertions"": 15, ""deletions"": 0, ""lines"": 15}, ""runtime/indent/testdir/vim.ok"": {""insertions"": 15, ""deletions"": 0, ""lines"": 15}, ""runtime/indent/vim.vim"": {""insertions"": 11, ""deletions"": 5, ""lines"": 16}, ""runtime/scripts.vim"": {""insertions"": 1, ""deletions"": 1, ""lines"": 2}, ""runtime/syntax/clojure.vim"": {""insertions"": 21, ""deletions"": 23, ""lines"": 44}, ""runtime/syntax/groovy.vim"": {""insertions"": 4, ""deletions"": 3, ""lines"": 7}, ""runtime/syntax/messages.vim"": {""insertions"": 2, ""deletions"": 1, ""lines"": 3}, ""src/po/cs.cp1250.po"": {""insertions"": 1, ""deletions"": 1, ""lines"": 2}, ""src/po/cs.po"": {""insertions"": 1, ""deletions"": 1, ""lines"": 2}, ""src/po/lv.po"": {""insertions"": 0, ""deletions"": 1, ""lines"": 1}}"
2021-02-13 16:08:33,0fa09676c25a0a4a01f339887b8bf40b4673621f,Bram Moolenaar,6,4,10,2,"{"".github/workflows/ci.yml"": {""insertions"": 4, ""deletions"": 4, ""lines"": 8}, ""src/version.c"": {""insertions"": 2, ""deletions"": 0, ""lines"": 2}}"
2021-02-13 14:02:46,c150c09ec4f97636c6339f5687fdaa9f665095d2,Bram Moolenaar,190,19,209,6,"{""src/testdir/test_vim9_disassemble.vim"": {""insertions"": 57, ""deletions"": 0, ""lines"": 57}, ""src/testdir/test_vim9_script.vim"": {""insertions"": 17, ""deletions"": 0, ""lines"": 17}, ""src/version.c"": {""insertions"": 2, ""deletions"": 0, ""lines"": 2}, ""src/vim9.h"": {""insertions"": 9, ""deletions"": 1, ""lines"": 10}, ""src/vim9compile.c"": {""insertions"": 54, ""deletions"": 14, ""lines"": 68}, ""src/vim9execute.c"": {""insertions"": 51, ""deletions"": 4, ""lines"": 55}}"
2021-02-12 21:10:21,31842cd0772b557eb9584a13740430db29de8a51,Bram Moolenaar,24,0,24,3,"{""src/testdir/test_vim9_func.vim"": {""insertions"": 15, ""deletions"": 0, ""lines"": 15}, ""src/userfunc.c"": {""insertions"": 7, ""deletions"": 0, ""lines"": 7}, ""src/version.c"": {""insertions"": 2, ""deletions"": 0, ""lines"": 2}}"
2021-02-12 20:50:57,44ec21c467ddf481b422c787324ea08f375f6942,Bram Moolenaar,16,1,17,3,"{""src/testdir/test_vim9_func.vim"": {""insertions"": 12, ""deletions"": 0, ""lines"": 12}, ""src/version.c"": {""insertions"": 2, ""deletions"": 0, ""lines"": 2}, ""src/vim9compile.c"": {""insertions"": 2, ""deletions"": 1, ""lines"": 3}}"
2021-02-12 20:32:47,d9d7789b6fe5f2b4074375ee9f1c0bad3e4d3cfe,Bram Moolenaar,21,1,22,3,"{""src/testdir/test_vim9_script.vim"": {""insertions"": 10, ""deletions"": 0, ""lines"": 10}, ""src/version.c"": {""insertions"": 2, ""deletions"": 0, ""lines"": 2}, ""src/vim9execute.c"": {""insertions"": 9, ""deletions"": 1, ""lines"": 10}}"
2021-02-12 18:48:51,ca753ec862f8191f1fc5ed161753704a488ed08d,Bram Moolenaar,4,1,5,2,"{"".github/workflows/ci.yml"": {""insertions"": 2, ""deletions"": 1, ""lines"": 3}, ""src/version.c"": {""insertions"": 2, ""deletions"": 0, ""lines"": 2}}"
2021-02-11 20:19:34,f785aa1354208f6b644e891aa01f8f86d947af7e,Bram Moolenaar,146,59,205,16,"{""src/dict.c"": {""insertions"": 2, ""deletions"": 1, ""lines"": 3}, ""src/errors.h"": {""insertions"": 2, ""deletions"": 0, ""lines"": 2}, ""src/eval.c"": {""insertions"": 7, ""deletions"": 5, ""lines"": 12}, ""src/evalvars.c"": {""insertions"": 22, ""deletions"": 12, ""lines"": 34}, ""src/list.c"": {""insertions"": 11, ""deletions"": 9, ""lines"": 20}, ""src/proto/eval.pro"": {""insertions"": 1, ""deletions"": 1, ""lines"": 2}, ""src/proto/evalvars.pro"": {""insertions"": 1, ""deletions"": 1, ""lines"": 2}, ""src/proto/vim9script.pro"": {""insertions"": 1, ""deletions"": 1, ""lines"": 2}, ""src/proto/vim9type.pro"": {""insertions"": 5, ""deletions"": 3, ""lines"": 8}, ""src/structs.h"": {""insertions"": 7, ""deletions"": 0, ""lines"": 7}, ""src/testdir/test_vim9_assign.vim"": {""insertions"": 8, ""deletions"": 0, ""lines"": 8}, ""src/version.c"": {""insertions"": 2, ""deletions"": 0, ""lines"": 2}, ""src/vim9compile.c"": {""insertions"": 13, ""deletions"": 3, ""lines"": 16}, ""src/vim9execute.c"": {""insertions"": 19, ""deletions"": 5, ""lines"": 24}, ""src/vim9script.c"": {""insertions"": 8, ""deletions"": 4, ""lines"": 12}, ""src/vim9type.c"": {""insertions"": 37, ""deletions"": 14, ""lines"": 51}}"
2021-02-11 18:18:58,0bcadf14aa700c166c09f1800ed3de00b9598b39,Bram Moolenaar,4,0,4,2,"{""src/main.c"": {""insertions"": 2, ""deletions"": 0, ""lines"": 2}, ""src/version.c"": {""insertions"": 2, ""deletions"": 0, ""lines"": 2}}"
2021-02-11 18:08:05,3b678047bcd50d6f409175dcffe7839dbb74728b,Bram Moolenaar,17,0,17,3,"{""src/main.c"": {""insertions"": 1, ""deletions"": 0, ""lines"": 1}, ""src/testdir/test_version.vim"": {""insertions"": 14, ""deletions"": 0, ""lines"": 14}, ""src/version.c"": {""insertions"": 2, ""deletions"": 0, ""lines"": 2}}"
2021-02-11 17:36:30,5affc034680a95eabfbfca763bedf86ae0a79c44,Bram Moolenaar,3,0,3,2,"{""src/testdir/test_viminfo.vim"": {""insertions"": 1, ""deletions"": 0, ""lines"": 1}, ""src/version.c"": {""insertions"": 2, ""deletions"": 0, ""lines"": 2}}"
2021-02-10 21:23:41,418a29f0ffcaa0a3d778724ab6d1111db525d3cc,Bram Moolenaar,46,3,49,5,"{""src/errors.h"": {""insertions"": 2, ""deletions"": 0, ""lines"": 2}, ""src/evalfunc.c"": {""insertions"": 23, ""deletions"": 2, ""lines"": 25}, ""src/testdir/test_vim9_builtin.vim"": {""insertions"": 16, ""deletions"": 0, ""lines"": 16}, ""src/typval.c"": {""insertions"": 3, ""deletions"": 1, ""lines"": 4}, ""src/version.c"": {""insertions"": 2, ""deletions"": 0, ""lines"": 2}}"
2021-02-10 20:20:30,5202929dab58402a5f3cd9c231e09abb5c451c56,Bram Moolenaar,10,3,13,2,"{""src/testdir/test_breakindent.vim"": {""insertions"": 8, ""deletions"": 3, ""lines"": 11}, ""src/version.c"": {""insertions"": 2, ""deletions"": 0, ""lines"": 2}}"
2021-02-10 20:10:12,8f33ebfade10cd1b4296d8ec8dca815a09e8a405,Bram Moolenaar,5,3,8,3,"{""src/move.c"": {""insertions"": 2, ""deletions"": 2, ""lines"": 4}, ""src/testdir/test_breakindent.vim"": {""insertions"": 1, ""deletions"": 1, ""lines"": 2}, ""src/version.c"": {""insertions"": 2, ""deletions"": 0, ""lines"": 2}}"
2021-02-10 18:22:15,3ff656f6b43465083b58e1d2fb9b8008abc5bc17,Bram Moolenaar,14,9,23,3,"{""src/version.c"": {""insertions"": 2, ""deletions"": 0, ""lines"": 2}, ""src/vim.h"": {""insertions"": 5, ""deletions"": 4, ""lines"": 9}, ""src/viminfo.c"": {""insertions"": 7, ""deletions"": 5, ""lines"": 12}}"
2021-02-10 16:20:28,f3fa18468c0adc4fa645f7c394d7a6d14d3d4352,Bram Moolenaar,44,1,45,5,"{""src/drawline.c"": {""insertions"": 6, ""deletions"": 1, ""lines"": 7}, ""src/testdir/dumps/Test_textprop_nowrap_01.dump"": {""insertions"": 6, ""deletions"": 0, ""lines"": 6}, ""src/testdir/dumps/Test_textprop_nowrap_02.dump"": {""insertions"": 6, ""deletions"": 0, ""lines"": 6}, ""src/testdir/test_textprop.vim"": {""insertions"": 24, ""deletions"": 0, ""lines"": 24}, ""src/version.c"": {""insertions"": 2, ""deletions"": 0, ""lines"": 2}}"
2021-02-10 15:45:24,b17ec4d427f9009eff5dbc3184b26d68b0163edb,Bram Moolenaar,3,1,4,2,"{""src/ex_getln.c"": {""insertions"": 1, ""deletions"": 1, ""lines"": 2}, ""src/version.c"": {""insertions"": 2, ""deletions"": 0, ""lines"": 2}}"
2021-02-10 13:56:11,82db31c10470b0e27d7039d15c32ed7e9417cc02,Bram Moolenaar,81,0,81,6,"{""src/popupwin.c"": {""insertions"": 6, ""deletions"": 0, ""lines"": 6}, ""src/testdir/dumps/Test_popup_prop_not_visible_01.dump"": {""insertions"": 10, ""deletions"": 0, ""lines"": 10}, ""src/testdir/dumps/Test_popup_prop_not_visible_02.dump"": {""insertions"": 10, ""deletions"": 0, ""lines"": 10}, ""src/testdir/dumps/Test_popup_prop_not_visible_03.dump"": {""insertions"": 10, ""deletions"": 0, ""lines"": 10}, ""src/testdir/test_popupwin.vim"": {""insertions"": 43, ""deletions"": 0, ""lines"": 43}, ""src/version.c"": {""insertions"": 2, ""deletions"": 0, ""lines"": 2}}"
2021-02-10 12:18:17,4223d43c0fb6ead1e611e4469a1680a9228b6015,Bram Moolenaar,38,7,45,5,"{""runtime/doc/diff.txt"": {""insertions"": 2, ""deletions"": 2, ""lines"": 4}, ""runtime/doc/options.txt"": {""insertions"": 2, ""deletions"": 0, ""lines"": 2}, ""src/diff.c"": {""insertions"": 17, ""deletions"": 5, ""lines"": 22}, ""src/testdir/test_diffmode.vim"": {""insertions"": 15, ""deletions"": 0, ""lines"": 15}, ""src/version.c"": {""insertions"": 2, ""deletions"": 0, ""lines"": 2}}"
2021-02-09 19:02:55,963ffa0a5a6091655ed72b4590ec5d5a1653bce8,Bram Moolenaar,30,16,46,3,"{""src/evalbuffer.c"": {""insertions"": 17, ""deletions"": 16, ""lines"": 33}, ""src/testdir/test_bufline.vim"": {""insertions"": 11, ""deletions"": 0, ""lines"": 11}, ""src/version.c"": {""insertions"": 2, ""deletions"": 0, ""lines"": 2}}"
2021-02-08 20:53:09,a853089479b60b829bab1c4a0a737a073415f8a7,Bram Moolenaar,9,6,15,4,"{""src/errors.h"": {""insertions"": 2, ""deletions"": 0, ""lines"": 2}, ""src/json.c"": {""insertions"": 1, ""deletions"": 2, ""lines"": 3}, ""src/testdir/test_json.vim"": {""insertions"": 4, ""deletions"": 4, ""lines"": 8}, ""src/version.c"": {""insertions"": 2, ""deletions"": 0, ""lines"": 2}}"
2021-02-08 20:29:48,4549dad874244fe933b969e4ac0b41923ee70dc3,Bram Moolenaar,43,6,49,4,"{""src/libvterm/src/state.c"": {""insertions"": 2, ""deletions"": 1, ""lines"": 3}, ""src/testdir/dumps/Test_terminal_combining.dump"": {""insertions"": 9, ""deletions"": 0, ""lines"": 9}, ""src/testdir/test_terminal.vim"": {""insertions"": 30, ""deletions"": 5, ""lines"": 35}, ""src/version.c"": {""insertions"": 2, ""deletions"": 0, ""lines"": 2}}"
2021-02-07 17:06:29,ba98fb54aefada4c36390add4c7dd90b93e7e5bb,Bram Moolenaar,18,14,32,7,"{""src/dict.c"": {""insertions"": 2, ""deletions"": 2, ""lines"": 4}, ""src/errors.h"": {""insertions"": 2, ""deletions"": 2, ""lines"": 4}, ""src/list.c"": {""insertions"": 2, ""deletions"": 1, ""lines"": 3}, ""src/userfunc.c"": {""insertions"": 2, ""deletions"": 2, ""lines"": 4}, ""src/version.c"": {""insertions"": 2, ""deletions"": 0, ""lines"": 2}, ""src/vim9compile.c"": {""insertions"": 5, ""deletions"": 5, ""lines"": 10}, ""src/vim9type.c"": {""insertions"": 3, ""deletions"": 2, ""lines"": 5}}"
2021-02-07 16:17:58,0123cc1e1422003704cc6941916dd75e61fb7976,Bram Moolenaar,20,2,22,3,"{""src/scriptfile.c"": {""insertions"": 4, ""deletions"": 1, ""lines"": 5}, ""src/testdir/test_vim9_script.vim"": {""insertions"": 14, ""deletions"": 1, ""lines"": 15}, ""src/version.c"": {""insertions"": 2, ""deletions"": 0, ""lines"": 2}}"
2021-02-07 15:40:05,dee37dc733df444df1950eb922a35560e4b113d6,Bram Moolenaar,7,2,9,3,"{""src/ex_docmd.c"": {""insertions"": 1, ""deletions"": 2, ""lines"": 3}, ""src/testdir/test_vim9_script.vim"": {""insertions"": 4, ""deletions"": 0, ""lines"": 4}, ""src/version.c"": {""insertions"": 2, ""deletions"": 0, ""lines"": 2}}"
2021-02-07 15:33:35,6628b7ebff1cfcb476ce96852a7d2b095872826c,Bram Moolenaar,39,0,39,3,"{""src/testdir/test_vim9_script.vim"": {""insertions"": 22, ""deletions"": 0, ""lines"": 22}, ""src/version.c"": {""insertions"": 2, ""deletions"": 0, ""lines"": 2}, ""src/vim9compile.c"": {""insertions"": 15, ""deletions"": 0, ""lines"": 15}}"
2021-02-07 15:05:47,a5a1ec1826c0e43d0282ba4d35c155a97bab3e27,Bram Moolenaar,4,0,4,2,"{""src/errors.h"": {""insertions"": 2, ""deletions"": 0, ""lines"": 2}, ""src/version.c"": {""insertions"": 2, ""deletions"": 0, ""lines"": 2}}"
2021-02-07 14:59:49,4f53b79bf5f8b0de7c6933fd157894ba7a53f35e,Bram Moolenaar,17,0,17,3,"{""src/testdir/test_vim9_func.vim"": {""insertions"": 10, ""deletions"": 0, ""lines"": 10}, ""src/userfunc.c"": {""insertions"": 5, ""deletions"": 0, ""lines"": 5}, ""src/version.c"": {""insertions"": 2, ""deletions"": 0, ""lines"": 2}}"
2021-02-07 14:28:09,c3fc75db023f2acd0b82b7eebffd7ed89e8001ed,Bram Moolenaar,22,18,40,8,"{""src/dict.c"": {""insertions"": 2, ""deletions"": 2, ""lines"": 4}, ""src/errors.h"": {""insertions"": 2, ""deletions"": 2, ""lines"": 4}, ""src/list.c"": {""insertions"": 1, ""deletions"": 1, ""lines"": 2}, ""src/userfunc.c"": {""insertions"": 4, ""deletions"": 4, ""lines"": 8}, ""src/version.c"": {""insertions"": 2, ""deletions"": 0, ""lines"": 2}, ""src/vim9compile.c"": {""insertions"": 6, ""deletions"": 6, ""lines"": 12}, ""src/vim9script.c"": {""insertions"": 1, ""deletions"": 1, ""lines"": 2}, ""src/vim9type.c"": {""insertions"": 4, ""deletions"": 2, ""lines"": 6}}"
2021-02-07 13:31:06,00385114dbd6a3d59516baa02e1ea86a1e7ee70e,Bram Moolenaar,16,10,26,3,"{""src/testdir/test_bufline.vim"": {""insertions"": 7, ""deletions"": 5, ""lines"": 12}, ""src/testdir/test_vim9_builtin.vim"": {""insertions"": 7, ""deletions"": 5, ""lines"": 12}, ""src/version.c"": {""insertions"": 2, ""deletions"": 0, ""lines"": 2}}"
2021-02-07 13:01:35,0dc5f603e9b86da9fe5798c231d8d6170501516e,Bram Moolenaar,6,1,7,2,"{""src/filepath.c"": {""insertions"": 4, ""deletions"": 1, ""lines"": 5}, ""src/version.c"": {""insertions"": 2, ""deletions"": 0, ""lines"": 2}}"
2021-02-07 12:32:46,dd07c02232e91ee963b91a4477179d4b9548b862,Bram Moolenaar,9,1,10,2,"{""src/testdir/test_autocmd.vim"": {""insertions"": 7, ""deletions"": 1, ""lines"": 8}, ""src/version.c"": {""insertions"": 2, ""deletions"": 0, ""lines"": 2}}"
2021-02-07 11:12:43,983d83ff1cd796ff321074335fa53fbe7ac45a46,Bram Moolenaar,26,11,37,7,"{""src/buffer.c"": {""insertions"": 8, ""deletions"": 2, ""lines"": 10}, ""src/errors.h"": {""insertions"": 2, ""deletions"": 0, ""lines"": 2}, ""src/popupwin.c"": {""insertions"": 1, ""deletions"": 1, ""lines"": 2}, ""src/structs.h"": {""insertions"": 2, ""deletions"": 0, ""lines"": 2}, ""src/testdir/test_autocmd.vim"": {""insertions"": 3, ""deletions"": 6, ""lines"": 9}, ""src/version.c"": {""insertions"": 2, ""deletions"": 0, ""lines"": 2}, ""src/window.c"": {""insertions"": 8, ""deletions"": 2, ""lines"": 10}}"
2021-02-06 18:28:48,dfc3db76b9de217542cc9258301c1b4818a51cd0,Bram Moolenaar,5,0,5,2,"{""src/testdir/test_autocmd.vim"": {""insertions"": 3, ""deletions"": 0, ""lines"": 3}, ""src/version.c"": {""insertions"": 2, ""deletions"": 0, ""lines"": 2}}"
2021-02-06 18:19:42,2c7080bf1ceef4a7779644fd428b2386a0676794,Bram Moolenaar,18,0,18,3,"{""src/quickfix.c"": {""insertions"": 2, ""deletions"": 0, ""lines"": 2}, ""src/testdir/test_autocmd.vim"": {""insertions"": 14, ""deletions"": 0, ""lines"": 14}, ""src/version.c"": {""insertions"": 2, ""deletions"": 0, ""lines"": 2}}"
2021-02-06 17:08:45,8c6951fa2836a1ae3257770e7b927a9380439912,Bram Moolenaar,14,3,17,3,"{""src/ex_getln.c"": {""insertions"": 3, ""deletions"": 3, ""lines"": 6}, ""src/testdir/test_autocmd.vim"": {""insertions"": 9, ""deletions"": 0, ""lines"": 9}, ""src/version.c"": {""insertions"": 2, ""deletions"": 0, ""lines"": 2}}"
2021-02-06 16:30:31,aad5f9d79a2b71e9d2581eace3652be156102b9d,Bram Moolenaar,27,5,32,3,"{""src/ex_cmds.c"": {""insertions"": 8, ""deletions"": 3, ""lines"": 11}, ""src/testdir/test_autocmd.vim"": {""insertions"": 17, ""deletions"": 2, ""lines"": 19}, ""src/version.c"": {""insertions"": 2, ""deletions"": 0, ""lines"": 2}}"
2021-02-06 13:59:27,efa1923565f0669d5bc09714b22a3b50cde03785,Bram Moolenaar,22,1,23,3,"{""src/popupwin.c"": {""insertions"": 1, ""deletions"": 1, ""lines"": 2}, ""src/testdir/test_popupwin.vim"": {""insertions"": 19, ""deletions"": 0, ""lines"": 19}, ""src/version.c"": {""insertions"": 2, ""deletions"": 0, ""lines"": 2}}"
2021-02-06 13:22:32,650264367725af6740b94cfd24d9f5caf0e91356,Bram Moolenaar,17,1,18,3,"{""src/popupwin.c"": {""insertions"": 1, ""deletions"": 1, ""lines"": 2}, ""src/testdir/test_popupwin.vim"": {""insertions"": 14, ""deletions"": 0, ""lines"": 14}, ""src/version.c"": {""insertions"": 2, ""deletions"": 0, ""lines"": 2}}"
2021-02-06 11:58:18,f5a5116a96b1877c3f44e7bae288fd6603151eb1,Bram Moolenaar,10,0,10,3,"{""src/ex_docmd.c"": {""insertions"": 5, ""deletions"": 0, ""lines"": 5}, ""src/testdir/test_excmd.vim"": {""insertions"": 3, ""deletions"": 0, ""lines"": 3}, ""src/version.c"": {""insertions"": 2, ""deletions"": 0, ""lines"": 2}}"
2021-02-06 11:38:51,038e09ee7645731de0296d255aabb17603276443,Bram Moolenaar,86,0,86,7,"{""runtime/doc/eval.txt"": {""insertions"": 16, ""deletions"": 0, ""lines"": 16}, ""runtime/doc/usr_41.txt"": {""insertions"": 1, ""deletions"": 0, ""lines"": 1}, ""src/evalfunc.c"": {""insertions"": 2, ""deletions"": 0, ""lines"": 2}, ""src/ex_docmd.c"": {""insertions"": 27, ""deletions"": 0, ""lines"": 27}, ""src/proto/evalfunc.pro"": {""insertions"": 1, ""deletions"": 0, ""lines"": 1}, ""src/testdir/test_cmdline.vim"": {""insertions"": 37, ""deletions"": 0, ""lines"": 37}, ""src/version.c"": {""insertions"": 2, ""deletions"": 0, ""lines"": 2}}"
2021-02-05 20:55:53,139348f3e8370826a1ceb10c73f7c7bb586f8125,Bram Moolenaar,18,1,19,3,"{""src/session.c"": {""insertions"": 2, ""deletions"": 1, ""lines"": 3}, ""src/testdir/test_mksession.vim"": {""insertions"": 14, ""deletions"": 0, ""lines"": 14}, ""src/version.c"": {""insertions"": 2, ""deletions"": 0, ""lines"": 2}}"
2021-02-04 21:07:16,ab65fc77c5389f7d3f788bbdc3d931561feab131,Bram Moolenaar,18,1,19,3,"{""src/evalfunc.c"": {""insertions"": 8, ""deletions"": 1, ""lines"": 9}, ""src/testdir/test_functions.vim"": {""insertions"": 8, ""deletions"": 0, ""lines"": 8}, ""src/version.c"": {""insertions"": 2, ""deletions"": 0, ""lines"": 2}}"
2021-02-03 22:04:46,92bb83e41ca42d0d00d21753810d92485c808a50,Bram Moolenaar,29,3,32,3,"{""src/search.c"": {""insertions"": 2, ""deletions"": 0, ""lines"": 2}, ""src/testdir/test_autocmd.vim"": {""insertions"": 25, ""deletions"": 3, ""lines"": 28}, ""src/version.c"": {""insertions"": 2, ""deletions"": 0, ""lines"": 2}}"
2021-02-03 20:56:59,8ab375706e6712308f8cf7529bcae56684a6f385,Bram Moolenaar,16,1,17,3,"{""src/ex_cmds.c"": {""insertions"": 3, ""deletions"": 1, ""lines"": 4}, ""src/testdir/test_autocmd.vim"": {""insertions"": 11, ""deletions"": 0, ""lines"": 11}, ""src/version.c"": {""insertions"": 2, ""deletions"": 0, ""lines"": 2}}"
2021-02-03 20:23:29,6bcb877ec19a647443195a54eeac60cb693fd827,Bram Moolenaar,15,0,15,3,"{""src/arglist.c"": {""insertions"": 4, ""deletions"": 0, ""lines"": 4}, ""src/testdir/test_autocmd.vim"": {""insertions"": 9, ""deletions"": 0, ""lines"": 9}, ""src/version.c"": {""insertions"": 2, ""deletions"": 0, ""lines"": 2}}"
2021-02-03 19:14:23,2c363a2e95ee0b366e72063d093d20e025ef4a66,Bram Moolenaar,7,1,8,2,"{""src/spellfile.c"": {""insertions"": 5, ""deletions"": 1, ""lines"": 6}, ""src/version.c"": {""insertions"": 2, ""deletions"": 0, ""lines"": 2}}"
2021-02-03 19:01:19,fef8064b54ad0b1a7ce2f9cf024526627e6bdf57,Bram Moolenaar,4,2,6,2,"{""src/version.c"": {""insertions"": 2, ""deletions"": 0, ""lines"": 2}, ""src/vim9execute.c"": {""insertions"": 2, ""deletions"": 2, ""lines"": 4}}"
2021-02-03 18:57:00,fc1dafa91cbf7876d711e8e36171eeec78eae13b,Bram Moolenaar,2,1,3,2,"{""src/version.c"": {""insertions"": 2, ""deletions"": 0, ""lines"": 2}, ""src/vim9compile.c"": {""insertions"": 0, ""deletions"": 1, ""lines"": 1}}"
2021-02-03 18:51:18,8bead9a058907e7f10ad25893d8475d2d9dd173c,Bram Moolenaar,2,2,4,2,"{""src/eval.c"": {""insertions"": 0, ""deletions"": 2, ""lines"": 2}, ""src/version.c"": {""insertions"": 2, ""deletions"": 0, ""lines"": 2}}"
2021-02-03 18:44:25,0dcd39bad5e5aa70ba8f60cb3fbf0658585f0151,Bram Moolenaar,5,1,6,2,"{""src/indent.c"": {""insertions"": 3, ""deletions"": 1, ""lines"": 4}, ""src/version.c"": {""insertions"": 2, ""deletions"": 0, ""lines"": 2}}"
2021-02-03 18:35:13,4dba04256b8a49b201d685217d3d7abc4988f090,Bram Moolenaar,5,0,5,2,"{""src/if_cscope.c"": {""insertions"": 3, ""deletions"": 0, ""lines"": 3}, ""src/version.c"": {""insertions"": 2, ""deletions"": 0, ""lines"": 2}}"
2021-02-03 18:31:29,7b6903f02c9eeb12cd85941ea0d352d84e4dab30,Bram Moolenaar,5,1,6,2,"{""src/userfunc.c"": {""insertions"": 3, ""deletions"": 1, ""lines"": 4}, ""src/version.c"": {""insertions"": 2, ""deletions"": 0, ""lines"": 2}}"
2021-02-03 16:41:24,2e5910bfbb05957c10c9c69756dfa342557e9a8b,Bram Moolenaar,74,38,112,8,"{""runtime/doc/vim9.txt"": {""insertions"": 6, ""deletions"": 0, ""lines"": 6}, ""src/dict.c"": {""insertions"": 5, ""deletions"": 3, ""lines"": 8}, ""src/eval.c"": {""insertions"": 16, ""deletions"": 4, ""lines"": 20}, ""src/testdir/test_vim9_builtin.vim"": {""insertions"": 5, ""deletions"": 5, ""lines"": 10}, ""src/testdir/test_vim9_expr.vim"": {""insertions"": 27, ""deletions"": 15, ""lines"": 42}, ""src/testdir/test_vim9_script.vim"": {""insertions"": 2, ""deletions"": 2, ""lines"": 4}, ""src/version.c"": {""insertions"": 2, ""deletions"": 0, ""lines"": 2}, ""src/vim9compile.c"": {""insertions"": 11, ""deletions"": 9, ""lines"": 20}}"
2021-02-03 14:58:13,91478ae49a1b2dc1de63821db731a343e855dcc0,Bram Moolenaar,81,8,89,7,"{""runtime/doc/options.txt"": {""insertions"": 4, ""deletions"": 0, ""lines"": 4}, ""src/drawline.c"": {""insertions"": 20, ""deletions"": 3, ""lines"": 23}, ""src/globals.h"": {""insertions"": 1, ""deletions"": 0, ""lines"": 1}, ""src/message.c"": {""insertions"": 24, ""deletions"": 5, ""lines"": 29}, ""src/screen.c"": {""insertions"": 1, ""deletions"": 0, ""lines"": 1}, ""src/testdir/test_listchars.vim"": {""insertions"": 29, ""deletions"": 0, ""lines"": 29}, ""src/version.c"": {""insertions"": 2, ""deletions"": 0, ""lines"": 2}}"
2021-02-02 20:33:52,148be9bc1cca16ce47ad21563f5835682001f9a2,Bram Moolenaar,35,0,35,3,"{""src/ex_docmd.c"": {""insertions"": 10, ""deletions"": 0, ""lines"": 10}, ""src/testdir/test_vim9_cmd.vim"": {""insertions"": 23, ""deletions"": 0, ""lines"": 23}, ""src/version.c"": {""insertions"": 2, ""deletions"": 0, ""lines"": 2}}"
2021-02-02 20:10:01,d5e8c92816f35ea1a9298084238a08f35958baa6,Bram Moolenaar,15,1,16,4,"{""src/option.c"": {""insertions"": 6, ""deletions"": 0, ""lines"": 6}, ""src/optiondefs.h"": {""insertions"": 1, ""deletions"": 1, ""lines"": 2}, ""src/testdir/test_options.vim"": {""insertions"": 6, ""deletions"": 0, ""lines"": 6}, ""src/version.c"": {""insertions"": 2, ""deletions"": 0, ""lines"": 2}}"
2021-02-01 19:50:37,e7bebc495d4014d7bc81f863939c35268cb8e97d,Bram Moolenaar,182,0,182,2,"{""src/os_win32.c"": {""insertions"": 180, ""deletions"": 0, ""lines"": 180}, ""src/version.c"": {""insertions"": 2, ""deletions"": 0, ""lines"": 2}}"
2021-02-01 19:35:01,7781ebe50f6d4daba02be3bd7e6ca08cd459674b,Bram Moolenaar,6,6,12,2,"{""src/bufwrite.c"": {""insertions"": 4, ""deletions"": 6, ""lines"": 10}, ""src/version.c"": {""insertions"": 2, ""deletions"": 0, ""lines"": 2}}"
2021-02-01 19:14:51,3b690069730805a147d45d92eaca4dc838272d1d,Bram Moolenaar,98,14,112,10,"{""runtime/doc/eval.txt"": {""insertions"": 9, ""deletions"": 1, ""lines"": 10}, ""runtime/doc/usr_41.txt"": {""insertions"": 1, ""deletions"": 0, ""lines"": 1}, ""src/errors.h"": {""insertions"": 2, ""deletions"": 0, ""lines"": 2}, ""src/evalfunc.c"": {""insertions"": 2, ""deletions"": 0, ""lines"": 2}, ""src/list.c"": {""insertions"": 49, ""deletions"": 13, ""lines"": 62}, ""src/proto/list.pro"": {""insertions"": 1, ""deletions"": 0, ""lines"": 1}, ""src/testdir/test_flatten.vim"": {""insertions"": 9, ""deletions"": 0, ""lines"": 9}, ""src/testdir/test_vim9_builtin.vim"": {""insertions"": 17, ""deletions"": 0, ""lines"": 17}, ""src/version.c"": {""insertions"": 2, ""deletions"": 0, ""lines"": 2}, ""src/vim9compile.c"": {""insertions"": 6, ""deletions"": 0, ""lines"": 6}}"
2021-02-01 18:31:47,9d20daffc296b9eb901fb14bdd83620ea55d440a,Bram Moolenaar,9,5,14,2,"{""src/if_ruby.c"": {""insertions"": 7, ""deletions"": 5, ""lines"": 12}, ""src/version.c"": {""insertions"": 2, ""deletions"": 0, ""lines"": 2}}"
2021-02-01 18:24:55,f9547eb6ef02e305203b859d2dcfdae930b9d544,Bram Moolenaar,31,2,33,3,"{""src/fold.c"": {""insertions"": 3, ""deletions"": 2, ""lines"": 5}, ""src/testdir/test_mksession.vim"": {""insertions"": 26, ""deletions"": 0, ""lines"": 26}, ""src/version.c"": {""insertions"": 2, ""deletions"": 0, ""lines"": 2}}"
2021-02-01 17:39:47,5daa91162699e4f8b54f9d1caaaab2715038941c,Bram Moolenaar,4,4,8,3,"{""src/optionstr.c"": {""insertions"": 1, ""deletions"": 1, ""lines"": 2}, ""src/testdir/test_options.vim"": {""insertions"": 1, ""deletions"": 3, ""lines"": 4}, ""src/version.c"": {""insertions"": 2, ""deletions"": 0, ""lines"": 2}}"
2021-01-31 21:18:29,0346b799fc228a3b48967ca0747e6b23586dbaa6,Bram Moolenaar,18,1,19,4,"{""src/errors.h"": {""insertions"": 2, ""deletions"": 0, ""lines"": 2}, ""src/testdir/test_vim9_func.vim"": {""insertions"": 7, ""deletions"": 0, ""lines"": 7}, ""src/userfunc.c"": {""insertions"": 7, ""deletions"": 1, ""lines"": 8}, ""src/version.c"": {""insertions"": 2, ""deletions"": 0, ""lines"": 2}}"
2021-01-31 20:47:42,e507ff15d52653dad3054ddc0073708977621c0c,Bram Moolenaar,11,2,13,3,"{""src/testdir/test_vim9_expr.vim"": {""insertions"": 3, ""deletions"": 0, ""lines"": 3}, ""src/version.c"": {""insertions"": 2, ""deletions"": 0, ""lines"": 2}, ""src/vim9compile.c"": {""insertions"": 6, ""deletions"": 2, ""lines"": 8}}"
2021-01-31 19:48:58,80ad3e25697cf759d5af5cd13e8b124c1cd657f5,Bram Moolenaar,16,1,17,3,"{""src/evalfunc.c"": {""insertions"": 2, ""deletions"": 1, ""lines"": 3}, ""src/testdir/test_vim9_builtin.vim"": {""insertions"": 12, ""deletions"": 0, ""lines"": 12}, ""src/version.c"": {""insertions"": 2, ""deletions"": 0, ""lines"": 2}}"
2021-01-31 18:52:50,f272ae12ac064856b710046393d5bf9b1670076d,Bram Moolenaar,22,0,22,3,"{""src/auto/configure"": {""insertions"": 9, ""deletions"": 0, ""lines"": 9}, ""src/configure.ac"": {""insertions"": 11, ""deletions"": 0, ""lines"": 11}, ""src/version.c"": {""insertions"": 2, ""deletions"": 0, ""lines"": 2}}"
2021-01-31 16:48:30,c03f5c677a1fba99d2379550ccf2391eaa43e2ac,Bram Moolenaar,48,25,73,3,"{""src/list.c"": {""insertions"": 26, ""deletions"": 8, ""lines"": 34}, ""src/testdir/test_vim9_builtin.vim"": {""insertions"": 20, ""deletions"": 17, ""lines"": 37}, ""src/version.c"": {""insertions"": 2, ""deletions"": 0, ""lines"": 2}}"
2021-01-31 16:03:52,853886722c051ecaef6d818ce32a822e4f43dc2b,Bram Moolenaar,19,155,174,7,"{""runtime/doc/autocmd.txt"": {""insertions"": 3, ""deletions"": 2, ""lines"": 5}, ""runtime/doc/cmdline.txt"": {""insertions"": 1, ""deletions"": 1, ""lines"": 2}, ""runtime/doc/hangulin.txt"": {""insertions"": 1, ""deletions"": 1, ""lines"": 2}, ""runtime/doc/todo.txt"": {""insertions"": 7, ""deletions"": 147, ""lines"": 154}, ""runtime/doc/various.txt"": {""insertions"": 3, ""deletions"": 2, ""lines"": 5}, ""runtime/doc/version8.txt"": {""insertions"": 2, ""deletions"": 2, ""lines"": 4}, ""src/version.c"": {""insertions"": 2, ""deletions"": 0, ""lines"": 2}}"
2021-01-31 15:45:53,3d2bb8b6f152c0c5056f49bccb350683a9ba2e13,Bram Moolenaar,43,1,44,2,"{""src/INSTALL"": {""insertions"": 41, ""deletions"": 1, ""lines"": 42}, ""src/version.c"": {""insertions"": 2, ""deletions"": 0, ""lines"": 2}}"
2021-01-31 13:46:00,6a12e3342d84a1d754d793ed5019778bd60e7494,Bram Moolenaar,4,2,6,2,"{""src/structs.h"": {""insertions"": 2, ""deletions"": 2, ""lines"": 4}, ""src/version.c"": {""insertions"": 2, ""deletions"": 0, ""lines"": 2}}"
2021-01-31 13:36:06,4d8479b335e92a95b09fdee09309ea0df934cb9e,Bram Moolenaar,4,2,6,3,"{""src/auto/configure"": {""insertions"": 1, ""deletions"": 1, ""lines"": 2}, ""src/configure.ac"": {""insertions"": 1, ""deletions"": 1, ""lines"": 2}, ""src/version.c"": {""insertions"": 2, ""deletions"": 0, ""lines"": 2}}"
2021-01-31 13:04:44,206c2a6e19475ab664ca4cea3df8e42313d3a4c5,Bram Moolenaar,4,1,5,2,"{""src/testdir/test_vim9_script.vim"": {""insertions"": 2, ""deletions"": 1, ""lines"": 3}, ""src/version.c"": {""insertions"": 2, ""deletions"": 0, ""lines"": 2}}"
2021-01-31 12:08:38,3445320839a38b3b0c253513b125da8298ec27d6,Bram Moolenaar,96,20,116,9,"{""runtime/doc/eval.txt"": {""insertions"": 7, ""deletions"": 4, ""lines"": 11}, ""src/debugger.c"": {""insertions"": 6, ""deletions"": 6, ""lines"": 12}, ""src/evalbuffer.c"": {""insertions"": 6, ""deletions"": 3, ""lines"": 9}, ""src/proto/typval.pro"": {""insertions"": 1, ""deletions"": 1, ""lines"": 2}, ""src/testdir/test_bufline.vim"": {""insertions"": 7, ""deletions"": 0, ""lines"": 7}, ""src/testdir/test_vim9_builtin.vim"": {""insertions"": 48, ""deletions"": 0, ""lines"": 48}, ""src/typval.c"": {""insertions"": 18, ""deletions"": 5, ""lines"": 23}, ""src/version.c"": {""insertions"": 2, ""deletions"": 0, ""lines"": 2}, ""src/vim9execute.c"": {""insertions"": 1, ""deletions"": 1, ""lines"": 2}}"
2021-01-30 22:05:11,f2b26bcf8f498fed72759af4aa768fb2aab3118c,Bram Moolenaar,50,2,52,5,"{""src/evalfunc.c"": {""insertions"": 15, ""deletions"": 2, ""lines"": 17}, ""src/proto/typval.pro"": {""insertions"": 2, ""deletions"": 0, ""lines"": 2}, ""src/testdir/test_vim9_builtin.vim"": {""insertions"": 7, ""deletions"": 0, ""lines"": 7}, ""src/typval.c"": {""insertions"": 24, ""deletions"": 0, ""lines"": 24}, ""src/version.c"": {""insertions"": 2, ""deletions"": 0, ""lines"": 2}}"
2021-01-30 20:40:03,b63f3ca66db20f7b135aae706d36be538f91f8cc,Bram Moolenaar,12,0,12,3,"{""src/ex_cmds.c"": {""insertions"": 9, ""deletions"": 0, ""lines"": 9}, ""src/testdir/test_cmdline.vim"": {""insertions"": 1, ""deletions"": 0, ""lines"": 1}, ""src/version.c"": {""insertions"": 2, ""deletions"": 0, ""lines"": 2}}"
2021-01-30 19:35:28,76ab5446d530a1c81ead0ee42cb55b4a4d515bad,Bram Moolenaar,6,1,7,2,"{""src/Makefile"": {""insertions"": 4, ""deletions"": 1, ""lines"": 5}, ""src/version.c"": {""insertions"": 2, ""deletions"": 0, ""lines"": 2}}"
2021-01-30 18:33:36,ebd211c8a39871c88189c8cda9e624eb30b300b3,Bram Moolenaar,6,3,9,3,"{""src/auto/configure"": {""insertions"": 2, ""deletions"": 2, ""lines"": 4}, ""src/configure.ac"": {""insertions"": 2, ""deletions"": 1, ""lines"": 3}, ""src/version.c"": {""insertions"": 2, ""deletions"": 0, ""lines"": 2}}"
2021-01-30 17:09:06,f8c6a1718007432812184c28495e8d27ee6c0395,Bram Moolenaar,12,3,15,4,"{""src/arglist.c"": {""insertions"": 2, ""deletions"": 2, ""lines"": 4}, ""src/quickfix.c"": {""insertions"": 1, ""deletions"": 1, ""lines"": 2}, ""src/testdir/test_quickfix.vim"": {""insertions"": 7, ""deletions"": 0, ""lines"": 7}, ""src/version.c"": {""insertions"": 2, ""deletions"": 0, ""lines"": 2}}"
2021-01-30 16:16:28,59ff64079b4fcf0393a7413e3242a8b58c2ceadb,Bram Moolenaar,55,11,66,3,"{""src/memline.c"": {""insertions"": 23, ""deletions"": 11, ""lines"": 34}, ""src/testdir/test_textprop.vim"": {""insertions"": 30, ""deletions"": 0, ""lines"": 30}, ""src/version.c"": {""insertions"": 2, ""deletions"": 0, ""lines"": 2}}"
2021-01-30 14:39:47,92e5df804719d2e6cb8145c2b098aa8d6f3dd252,Bram Moolenaar,57,5,62,3,"{""src/term.c"": {""insertions"": 26, ""deletions"": 4, ""lines"": 30}, ""src/testdir/test_termcodes.vim"": {""insertions"": 29, ""deletions"": 1, ""lines"": 30}, ""src/version.c"": {""insertions"": 2, ""deletions"": 0, ""lines"": 2}}"
2021-01-29 20:47:24,3eb6bd9c2b36dcce471bfb543c8d5488f1dc17a4,Bram Moolenaar,7,24,31,4,"{""src/insexpand.c"": {""insertions"": 2, ""deletions"": 19, ""lines"": 21}, ""src/testdir/test_ins_complete.vim"": {""insertions"": 1, ""deletions"": 1, ""lines"": 2}, ""src/testdir/test_popup.vim"": {""insertions"": 2, ""deletions"": 4, ""lines"": 6}, ""src/version.c"": {""insertions"": 2, ""deletions"": 0, ""lines"": 2}}"
2021-01-29 20:07:07,28976e2accf11591c60e8a658a9e03544f0408b2,Bram Moolenaar,17,21,38,4,"{""src/insexpand.c"": {""insertions"": 6, ""deletions"": 5, ""lines"": 11}, ""src/testdir/test_ins_complete.vim"": {""insertions"": 6, ""deletions"": 13, ""lines"": 19}, ""src/testdir/test_popup.vim"": {""insertions"": 3, ""deletions"": 3, ""lines"": 6}, ""src/version.c"": {""insertions"": 2, ""deletions"": 0, ""lines"": 2}}"
2021-01-28 19:18:08,df2c2988bbaecd28b0fbec8d64327b1bbb005e19,Bram Moolenaar,9,0,9,3,"{""src/ex_cmds.c"": {""insertions"": 2, ""deletions"": 0, ""lines"": 2}, ""src/testdir/test_eval_stuff.vim"": {""insertions"": 5, ""deletions"": 0, ""lines"": 5}, ""src/version.c"": {""insertions"": 2, ""deletions"": 0, ""lines"": 2}}"
2021-01-28 17:34:35,97202d951685fc4d90085da676a90644cbf72571,Bram Moolenaar,37,20,57,5,"{""src/testdir/check.vim"": {""insertions"": 8, ""deletions"": 0, ""lines"": 8}, ""src/testdir/test_ex_mode.vim"": {""insertions"": 3, ""deletions"": 0, ""lines"": 3}, ""src/testdir/test_ins_complete.vim"": {""insertions"": 21, ""deletions"": 15, ""lines"": 36}, ""src/testdir/test_memory_usage.vim"": {""insertions"": 3, ""deletions"": 5, ""lines"": 8}, ""src/version.c"": {""insertions"": 2, ""deletions"": 0, ""lines"": 2}}"
2021-01-28 16:56:09,61015162ba834541c42da5db6f3fa0ebe1d40e87,Bram Moolenaar,4,0,4,2,"{""src/errors.h"": {""insertions"": 2, ""deletions"": 0, ""lines"": 2}, ""src/version.c"": {""insertions"": 2, ""deletions"": 0, ""lines"": 2}}"
2021-01-28 16:24:58,1d859e24218635c57c09801840ff159cb845ae6a,Bram Moolenaar,23,1,24,3,"{""src/normal.c"": {""insertions"": 5, ""deletions"": 1, ""lines"": 6}, ""src/testdir/test_ex_mode.vim"": {""insertions"": 16, ""deletions"": 0, ""lines"": 16}, ""src/version.c"": {""insertions"": 2, ""deletions"": 0, ""lines"": 2}}"
2021-01-28 13:24:55,5ed58c7b700fcb9fd03c418300145b616f4bdcdd,Bram Moolenaar,46,9,55,3,"{""src/arglist.c"": {""insertions"": 38, ""deletions"": 9, ""lines"": 47}, ""src/testdir/test_autocmd.vim"": {""insertions"": 6, ""deletions"": 0, ""lines"": 6}, ""src/version.c"": {""insertions"": 2, ""deletions"": 0, ""lines"": 2}}"
2021-01-28 12:47:59,9a046fd08bcae319d39a4dbde2be81decee19013,Bram Moolenaar,23,27,50,6,"{""src/autocmd.c"": {""insertions"": 8, ""deletions"": 5, ""lines"": 13}, ""src/errors.h"": {""insertions"": 2, ""deletions"": 0, ""lines"": 2}, ""src/testdir/test_autocmd.vim"": {""insertions"": 3, ""deletions"": 14, ""lines"": 17}, ""src/testdir/test_quickfix.vim"": {""insertions"": 6, ""deletions"": 6, ""lines"": 12}, ""src/testdir/test_window_cmd.vim"": {""insertions"": 2, ""deletions"": 2, ""lines"": 4}, ""src/version.c"": {""insertions"": 2, ""deletions"": 0, ""lines"": 2}}"
2021-01-28 11:08:35,d697ddea1466d877a79f8c56d46361dc54e9baef,Bram Moolenaar,2,9,11,2,"{""src/testdir/test_autocmd.vim"": {""insertions"": 0, ""deletions"": 9, ""lines"": 9}, ""src/version.c"": {""insertions"": 2, ""deletions"": 0, ""lines"": 2}}"
2021-01-28 10:07:44,2e6cdb91e8dea08301f31bc83188c06112eb7f57,Bram Moolenaar,6,0,6,2,"{""src/edit.c"": {""insertions"": 4, ""deletions"": 0, ""lines"": 4}, ""src/version.c"": {""insertions"": 2, ""deletions"": 0, ""lines"": 2}}"
2021-01-27 20:37:13,3e492c2d5fbd4ae395ffddfc059a3c414604b951,Bram Moolenaar,9,0,9,2,"{""src/ex_eval.c"": {""insertions"": 7, ""deletions"": 0, ""lines"": 7}, ""src/version.c"": {""insertions"": 2, ""deletions"": 0, ""lines"": 2}}"
2021-01-27 19:34:29,bed72df3e61a8908ed6324212595118f305dded0,Bram Moolenaar,12,3,15,3,"{""src/ex_getln.c"": {""insertions"": 1, ""deletions"": 0, ""lines"": 1}, ""src/testdir/test_arglist.vim"": {""insertions"": 9, ""deletions"": 3, ""lines"": 12}, ""src/version.c"": {""insertions"": 2, ""deletions"": 0, ""lines"": 2}}"
2021-01-26 21:42:21,21829c5f2c86cd525c8468121b4fc54c5d75bf6e,Bram Moolenaar,53,13,66,11,"{""runtime/doc/cmdline.txt"": {""insertions"": 1, ""deletions"": 1, ""lines"": 2}, ""src/evalfunc.c"": {""insertions"": 7, ""deletions"": 0, ""lines"": 7}, ""src/testdir/test_arglist.vim"": {""insertions"": 6, ""deletions"": 1, ""lines"": 7}, ""src/testdir/test_autocmd.vim"": {""insertions"": 2, ""deletions"": 4, ""lines"": 6}, ""src/testdir/test_cmdline.vim"": {""insertions"": 22, ""deletions"": 4, ""lines"": 26}, ""src/testdir/test_ins_complete.vim"": {""insertions"": 2, ""deletions"": 0, ""lines"": 2}, ""src/testdir/test_normal.vim"": {""insertions"": 5, ""deletions"": 3, ""lines"": 8}, ""src/testdir/test_tabpage.vim"": {""insertions"": 2, ""deletions"": 0, ""lines"": 2}, ""src/testdir/test_termcodes.vim"": {""insertions"": 2, ""deletions"": 0, ""lines"": 2}, ""src/testdir/test_window_cmd.vim"": {""insertions"": 2, ""deletions"": 0, ""lines"": 2}, ""src/version.c"": {""insertions"": 2, ""deletions"": 0, ""lines"": 2}}"
2021-01-26 21:00:52,b7e2670b6a1de02c772af5097ba24f2a15b26eec,Bram Moolenaar,8,1,9,2,"{""src/ex_getln.c"": {""insertions"": 6, ""deletions"": 1, ""lines"": 7}, ""src/version.c"": {""insertions"": 2, ""deletions"": 0, ""lines"": 2}}"
2021-01-26 20:35:08,bb4b93ed85726c3921596ca267f531c8c94d819a,Bram Moolenaar,20,1,21,4,"{""src/arglist.c"": {""insertions"": 7, ""deletions"": 0, ""lines"": 7}, ""src/ex_getln.c"": {""insertions"": 3, ""deletions"": 1, ""lines"": 4}, ""src/testdir/test_arglist.vim"": {""insertions"": 8, ""deletions"": 0, ""lines"": 8}, ""src/version.c"": {""insertions"": 2, ""deletions"": 0, ""lines"": 2}}"
2021-01-26 18:32:53,ce0370d9e67df80c62ff033aa8ca2dbe86841de9,Bram Moolenaar,3,4,7,2,"{""src/ex_docmd.c"": {""insertions"": 1, ""deletions"": 4, ""lines"": 5}, ""src/version.c"": {""insertions"": 2, ""deletions"": 0, ""lines"": 2}}"
2021-01-26 11:06:30,98989a00145cc4f5783bcc12a2968a2f716eabb9,Bram Moolenaar,8,1,9,2,"{""src/testdir/test_profile.vim"": {""insertions"": 6, ""deletions"": 1, ""lines"": 7}, ""src/version.c"": {""insertions"": 2, ""deletions"": 0, ""lines"": 2}}"
2021-01-25 22:02:38,ff0e57fe77b1a87a034191c629730b081f6fb7ad,Bram Moolenaar,3,1,4,2,"{""src/version.c"": {""insertions"": 2, ""deletions"": 0, ""lines"": 2}, ""src/vim9.h"": {""insertions"": 1, ""deletions"": 1, ""lines"": 2}}"
2021-01-25 20:14:57,e0e3917554327f2524066f89fbbef9c83c1535da,Bram Moolenaar,479,134,613,32,"{"".github/CODEOWNERS"": {""insertions"": 5, ""deletions"": 0, ""lines"": 5}, ""runtime/compiler/fbc.vim"": {""insertions"": 27, ""deletions"": 0, ""lines"": 27}, ""runtime/compiler/tidy.vim"": {""insertions"": 12, ""deletions"": 5, ""lines"": 17}, ""runtime/doc/change.txt"": {""insertions"": 20, ""deletions"": 2, ""lines"": 22}, ""runtime/doc/eval.txt"": {""insertions"": 2, ""deletions"": 2, ""lines"": 4}, ""runtime/doc/filetype.txt"": {""insertions"": 1, ""deletions"": 1, ""lines"": 2}, ""runtime/doc/popup.txt"": {""insertions"": 1, ""deletions"": 1, ""lines"": 2}, ""runtime/doc/syntax.txt"": {""insertions"": 1, ""deletions"": 1, ""lines"": 2}, ""runtime/doc/tags"": {""insertions"": 24, ""deletions"": 0, ""lines"": 24}, ""runtime/doc/todo.txt"": {""insertions"": 12, ""deletions"": 12, ""lines"": 24}, ""runtime/doc/vi_diff.txt"": {""insertions"": 1, ""deletions"": 1, ""lines"": 2}, ""runtime/doc/vim9.txt"": {""insertions"": 10, ""deletions"": 1, ""lines"": 11}, ""runtime/filetype.vim"": {""insertions"": 1, ""deletions"": 1, ""lines"": 2}, ""runtime/ftplugin/ada.vim"": {""insertions"": 35, ""deletions"": 34, ""lines"": 69}, ""runtime/ftplugin/basic.vim"": {""insertions"": 27, ""deletions"": 0, ""lines"": 27}, ""runtime/ftplugin/bzl.vim"": {""insertions"": 3, ""deletions"": 1, ""lines"": 4}, ""runtime/ftplugin/framescript.vim"": {""insertions"": 3, ""deletions"": 3, ""lines"": 6}, ""runtime/ftplugin/freebasic.vim"": {""insertions"": 13, ""deletions"": 0, ""lines"": 13}, ""runtime/ftplugin/hamster.vim"": {""insertions"": 5, ""deletions"": 2, ""lines"": 7}, ""runtime/ftplugin/ocaml.vim"": {""insertions"": 3, ""deletions"": 1, ""lines"": 4}, ""runtime/ftplugin/tidy.vim"": {""insertions"": 32, ""deletions"": 0, ""lines"": 32}, ""runtime/ftplugin/vim.vim"": {""insertions"": 7, ""deletions"": 2, ""lines"": 9}, ""runtime/indent/fortran.vim"": {""insertions"": 5, ""deletions"": 1, ""lines"": 6}, ""runtime/indent/testdir/vim.in"": {""insertions"": 5, ""deletions"": 0, ""lines"": 5}, ""runtime/indent/testdir/vim.ok"": {""insertions"": 5, ""deletions"": 0, ""lines"": 5}, ""runtime/indent/vim.vim"": {""insertions"": 8, ""deletions"": 3, ""lines"": 11}, ""runtime/indent/yaml.vim"": {""insertions"": 4, ""deletions"": 4, ""lines"": 8}, ""runtime/syntax/basic.vim"": {""insertions"": 36, ""deletions"": 26, ""lines"": 62}, ""runtime/syntax/tidy.vim"": {""insertions"": 168, ""deletions"": 27, ""lines"": 195}, ""runtime/tutor/tutor.ko"": {""insertions"": 1, ""deletions"": 1, ""lines"": 2}, ""runtime/tutor/tutor.ko.euc"": {""insertions"": 1, ""deletions"": 1, ""lines"": 2}, ""runtime/tutor/tutor.ko.utf-8"": {""insertions"": 1, ""deletions"": 1, ""lines"": 2}}"
2021-01-25 20:01:48,e5ea346a07a7750c02a89996b67716b43c767d06,Bram Moolenaar,54,26,80,5,"{""src/testdir/test_profile.vim"": {""insertions"": 18, ""deletions"": 0, ""lines"": 18}, ""src/version.c"": {""insertions"": 2, ""deletions"": 0, ""lines"": 2}, ""src/vim9.h"": {""insertions"": 10, ""deletions"": 0, ""lines"": 10}, ""src/vim9compile.c"": {""insertions"": 7, ""deletions"": 7, ""lines"": 14}, ""src/vim9execute.c"": {""insertions"": 17, ""deletions"": 19, ""lines"": 36}}"
2021-01-25 18:18:02,5c829bf229de463657e4ba1de6c4ee91899de14e,Bram Moolenaar,6,4,10,3,"{""src/GvimExt/Make_ming.mak"": {""insertions"": 2, ""deletions"": 2, ""lines"": 4}, ""src/Make_cyg_ming.mak"": {""insertions"": 2, ""deletions"": 2, ""lines"": 4}, ""src/version.c"": {""insertions"": 2, ""deletions"": 0, ""lines"": 2}}"
2021-01-25 17:44:57,ab55f11d9bc776d546794748bc62ac47d5340c2e,Bram Moolenaar,2,21,23,2,"{""src/mark.c"": {""insertions"": 0, ""deletions"": 21, ""lines"": 21}, ""src/version.c"": {""insertions"": 2, ""deletions"": 0, ""lines"": 2}}"
2021-01-24 20:30:48,c05fe07529f10fc32a2086cb44a708520c8d14ce,Bram Moolenaar,11,0,11,2,"{""src/version.c"": {""insertions"": 2, ""deletions"": 0, ""lines"": 2}, ""src/vim9compile.c"": {""insertions"": 9, ""deletions"": 0, ""lines"": 9}}"
2021-01-24 20:14:20,4efd9948291801bffebf36b4a9910d08ff981987,Bram Moolenaar,40,0,40,3,"{""src/testdir/test_vim9_func.vim"": {""insertions"": 32, ""deletions"": 0, ""lines"": 32}, ""src/userfunc.c"": {""insertions"": 6, ""deletions"": 0, ""lines"": 6}, ""src/version.c"": {""insertions"": 2, ""deletions"": 0, ""lines"": 2}}"
2021-01-24 19:52:00,107e9cecf72928b4aaaf08b73bf2d191924ab695,Bram Moolenaar,131,56,187,4,"{""src/testdir/test_profile.vim"": {""insertions"": 35, ""deletions"": 22, ""lines"": 57}, ""src/version.c"": {""insertions"": 2, ""deletions"": 0, ""lines"": 2}, ""src/vim9compile.c"": {""insertions"": 49, ""deletions"": 9, ""lines"": 58}, ""src/vim9execute.c"": {""insertions"": 45, ""deletions"": 25, ""lines"": 70}}"
2021-01-24 16:53:47,ced68a0070dac059fc978a1a99e2893edf158116,Bram Moolenaar,115,35,150,5,"{""src/testdir/test_profile.vim"": {""insertions"": 33, ""deletions"": 24, ""lines"": 57}, ""src/testdir/test_vim9_disassemble.vim"": {""insertions"": 1, ""deletions"": 1, ""lines"": 2}, ""src/testdir/test_vim9_script.vim"": {""insertions"": 1, ""deletions"": 1, ""lines"": 2}, ""src/version.c"": {""insertions"": 2, ""deletions"": 0, ""lines"": 2}, ""src/vim9compile.c"": {""insertions"": 78, ""deletions"": 9, ""lines"": 87}}"
2021-01-24 14:25:56,8323cab31c3120a7f80cf3271a506a30ec04d99e,Bram Moolenaar,21,7,28,3,"{""runtime/filetype.vim"": {""insertions"": 16, ""deletions"": 6, ""lines"": 22}, ""src/testdir/test_filetype.vim"": {""insertions"": 3, ""deletions"": 1, ""lines"": 4}, ""src/version.c"": {""insertions"": 2, ""deletions"": 0, ""lines"": 2}}"
2021-01-24 12:34:18,f002a41d127d49cfe5a59819d1498bc0ff8b594a,Bram Moolenaar,63,7,70,6,"{""src/structs.h"": {""insertions"": 5, ""deletions"": 0, ""lines"": 5}, ""src/testdir/test_vim9_disassemble.vim"": {""insertions"": 3, ""deletions"": 0, ""lines"": 3}, ""src/version.c"": {""insertions"": 2, ""deletions"": 0, ""lines"": 2}, ""src/vim9.h"": {""insertions"": 4, ""deletions"": 2, ""lines"": 6}, ""src/vim9compile.c"": {""insertions"": 25, ""deletions"": 4, ""lines"": 29}, ""src/vim9execute.c"": {""insertions"": 24, ""deletions"": 1, ""lines"": 25}}"
2021-01-24 11:53:53,b204990346ca857802b174afe8a7fbb05e4f318e,Bram Moolenaar,311,109,420,16,"{""runtime/doc/repeat.txt"": {""insertions"": 13, ""deletions"": 7, ""lines"": 20}, ""src/debugger.c"": {""insertions"": 18, ""deletions"": 10, ""lines"": 28}, ""src/ex_cmds.h"": {""insertions"": 1, ""deletions"": 1, ""lines"": 2}, ""src/ex_docmd.c"": {""insertions"": 1, ""deletions"": 1, ""lines"": 2}, ""src/profiler.c"": {""insertions"": 48, ""deletions"": 4, ""lines"": 52}, ""src/proto/profiler.pro"": {""insertions"": 3, ""deletions"": 1, ""lines"": 4}, ""src/proto/vim9compile.pro"": {""insertions"": 2, ""deletions"": 1, ""lines"": 3}, ""src/structs.h"": {""insertions"": 8, ""deletions"": 1, ""lines"": 9}, ""src/testdir/test_profile.vim"": {""insertions"": 24, ""deletions"": 15, ""lines"": 39}, ""src/testdir/test_vim9_disassemble.vim"": {""insertions"": 21, ""deletions"": 0, ""lines"": 21}, ""src/userfunc.c"": {""insertions"": 19, ""deletions"": 37, ""lines"": 56}, ""src/version.c"": {""insertions"": 2, ""deletions"": 0, ""lines"": 2}, ""src/vim9.h"": {""insertions"": 8, ""deletions"": 1, ""lines"": 9}, ""src/vim9compile.c"": {""insertions"": 96, ""deletions"": 18, ""lines"": 114}, ""src/vim9execute.c"": {""insertions"": 45, ""deletions"": 11, ""lines"": 56}, ""src/vim9type.c"": {""insertions"": 2, ""deletions"": 1, ""lines"": 3}}"
2021-01-24 11:00:01,7cf0c114d690c91ac88c92a1a6f1b1935cb6410f,Bram Moolenaar,3,1,4,2,"{""src/testdir/test_fold.vim"": {""insertions"": 1, ""deletions"": 1, ""lines"": 2}, ""src/version.c"": {""insertions"": 2, ""deletions"": 0, ""lines"": 2}}"
2021-01-23 14:27:09,40be52ba71b9d6a7f586b1e77db8e827ff4c0c42,Bram Moolenaar,6,2,8,2,"{""src/testdir/test_method.vim"": {""insertions"": 4, ""deletions"": 2, ""lines"": 6}, ""src/version.c"": {""insertions"": 2, ""deletions"": 0, ""lines"": 2}}"
2021-01-23 14:15:01,dfbc5fd879d92c2a79ced1e1d16dc89f4d55772d,Bram Moolenaar,20,4,24,3,"{""src/buffer.c"": {""insertions"": 7, ""deletions"": 4, ""lines"": 11}, ""src/testdir/test_vim9_cmd.vim"": {""insertions"": 11, ""deletions"": 0, ""lines"": 11}, ""src/version.c"": {""insertions"": 2, ""deletions"": 0, ""lines"": 2}}"
2021-01-23 13:22:16,7cebe8ba7dd9a3a955e2da74014f11c42e1c6ac3,Bram Moolenaar,24,11,35,4,"{""src/eval.c"": {""insertions"": 4, ""deletions"": 8, ""lines"": 12}, ""src/ex_docmd.c"": {""insertions"": 4, ""deletions"": 3, ""lines"": 7}, ""src/testdir/test_vim9_cmd.vim"": {""insertions"": 14, ""deletions"": 0, ""lines"": 14}, ""src/version.c"": {""insertions"": 2, ""deletions"": 0, ""lines"": 2}}"
2021-01-23 12:39:14,9a562c184d98d82bb7506caf2071cfe15a92fa43,Bram Moolenaar,11,0,11,3,"{""src/evalvars.c"": {""insertions"": 7, ""deletions"": 0, ""lines"": 7}, ""src/testdir/test_vim9_assign.vim"": {""insertions"": 2, ""deletions"": 0, ""lines"": 2}, ""src/version.c"": {""insertions"": 2, ""deletions"": 0, ""lines"": 2}}"
2021-01-22 21:31:10,9ae3705b6ebd45086ca13c0f93a93f943559bd15,Bram Moolenaar,32,2,34,3,"{""src/evalfunc.c"": {""insertions"": 2, ""deletions"": 2, ""lines"": 4}, ""src/testdir/test_vim9_builtin.vim"": {""insertions"": 28, ""deletions"": 0, ""lines"": 28}, ""src/version.c"": {""insertions"": 2, ""deletions"": 0, ""lines"": 2}}"
2021-01-22 21:06:56,4bce26bb70144633713e7e8f149ba99cac511336,Bram Moolenaar,10,1,11,3,"{""src/dict.c"": {""insertions"": 2, ""deletions"": 1, ""lines"": 3}, ""src/testdir/test_vim9_script.vim"": {""insertions"": 6, ""deletions"": 0, ""lines"": 6}, ""src/version.c"": {""insertions"": 2, ""deletions"": 0, ""lines"": 2}}"
2021-01-22 19:55:04,402115f1c2b4d0704a822206f2e6e931e721c129,Bram Moolenaar,11,0,11,4,"{""runtime/filetype.vim"": {""insertions"": 3, ""deletions"": 0, ""lines"": 3}, ""runtime/scripts.vim"": {""insertions"": 4, ""deletions"": 0, ""lines"": 4}, ""src/testdir/test_filetype.vim"": {""insertions"": 2, ""deletions"": 0, ""lines"": 2}, ""src/version.c"": {""insertions"": 2, ""deletions"": 0, ""lines"": 2}}"
2021-01-22 19:46:27,0d3de8cb590aed90be71d96eb3dbc6addf80bb11,Bram Moolenaar,45,32,77,3,"{""src/userfunc.c"": {""insertions"": 19, ""deletions"": 17, ""lines"": 36}, ""src/version.c"": {""insertions"": 2, ""deletions"": 0, ""lines"": 2}, ""src/vim9execute.c"": {""insertions"": 24, ""deletions"": 15, ""lines"": 39}}"
2021-01-22 16:51:06,b3005ce191d27fd2f234df4969d5b58fda9c1940,Bram Moolenaar,9,9,18,4,"{""src/version.c"": {""insertions"": 2, ""deletions"": 0, ""lines"": 2}, ""src/vim9.h"": {""insertions"": 2, ""deletions"": 2, ""lines"": 4}, ""src/vim9compile.c"": {""insertions"": 2, ""deletions"": 4, ""lines"": 6}, ""src/vim9execute.c"": {""insertions"": 3, ""deletions"": 3, ""lines"": 6}}"
2021-01-21 21:53:38,9b6344613eecfcf77c510d7b63fcc4b7b51aefbc,Bram Moolenaar,9,5,14,4,"{""src/version.c"": {""insertions"": 2, ""deletions"": 0, ""lines"": 2}, ""src/vim9.h"": {""insertions"": 1, ""deletions"": 1, ""lines"": 2}, ""src/vim9compile.c"": {""insertions"": 3, ""deletions"": 1, ""lines"": 4}, ""src/vim9execute.c"": {""insertions"": 3, ""deletions"": 3, ""lines"": 6}}"
2021-01-21 20:42:31,57d5a01cb45d6edb16c3835a49b42d6d8fc0163e,Bram Moolenaar,47,30,77,5,"{""runtime/doc/eval.txt"": {""insertions"": 7, ""deletions"": 1, ""lines"": 8}, ""src/evalvars.c"": {""insertions"": 4, ""deletions"": 0, ""lines"": 4}, ""src/testdir/test_eval_stuff.vim"": {""insertions"": 6, ""deletions"": 3, ""lines"": 9}, ""src/version.c"": {""insertions"": 2, ""deletions"": 0, ""lines"": 2}, ""src/vim.h"": {""insertions"": 28, ""deletions"": 26, ""lines"": 54}}"
2021-01-21 19:21:29,e32e516dfa46e9c5965d278f96aaf57573de8ac4,Bram Moolenaar,41,12,53,7,"{""src/testdir/test_vim9_builtin.vim"": {""insertions"": 1, ""deletions"": 1, ""lines"": 2}, ""src/testdir/test_vim9_disassemble.vim"": {""insertions"": 1, ""deletions"": 1, ""lines"": 2}, ""src/testdir/test_vim9_func.vim"": {""insertions"": 16, ""deletions"": 0, ""lines"": 16}, ""src/version.c"": {""insertions"": 2, ""deletions"": 0, ""lines"": 2}, ""src/vim9.h"": {""insertions"": 2, ""deletions"": 1, ""lines"": 3}, ""src/vim9compile.c"": {""insertions"": 7, ""deletions"": 5, ""lines"": 12}, ""src/vim9execute.c"": {""insertions"": 12, ""deletions"": 4, ""lines"": 16}}"
2021-01-21 18:41:16,f904133e1a5ea84a124d3ece12b1f0a7392f1ca7,Bram Moolenaar,37,0,37,3,"{""src/testdir/test_vim9_func.vim"": {""insertions"": 18, ""deletions"": 0, ""lines"": 18}, ""src/version.c"": {""insertions"": 2, ""deletions"": 0, ""lines"": 2}, ""src/vim9execute.c"": {""insertions"": 17, ""deletions"": 0, ""lines"": 17}}"
2021-01-21 16:03:07,e71996bd0865659bde5450f466bc3e53e83431b2,Bram Moolenaar,48,20,68,3,"{""src/normal.c"": {""insertions"": 11, ""deletions"": 20, ""lines"": 31}, ""src/testdir/test_fold.vim"": {""insertions"": 35, ""deletions"": 0, ""lines"": 35}, ""src/version.c"": {""insertions"": 2, ""deletions"": 0, ""lines"": 2}}"
2021-01-21 13:45:13,5e6a7aa2b26077775906eb8411952dc6259694de,Bram Moolenaar,26,2,28,3,"{""runtime/filetype.vim"": {""insertions"": 7, ""deletions"": 2, ""lines"": 9}, ""src/testdir/test_filetype.vim"": {""insertions"": 17, ""deletions"": 0, ""lines"": 17}, ""src/version.c"": {""insertions"": 2, ""deletions"": 0, ""lines"": 2}}"
2021-01-21 12:36:43,ccb47a2899d9f8076dad0f8348c057450febf32b,Bram Moolenaar,4,0,4,2,"{""src/misc2.c"": {""insertions"": 2, ""deletions"": 0, ""lines"": 2}, ""src/version.c"": {""insertions"": 2, ""deletions"": 0, ""lines"": 2}}"
2021-01-21 12:03:20,b1f2857096aabe9a11e576005d08fc4e53781698,Bram Moolenaar,8,4,12,2,"{""src/version.c"": {""insertions"": 2, ""deletions"": 0, ""lines"": 2}, ""src/vim9execute.c"": {""insertions"": 6, ""deletions"": 4, ""lines"": 10}}"
2021-01-21 11:34:14,c5f59fab23820454f060562927ddc1397f9d479a,Bram Moolenaar,77,16,93,7,"{""src/eval.c"": {""insertions"": 24, ""deletions"": 7, ""lines"": 31}, ""src/evalvars.c"": {""insertions"": 4, ""deletions"": 2, ""lines"": 6}, ""src/proto/eval.pro"": {""insertions"": 2, ""deletions"": 2, ""lines"": 4}, ""src/testdir/test_vim9_assign.vim"": {""insertions"": 24, ""deletions"": 0, ""lines"": 24}, ""src/testdir/vim9.vim"": {""insertions"": 13, ""deletions"": 0, ""lines"": 13}, ""src/version.c"": {""insertions"": 2, ""deletions"": 0, ""lines"": 2}, ""src/vim9compile.c"": {""insertions"": 8, ""deletions"": 5, ""lines"": 13}}"
2021-01-20 21:22:49,a0f7f73ebb3ab032af08699c24c465403512b7d8,Bram Moolenaar,5,0,5,2,"{""src/time.c"": {""insertions"": 3, ""deletions"": 0, ""lines"": 3}, ""src/version.c"": {""insertions"": 2, ""deletions"": 0, ""lines"": 2}}"
2021-01-20 20:42:33,77a849c4b3d73c228013a047913c90834a93b4f6,Bram Moolenaar,6,2,8,2,"{""src/spellsuggest.c"": {""insertions"": 4, ""deletions"": 2, ""lines"": 6}, ""src/version.c"": {""insertions"": 2, ""deletions"": 0, ""lines"": 2}}"
2021-01-20 20:23:14,99880f96cf444014d589fc1d99bb164deaba71ce,Bram Moolenaar,20,6,26,5,"{""src/errors.h"": {""insertions"": 2, ""deletions"": 0, ""lines"": 2}, ""src/eval.c"": {""insertions"": 5, ""deletions"": 2, ""lines"": 7}, ""src/testdir/test_vim9_expr.vim"": {""insertions"": 3, ""deletions"": 2, ""lines"": 5}, ""src/version.c"": {""insertions"": 2, ""deletions"": 0, ""lines"": 2}, ""src/vim9execute.c"": {""insertions"": 8, ""deletions"": 2, ""lines"": 10}}"
2021-01-19 21:48:09,a28639e71198238d5c09c43445dc448d7f3fb29b,Bram Moolenaar,26,16,42,3,"{""src/testdir/test_vim9_cmd.vim"": {""insertions"": 4, ""deletions"": 0, ""lines"": 4}, ""src/version.c"": {""insertions"": 2, ""deletions"": 0, ""lines"": 2}, ""src/vim9execute.c"": {""insertions"": 20, ""deletions"": 16, ""lines"": 36}}"
2021-01-19 21:16:41,e64f83cc6aba05baa61ba4a4cb8d4447b8091e5b,Bram Moolenaar,8,2,10,3,"{""src/testdir/test_vim9_expr.vim"": {""insertions"": 2, ""deletions"": 0, ""lines"": 2}, ""src/version.c"": {""insertions"": 2, ""deletions"": 0, ""lines"": 2}, ""src/vim9compile.c"": {""insertions"": 4, ""deletions"": 2, ""lines"": 6}}"
2021-01-19 16:22:58,09fbedc8dc3adc0a7adf2093916911e633cfa626,Bram Moolenaar,5,2,7,2,"{""src/testdir/test_highlight.vim"": {""insertions"": 3, ""deletions"": 2, ""lines"": 5}, ""src/version.c"": {""insertions"": 2, ""deletions"": 0, ""lines"": 2}}"
2021-01-18 18:55:44,98a29d00a48e15a50e2850e1a29b7d475c531b0c,Bram Moolenaar,150,116,266,17,"{""runtime/doc/eval.txt"": {""insertions"": 27, ""deletions"": 25, ""lines"": 52}, ""runtime/doc/filetype.txt"": {""insertions"": 1, ""deletions"": 0, ""lines"": 1}, ""runtime/doc/index.txt"": {""insertions"": 1, ""deletions"": 1, ""lines"": 2}, ""runtime/doc/options.txt"": {""insertions"": 2, ""deletions"": 2, ""lines"": 4}, ""runtime/doc/popup.txt"": {""insertions"": 0, ""deletions"": 2, ""lines"": 2}, ""runtime/doc/syntax.txt"": {""insertions"": 5, ""deletions"": 4, ""lines"": 9}, ""runtime/doc/tags"": {""insertions"": 11, ""deletions"": 4, ""lines"": 15}, ""runtime/doc/term.txt"": {""insertions"": 3, ""deletions"": 3, ""lines"": 6}, ""runtime/doc/todo.txt"": {""insertions"": 7, ""deletions"": 21, ""lines"": 28}, ""runtime/doc/usr_41.txt"": {""insertions"": 1, ""deletions"": 1, ""lines"": 2}, ""runtime/doc/various.txt"": {""insertions"": 5, ""deletions"": 2, ""lines"": 7}, ""runtime/doc/version6.txt"": {""insertions"": 1, ""deletions"": 1, ""lines"": 2}, ""runtime/doc/vi_diff.txt"": {""insertions"": 1, ""deletions"": 1, ""lines"": 2}, ""runtime/doc/vim9.txt"": {""insertions"": 65, ""deletions"": 35, ""lines"": 100}, ""runtime/ftplugin/vim.vim"": {""insertions"": 5, ""deletions"": 5, ""lines"": 10}, ""runtime/syntax/c.vim"": {""insertions"": 11, ""deletions"": 8, ""lines"": 19}, ""runtime/syntax/cpp.vim"": {""insertions"": 4, ""deletions"": 1, ""lines"": 5}}"
2021-01-17 21:04:02,82aa6e09e02b138ab7ee6b79ecac487813f117e5,Bram Moolenaar,3,1,4,2,"{""src/edit.c"": {""insertions"": 1, ""deletions"": 1, ""lines"": 2}, ""src/version.c"": {""insertions"": 2, ""deletions"": 0, ""lines"": 2}}"
2021-01-17 20:51:24,f30a14db3b26e510f193f50ee0dd8a41303e4740,Bram Moolenaar,15,7,22,3,"{""src/testdir/test_vim9_assign.vim"": {""insertions"": 11, ""deletions"": 2, ""lines"": 13}, ""src/version.c"": {""insertions"": 2, ""deletions"": 0, ""lines"": 2}, ""src/vim9compile.c"": {""insertions"": 2, ""deletions"": 5, ""lines"": 7}}"
2021-01-17 19:52:13,585587dadbc2558520c33969098db9ff49598785,Bram Moolenaar,6,3,9,2,"{""src/evalvars.c"": {""insertions"": 4, ""deletions"": 3, ""lines"": 7}, ""src/version.c"": {""insertions"": 2, ""deletions"": 0, ""lines"": 2}}"
2021-01-17 19:23:38,036d07144efe213199b1ed8de998e6f12a056499,Bram Moolenaar,19,4,23,4,"{""src/evalvars.c"": {""insertions"": 7, ""deletions"": 4, ""lines"": 11}, ""src/testdir/test_vim9_script.vim"": {""insertions"": 6, ""deletions"": 0, ""lines"": 6}, ""src/version.c"": {""insertions"": 2, ""deletions"": 0, ""lines"": 2}, ""src/vim9compile.c"": {""insertions"": 4, ""deletions"": 0, ""lines"": 4}}"
2021-01-17 18:20:32,1430ceeb2d4185a8d60fa81007fbc8b74fd68c46,Bram Moolenaar,40,0,40,3,"{""src/testdir/test_vim9_script.vim"": {""insertions"": 37, ""deletions"": 0, ""lines"": 37}, ""src/version.c"": {""insertions"": 2, ""deletions"": 0, ""lines"": 2}, ""src/vim9execute.c"": {""insertions"": 1, ""deletions"": 0, ""lines"": 1}}"
2021-01-17 15:16:23,3af15ab7888033fdfae0ae7085172aab794339a2,Bram Moolenaar,97,70,167,4,"{""src/evalfunc.c"": {""insertions"": 74, ""deletions"": 69, ""lines"": 143}, ""src/testdir/test_vim9_builtin.vim"": {""insertions"": 20, ""deletions"": 0, ""lines"": 20}, ""src/testdir/test_vim9_disassemble.vim"": {""insertions"": 1, ""deletions"": 1, ""lines"": 2}, ""src/version.c"": {""insertions"": 2, ""deletions"": 0, ""lines"": 2}}"
2021-01-17 12:48:03,85773bf32b51cbe7e971c5ac11cb9c743bb7a38a,Bram Moolenaar,20,1,21,2,"{""src/testdir/test_options.vim"": {""insertions"": 18, ""deletions"": 1, ""lines"": 19}, ""src/version.c"": {""insertions"": 2, ""deletions"": 0, ""lines"": 2}}"
2021-01-17 12:21:20,239f8d932672bcf5be6d32fc7c0bf95a2e69f5eb,Bram Moolenaar,15,13,28,5,"{""src/errors.h"": {""insertions"": 1, ""deletions"": 1, ""lines"": 2}, ""src/evalfunc.c"": {""insertions"": 6, ""deletions"": 6, ""lines"": 12}, ""src/list.c"": {""insertions"": 3, ""deletions"": 3, ""lines"": 6}, ""src/version.c"": {""insertions"": 2, ""deletions"": 0, ""lines"": 2}, ""src/vim9execute.c"": {""insertions"": 3, ""deletions"": 3, ""lines"": 6}}"
2021-01-16 19:21:23,e2edc2ed4a9a229870b1e1811b0ecf045b84e429,Bram Moolenaar,49,10,59,10,"{""runtime/doc/index.txt"": {""insertions"": 2, ""deletions"": 0, ""lines"": 2}, ""runtime/doc/various.txt"": {""insertions"": 2, ""deletions"": 2, ""lines"": 4}, ""src/ex_cmds.h"": {""insertions"": 1, ""deletions"": 1, ""lines"": 2}, ""src/ex_docmd.c"": {""insertions"": 10, ""deletions"": 3, ""lines"": 13}, ""src/normal.c"": {""insertions"": 2, ""deletions"": 2, ""lines"": 4}, ""src/proto/ex_docmd.pro"": {""insertions"": 1, ""deletions"": 1, ""lines"": 2}, ""src/term.c"": {""insertions"": 1, ""deletions"": 1, ""lines"": 2}, ""src/testdir/Make_all.mak"": {""insertions"": 2, ""deletions"": 0, ""lines"": 2}, ""src/testdir/test_sleep.vim"": {""insertions"": 26, ""deletions"": 0, ""lines"": 26}, ""src/version.c"": {""insertions"": 2, ""deletions"": 0, ""lines"": 2}}"
2021-01-16 18:01:53,70250fb4d2ffc2e92db224c6374db418f70691fd,Bram Moolenaar,80,29,109,4,"{""src/list.c"": {""insertions"": 38, ""deletions"": 7, ""lines"": 45}, ""src/testdir/test_vim9_assign.vim"": {""insertions"": 1, ""deletions"": 1, ""lines"": 2}, ""src/testdir/test_vim9_builtin.vim"": {""insertions"": 39, ""deletions"": 21, ""lines"": 60}, ""src/version.c"": {""insertions"": 2, ""deletions"": 0, ""lines"": 2}}"
2021-01-16 17:09:52,f898f7c68dc06def1a5ae02ce82a52a82af37cc4,Bram Moolenaar,30,6,36,3,"{""src/testdir/test_vim9_func.vim"": {""insertions"": 12, ""deletions"": 0, ""lines"": 12}, ""src/userfunc.c"": {""insertions"": 16, ""deletions"": 6, ""lines"": 22}, ""src/version.c"": {""insertions"": 2, ""deletions"": 0, ""lines"": 2}}"
2021-01-16 15:52:49,9ebcf231bdccc1673cc92b20f5190fc577ad29d0,Bram Moolenaar,7,1,8,3,"{""src/evalfunc.c"": {""insertions"": 2, ""deletions"": 1, ""lines"": 3}, ""src/testdir/test_cursor_func.vim"": {""insertions"": 3, ""deletions"": 0, ""lines"": 3}, ""src/version.c"": {""insertions"": 2, ""deletions"": 0, ""lines"": 2}}"
2021-01-16 15:07:01,351ead09dd365ebdee2bfa27ab22542d4920c779,Bram Moolenaar,63,44,107,8,"{""src/evalfunc.c"": {""insertions"": 28, ""deletions"": 6, ""lines"": 34}, ""src/proto/evalfunc.pro"": {""insertions"": 1, ""deletions"": 1, ""lines"": 2}, ""src/proto/vim9compile.pro"": {""insertions"": 1, ""deletions"": 0, ""lines"": 1}, ""src/proto/vim9type.pro"": {""insertions"": 0, ""deletions"": 1, ""lines"": 1}, ""src/testdir/test_vim9_builtin.vim"": {""insertions"": 3, ""deletions"": 0, ""lines"": 3}, ""src/version.c"": {""insertions"": 2, ""deletions"": 0, ""lines"": 2}, ""src/vim9compile.c"": {""insertions"": 23, ""deletions"": 21, ""lines"": 44}, ""src/vim9type.c"": {""insertions"": 5, ""deletions"": 15, ""lines"": 20}}"
2021-01-16 13:34:45,7c886db915035bc064ca307f02c34ae9d99cc733,Bram Moolenaar,7,0,7,2,"{""src/ex_cmds.c"": {""insertions"": 5, ""deletions"": 0, ""lines"": 5}, ""src/version.c"": {""insertions"": 2, ""deletions"": 0, ""lines"": 2}}"
2021-01-16 12:43:31,a3b494d6afa79aedce42fa4ecc7ef0dbae79e37e,Bram Moolenaar,3,1,4,2,"{""src/testdir/test_filetype.vim"": {""insertions"": 1, ""deletions"": 1, ""lines"": 2}, ""src/version.c"": {""insertions"": 2, ""deletions"": 0, ""lines"": 2}}"
2021-01-16 12:11:42,e2924328c165f1fc549f91bf212c93c87bb1d9ed,Bram Moolenaar,10,0,10,2,"{""src/testdir/test_autocmd.vim"": {""insertions"": 8, ""deletions"": 0, ""lines"": 8}, ""src/version.c"": {""insertions"": 2, ""deletions"": 0, ""lines"": 2}}"
2021-01-16 10:21:40,bf78974ca4a6798db7172c226cbfe7b2485b7baa,Bram Moolenaar,7,5,12,2,"{""src/term.c"": {""insertions"": 5, ""deletions"": 5, ""lines"": 10}, ""src/version.c"": {""insertions"": 2, ""deletions"": 0, ""lines"": 2}}"
2021-01-15 18:04:32,648ea76e1d8ca9a9788f88d0d96d0cf0653006bb,Bram Moolenaar,19,0,19,3,"{""src/testdir/test_vim9_func.vim"": {""insertions"": 11, ""deletions"": 0, ""lines"": 11}, ""src/userfunc.c"": {""insertions"": 6, ""deletions"": 0, ""lines"": 6}, ""src/version.c"": {""insertions"": 2, ""deletions"": 0, ""lines"": 2}}"
2021-01-15 17:04:43,883cf97f109d2ff281cf77f7b2e3bb44aced7cb3,Bram Moolenaar,47,26,73,5,"{""src/eval.c"": {""insertions"": 40, ""deletions"": 25, ""lines"": 65}, ""src/proto/eval.pro"": {""insertions"": 1, ""deletions"": 0, ""lines"": 1}, ""src/testdir/test_vim9_cmd.vim"": {""insertions"": 3, ""deletions"": 0, ""lines"": 3}, ""src/version.c"": {""insertions"": 2, ""deletions"": 0, ""lines"": 2}, ""src/vim9execute.c"": {""insertions"": 1, ""deletions"": 1, ""lines"": 2}}"
2021-01-15 15:45:21,97c6943e11516711541848e51db3cc2ace25bbb2,Bram Moolenaar,5,3,8,2,"{""src/testdir/test_autocmd.vim"": {""insertions"": 3, ""deletions"": 3, ""lines"": 6}, ""src/version.c"": {""insertions"": 2, ""deletions"": 0, ""lines"": 2}}"
2021-01-15 15:22:52,797e63b9f2baa1853e7063aac478d663cd02f207,Bram Moolenaar,46,11,57,5,"{""src/buffer.c"": {""insertions"": 12, ""deletions"": 9, ""lines"": 21}, ""src/ex_cmds.c"": {""insertions"": 11, ""deletions"": 1, ""lines"": 12}, ""src/proto/buffer.pro"": {""insertions"": 1, ""deletions"": 1, ""lines"": 2}, ""src/testdir/test_autocmd.vim"": {""insertions"": 20, ""deletions"": 0, ""lines"": 20}, ""src/version.c"": {""insertions"": 2, ""deletions"": 0, ""lines"": 2}}"
2021-01-15 12:35:30,17d015b2438e51d4d42d72720611d16c772cc4bb,Bram Moolenaar,6,0,6,3,"{""runtime/filetype.vim"": {""insertions"": 3, ""deletions"": 0, ""lines"": 3}, ""src/testdir/test_filetype.vim"": {""insertions"": 1, ""deletions"": 0, ""lines"": 1}, ""src/version.c"": {""insertions"": 2, ""deletions"": 0, ""lines"": 2}}"
2021-01-14 20:57:58,d44cc593cee84fc3c712ca1828d1574f80700383,Bram Moolenaar,16,8,24,2,"{""src/term.c"": {""insertions"": 14, ""deletions"": 8, ""lines"": 22}, ""src/version.c"": {""insertions"": 2, ""deletions"": 0, ""lines"": 2}}"
2021-01-14 20:47:06,8f81b22e8691f6e7c76153e945bbef15a8190cd9,Bram Moolenaar,26,0,26,3,"{""src/testdir/test_vim9_script.vim"": {""insertions"": 13, ""deletions"": 0, ""lines"": 13}, ""src/version.c"": {""insertions"": 2, ""deletions"": 0, ""lines"": 2}, ""src/vim9execute.c"": {""insertions"": 11, ""deletions"": 0, ""lines"": 11}}"
2021-01-14 20:40:22,033135eb8eccd00c9ee72c6c0cf4b8b9f81bd269,Bram Moolenaar,4,2,6,2,"{""src/ex_docmd.c"": {""insertions"": 2, ""deletions"": 2, ""lines"": 4}, ""src/version.c"": {""insertions"": 2, ""deletions"": 0, ""lines"": 2}}"
2021-01-14 19:35:49,2415669348c455df0d1b9bf55b17a06d2f990c19,Bram Moolenaar,25,13,38,3,"{""src/testdir/test_vim9_expr.vim"": {""insertions"": 20, ""deletions"": 12, ""lines"": 32}, ""src/version.c"": {""insertions"": 2, ""deletions"": 0, ""lines"": 2}, ""src/vim9compile.c"": {""insertions"": 3, ""deletions"": 1, ""lines"": 4}}"
2021-01-14 18:19:18,fadd55bd633b3b84d41a691e953f569bb6c21689,Bram Moolenaar,4,14,18,3,"{""src/term.c"": {""insertions"": 2, ""deletions"": 12, ""lines"": 14}, ""src/ui.c"": {""insertions"": 0, ""deletions"": 2, ""lines"": 2}, ""src/version.c"": {""insertions"": 2, ""deletions"": 0, ""lines"": 2}}"
2021-01-14 18:04:44,e1ee58ac788508585f60c91fcf6629e2251a9220,Bram Moolenaar,6,2,8,2,"{""src/term.c"": {""insertions"": 4, ""deletions"": 2, ""lines"": 6}, ""src/version.c"": {""insertions"": 2, ""deletions"": 0, ""lines"": 2}}"
2021-01-14 16:55:59,845b72854de90de13879598df53f1c388e52e1ba,Bram Moolenaar,8,0,8,3,"{""appveyor.yml => .appveyor.yml"": {""insertions"": 0, ""deletions"": 0, ""lines"": 0}, "".codecov.yml"": {""insertions"": 6, ""deletions"": 0, ""lines"": 6}, ""src/version.c"": {""insertions"": 2, ""deletions"": 0, ""lines"": 2}}"
2021-01-14 16:35:21,681fc3fa782e99fe69ed2c83c3e29109d2d61e1a,Bram Moolenaar,111,3,114,5,"{""runtime/doc/term.txt"": {""insertions"": 14, ""deletions"": 0, ""lines"": 14}, ""src/optiondefs.h"": {""insertions"": 2, ""deletions"": 0, ""lines"": 2}, ""src/term.c"": {""insertions"": 87, ""deletions"": 1, ""lines"": 88}, ""src/term.h"": {""insertions"": 6, ""deletions"": 2, ""lines"": 8}, ""src/version.c"": {""insertions"": 2, ""deletions"": 0, ""lines"": 2}}"
2021-01-13 20:47:15,6601b62943a19d4f8818c3638440663d67a17b6a,Bram Moolenaar,106,28,134,11,"{""runtime/doc/eval.txt"": {""insertions"": 20, ""deletions"": 0, ""lines"": 20}, ""runtime/doc/usr_41.txt"": {""insertions"": 3, ""deletions"": 0, ""lines"": 3}, ""src/eval.c"": {""insertions"": 34, ""deletions"": 11, ""lines"": 45}, ""src/evalfunc.c"": {""insertions"": 2, ""deletions"": 0, ""lines"": 2}, ""src/list.c"": {""insertions"": 8, ""deletions"": 5, ""lines"": 13}, ""src/proto/eval.pro"": {""insertions"": 3, ""deletions"": 2, ""lines"": 5}, ""src/proto/list.pro"": {""insertions"": 1, ""deletions"": 1, ""lines"": 2}, ""src/proto/vim9execute.pro"": {""insertions"": 1, ""deletions"": 1, ""lines"": 2}, ""src/testdir/test_vim9_builtin.vim"": {""insertions"": 23, ""deletions"": 0, ""lines"": 23}, ""src/version.c"": {""insertions"": 2, ""deletions"": 0, ""lines"": 2}, ""src/vim9execute.c"": {""insertions"": 9, ""deletions"": 8, ""lines"": 17}}"
2021-01-13 19:38:03,c423ad77ed763c11ba67729bbf63c1cf0915231f,Bram Moolenaar,74,10,84,7,"{""runtime/doc/eval.txt"": {""insertions"": 17, ""deletions"": 4, ""lines"": 21}, ""runtime/doc/usr_41.txt"": {""insertions"": 1, ""deletions"": 0, ""lines"": 1}, ""src/evalfunc.c"": {""insertions"": 3, ""deletions"": 1, ""lines"": 4}, ""src/filepath.c"": {""insertions"": 23, ""deletions"": 4, ""lines"": 27}, ""src/proto/filepath.pro"": {""insertions"": 2, ""deletions"": 1, ""lines"": 3}, ""src/testdir/test_vim9_builtin.vim"": {""insertions"": 26, ""deletions"": 0, ""lines"": 26}, ""src/version.c"": {""insertions"": 2, ""deletions"": 0, ""lines"": 2}}"
2021-01-13 19:08:38,9145846b6aa411e3ab5c0d145b37808654352877,Bram Moolenaar,91,17,108,4,"{""src/eval.c"": {""insertions"": 23, ""deletions"": 10, ""lines"": 33}, ""src/evalfunc.c"": {""insertions"": 3, ""deletions"": 3, ""lines"": 6}, ""src/testdir/test_cursor_func.vim"": {""insertions"": 63, ""deletions"": 4, ""lines"": 67}, ""src/version.c"": {""insertions"": 2, ""deletions"": 0, ""lines"": 2}}"
2021-01-13 18:48:46,1bb4de5302ba038b9c59e845b6d735e87d5681d0,Bram Moolenaar,12,1,13,5,"{""src/evalfunc.c"": {""insertions"": 4, ""deletions"": 0, ""lines"": 4}, ""src/evalvars.c"": {""insertions"": 1, ""deletions"": 1, ""lines"": 2}, ""src/proto/evalvars.pro"": {""insertions"": 1, ""deletions"": 0, ""lines"": 1}, ""src/testdir/test_cmdline.vim"": {""insertions"": 4, ""deletions"": 0, ""lines"": 4}, ""src/version.c"": {""insertions"": 2, ""deletions"": 0, ""lines"": 2}}"
2021-01-12 21:08:53,37487e16da7877129edee8d11b9b7f5c8df312c6,Bram Moolenaar,13,0,13,4,"{""src/evalwindow.c"": {""insertions"": 4, ""deletions"": 0, ""lines"": 4}, ""src/testdir/test_execute_func.vim"": {""insertions"": 2, ""deletions"": 0, ""lines"": 2}, ""src/testdir/test_vim9_builtin.vim"": {""insertions"": 5, ""deletions"": 0, ""lines"": 5}, ""src/version.c"": {""insertions"": 2, ""deletions"": 0, ""lines"": 2}}"
2021-01-12 20:49:00,a47e05f04a5a5c0369c949157c24d09cbe64ad6a,Bram Moolenaar,52,4,56,8,"{""runtime/doc/eval.txt"": {""insertions"": 10, ""deletions"": 1, ""lines"": 11}, ""runtime/doc/usr_41.txt"": {""insertions"": 2, ""deletions"": 1, ""lines"": 3}, ""src/evalfunc.c"": {""insertions"": 2, ""deletions"": 0, ""lines"": 2}, ""src/proto/vim9type.pro"": {""insertions"": 1, ""deletions"": 0, ""lines"": 1}, ""src/testdir/test_vim9_builtin.vim"": {""insertions"": 2, ""deletions"": 2, ""lines"": 4}, ""src/testdir/test_vimscript.vim"": {""insertions"": 8, ""deletions"": 0, ""lines"": 8}, ""src/version.c"": {""insertions"": 2, ""deletions"": 0, ""lines"": 2}, ""src/vim9type.c"": {""insertions"": 25, ""deletions"": 0, ""lines"": 25}}"
2021-01-12 20:22:31,64ed4d4398e92ac56a9bbd66d5ec992dd4c335f7,Bram Moolenaar,21,1,22,4,"{""src/evalfunc.c"": {""insertions"": 8, ""deletions"": 1, ""lines"": 9}, ""src/globals.h"": {""insertions"": 1, ""deletions"": 0, ""lines"": 1}, ""src/testdir/test_vim9_builtin.vim"": {""insertions"": 10, ""deletions"": 0, ""lines"": 10}, ""src/version.c"": {""insertions"": 2, ""deletions"": 0, ""lines"": 2}}"
2021-01-12 19:51:24,67876de7bbc4254268d8180d68203b965e25ed95,Bram Moolenaar,9,0,9,3,"{""src/auto/configure"": {""insertions"": 4, ""deletions"": 0, ""lines"": 4}, ""src/configure.ac"": {""insertions"": 3, ""deletions"": 0, ""lines"": 3}, ""src/version.c"": {""insertions"": 2, ""deletions"": 0, ""lines"": 2}}"
2021-01-12 19:23:40,b0e6b513648db7035046613431a4aa9d71ef4653,Bram Moolenaar,118,12,130,8,"{""runtime/doc/eval.txt"": {""insertions"": 10, ""deletions"": 0, ""lines"": 10}, ""runtime/doc/usr_41.txt"": {""insertions"": 2, ""deletions"": 0, ""lines"": 2}, ""src/evalfunc.c"": {""insertions"": 19, ""deletions"": 1, ""lines"": 20}, ""src/list.c"": {""insertions"": 62, ""deletions"": 11, ""lines"": 73}, ""src/proto/list.pro"": {""insertions"": 1, ""deletions"": 0, ""lines"": 1}, ""src/testdir/test_listdict.vim"": {""insertions"": 12, ""deletions"": 0, ""lines"": 12}, ""src/testdir/test_vim9_builtin.vim"": {""insertions"": 10, ""deletions"": 0, ""lines"": 10}, ""src/version.c"": {""insertions"": 2, ""deletions"": 0, ""lines"": 2}}"
2021-01-12 17:58:39,7cd24227c02afdb4249db406e2174eda1e6b36b4,Bram Moolenaar,22,0,22,3,"{""src/testdir/test_vim9_disassemble.vim"": {""insertions"": 15, ""deletions"": 0, ""lines"": 15}, ""src/version.c"": {""insertions"": 2, ""deletions"": 0, ""lines"": 2}, ""src/vim9compile.c"": {""insertions"": 5, ""deletions"": 0, ""lines"": 5}}"
2021-01-12 16:42:24,a0122dcd1cc9e9bb62c071a9b91426a8bce4f8d9,Bram Moolenaar,61,4,65,5,"{""runtime/autoload/dist/ft.vim"": {""insertions"": 21, ""deletions"": 2, ""lines"": 23}, ""runtime/filetype.vim"": {""insertions"": 3, ""deletions"": 1, ""lines"": 4}, ""runtime/scripts.vim"": {""insertions"": 4, ""deletions"": 0, ""lines"": 4}, ""src/testdir/test_filetype.vim"": {""insertions"": 31, ""deletions"": 1, ""lines"": 32}, ""src/version.c"": {""insertions"": 2, ""deletions"": 0, ""lines"": 2}}"
2021-01-12 16:17:01,cb6cbf29e97b7abdeb1e6cbdc5e735f5b55e97a1,Bram Moolenaar,4,2,6,2,"{""src/version.c"": {""insertions"": 2, ""deletions"": 0, ""lines"": 2}, ""src/vim9execute.c"": {""insertions"": 2, ""deletions"": 2, ""lines"": 4}}"
2021-01-11 21:16:30,9567efa1b4a41baca9b2266f5903d5dda7ad1e88,Bram Moolenaar,62,42,104,5,"{""src/scriptfile.c"": {""insertions"": 16, ""deletions"": 40, ""lines"": 56}, ""src/structs.h"": {""insertions"": 26, ""deletions"": 0, ""lines"": 26}, ""src/testdir/test_vim9_cmd.vim"": {""insertions"": 7, ""deletions"": 0, ""lines"": 7}, ""src/version.c"": {""insertions"": 2, ""deletions"": 0, ""lines"": 2}, ""src/vim9execute.c"": {""insertions"": 11, ""deletions"": 2, ""lines"": 13}}"
2021-01-11 20:20:18,082517570d1dce2faf3baa9f752ce0858355d221,Bram Moolenaar,68,18,86,7,"{""src/evalvars.c"": {""insertions"": 2, ""deletions"": 2, ""lines"": 4}, ""src/proto/vim9script.pro"": {""insertions"": 1, ""deletions"": 1, ""lines"": 2}, ""src/structs.h"": {""insertions"": 1, ""deletions"": 1, ""lines"": 2}, ""src/testdir/test_vim9_assign.vim"": {""insertions"": 16, ""deletions"": 0, ""lines"": 16}, ""src/version.c"": {""insertions"": 2, ""deletions"": 0, ""lines"": 2}, ""src/vim9compile.c"": {""insertions"": 35, ""deletions"": 10, ""lines"": 45}, ""src/vim9script.c"": {""insertions"": 11, ""deletions"": 4, ""lines"": 15}}"
2021-01-11 19:17:34,9e1d9e3473f852735ffd605a0fa4d224b81a4f0c,Bram Moolenaar,14,2,16,3,"{""src/testdir/test_vim9_script.vim"": {""insertions"": 7, ""deletions"": 1, ""lines"": 8}, ""src/version.c"": {""insertions"": 2, ""deletions"": 0, ""lines"": 2}, ""src/vim9compile.c"": {""insertions"": 5, ""deletions"": 1, ""lines"": 6}}"
2021-01-11 18:54:42,df4c9af7e73aa5d0fb5bf4c0e19a39b4e1d73517,Bram Moolenaar,78,0,78,2,"{""src/testdir/test_startup.vim"": {""insertions"": 76, ""deletions"": 0, ""lines"": 76}, ""src/version.c"": {""insertions"": 2, ""deletions"": 0, ""lines"": 2}}"
2021-01-11 18:40:15,82be4849eed0b8fbee45bc8da99b685ec89af59a,Bram Moolenaar,480,161,641,24,"{"".github/CODEOWNERS"": {""insertions"": 1, ""deletions"": 0, ""lines"": 1}, ""runtime/doc/editing.txt"": {""insertions"": 2, ""deletions"": 2, ""lines"": 4}, ""runtime/doc/options.txt"": {""insertions"": 2, ""deletions"": 2, ""lines"": 4}, ""runtime/doc/os_vms.txt"": {""insertions"": 5, ""deletions"": 3, ""lines"": 8}, ""runtime/doc/pattern.txt"": {""insertions"": 4, ""deletions"": 3, ""lines"": 7}, ""runtime/doc/tags"": {""insertions"": 11, ""deletions"": 0, ""lines"": 11}, ""runtime/doc/terminal.txt"": {""insertions"": 9, ""deletions"": 1, ""lines"": 10}, ""runtime/doc/todo.txt"": {""insertions"": 61, ""deletions"": 46, ""lines"": 107}, ""runtime/doc/usr_03.txt"": {""insertions"": 1, ""deletions"": 1, ""lines"": 2}, ""runtime/doc/usr_41.txt"": {""insertions"": 4, ""deletions"": 4, ""lines"": 8}, ""runtime/doc/vim9.txt"": {""insertions"": 51, ""deletions"": 16, ""lines"": 67}, ""runtime/ftplugin/erlang.vim"": {""insertions"": 54, ""deletions"": 58, ""lines"": 112}, ""runtime/ftplugin/fstab.vim"": {""insertions"": 2, ""deletions"": 2, ""lines"": 4}, ""runtime/ftplugin/swift.vim"": {""insertions"": 10, ""deletions"": 1, ""lines"": 11}, ""runtime/ftplugin/vim.vim"": {""insertions"": 12, ""deletions"": 7, ""lines"": 19}, ""runtime/indent/systemverilog.vim"": {""insertions"": 1, ""deletions"": 1, ""lines"": 2}, ""runtime/indent/testdir/vim.in"": {""insertions"": 19, ""deletions"": 0, ""lines"": 19}, ""runtime/indent/testdir/vim.ok"": {""insertions"": 19, ""deletions"": 0, ""lines"": 19}, ""runtime/indent/vim.vim"": {""insertions"": 44, ""deletions"": 2, ""lines"": 46}, ""runtime/lang/menu_tr.cp1254.vim"": {""insertions"": 1, ""deletions"": 1, ""lines"": 2}, ""runtime/lang/menu_tr.iso_8859-9.vim"": {""insertions"": 1, ""deletions"": 1, ""lines"": 2}, ""runtime/pack/dist/opt/termdebug/plugin/termdebug.vim"": {""insertions"": 159, ""deletions"": 3, ""lines"": 162}, ""runtime/syntax/abap.vim"": {""insertions"": 2, ""deletions"": 2, ""lines"": 4}, ""runtime/syntax/prolog.vim"": {""insertions"": 5, ""deletions"": 5, ""lines"": 10}}"
2021-01-11 17:47:00,48e11c10548782f573411b6302f77adb69c40401,Bram Moolenaar,5,2,7,3,"{""src/testdir/test_clientserver.vim"": {""insertions"": 1, ""deletions"": 0, ""lines"": 1}, ""src/testdir/test_vim9_script.vim"": {""insertions"": 2, ""deletions"": 2, ""lines"": 4}, ""src/version.c"": {""insertions"": 2, ""deletions"": 0, ""lines"": 2}}"
2021-01-10 22:58:28,16a6f91ccb42ebde639a4185322b07719d345e86,Bram Moolenaar,2,6,8,2,"{""src/version.c"": {""insertions"": 2, ""deletions"": 0, ""lines"": 2}, ""src/vim9execute.c"": {""insertions"": 0, ""deletions"": 6, ""lines"": 6}}"
2021-01-10 21:56:36,086ae06862077ba228fcae777f2a0b41416c11bb,Bram Moolenaar,3,1,4,2,"{""src/mbyte.c"": {""insertions"": 1, ""deletions"": 1, ""lines"": 2}, ""src/version.c"": {""insertions"": 2, ""deletions"": 0, ""lines"": 2}}"
2021-01-10 21:42:50,75ab91ff3403e725a79ac9c7351b78e9aff71d67,Bram Moolenaar,50,18,68,8,"{""src/evalfunc.c"": {""insertions"": 9, ""deletions"": 0, ""lines"": 9}, ""src/list.c"": {""insertions"": 7, ""deletions"": 4, ""lines"": 11}, ""src/proto/evalfunc.pro"": {""insertions"": 1, ""deletions"": 0, ""lines"": 1}, ""src/testdir/test_vim9_builtin.vim"": {""insertions"": 11, ""deletions"": 2, ""lines"": 13}, ""src/testdir/test_vim9_expr.vim"": {""insertions"": 9, ""deletions"": 9, ""lines"": 18}, ""src/testdir/test_vim9_func.vim"": {""insertions"": 3, ""deletions"": 3, ""lines"": 6}, ""src/version.c"": {""insertions"": 2, ""deletions"": 0, ""lines"": 2}, ""src/vim9compile.c"": {""insertions"": 8, ""deletions"": 0, ""lines"": 8}}"
2021-01-10 19:22:54,6f02b00bb0958f70bc15534e115b4c6dadff0e06,Bram Moolenaar,668,190,858,9,"{""runtime/doc/eval.txt"": {""insertions"": 121, ""deletions"": 29, ""lines"": 150}, ""runtime/doc/usr_41.txt"": {""insertions"": 5, ""deletions"": 0, ""lines"": 5}, ""src/eval.c"": {""insertions"": 93, ""deletions"": 7, ""lines"": 100}, ""src/evalfunc.c"": {""insertions"": 257, ""deletions"": 149, ""lines"": 406}, ""src/proto/eval.pro"": {""insertions"": 4, ""deletions"": 2, ""lines"": 6}, ""src/tag.c"": {""insertions"": 1, ""deletions"": 1, ""lines"": 2}, ""src/testdir/test_cursor_func.vim"": {""insertions"": 184, ""deletions"": 1, ""lines"": 185}, ""src/typval.c"": {""insertions"": 1, ""deletions"": 1, ""lines"": 2}, ""src/version.c"": {""insertions"": 2, ""deletions"": 0, ""lines"": 2}}"
2021-01-10 18:23:27,31a11b942a56bf75a653eec0976f365f9b389a5a,Bram Moolenaar,35,1,36,3,"{""src/testdir/test_vim9_expr.vim"": {""insertions"": 19, ""deletions"": 0, ""lines"": 19}, ""src/version.c"": {""insertions"": 2, ""deletions"": 0, ""lines"": 2}, ""src/vim9compile.c"": {""insertions"": 14, ""deletions"": 1, ""lines"": 15}}"
2021-01-10 17:33:11,0186e58639b19933d3d9188d552fe6745265eb1b,Bram Moolenaar,156,129,285,5,"{""src/structs.h"": {""insertions"": 13, ""deletions"": 7, ""lines"": 20}, ""src/testdir/test_vim9_func.vim"": {""insertions"": 7, ""deletions"": 0, ""lines"": 7}, ""src/version.c"": {""insertions"": 2, ""deletions"": 0, ""lines"": 2}, ""src/vim9.h"": {""insertions"": 8, ""deletions"": 5, ""lines"": 13}, ""src/vim9execute.c"": {""insertions"": 126, ""deletions"": 117, ""lines"": 243}}"
2021-01-10 13:02:28,ab360526ef653b139f4b007a0efbdb3410c8fb4b,Bram Moolenaar,177,43,220,7,"{""src/structs.h"": {""insertions"": 2, ""deletions"": 0, ""lines"": 2}, ""src/testdir/test_vim9_disassemble.vim"": {""insertions"": 3, ""deletions"": 3, ""lines"": 6}, ""src/testdir/test_vim9_func.vim"": {""insertions"": 10, ""deletions"": 0, ""lines"": 10}, ""src/version.c"": {""insertions"": 2, ""deletions"": 0, ""lines"": 2}, ""src/vim9.h"": {""insertions"": 9, ""deletions"": 2, ""lines"": 11}, ""src/vim9compile.c"": {""insertions"": 61, ""deletions"": 18, ""lines"": 79}, ""src/vim9execute.c"": {""insertions"": 90, ""deletions"": 20, ""lines"": 110}}"
2021-01-09 15:21:37,cff40ff98664f4f5a9631aff1a155caf762ea74b,Bram Moolenaar,40,0,40,4,"{""src/errors.h"": {""insertions"": 2, ""deletions"": 0, ""lines"": 2}, ""src/testdir/test_vim9_expr.vim"": {""insertions"": 12, ""deletions"": 0, ""lines"": 12}, ""src/typval.c"": {""insertions"": 24, ""deletions"": 0, ""lines"": 24}, ""src/version.c"": {""insertions"": 2, ""deletions"": 0, ""lines"": 2}}"
2021-01-09 14:45:23,657137ca487c60d63989236115115161def270a5,Bram Moolenaar,26,24,50,9,"{""src/eval.c"": {""insertions"": 1, ""deletions"": 1, ""lines"": 2}, ""src/proto/typval.pro"": {""insertions"": 1, ""deletions"": 1, ""lines"": 2}, ""src/proto/vim9compile.pro"": {""insertions"": 2, ""deletions"": 2, ""lines"": 4}, ""src/structs.h"": {""insertions"": 1, ""deletions"": 1, ""lines"": 2}, ""src/typval.c"": {""insertions"": 1, ""deletions"": 1, ""lines"": 2}, ""src/version.c"": {""insertions"": 2, ""deletions"": 0, ""lines"": 2}, ""src/vim9.h"": {""insertions"": 3, ""deletions"": 3, ""lines"": 6}, ""src/vim9compile.c"": {""insertions"": 13, ""deletions"": 13, ""lines"": 26}, ""src/vim9execute.c"": {""insertions"": 2, ""deletions"": 2, ""lines"": 4}}"
2021-01-09 12:20:37,e7525c552060dd04aacdbca6bb5fe6460cf4da60,Bram Moolenaar,121,101,222,7,"{""src/eval.c"": {""insertions"": 0, ""deletions"": 91, ""lines"": 91}, ""src/list.c"": {""insertions"": 1, ""deletions"": 1, ""lines"": 2}, ""src/proto/eval.pro"": {""insertions"": 0, ""deletions"": 2, ""lines"": 2}, ""src/proto/vim9execute.pro"": {""insertions"": 2, ""deletions"": 0, ""lines"": 2}, ""src/testdir/test_vim9_expr.vim"": {""insertions"": 14, ""deletions"": 7, ""lines"": 21}, ""src/version.c"": {""insertions"": 2, ""deletions"": 0, ""lines"": 2}, ""src/vim9execute.c"": {""insertions"": 102, ""deletions"": 0, ""lines"": 102}}"
2021-01-09 11:09:22,9e0f883f89c915e08ef5fd9e6bf382af57fa9eb2,Bram Moolenaar,30,19,49,3,"{""src/ex_docmd.c"": {""insertions"": 7, ""deletions"": 4, ""lines"": 11}, ""src/testdir/test_vim9_assign.vim"": {""insertions"": 21, ""deletions"": 15, ""lines"": 36}, ""src/version.c"": {""insertions"": 2, ""deletions"": 0, ""lines"": 2}}"
2021-01-08 21:24:19,b657198cb30765468451d7f68fce49b5b4000c5d,Bram Moolenaar,21,1,22,3,"{""src/testdir/test_vim9_func.vim"": {""insertions"": 10, ""deletions"": 0, ""lines"": 10}, ""src/userfunc.c"": {""insertions"": 9, ""deletions"": 1, ""lines"": 10}, ""src/version.c"": {""insertions"": 2, ""deletions"": 0, ""lines"": 2}}"
2021-01-08 20:55:26,832ea89ca90cdff019ee7cf31d5c44bfa164313a,Bram Moolenaar,14,2,16,3,"{""src/testdir/test_vim9_func.vim"": {""insertions"": 8, ""deletions"": 0, ""lines"": 8}, ""src/userfunc.c"": {""insertions"": 4, ""deletions"": 2, ""lines"": 6}, ""src/version.c"": {""insertions"": 2, ""deletions"": 0, ""lines"": 2}}"
2021-01-08 19:53:09,299f3036ec21cc9735846b2e0dfdfc5a78b26c1c,Bram Moolenaar,42,50,92,5,"{""src/testdir/test_vim9_disassemble.vim"": {""insertions"": 24, ""deletions"": 48, ""lines"": 72}, ""src/version.c"": {""insertions"": 2, ""deletions"": 0, ""lines"": 2}, ""src/vim9.h"": {""insertions"": 1, ""deletions"": 0, ""lines"": 1}, ""src/vim9compile.c"": {""insertions"": 2, ""deletions"": 2, ""lines"": 4}, ""src/vim9execute.c"": {""insertions"": 13, ""deletions"": 0, ""lines"": 13}}"
2021-01-08 19:40:45,ece0b87c0fb0e35ff4c51f9ba81389f56428e42b,Bram Moolenaar,11,1,12,3,"{""src/testdir/test_vim9_cmd.vim"": {""insertions"": 6, ""deletions"": 0, ""lines"": 6}, ""src/version.c"": {""insertions"": 2, ""deletions"": 0, ""lines"": 2}, ""src/vim9execute.c"": {""insertions"": 3, ""deletions"": 1, ""lines"": 4}}"
2021-01-08 18:31:39,467b59c2eb06f7fe6c2b5b677855cd422adbc45c,Bram Moolenaar,4,0,4,2,"{""src/if_ruby.c"": {""insertions"": 2, ""deletions"": 0, ""lines"": 2}, ""src/version.c"": {""insertions"": 2, ""deletions"": 0, ""lines"": 2}}"
2021-01-07 21:03:02,17126b13969c3b91516a8e9ff80fb6a1f6924d40,Bram Moolenaar,120,61,181,4,"{""src/ex_docmd.c"": {""insertions"": 19, ""deletions"": 0, ""lines"": 19}, ""src/testdir/test_vim9_assign.vim"": {""insertions"": 21, ""deletions"": 0, ""lines"": 21}, ""src/version.c"": {""insertions"": 2, ""deletions"": 0, ""lines"": 2}, ""src/vim9compile.c"": {""insertions"": 78, ""deletions"": 61, ""lines"": 139}}"
2021-01-07 19:23:33,43b69b39acb85a2aab2310cba5a2dbac338a4eb9,Bram Moolenaar,13,1,14,3,"{""src/evalfunc.c"": {""insertions"": 1, ""deletions"": 1, ""lines"": 2}, ""src/testdir/test_vim9_builtin.vim"": {""insertions"": 10, ""deletions"": 0, ""lines"": 10}, ""src/version.c"": {""insertions"": 2, ""deletions"": 0, ""lines"": 2}}"
2021-01-07 18:36:30,c37b655443e0a11a77a9f0707e3259ab4b8b3dda,Bram Moolenaar,11,1,12,3,"{""src/charset.c"": {""insertions"": 7, ""deletions"": 1, ""lines"": 8}, ""src/testdir/test_eval_stuff.vim"": {""insertions"": 2, ""deletions"": 0, ""lines"": 2}, ""src/version.c"": {""insertions"": 2, ""deletions"": 0, ""lines"": 2}}"
2021-01-07 18:23:08,328eac2b5d1569c57e1130ecb9f7cca733b84d78,Bram Moolenaar,16,4,20,5,"{""src/testdir/test_vim9_assign.vim"": {""insertions"": 7, ""deletions"": 0, ""lines"": 7}, ""src/testdir/test_vim9_func.vim"": {""insertions"": 1, ""deletions"": 1, ""lines"": 2}, ""src/userfunc.c"": {""insertions"": 1, ""deletions"": 1, ""lines"": 2}, ""src/version.c"": {""insertions"": 2, ""deletions"": 0, ""lines"": 2}, ""src/vim9compile.c"": {""insertions"": 5, ""deletions"": 2, ""lines"": 7}}"
2021-01-07 13:45:03,ebbf11c1198b7aec8a1a55f7231ecb4f1a432fa0,Bram Moolenaar,3,5,8,2,"{""src/ex_cmds.c"": {""insertions"": 1, ""deletions"": 5, ""lines"": 6}, ""src/version.c"": {""insertions"": 2, ""deletions"": 0, ""lines"": 2}}"
2021-01-06 20:59:39,32b3f820107139d7edf0c592bb06f090c3eb6c51,Bram Moolenaar,154,54,208,12,"{""src/eval.c"": {""insertions"": 13, ""deletions"": 7, ""lines"": 20}, ""src/evalfunc.c"": {""insertions"": 2, ""deletions"": 1, ""lines"": 3}, ""src/evalvars.c"": {""insertions"": 4, ""deletions"": 6, ""lines"": 10}, ""src/proto/userfunc.pro"": {""insertions"": 2, ""deletions"": 2, ""lines"": 4}, ""src/proto/vim9type.pro"": {""insertions"": 1, ""deletions"": 0, ""lines"": 1}, ""src/structs.h"": {""insertions"": 1, ""deletions"": 0, ""lines"": 1}, ""src/testdir/test_vim9_func.vim"": {""insertions"": 16, ""deletions"": 0, ""lines"": 16}, ""src/userfunc.c"": {""insertions"": 70, ""deletions"": 35, ""lines"": 105}, ""src/version.c"": {""insertions"": 2, ""deletions"": 0, ""lines"": 2}, ""src/vim9compile.c"": {""insertions"": 2, ""deletions"": 2, ""lines"": 4}, ""src/vim9execute.c"": {""insertions"": 1, ""deletions"": 1, ""lines"": 2}, ""src/vim9type.c"": {""insertions"": 40, ""deletions"": 0, ""lines"": 40}}"
2021-01-05 21:08:20,b23279d7a2d28de5df942924b77cf23672fc684f,Bram Moolenaar,75,23,98,5,"{""src/eval.c"": {""insertions"": 24, ""deletions"": 2, ""lines"": 26}, ""src/proto/eval.pro"": {""insertions"": 1, ""deletions"": 0, ""lines"": 1}, ""src/testdir/test_vim9_expr.vim"": {""insertions"": 46, ""deletions"": 19, ""lines"": 65}, ""src/version.c"": {""insertions"": 2, ""deletions"": 0, ""lines"": 2}, ""src/vim9compile.c"": {""insertions"": 2, ""deletions"": 2, ""lines"": 4}}"
2021-01-05 19:58:25,0acbf5ae6632b36c2d2f93406478270ef21f528b,Bram Moolenaar,44,12,56,3,"{""src/testdir/test_vim9_assign.vim"": {""insertions"": 37, ""deletions"": 12, ""lines"": 49}, ""src/version.c"": {""insertions"": 2, ""deletions"": 0, ""lines"": 2}, ""src/vim9execute.c"": {""insertions"": 5, ""deletions"": 0, ""lines"": 5}}"
2021-01-05 18:23:28,ecac591cce23919059a5d93ed2e94541b1be99b5,Bram Moolenaar,26,0,26,3,"{""src/testdir/test_vim9_cmd.vim"": {""insertions"": 17, ""deletions"": 0, ""lines"": 17}, ""src/version.c"": {""insertions"": 2, ""deletions"": 0, ""lines"": 2}, ""src/vim9compile.c"": {""insertions"": 7, ""deletions"": 0, ""lines"": 7}}"
2021-01-05 16:50:28,a79925a0a8f00577782090859eb0ef69e220d4aa,Bram Moolenaar,12,0,12,3,"{""src/testdir/test_vim9_expr.vim"": {""insertions"": 9, ""deletions"": 0, ""lines"": 9}, ""src/typval.c"": {""insertions"": 1, ""deletions"": 0, ""lines"": 1}, ""src/version.c"": {""insertions"": 2, ""deletions"": 0, ""lines"": 2}}"
2021-01-04 20:57:11,752fc692ace51459cb407ec117c147b3bbebc071,Bram Moolenaar,685,433,1118,5,"{""src/testdir/test_vim9_assign.vim"": {""insertions"": 40, ""deletions"": 7, ""lines"": 47}, ""src/version.c"": {""insertions"": 2, ""deletions"": 0, ""lines"": 2}, ""src/vim9.h"": {""insertions"": 1, ""deletions"": 0, ""lines"": 1}, ""src/vim9compile.c"": {""insertions"": 550, ""deletions"": 426, ""lines"": 976}, ""src/vim9execute.c"": {""insertions"": 92, ""deletions"": 0, ""lines"": 92}}"
2021-01-04 16:40:12,d62d87d8f3f337a25b7da72abf55fc8a4bb6100c,Bram Moolenaar,6,0,6,3,"{""src/testdir/test_vim9_expr.vim"": {""insertions"": 2, ""deletions"": 0, ""lines"": 2}, ""src/version.c"": {""insertions"": 2, ""deletions"": 0, ""lines"": 2}, ""src/vim9compile.c"": {""insertions"": 2, ""deletions"": 0, ""lines"": 2}}"
2021-01-04 15:15:58,d1510ee9469f623c872a18b6e3c3666c0fb23c58,Bram Moolenaar,40,6,46,6,"{""src/errors.h"": {""insertions"": 2, ""deletions"": 0, ""lines"": 2}, ""src/ex_docmd.c"": {""insertions"": 5, ""deletions"": 3, ""lines"": 8}, ""src/testdir/test_vim9_cmd.vim"": {""insertions"": 23, ""deletions"": 3, ""lines"": 26}, ""src/version.c"": {""insertions"": 2, ""deletions"": 0, ""lines"": 2}, ""src/vim9compile.c"": {""insertions"": 7, ""deletions"": 0, ""lines"": 7}, ""src/vim9execute.c"": {""insertions"": 1, ""deletions"": 0, ""lines"": 1}}"
2021-01-04 13:09:43,cef1270dec61efb3544f26ceea0f6a4f57e0198a,Bram Moolenaar,54,9,63,4,"{""src/proto/userfunc.pro"": {""insertions"": 0, ""deletions"": 1, ""lines"": 1}, ""src/testdir/test_vim9_func.vim"": {""insertions"": 36, ""deletions"": 0, ""lines"": 36}, ""src/userfunc.c"": {""insertions"": 16, ""deletions"": 8, ""lines"": 24}, ""src/version.c"": {""insertions"": 2, ""deletions"": 0, ""lines"": 2}}"
2021-01-04 12:37:54,0ea04408653be843e37d03ce574f5d2eae682339,Bram Moolenaar,19,2,21,3,"{""src/evalvars.c"": {""insertions"": 8, ""deletions"": 2, ""lines"": 10}, ""src/testdir/test_vim9_assign.vim"": {""insertions"": 9, ""deletions"": 0, ""lines"": 9}, ""src/version.c"": {""insertions"": 2, ""deletions"": 0, ""lines"": 2}}"
2021-01-04 12:18:30,014f698cb68ff80c49f9f5d3dbe78127df281885,Bram Moolenaar,13,4,17,4,"{""runtime/doc/popup.txt"": {""insertions"": 2, ""deletions"": 2, ""lines"": 4}, ""src/popupwin.c"": {""insertions"": 3, ""deletions"": 2, ""lines"": 5}, ""src/testdir/test_popupwin.vim"": {""insertions"": 6, ""deletions"": 0, ""lines"": 6}, ""src/version.c"": {""insertions"": 2, ""deletions"": 0, ""lines"": 2}}"
2021-01-04 11:42:13,d93a7fc1a98a58f8101ee780d4735079ad99ae35,Bram Moolenaar,125,40,165,15,"{""src/ex_cmds.c"": {""insertions"": 2, ""deletions"": 2, ""lines"": 4}, ""src/ex_docmd.c"": {""insertions"": 3, ""deletions"": 2, ""lines"": 5}, ""src/ex_getln.c"": {""insertions"": 36, ""deletions"": 12, ""lines"": 48}, ""src/globals.h"": {""insertions"": 3, ""deletions"": 4, ""lines"": 7}, ""src/option.c"": {""insertions"": 3, ""deletions"": 3, ""lines"": 6}, ""src/proto/regexp.pro"": {""insertions"": 1, ""deletions"": 1, ""lines"": 2}, ""src/regexp.c"": {""insertions"": 8, ""deletions"": 8, ""lines"": 16}, ""src/search.c"": {""insertions"": 1, ""deletions"": 1, ""lines"": 2}, ""src/structs.h"": {""insertions"": 15, ""deletions"": 3, ""lines"": 18}, ""src/tag.c"": {""insertions"": 2, ""deletions"": 2, ""lines"": 4}, ""src/testdir/dumps/Test_incsearch_sub_01.dump"": {""insertions"": 9, ""deletions"": 0, ""lines"": 9}, ""src/testdir/dumps/Test_incsearch_sub_02.dump"": {""insertions"": 9, ""deletions"": 0, ""lines"": 9}, ""src/testdir/test_search.vim"": {""insertions"": 29, ""deletions"": 0, ""lines"": 29}, ""src/version.c"": {""insertions"": 2, ""deletions"": 0, ""lines"": 2}, ""src/vim9compile.c"": {""insertions"": 2, ""deletions"": 2, ""lines"": 4}}"
2021-01-04 09:47:26,82c38fe508155c11a904e6111b5bfb6adde3fb9a,Bram Moolenaar,110,54,164,9,"{""src/Make_vms.mms"": {""insertions"": 44, ""deletions"": 17, ""lines"": 61}, ""src/fileio.c"": {""insertions"": 7, ""deletions"": 2, ""lines"": 9}, ""src/gui_xmebw.c"": {""insertions"": 24, ""deletions"": 10, ""lines"": 34}, ""src/macros.h"": {""insertions"": 0, ""deletions"": 1, ""lines"": 1}, ""src/os_unix.h"": {""insertions"": 3, ""deletions"": 2, ""lines"": 5}, ""src/os_vms.c"": {""insertions"": 11, ""deletions"": 2, ""lines"": 13}, ""src/os_vms_conf.h"": {""insertions"": 6, ""deletions"": 7, ""lines"": 13}, ""src/version.c"": {""insertions"": 2, ""deletions"": 0, ""lines"": 2}, ""src/vim9execute.c"": {""insertions"": 13, ""deletions"": 13, ""lines"": 26}}"
2021-01-03 21:12:15,bb0956fc65ebe8df1da823f9c4d6a0013d9ba5c1,Bram Moolenaar,3,1,4,2,"{""src/gui_motif.c"": {""insertions"": 1, ""deletions"": 1, ""lines"": 2}, ""src/version.c"": {""insertions"": 2, ""deletions"": 0, ""lines"": 2}}"
2021-01-03 21:05:19,5f63938447f3eebd1fc4add999ff8d5b42899178,Bram Moolenaar,10,1,11,2,"{""src/eval.c"": {""insertions"": 8, ""deletions"": 1, ""lines"": 9}, ""src/version.c"": {""insertions"": 2, ""deletions"": 0, ""lines"": 2}}"
2021-01-03 20:53:53,67977821270bd328cd37c4ace38fb97f21ad4fd5,Bram Moolenaar,28,8,36,5,"{""runtime/doc/vim9.txt"": {""insertions"": 6, ""deletions"": 6, ""lines"": 12}, ""src/evalvars.c"": {""insertions"": 1, ""deletions"": 1, ""lines"": 2}, ""src/testdir/test_vim9_expr.vim"": {""insertions"": 4, ""deletions"": 1, ""lines"": 5}, ""src/version.c"": {""insertions"": 2, ""deletions"": 0, ""lines"": 2}, ""src/vim9compile.c"": {""insertions"": 15, ""deletions"": 0, ""lines"": 15}}"
2021-01-03 19:55:26,2ef951dd31505874ae9ac35a18513ef34ae0ea3e,Bram Moolenaar,26,3,29,5,"{""src/eval.c"": {""insertions"": 2, ""deletions"": 2, ""lines"": 4}, ""src/testdir/test_vim9_assign.vim"": {""insertions"": 9, ""deletions"": 0, ""lines"": 9}, ""src/version.c"": {""insertions"": 2, ""deletions"": 0, ""lines"": 2}, ""src/vim.h"": {""insertions"": 2, ""deletions"": 0, ""lines"": 2}, ""src/vim9compile.c"": {""insertions"": 11, ""deletions"": 1, ""lines"": 12}}"
2021-01-03 18:52:05,e5a2dc87fd9d63dfd0d9c379e363ee8b8c05b14c,Bram Moolenaar,56,11,67,10,"{""src/eval.c"": {""insertions"": 7, ""deletions"": 1, ""lines"": 8}, ""src/evalbuffer.c"": {""insertions"": 1, ""deletions"": 1, ""lines"": 2}, ""src/evalfunc.c"": {""insertions"": 8, ""deletions"": 2, ""lines"": 10}, ""src/ex_eval.c"": {""insertions"": 1, ""deletions"": 1, ""lines"": 2}, ""src/gui_motif.c"": {""insertions"": 1, ""deletions"": 1, ""lines"": 2}, ""src/map.c"": {""insertions"": 1, ""deletions"": 1, ""lines"": 2}, ""src/quickfix.c"": {""insertions"": 13, ""deletions"": 2, ""lines"": 15}, ""src/syntax.c"": {""insertions"": 2, ""deletions"": 2, ""lines"": 4}, ""src/testdir/test_quickfix.vim"": {""insertions"": 20, ""deletions"": 0, ""lines"": 20}, ""src/version.c"": {""insertions"": 2, ""deletions"": 0, ""lines"": 2}}"
2021-01-03 17:33:13,5afd081cd3d0f3dfbc7f6b157a8caad0ce6394ee,Bram Moolenaar,22,23,45,3,"{""src/testdir/test_vim9_expr.vim"": {""insertions"": 10, ""deletions"": 1, ""lines"": 11}, ""src/version.c"": {""insertions"": 2, ""deletions"": 0, ""lines"": 2}, ""src/vim9compile.c"": {""insertions"": 10, ""deletions"": 22, ""lines"": 32}}"
2021-01-03 16:39:28,cec77d4530ae51ee9ffe0ab57fa7a37cced2b181,Bram Moolenaar,14,12,26,2,"{""src/testdir/test_sort.vim"": {""insertions"": 12, ""deletions"": 12, ""lines"": 24}, ""src/version.c"": {""insertions"": 2, ""deletions"": 0, ""lines"": 2}}"
2021-01-03 15:18:04,fefa6c347e2c7f01ed2b095084f4aa694ff72149,Bram Moolenaar,111,55,166,2,"{""src/testdir/test_sort.vim"": {""insertions"": 109, ""deletions"": 55, ""lines"": 164}, ""src/version.c"": {""insertions"": 2, ""deletions"": 0, ""lines"": 2}}"
2021-01-03 14:55:10,b0d8182fa39f2c9403f5f9a0663589fcab43a6c8,Bram Moolenaar,13,3,16,3,"{""src/evalvars.c"": {""insertions"": 9, ""deletions"": 3, ""lines"": 12}, ""src/testdir/test_vim9_builtin.vim"": {""insertions"": 2, ""deletions"": 0, ""lines"": 2}, ""src/version.c"": {""insertions"": 2, ""deletions"": 0, ""lines"": 2}}"
2021-01-03 13:47:25,31a201a04aa95708af5d62070d2d397a201cc1a5,Bram Moolenaar,13,1,14,3,"{""src/evalvars.c"": {""insertions"": 3, ""deletions"": 1, ""lines"": 4}, ""src/testdir/test_vim9_builtin.vim"": {""insertions"": 8, ""deletions"": 0, ""lines"": 8}, ""src/version.c"": {""insertions"": 2, ""deletions"": 0, ""lines"": 2}}"
2021-01-03 12:09:51,e68b02a1c40388bbb85e7b825bc538298963e1e1,Bram Moolenaar,17,2,19,3,"{""src/testdir/test_vim9_func.vim"": {""insertions"": 12, ""deletions"": 0, ""lines"": 12}, ""src/version.c"": {""insertions"": 2, ""deletions"": 0, ""lines"": 2}, ""src/vim9type.c"": {""insertions"": 3, ""deletions"": 2, ""lines"": 5}}"
2021-01-02 19:14:23,339c1bdbdfb823c4ea36242f0a4f083cbc010b84,Bram Moolenaar,6,6,12,2,"{""src/ui.c"": {""insertions"": 4, ""deletions"": 6, ""lines"": 10}, ""src/version.c"": {""insertions"": 2, ""deletions"": 0, ""lines"": 2}}"
2021-01-02 18:44:56,a11919fa44fb43e947ef7871f31096a79429ec8a,Bram Moolenaar,26,0,26,3,"{""src/testdir/test_vim9_cmd.vim"": {""insertions"": 10, ""deletions"": 0, ""lines"": 10}, ""src/version.c"": {""insertions"": 2, ""deletions"": 0, ""lines"": 2}, ""src/vim9compile.c"": {""insertions"": 14, ""deletions"": 0, ""lines"": 14}}"
2021-01-02 17:31:32,9d19e4f4ba55f8bef18d4991abdf740ff6472dba,Bram Moolenaar,79,58,137,4,"{""runtime/doc/eval.txt"": {""insertions"": 8, ""deletions"": 8, ""lines"": 16}, ""src/search.c"": {""insertions"": 25, ""deletions"": 6, ""lines"": 31}, ""src/testdir/test_matchfuzzy.vim"": {""insertions"": 44, ""deletions"": 44, ""lines"": 88}, ""src/version.c"": {""insertions"": 2, ""deletions"": 0, ""lines"": 2}}"
2021-01-02 17:17:26,508b5618ec0bc6d1edff71e04d99280a2a51df9d,Bram Moolenaar,7,1,8,2,"{""src/version.c"": {""insertions"": 2, ""deletions"": 0, ""lines"": 2}, ""src/vim9compile.c"": {""insertions"": 5, ""deletions"": 1, ""lines"": 6}}"
2021-01-02 16:43:49,66c50c565321d4d49d8d5620912e5e8fe4825644,Bram Moolenaar,73,3,76,4,"{""src/regexp.c"": {""insertions"": 8, ""deletions"": 1, ""lines"": 9}, ""src/regexp_nfa.c"": {""insertions"": 17, ""deletions"": 2, ""lines"": 19}, ""src/testdir/test_regexp_utf8.vim"": {""insertions"": 46, ""deletions"": 0, ""lines"": 46}, ""src/version.c"": {""insertions"": 2, ""deletions"": 0, ""lines"": 2}}"
2021-01-02 16:06:16,9281c6cae4e1cec2c661487d761d407bad7c6ad6,Bram Moolenaar,3,1,4,2,"{""Filelist"": {""insertions"": 1, ""deletions"": 1, ""lines"": 2}, ""src/version.c"": {""insertions"": 2, ""deletions"": 0, ""lines"": 2}}"
2021-01-02 15:53:13,a72514945bc3edd4fc4d745004e37c5d5487c98d,Bram Moolenaar,18,15,33,8,"{""Filelist"": {""insertions"": 9, ""deletions"": 6, ""lines"": 15}, ""src/clipboard.c"": {""insertions"": 2, ""deletions"": 0, ""lines"": 2}, ""src/fileio.c"": {""insertions"": 1, ""deletions"": 0, ""lines"": 1}, ""src/option.c"": {""insertions"": 1, ""deletions"": 1, ""lines"": 2}, ""src/screen.c"": {""insertions"": 0, ""deletions"": 1, ""lines"": 1}, ""src/testdir/Make_vms.mms"": {""insertions"": 1, ""deletions"": 1, ""lines"": 2}, ""src/testdir/test_signals.vim"": {""insertions"": 2, ""deletions"": 6, ""lines"": 8}, ""src/version.c"": {""insertions"": 2, ""deletions"": 0, ""lines"": 2}}"
2021-01-02 15:39:53,7e6a515ed14e204fafb3dd6e98f2fb543e64aedd,Bram Moolenaar,1730,692,2422,33,"{"".github/CODEOWNERS"": {""insertions"": 0, ""deletions"": 1, ""lines"": 1}, ""runtime/compiler/ocaml.vim"": {""insertions"": 4, ""deletions"": 2, ""lines"": 6}, ""runtime/doc/cmdline.txt"": {""insertions"": 11, ""deletions"": 1, ""lines"": 12}, ""runtime/doc/eval.txt"": {""insertions"": 4, ""deletions"": 4, ""lines"": 8}, ""runtime/doc/helphelp.txt"": {""insertions"": 4, ""deletions"": 1, ""lines"": 5}, ""runtime/doc/intro.txt"": {""insertions"": 3, ""deletions"": 3, ""lines"": 6}, ""runtime/doc/message.txt"": {""insertions"": 4, ""deletions"": 1, ""lines"": 5}, ""runtime/doc/os_vms.txt"": {""insertions"": 9, ""deletions"": 2, ""lines"": 11}, ""runtime/doc/pattern.txt"": {""insertions"": 22, ""deletions"": 20, ""lines"": 42}, ""runtime/doc/repeat.txt"": {""insertions"": 9, ""deletions"": 1, ""lines"": 10}, ""runtime/doc/tags"": {""insertions"": 17, ""deletions"": 3, ""lines"": 20}, ""runtime/doc/term.txt"": {""insertions"": 1, ""deletions"": 1, ""lines"": 2}, ""runtime/doc/terminal.txt"": {""insertions"": 4, ""deletions"": 1, ""lines"": 5}, ""runtime/doc/tips.txt"": {""insertions"": 26, ""deletions"": 1, ""lines"": 27}, ""runtime/doc/todo.txt"": {""insertions"": 56, ""deletions"": 46, ""lines"": 102}, ""runtime/doc/version8.txt"": {""insertions"": 7, ""deletions"": 7, ""lines"": 14}, ""runtime/doc/vim9.txt"": {""insertions"": 17, ""deletions"": 7, ""lines"": 24}, ""runtime/filetype.vim"": {""insertions"": 1, ""deletions"": 1, ""lines"": 2}, ""runtime/ftplugin/dune.vim"": {""insertions"": 1, ""deletions"": 1, ""lines"": 2}, ""runtime/ftplugin/fstab.vim"": {""insertions"": 19, ""deletions"": 0, ""lines"": 19}, ""runtime/ftplugin/ocaml.vim"": {""insertions"": 7, ""deletions"": 6, ""lines"": 13}, ""runtime/ftplugin/sexplib.vim"": {""insertions"": 15, ""deletions"": 0, ""lines"": 15}, ""runtime/indent/dune.vim"": {""insertions"": 13, ""deletions"": 0, ""lines"": 13}, ""runtime/indent/ocaml.vim"": {""insertions"": 3, ""deletions"": 2, ""lines"": 5}, ""runtime/syntax/diff.vim"": {""insertions"": 11, ""deletions"": 6, ""lines"": 17}, ""runtime/syntax/dune.vim"": {""insertions"": 3, ""deletions"": 2, ""lines"": 5}, ""runtime/syntax/fstab.vim"": {""insertions"": 2, ""deletions"": 2, ""lines"": 4}, ""runtime/syntax/gift.vim"": {""insertions"": 216, ""deletions"": 0, ""lines"": 216}, ""runtime/syntax/ocaml.vim"": {""insertions"": 42, ""deletions"": 19, ""lines"": 61}, ""runtime/syntax/opam.vim"": {""insertions"": 38, ""deletions"": 0, ""lines"": 38}, ""runtime/syntax/sexplib.vim"": {""insertions"": 88, ""deletions"": 0, ""lines"": 88}, ""runtime/syntax/sml.vim"": {""insertions"": 47, ""deletions"": 44, ""lines"": 91}, ""src/po/fr.po"": {""insertions"": 1026, ""deletions"": 507, ""lines"": 1533}}"
2021-01-02 15:17:18,02faa944c69ea22a7a5338135b686dac2c946ca1,Bram Moolenaar,7,2,9,2,"{""src/ui.c"": {""insertions"": 5, ""deletions"": 2, ""lines"": 7}, ""src/version.c"": {""insertions"": 2, ""deletions"": 0, ""lines"": 2}}"
2021-01-02 15:06:44,2f91e2f8da572123e53ae7579dde57c750137def,Bram Moolenaar,3,1,4,2,"{""README.md"": {""insertions"": 1, ""deletions"": 1, ""lines"": 2}, ""src/version.c"": {""insertions"": 2, ""deletions"": 0, ""lines"": 2}}"
2021-01-02 14:49:28,628c102d128b4e376916ba38b883eb9ae9f41f31,Bram Moolenaar,4,1,5,2,"{""src/version.c"": {""insertions"": 2, ""deletions"": 0, ""lines"": 2}, ""src/vim9.h"": {""insertions"": 2, ""deletions"": 1, ""lines"": 3}}"
2021-01-02 14:41:03,aa210a3aeccc33c6051978017959126b037f94af,Bram Moolenaar,149,13,162,11,"{""src/dict.c"": {""insertions"": 13, ""deletions"": 0, ""lines"": 13}, ""src/evalvars.c"": {""insertions"": 12, ""deletions"": 4, ""lines"": 16}, ""src/list.c"": {""insertions"": 7, ""deletions"": 2, ""lines"": 9}, ""src/proto/vim9script.pro"": {""insertions"": 1, ""deletions"": 1, ""lines"": 2}, ""src/structs.h"": {""insertions"": 2, ""deletions"": 0, ""lines"": 2}, ""src/testdir/test_vim9_builtin.vim"": {""insertions"": 51, ""deletions"": 0, ""lines"": 51}, ""src/testdir/test_vim9_disassemble.vim"": {""insertions"": 5, ""deletions"": 0, ""lines"": 5}, ""src/version.c"": {""insertions"": 2, ""deletions"": 0, ""lines"": 2}, ""src/vim9compile.c"": {""insertions"": 24, ""deletions"": 0, ""lines"": 24}, ""src/vim9execute.c"": {""insertions"": 27, ""deletions"": 0, ""lines"": 27}, ""src/vim9script.c"": {""insertions"": 5, ""deletions"": 6, ""lines"": 11}}"
2021-01-02 12:53:59,3e0107ea16349b354e0e9712e95b09ef019e99e5,Bram Moolenaar,41,0,41,3,"{""src/evalbuffer.c"": {""insertions"": 6, ""deletions"": 0, ""lines"": 6}, ""src/testdir/test_python3.vim"": {""insertions"": 33, ""deletions"": 0, ""lines"": 33}, ""src/version.c"": {""insertions"": 2, ""deletions"": 0, ""lines"": 2}}"
2021-01-02 11:45:45,38a434f7ba89ab2602019476219780e07fd8251f,Bram Moolenaar,3,1,4,2,"{""src/version.c"": {""insertions"": 2, ""deletions"": 0, ""lines"": 2}, ""src/vim9execute.c"": {""insertions"": 1, ""deletions"": 1, ""lines"": 2}}"
2021-01-01 20:34:37,edc10b541b468f5f5aa2e2d5ef58a3e17e043bff,Bram Moolenaar,17,8,25,2,"{""src/testdir/test_hardcopy.vim"": {""insertions"": 15, ""deletions"": 8, ""lines"": 23}, ""src/version.c"": {""insertions"": 2, ""deletions"": 0, ""lines"": 2}}"
2021-01-01 20:05:55,3862ea3f620f02569c2d816ca9ceeeac3a0ad901,Bram Moolenaar,54,15,69,7,"{""src/eval.c"": {""insertions"": 1, ""deletions"": 1, ""lines"": 2}, ""src/evalvars.c"": {""insertions"": 17, ""deletions"": 9, ""lines"": 26}, ""src/testdir/test_vim9_assign.vim"": {""insertions"": 26, ""deletions"": 4, ""lines"": 30}, ""src/version.c"": {""insertions"": 2, ""deletions"": 0, ""lines"": 2}, ""src/vim.h"": {""insertions"": 1, ""deletions"": 0, ""lines"": 1}, ""src/vim9compile.c"": {""insertions"": 6, ""deletions"": 0, ""lines"": 6}, ""src/vim9execute.c"": {""insertions"": 1, ""deletions"": 1, ""lines"": 2}}"
2021-01-01 18:40:02,c368957b1904bfaa2b0b52bbcade51b20173f3ed,Bram Moolenaar,35,13,48,3,"{""src/evalvars.c"": {""insertions"": 1, ""deletions"": 1, ""lines"": 2}, ""src/testdir/test_vim9_assign.vim"": {""insertions"": 32, ""deletions"": 12, ""lines"": 44}, ""src/version.c"": {""insertions"": 2, ""deletions"": 0, ""lines"": 2}}"
2021-01-01 18:17:55,e7a73e07625b64a40671a0007ad38a34cbe9d1ee,Bram Moolenaar,35,24,59,7,"{""src/errors.h"": {""insertions"": 2, ""deletions"": 2, ""lines"": 4}, ""src/eval.c"": {""insertions"": 4, ""deletions"": 2, ""lines"": 6}, ""src/evalvars.c"": {""insertions"": 2, ""deletions"": 1, ""lines"": 3}, ""src/testdir/test_vim9_expr.vim"": {""insertions"": 12, ""deletions"": 10, ""lines"": 22}, ""src/userfunc.c"": {""insertions"": 2, ""deletions"": 2, ""lines"": 4}, ""src/version.c"": {""insertions"": 2, ""deletions"": 0, ""lines"": 2}, ""src/vim9compile.c"": {""insertions"": 11, ""deletions"": 7, ""lines"": 18}}"
2021-01-01 17:54:34,b8ba9b919708f44b718c17f1fec85b1df8050a17,Bram Moolenaar,22,0,22,3,"{""src/testdir/test_vim9_func.vim"": {""insertions"": 18, ""deletions"": 0, ""lines"": 18}, ""src/userfunc.c"": {""insertions"": 2, ""deletions"": 0, ""lines"": 2}, ""src/version.c"": {""insertions"": 2, ""deletions"": 0, ""lines"": 2}}"
2021-01-01 17:43:51,5178b1b02fc96f42d62199a4be9184c2aea8a49a,Bram Moolenaar,63,22,85,4,"{""src/errors.h"": {""insertions"": 4, ""deletions"": 0, ""lines"": 4}, ""src/testdir/test_vim9_func.vim"": {""insertions"": 19, ""deletions"": 0, ""lines"": 19}, ""src/userfunc.c"": {""insertions"": 38, ""deletions"": 22, ""lines"": 60}, ""src/version.c"": {""insertions"": 2, ""deletions"": 0, ""lines"": 2}}"
2021-01-01 15:10:46,69f7050cebb0f069d6e39571961b9bbe8531c69a,Bram Moolenaar,78,37,115,3,"{""src/testdir/test_vim9_script.vim"": {""insertions"": 29, ""deletions"": 0, ""lines"": 29}, ""src/version.c"": {""insertions"": 2, ""deletions"": 0, ""lines"": 2}, ""src/vim9compile.c"": {""insertions"": 47, ""deletions"": 37, ""lines"": 84}}"
2021-01-01 14:11:04,a8b8af19e48e1803e20a129e9aebab1aac544956,Bram Moolenaar,13,6,19,4,"{""src/evalvars.c"": {""insertions"": 2, ""deletions"": 2, ""lines"": 4}, ""src/testdir/test_vim9_disassemble.vim"": {""insertions"": 2, ""deletions"": 2, ""lines"": 4}, ""src/testdir/test_vim9_expr.vim"": {""insertions"": 7, ""deletions"": 2, ""lines"": 9}, ""src/version.c"": {""insertions"": 2, ""deletions"": 0, ""lines"": 2}}"
2021-01-01 13:49:15,d5ea8f08f78d20fde8773663894de5e8c023bd83,Bram Moolenaar,10,2,12,3,"{""src/testdir/test_vim9_expr.vim"": {""insertions"": 5, ""deletions"": 0, ""lines"": 5}, ""src/version.c"": {""insertions"": 2, ""deletions"": 0, ""lines"": 2}, ""src/vim9compile.c"": {""insertions"": 3, ""deletions"": 2, ""lines"": 5}}"
2021-01-01 13:31:34,5efe0e5d16db070f0ab0b944686139e597afe166,Bram Moolenaar,3,1,4,2,"{""src/testdir/test_window_cmd.vim"": {""insertions"": 1, ""deletions"": 1, ""lines"": 2}, ""src/version.c"": {""insertions"": 2, ""deletions"": 0, ""lines"": 2}}"
2021-01-01 13:20:44,a387083b2f65c2c14b19087c7d7f94ca23de1d48,Bram Moolenaar,9,1,10,2,"{""src/testdir/test_functions.vim"": {""insertions"": 7, ""deletions"": 1, ""lines"": 8}, ""src/version.c"": {""insertions"": 2, ""deletions"": 0, ""lines"": 2}}"
2021-01-01 12:54:00,beef4eeda5c6865fcfe46db43ae71429a2025b58,Bram Moolenaar,17,3,20,3,"{""runtime/filetype.vim"": {""insertions"": 11, ""deletions"": 2, ""lines"": 13}, ""src/testdir/test_filetype.vim"": {""insertions"": 4, ""deletions"": 1, ""lines"": 5}, ""src/version.c"": {""insertions"": 2, ""deletions"": 0, ""lines"": 2}}"
2020-12-31 20:28:47,2949cfdbe4335b9abcfeda1be4dfc52090ee1df6,Bram Moolenaar,137,173,310,10,"{""src/eval.c"": {""insertions"": 24, ""deletions"": 4, ""lines"": 28}, ""src/testdir/test_vim9_assign.vim"": {""insertions"": 4, ""deletions"": 4, ""lines"": 8}, ""src/testdir/test_vim9_builtin.vim"": {""insertions"": 14, ""deletions"": 14, ""lines"": 28}, ""src/testdir/test_vim9_cmd.vim"": {""insertions"": 2, ""deletions"": 2, ""lines"": 4}, ""src/testdir/test_vim9_disassemble.vim"": {""insertions"": 8, ""deletions"": 8, ""lines"": 16}, ""src/testdir/test_vim9_expr.vim"": {""insertions"": 45, ""deletions"": 46, ""lines"": 91}, ""src/testdir/test_vim9_func.vim"": {""insertions"": 29, ""deletions"": 29, ""lines"": 58}, ""src/testdir/test_vim9_script.vim"": {""insertions"": 2, ""deletions"": 2, ""lines"": 4}, ""src/version.c"": {""insertions"": 2, ""deletions"": 0, ""lines"": 2}, ""src/vim9compile.c"": {""insertions"": 7, ""deletions"": 64, ""lines"": 71}}"
2020-12-31 17:28:18,adc8e4464563a2952c10362d396bb4a9f28cd12d,Bram Moolenaar,29,1,30,3,"{""src/testdir/test_vim9_func.vim"": {""insertions"": 5, ""deletions"": 0, ""lines"": 5}, ""src/userfunc.c"": {""insertions"": 22, ""deletions"": 1, ""lines"": 23}, ""src/version.c"": {""insertions"": 2, ""deletions"": 0, ""lines"": 2}}"
2020-12-31 17:11:16,1779ff48427931736998a6e5621b5cbe4d99c3e3,Bram Moolenaar,21,16,37,2,"{""src/if_tcl.c"": {""insertions"": 19, ""deletions"": 16, ""lines"": 35}, ""src/version.c"": {""insertions"": 2, ""deletions"": 0, ""lines"": 2}}"
2020-12-31 16:41:01,dd1f426bd617ac6a775f2e7795ff0b159e3fa315,Bram Moolenaar,104,56,160,12,"{""src/evalvars.c"": {""insertions"": 14, ""deletions"": 7, ""lines"": 21}, ""src/if_mzsch.c"": {""insertions"": 10, ""deletions"": 7, ""lines"": 17}, ""src/if_ruby.c"": {""insertions"": 2, ""deletions"": 6, ""lines"": 8}, ""src/option.c"": {""insertions"": 18, ""deletions"": 14, ""lines"": 32}, ""src/option.h"": {""insertions"": 11, ""deletions"": 0, ""lines"": 11}, ""src/proto/option.pro"": {""insertions"": 1, ""deletions"": 1, ""lines"": 2}, ""src/spell.c"": {""insertions"": 1, ""deletions"": 1, ""lines"": 2}, ""src/testdir/test_vim9_assign.vim"": {""insertions"": 5, ""deletions"": 0, ""lines"": 5}, ""src/testdir/test_vim9_cmd.vim"": {""insertions"": 1, ""deletions"": 1, ""lines"": 2}, ""src/typval.c"": {""insertions"": 20, ""deletions"": 9, ""lines"": 29}, ""src/version.c"": {""insertions"": 2, ""deletions"": 0, ""lines"": 2}, ""src/vim9compile.c"": {""insertions"": 19, ""deletions"": 10, ""lines"": 29}}"
2020-12-31 12:39:54,ca2f7e7af32d51c2be378a5298bc85958c877653,Bram Moolenaar,4,0,4,2,"{""src/userfunc.c"": {""insertions"": 2, ""deletions"": 0, ""lines"": 2}, ""src/version.c"": {""insertions"": 2, ""deletions"": 0, ""lines"": 2}}"
2020-12-31 12:31:23,6b55377303968e1624339cd95053201d5acdcaa2,Bram Moolenaar,12,2,14,4,"{""src/testdir/test_vim9_expr.vim"": {""insertions"": 4, ""deletions"": 0, ""lines"": 4}, ""src/version.c"": {""insertions"": 2, ""deletions"": 0, ""lines"": 2}, ""src/vim9compile.c"": {""insertions"": 2, ""deletions"": 1, ""lines"": 3}, ""src/vim9type.c"": {""insertions"": 4, ""deletions"": 1, ""lines"": 5}}"
2020-12-30 20:16:37,a04d447d3aaddb5b978dd9a0e0186007fde8e09e,Bram Moolenaar,3,1,4,2,"{""src/eval.c"": {""insertions"": 1, ""deletions"": 1, ""lines"": 2}, ""src/version.c"": {""insertions"": 2, ""deletions"": 0, ""lines"": 2}}"
2020-12-30 19:39:21,de4f95b04134f6dfd10f60051a5078fd903a297d,Bram Moolenaar,113,74,187,5,"{""src/eval.c"": {""insertions"": 16, ""deletions"": 1, ""lines"": 17}, ""src/testdir/test_vim9_disassemble.vim"": {""insertions"": 6, ""deletions"": 6, ""lines"": 12}, ""src/testdir/test_vim9_expr.vim"": {""insertions"": 74, ""deletions"": 65, ""lines"": 139}, ""src/version.c"": {""insertions"": 2, ""deletions"": 0, ""lines"": 2}, ""src/vim9compile.c"": {""insertions"": 15, ""deletions"": 2, ""lines"": 17}}"
2020-12-30 13:59:23,2a5c61a0196d2d67313f5b3189974211e6f33562,Bram Moolenaar,6,1,7,2,"{""src/testdir/test_termcodes.vim"": {""insertions"": 4, ""deletions"": 1, ""lines"": 5}, ""src/version.c"": {""insertions"": 2, ""deletions"": 0, ""lines"": 2}}"
2020-12-30 13:08:35,2808da39f9aad674d25df784da636e42372b78e3,Bram Moolenaar,6,3,9,2,"{""src/term.c"": {""insertions"": 4, ""deletions"": 3, ""lines"": 7}, ""src/version.c"": {""insertions"": 2, ""deletions"": 0, ""lines"": 2}}"
2020-12-30 12:14:45,467676d468cb10db78d79d5bd2139ded9f70d26f,Bram Moolenaar,56,32,88,9,"{""src/Make_vms.mms"": {""insertions"": 20, ""deletions"": 6, ""lines"": 26}, ""src/gui.h"": {""insertions"": 2, ""deletions"": 1, ""lines"": 3}, ""src/gui_gtk_vms.h"": {""insertions"": 1, ""deletions"": 11, ""lines"": 12}, ""src/gui_x11.c"": {""insertions"": 9, ""deletions"": 7, ""lines"": 16}, ""src/macros.h"": {""insertions"": 2, ""deletions"": 2, ""lines"": 4}, ""src/os_unix.h"": {""insertions"": 4, ""deletions"": 3, ""lines"": 7}, ""src/os_vms_conf.h"": {""insertions"": 15, ""deletions"": 1, ""lines"": 16}, ""src/term.c"": {""insertions"": 1, ""deletions"": 1, ""lines"": 2}, ""src/version.c"": {""insertions"": 2, ""deletions"": 0, ""lines"": 2}}"
2020-12-29 19:53:33,4d8c96d4668ac965d4e84b9676fba6d7efe62a32,Bram Moolenaar,33,12,45,4,"{""runtime/doc/term.txt"": {""insertions"": 4, ""deletions"": 0, ""lines"": 4}, ""src/term.c"": {""insertions"": 21, ""deletions"": 7, ""lines"": 28}, ""src/testdir/test_terminal3.vim"": {""insertions"": 6, ""deletions"": 5, ""lines"": 11}, ""src/version.c"": {""insertions"": 2, ""deletions"": 0, ""lines"": 2}}"
2020-12-29 19:25:19,285b15fce164ade8b1537b884cc15aebaa60e9ef,Bram Moolenaar,14,2,16,3,"{""src/evalwindow.c"": {""insertions"": 2, ""deletions"": 2, ""lines"": 4}, ""src/testdir/test_vim9_builtin.vim"": {""insertions"": 10, ""deletions"": 0, ""lines"": 10}, ""src/version.c"": {""insertions"": 2, ""deletions"": 0, ""lines"": 2}}"
2020-12-29 11:46:51,89015a675990bd7d70e041c5d890edb803b5c6b7,Bram Moolenaar,12,0,12,3,"{""src/testdir/test_window_cmd.vim"": {""insertions"": 8, ""deletions"": 0, ""lines"": 8}, ""src/version.c"": {""insertions"": 2, ""deletions"": 0, ""lines"": 2}, ""src/window.c"": {""insertions"": 2, ""deletions"": 0, ""lines"": 2}}"
2020-12-29 10:57:46,4012d262072a3ac95878c9d061fa985301720ec2,Bram Moolenaar,16,2,18,3,"{""src/popupwin.c"": {""insertions"": 10, ""deletions"": 2, ""lines"": 12}, ""src/testdir/test_popupwin.vim"": {""insertions"": 4, ""deletions"": 0, ""lines"": 4}, ""src/version.c"": {""insertions"": 2, ""deletions"": 0, ""lines"": 2}}"
2020-12-29 10:15:01,8242ebbdba64cfa5c504c9d8dfb802076d99c602,Bram Moolenaar,43,27,70,6,"{""src/ex_docmd.c"": {""insertions"": 2, ""deletions"": 1, ""lines"": 3}, ""src/scriptfile.c"": {""insertions"": 4, ""deletions"": 4, ""lines"": 8}, ""src/structs.h"": {""insertions"": 2, ""deletions"": 2, ""lines"": 4}, ""src/testdir/test_vim9_cmd.vim"": {""insertions"": 31, ""deletions"": 18, ""lines"": 49}, ""src/userfunc.c"": {""insertions"": 2, ""deletions"": 2, ""lines"": 4}, ""src/version.c"": {""insertions"": 2, ""deletions"": 0, ""lines"": 2}}"
2020-12-28 20:36:56,864a28b6a6ae4f1a56e230be26bc6d13e3f8b3d9,Bram Moolenaar,9,1,10,4,"{""ci/config.mk.clang.sed"": {""insertions"": 1, ""deletions"": 1, ""lines"": 2}, ""src/auto/configure"": {""insertions"": 3, ""deletions"": 0, ""lines"": 3}, ""src/configure.ac"": {""insertions"": 3, ""deletions"": 0, ""lines"": 3}, ""src/version.c"": {""insertions"": 2, ""deletions"": 0, ""lines"": 2}}"
2020-12-28 20:15:16,41a834d1e3dbf9c8759737bcd6524159a9b93d2a,Bram Moolenaar,5,3,8,2,"{""src/testdir/test_clientserver.vim"": {""insertions"": 3, ""deletions"": 3, ""lines"": 6}, ""src/version.c"": {""insertions"": 2, ""deletions"": 0, ""lines"": 2}}"
2020-12-28 19:53:21,dcc58e031ded8b846a39146112b9b075cbb977d9,Bram Moolenaar,86,41,127,10,"{""runtime/doc/vim9.txt"": {""insertions"": 23, ""deletions"": 12, ""lines"": 35}, ""src/proto/vim9compile.pro"": {""insertions"": 1, ""deletions"": 2, ""lines"": 3}, ""src/proto/vim9script.pro"": {""insertions"": 1, ""deletions"": 0, ""lines"": 1}, ""src/scriptfile.c"": {""insertions"": 23, ""deletions"": 15, ""lines"": 38}, ""src/structs.h"": {""insertions"": 2, ""deletions"": 1, ""lines"": 3}, ""src/testdir/test_vim9_cmd.vim"": {""insertions"": 20, ""deletions"": 0, ""lines"": 20}, ""src/userfunc.c"": {""insertions"": 5, ""deletions"": 2, ""lines"": 7}, ""src/version.c"": {""insertions"": 2, ""deletions"": 0, ""lines"": 2}, ""src/vim9compile.c"": {""insertions"": 0, ""deletions"": 9, ""lines"": 9}, ""src/vim9script.c"": {""insertions"": 9, ""deletions"": 0, ""lines"": 9}}"
2020-12-28 17:26:00,9b8d62267f583d5dc042920adb1de046959ad11d,Bram Moolenaar,63,65,128,13,"{""src/autocmd.c"": {""insertions"": 4, ""deletions"": 8, ""lines"": 12}, ""src/buffer.c"": {""insertions"": 5, ""deletions"": 6, ""lines"": 11}, ""src/errors.h"": {""insertions"": 6, ""deletions"": 2, ""lines"": 8}, ""src/ex_docmd.c"": {""insertions"": 1, ""deletions"": 5, ""lines"": 6}, ""src/globals.h"": {""insertions"": 8, ""deletions"": 3, ""lines"": 11}, ""src/main.c"": {""insertions"": 4, ""deletions"": 6, ""lines"": 10}, ""src/menu.c"": {""insertions"": 2, ""deletions"": 10, ""lines"": 12}, ""src/proto.h"": {""insertions"": 1, ""deletions"": 1, ""lines"": 2}, ""src/scriptfile.c"": {""insertions"": 8, ""deletions"": 7, ""lines"": 15}, ""src/structs.h"": {""insertions"": 7, ""deletions"": 5, ""lines"": 12}, ""src/usercmd.c"": {""insertions"": 3, ""deletions"": 7, ""lines"": 10}, ""src/version.c"": {""insertions"": 2, ""deletions"": 0, ""lines"": 2}, ""src/vim9script.c"": {""insertions"": 12, ""deletions"": 5, ""lines"": 17}}"
2020-12-28 14:46:47,ed1e4c9a70aaa7de56bac23e75a846e874a32a56,Bram Moolenaar,3,1,4,2,"{"".github/workflows/ci.yml"": {""insertions"": 1, ""deletions"": 1, ""lines"": 2}, ""src/version.c"": {""insertions"": 2, ""deletions"": 0, ""lines"": 2}}"
2020-12-28 14:41:41,746670604a60cb0356b56c112ffb6d297c679099,Bram Moolenaar,39,1,40,6,"{""runtime/doc/options.txt"": {""insertions"": 3, ""deletions"": 1, ""lines"": 4}, ""src/scriptfile.c"": {""insertions"": 3, ""deletions"": 0, ""lines"": 3}, ""src/testdir/test_options.vim"": {""insertions"": 18, ""deletions"": 0, ""lines"": 18}, ""src/version.c"": {""insertions"": 2, ""deletions"": 0, ""lines"": 2}, ""src/vim.h"": {""insertions"": 1, ""deletions"": 0, ""lines"": 1}, ""src/window.c"": {""insertions"": 12, ""deletions"": 0, ""lines"": 12}}"
2020-12-28 14:07:45,dace9f785fca6cc802b2fb7f11a5ee4fab896432,Bram Moolenaar,92,55,147,3,"{""ci/config.mk.clang.sed"": {""insertions"": 1, ""deletions"": 1, ""lines"": 2}, ""src/if_ruby.c"": {""insertions"": 89, ""deletions"": 54, ""lines"": 143}, ""src/version.c"": {""insertions"": 2, ""deletions"": 0, ""lines"": 2}}"
2020-12-28 12:41:53,3e112acc220dcacb58d77edca71910a532fffd0f,Bram Moolenaar,17,12,29,2,"{""src/testdir/test_cmdline.vim"": {""insertions"": 15, ""deletions"": 12, ""lines"": 27}, ""src/version.c"": {""insertions"": 2, ""deletions"": 0, ""lines"": 2}}"
2020-12-28 11:56:58,17793ef23aae0bc94539390ccfe5e63b0ad39ff2,Bram Moolenaar,109,0,109,5,"{""runtime/doc/eval.txt"": {""insertions"": 27, ""deletions"": 0, ""lines"": 27}, ""runtime/doc/usr_41.txt"": {""insertions"": 1, ""deletions"": 0, ""lines"": 1}, ""src/evalfunc.c"": {""insertions"": 54, ""deletions"": 0, ""lines"": 54}, ""src/testdir/test_functions.vim"": {""insertions"": 25, ""deletions"": 0, ""lines"": 25}, ""src/version.c"": {""insertions"": 2, ""deletions"": 0, ""lines"": 2}}"
2020-12-27 18:18:03,9618a25b9c054f0ee4e267d2db96b6e7c113ed7a,Bram Moolenaar,3,2,5,2,"{""src/ex_docmd.c"": {""insertions"": 1, ""deletions"": 2, ""lines"": 3}, ""src/version.c"": {""insertions"": 2, ""deletions"": 0, ""lines"": 2}}"
2020-12-27 18:00:24,e4862a0fe62261754daf476866ef2aa8586b716c,Bram Moolenaar,20,0,20,3,"{""src/ex_cmds.c"": {""insertions"": 9, ""deletions"": 0, ""lines"": 9}, ""src/testdir/test_clientserver.vim"": {""insertions"": 9, ""deletions"": 0, ""lines"": 9}, ""src/version.c"": {""insertions"": 2, ""deletions"": 0, ""lines"": 2}}"
2020-12-27 17:03:22,179eb567b15a2ed5cf25b45d95d06c7a729d50bc,Bram Moolenaar,22,1,23,3,"{""src/insexpand.c"": {""insertions"": 1, ""deletions"": 1, ""lines"": 2}, ""src/testdir/test_vim9_cmd.vim"": {""insertions"": 19, ""deletions"": 0, ""lines"": 19}, ""src/version.c"": {""insertions"": 2, ""deletions"": 0, ""lines"": 2}}"
2020-12-27 16:35:18,39cb2dab18e85fc60f116a4543e433616872b690,Bram Moolenaar,6,0,6,2,"{""src/ex_docmd.c"": {""insertions"": 4, ""deletions"": 0, ""lines"": 4}, ""src/version.c"": {""insertions"": 2, ""deletions"": 0, ""lines"": 2}}"
2020-12-27 15:55:11,4389f9cd00632adc0216d5ead13d859b186bcbf8,Bram Moolenaar,91,31,122,3,"{""src/ex_docmd.c"": {""insertions"": 42, ""deletions"": 31, ""lines"": 73}, ""src/testdir/test_vim9_cmd.vim"": {""insertions"": 47, ""deletions"": 0, ""lines"": 47}, ""src/version.c"": {""insertions"": 2, ""deletions"": 0, ""lines"": 2}}"
2020-12-27 13:43:30,e462f52db3cab656485a71e4322b6cb18d564a06,Bram Moolenaar,25,59,84,4,"{""src/testdir/test_vim9_expr.vim"": {""insertions"": 7, ""deletions"": 11, ""lines"": 18}, ""src/userfunc.c"": {""insertions"": 1, ""deletions"": 1, ""lines"": 2}, ""src/version.c"": {""insertions"": 2, ""deletions"": 0, ""lines"": 2}, ""src/vim9compile.c"": {""insertions"": 15, ""deletions"": 47, ""lines"": 62}}"
2020-12-27 13:02:27,7e3ee7823ffc55b37e9718720263637ed7232646,Bram Moolenaar,4,0,4,2,"{""src/scriptfile.c"": {""insertions"": 2, ""deletions"": 0, ""lines"": 2}, ""src/version.c"": {""insertions"": 2, ""deletions"": 0, ""lines"": 2}}"
2020-12-27 12:39:50,a6294955308fac1d14b9a8481e7f8581146c706c,Bram Moolenaar,116,43,159,7,"{""src/evalvars.c"": {""insertions"": 1, ""deletions"": 1, ""lines"": 2}, ""src/proto/vim9script.pro"": {""insertions"": 1, ""deletions"": 0, ""lines"": 1}, ""src/structs.h"": {""insertions"": 6, ""deletions"": 4, ""lines"": 10}, ""src/testdir/test_vim9_script.vim"": {""insertions"": 32, ""deletions"": 16, ""lines"": 48}, ""src/version.c"": {""insertions"": 2, ""deletions"": 0, ""lines"": 2}, ""src/vim9compile.c"": {""insertions"": 1, ""deletions"": 1, ""lines"": 2}, ""src/vim9script.c"": {""insertions"": 73, ""deletions"": 21, ""lines"": 94}}"
2020-12-26 19:09:15,07a65d26e7d76ad22d6ef23b50c0faa25e435e02,Bram Moolenaar,105,47,152,11,"{""src/errors.h"": {""insertions"": 2, ""deletions"": 0, ""lines"": 2}, ""src/evalvars.c"": {""insertions"": 9, ""deletions"": 2, ""lines"": 11}, ""src/proto/vim9script.pro"": {""insertions"": 1, ""deletions"": 1, ""lines"": 2}, ""src/proto/vim9type.pro"": {""insertions"": 1, ""deletions"": 0, ""lines"": 1}, ""src/testdir/test_vim9_script.vim"": {""insertions"": 26, ""deletions"": 0, ""lines"": 26}, ""src/version.c"": {""insertions"": 2, ""deletions"": 0, ""lines"": 2}, ""src/vim9.h"": {""insertions"": 1, ""deletions"": 0, ""lines"": 1}, ""src/vim9compile.c"": {""insertions"": 1, ""deletions"": 0, ""lines"": 1}, ""src/vim9execute.c"": {""insertions"": 31, ""deletions"": 25, ""lines"": 56}, ""src/vim9script.c"": {""insertions"": 30, ""deletions"": 18, ""lines"": 48}, ""src/vim9type.c"": {""insertions"": 1, ""deletions"": 1, ""lines"": 2}}"
2020-12-26 16:43:08,cdc40c43f1008bda2f173d3a13606236679e8067,Bram Moolenaar,18,38,56,5,"{""runtime/doc/vim9.txt"": {""insertions"": 0, ""deletions"": 17, ""lines"": 17}, ""src/testdir/test_vim9_script.vim"": {""insertions"": 4, ""deletions"": 11, ""lines"": 15}, ""src/userfunc.c"": {""insertions"": 1, ""deletions"": 3, ""lines"": 4}, ""src/version.c"": {""insertions"": 2, ""deletions"": 0, ""lines"": 2}, ""src/vim9compile.c"": {""insertions"": 11, ""deletions"": 7, ""lines"": 18}}"
2020-12-26 14:39:31,2b32700dabf392566d8e9fef76e0d587a891ee3e,Bram Moolenaar,161,48,209,8,"{""runtime/doc/vim9.txt"": {""insertions"": 60, ""deletions"": 10, ""lines"": 70}, ""src/ex_cmds.h"": {""insertions"": 1, ""deletions"": 1, ""lines"": 2}, ""src/ex_docmd.c"": {""insertions"": 1, ""deletions"": 1, ""lines"": 2}, ""src/scriptfile.c"": {""insertions"": 18, ""deletions"": 32, ""lines"": 50}, ""src/structs.h"": {""insertions"": 5, ""deletions"": 1, ""lines"": 6}, ""src/testdir/test_vim9_script.vim"": {""insertions"": 47, ""deletions"": 0, ""lines"": 47}, ""src/version.c"": {""insertions"": 2, ""deletions"": 0, ""lines"": 2}, ""src/vim9script.c"": {""insertions"": 27, ""deletions"": 3, ""lines"": 30}}"
2020-12-26 11:06:54,b0ac4ea5e1c5f0ff4e951978c32ccfffe46916f8,Bram Moolenaar,21,0,21,3,"{""src/cmdexpand.c"": {""insertions"": 6, ""deletions"": 0, ""lines"": 6}, ""src/testdir/test_cmdline.vim"": {""insertions"": 13, ""deletions"": 0, ""lines"": 13}, ""src/version.c"": {""insertions"": 2, ""deletions"": 0, ""lines"": 2}}"
2020-12-25 21:30:16,e5730bdcea0d4b574835f94b9813f80316590db9,Bram Moolenaar,3,0,3,2,"{""src/userfunc.c"": {""insertions"": 1, ""deletions"": 0, ""lines"": 1}, ""src/version.c"": {""insertions"": 2, ""deletions"": 0, ""lines"": 2}}"
2020-12-25 20:56:57,7e3682068bebc53a5d1e9eaaba61bb4fa9c612da,Bram Moolenaar,120,61,181,3,"{""src/testdir/test_vim9_expr.vim"": {""insertions"": 33, ""deletions"": 27, ""lines"": 60}, ""src/version.c"": {""insertions"": 2, ""deletions"": 0, ""lines"": 2}, ""src/vim9compile.c"": {""insertions"": 85, ""deletions"": 34, ""lines"": 119}}"
2020-12-25 19:24:51,fc0e8f5c3ef51c86cfa4a51f92b264ef79962b9d,Bram Moolenaar,12,2,14,3,"{""src/testdir/test_vim9_builtin.vim"": {""insertions"": 5, ""deletions"": 0, ""lines"": 5}, ""src/version.c"": {""insertions"": 2, ""deletions"": 0, ""lines"": 2}, ""src/vim9execute.c"": {""insertions"": 5, ""deletions"": 2, ""lines"": 7}}"
2020-12-25 18:47:24,20a762987eaa7e6034e9f75df0eb87eedb85d71f,Bram Moolenaar,16,0,16,3,"{""src/testdir/test_vim9_cmd.vim"": {""insertions"": 7, ""deletions"": 0, ""lines"": 7}, ""src/version.c"": {""insertions"": 2, ""deletions"": 0, ""lines"": 2}, ""src/vim9execute.c"": {""insertions"": 7, ""deletions"": 0, ""lines"": 7}}"
2020-12-25 18:25:45,6e2c2c50bada4e3f5c7234902c0bdd64f66619ac,Bram Moolenaar,7,5,12,5,"{""src/errors.h"": {""insertions"": 2, ""deletions"": 2, ""lines"": 4}, ""src/ex_docmd.c"": {""insertions"": 1, ""deletions"": 1, ""lines"": 2}, ""src/testdir/test_vim9_cmd.vim"": {""insertions"": 1, ""deletions"": 1, ""lines"": 2}, ""src/version.c"": {""insertions"": 2, ""deletions"": 0, ""lines"": 2}, ""src/vim9compile.c"": {""insertions"": 1, ""deletions"": 1, ""lines"": 2}}"
2020-12-25 17:35:29,56ce9ea3ea46529cac2fdf3151abfa0e1ae49bad,Bram Moolenaar,25,1,26,3,"{""src/testdir/test_vim9_cmd.vim"": {""insertions"": 9, ""deletions"": 0, ""lines"": 9}, ""src/version.c"": {""insertions"": 2, ""deletions"": 0, ""lines"": 2}, ""src/vim9compile.c"": {""insertions"": 14, ""deletions"": 1, ""lines"": 15}}"
2020-12-25 16:36:27,f8103f274e828bdc2dcbc4d857f166f25e0a855e,Bram Moolenaar,22,15,37,3,"{""src/ex_docmd.c"": {""insertions"": 1, ""deletions"": 1, ""lines"": 2}, ""src/testdir/test_vim9_script.vim"": {""insertions"": 19, ""deletions"": 14, ""lines"": 33}, ""src/version.c"": {""insertions"": 2, ""deletions"": 0, ""lines"": 2}}"
2020-12-25 15:11:53,7cfcd0c99c485a973d8cbff939531e430ad77f55,Bram Moolenaar,3,1,4,2,"{""src/userfunc.c"": {""insertions"": 1, ""deletions"": 1, ""lines"": 2}, ""src/version.c"": {""insertions"": 2, ""deletions"": 0, ""lines"": 2}}"
2020-12-25 14:24:23,c754b4cc98253e1935d3ea5790bc60869c7bc091,Bram Moolenaar,56,16,72,6,"{""src/eval.c"": {""insertions"": 6, ""deletions"": 1, ""lines"": 7}, ""src/testdir/test_vim9_assign.vim"": {""insertions"": 3, ""deletions"": 3, ""lines"": 6}, ""src/testdir/test_vim9_expr.vim"": {""insertions"": 13, ""deletions"": 5, ""lines"": 18}, ""src/userfunc.c"": {""insertions"": 30, ""deletions"": 7, ""lines"": 37}, ""src/version.c"": {""insertions"": 2, ""deletions"": 0, ""lines"": 2}, ""src/vim9type.c"": {""insertions"": 2, ""deletions"": 0, ""lines"": 2}}"
2020-12-25 12:52:37,b2f9e0e2c537bcde16dab3b62687a17e17849ce1,Bram Moolenaar,75,0,75,2,"{""src/if_python3.c"": {""insertions"": 73, ""deletions"": 0, ""lines"": 73}, ""src/version.c"": {""insertions"": 2, ""deletions"": 0, ""lines"": 2}}"
2020-12-25 12:20:41,3868f59466ed5ff1c5624f40b93c0034ce62cb82,Bram Moolenaar,7,22,29,4,"{""src/globals.h"": {""insertions"": 1, ""deletions"": 0, ""lines"": 1}, ""src/version.c"": {""insertions"": 2, ""deletions"": 0, ""lines"": 2}, ""src/vim9compile.c"": {""insertions"": 1, ""deletions"": 10, ""lines"": 11}, ""src/vim9type.c"": {""insertions"": 3, ""deletions"": 12, ""lines"": 15}}"
2020-12-25 11:38:04,9e68c32563d8c9ffe1ac04ecd4ccd730af66b97c,Bram Moolenaar,125,69,194,8,"{""src/eval.c"": {""insertions"": 3, ""deletions"": 1, ""lines"": 4}, ""src/proto/vim9type.pro"": {""insertions"": 1, ""deletions"": 1, ""lines"": 2}, ""src/testdir/test_vim9_expr.vim"": {""insertions"": 10, ""deletions"": 5, ""lines"": 15}, ""src/userfunc.c"": {""insertions"": 32, ""deletions"": 15, ""lines"": 47}, ""src/version.c"": {""insertions"": 2, ""deletions"": 0, ""lines"": 2}, ""src/vim9compile.c"": {""insertions"": 15, ""deletions"": 12, ""lines"": 27}, ""src/vim9script.c"": {""insertions"": 2, ""deletions"": 3, ""lines"": 5}, ""src/vim9type.c"": {""insertions"": 60, ""deletions"": 32, ""lines"": 92}}"
2020-12-24 20:56:41,4aab88d919168ce2ddf4845482f4cff9efa52b5b,Bram Moolenaar,131,25,156,8,"{""src/errors.h"": {""insertions"": 2, ""deletions"": 0, ""lines"": 2}, ""src/scriptfile.c"": {""insertions"": 1, ""deletions"": 0, ""lines"": 1}, ""src/structs.h"": {""insertions"": 2, ""deletions"": 3, ""lines"": 5}, ""src/testdir/test_vim9_script.vim"": {""insertions"": 61, ""deletions"": 0, ""lines"": 61}, ""src/version.c"": {""insertions"": 2, ""deletions"": 0, ""lines"": 2}, ""src/vim9.h"": {""insertions"": 9, ""deletions"": 2, ""lines"": 11}, ""src/vim9compile.c"": {""insertions"": 18, ""deletions"": 4, ""lines"": 22}, ""src/vim9execute.c"": {""insertions"": 36, ""deletions"": 16, ""lines"": 52}}"
2020-12-24 17:39:02,38455a921395a56690790c8c1d28c1c43ca04c8a,Bram Moolenaar,83,4,87,5,"{""src/popupmenu.c"": {""insertions"": 15, ""deletions"": 2, ""lines"": 17}, ""src/testdir/dumps/Test_popup_command_04.dump"": {""insertions"": 20, ""deletions"": 0, ""lines"": 20}, ""src/testdir/dumps/Test_popup_command_05.dump"": {""insertions"": 20, ""deletions"": 0, ""lines"": 20}, ""src/testdir/test_popup.vim"": {""insertions"": 26, ""deletions"": 2, ""lines"": 28}, ""src/version.c"": {""insertions"": 2, ""deletions"": 0, ""lines"": 2}}"
2020-12-24 16:41:12,0261a1aeeb4ccec4ef75cc8e0685c78f5622dbf5,Bram Moolenaar,2,3,5,1,"{""README.md"": {""insertions"": 2, ""deletions"": 3, ""lines"": 5}}"
2020-12-24 16:35:41,c139aa8a2bf3de9fb524344e632eb323e0093fd2,Bram Moolenaar,2,14,16,1,"{""README.md"": {""insertions"": 2, ""deletions"": 14, ""lines"": 16}}"
2020-12-24 16:25:06,b04ddb5b04fbb220a680780928242f9e4eda9f62,Bram Moolenaar,2,2,4,1,"{""README.md"": {""insertions"": 2, ""deletions"": 2, ""lines"": 4}}"
2020-12-24 16:20:24,b54f1202b3cd9e5e0510b546d8a9a4f2e7b6b451,Bram Moolenaar,18,4,22,1,"{""README.md"": {""insertions"": 18, ""deletions"": 4, ""lines"": 22}}"
2020-12-24 16:15:53,4941b5effd7f6a26583a949c92ee50276a3b43f9,Bram Moolenaar,31,0,31,3,"{""src/eval.c"": {""insertions"": 18, ""deletions"": 0, ""lines"": 18}, ""src/testdir/test_cmdline.vim"": {""insertions"": 11, ""deletions"": 0, ""lines"": 11}, ""src/version.c"": {""insertions"": 2, ""deletions"": 0, ""lines"": 2}}"
2020-12-24 15:06:00,6dd41b1d575e8859238144899600e3cbb412c79b,Bram Moolenaar,10,0,10,2,"{""src/userfunc.c"": {""insertions"": 8, ""deletions"": 0, ""lines"": 8}, ""src/version.c"": {""insertions"": 2, ""deletions"": 0, ""lines"": 2}}"
2020-12-24 14:14:01,65c4415276394c871c7a8711c7633c19ec9235b1,Bram Moolenaar,246,44,290,5,"{""runtime/doc/vim9.txt"": {""insertions"": 36, ""deletions"": 10, ""lines"": 46}, ""src/testdir/test_vim9_expr.vim"": {""insertions"": 94, ""deletions"": 0, ""lines"": 94}, ""src/userfunc.c"": {""insertions"": 54, ""deletions"": 12, ""lines"": 66}, ""src/version.c"": {""insertions"": 2, ""deletions"": 0, ""lines"": 2}, ""src/vim9compile.c"": {""insertions"": 60, ""deletions"": 22, ""lines"": 82}}"
2020-12-24 12:33:46,b34f33747223d9cba4b32a27aee70c1705b36ed9,Bram Moolenaar,6,0,6,3,"{""runtime/filetype.vim"": {""insertions"": 3, ""deletions"": 0, ""lines"": 3}, ""src/testdir/test_filetype.vim"": {""insertions"": 1, ""deletions"": 0, ""lines"": 1}, ""src/version.c"": {""insertions"": 2, ""deletions"": 0, ""lines"": 2}}"
2020-12-23 21:40:11,16204962c7ad7380a40f0855443303ad16114e2b,Bram Moolenaar,4,2,6,2,"{""src/testdir/test_writefile.vim"": {""insertions"": 2, ""deletions"": 2, ""lines"": 4}, ""src/version.c"": {""insertions"": 2, ""deletions"": 0, ""lines"": 2}}"
2020-12-23 19:55:15,bd318559cf8dea210e943100536011473f25bf68,Bram Moolenaar,5,1,6,2,"{""src/testdir/test_writefile.vim"": {""insertions"": 3, ""deletions"": 1, ""lines"": 4}, ""src/version.c"": {""insertions"": 2, ""deletions"": 0, ""lines"": 2}}"
2020-12-23 19:27:31,27bf7af9d042b396c412fcad7bac59849a4a420f,Bram Moolenaar,20,9,29,4,"{""src/testdir/test_vim9_disassemble.vim"": {""insertions"": 4, ""deletions"": 4, ""lines"": 8}, ""src/testdir/test_vim9_expr.vim"": {""insertions"": 5, ""deletions"": 1, ""lines"": 6}, ""src/version.c"": {""insertions"": 2, ""deletions"": 0, ""lines"": 2}, ""src/vim9compile.c"": {""insertions"": 9, ""deletions"": 4, ""lines"": 13}}"
2020-12-23 17:54:57,b3c8b1d25414f2e24ad03551cdf125b3e2c142b1,Bram Moolenaar,21,1,22,3,"{""src/bufwrite.c"": {""insertions"": 1, ""deletions"": 1, ""lines"": 2}, ""src/testdir/test_writefile.vim"": {""insertions"": 18, ""deletions"": 0, ""lines"": 18}, ""src/version.c"": {""insertions"": 2, ""deletions"": 0, ""lines"": 2}}"
2020-12-23 13:36:00,23999d799cfe844b604f193183f8f84052c8e746,Bram Moolenaar,37,3,40,5,"{""src/move.c"": {""insertions"": 13, ""deletions"": 2, ""lines"": 15}, ""src/proto/move.pro"": {""insertions"": 1, ""deletions"": 0, ""lines"": 1}, ""src/testdir/test_textprop.vim"": {""insertions"": 20, ""deletions"": 0, ""lines"": 20}, ""src/textprop.c"": {""insertions"": 1, ""deletions"": 1, ""lines"": 2}, ""src/version.c"": {""insertions"": 2, ""deletions"": 0, ""lines"": 2}}"
2020-12-23 12:56:35,4072ba571babd733d1800c082416fe8fe3c28ed7,Bram Moolenaar,266,160,426,29,"{"".github/CODEOWNERS"": {""insertions"": 20, ""deletions"": 4, ""lines"": 24}, ""README.md"": {""insertions"": 4, ""deletions"": 13, ""lines"": 17}, ""runtime/doc/autocmd.txt"": {""insertions"": 3, ""deletions"": 1, ""lines"": 4}, ""runtime/doc/editing.txt"": {""insertions"": 4, ""deletions"": 4, ""lines"": 8}, ""runtime/doc/eval.txt"": {""insertions"": 9, ""deletions"": 3, ""lines"": 12}, ""runtime/doc/helphelp.txt"": {""insertions"": 3, ""deletions"": 3, ""lines"": 6}, ""runtime/doc/intro.txt"": {""insertions"": 2, ""deletions"": 2, ""lines"": 4}, ""runtime/doc/options.txt"": {""insertions"": 6, ""deletions"": 2, ""lines"": 8}, ""runtime/doc/starting.txt"": {""insertions"": 2, ""deletions"": 2, ""lines"": 4}, ""runtime/doc/syntax.txt"": {""insertions"": 3, ""deletions"": 3, ""lines"": 6}, ""runtime/doc/tags"": {""insertions"": 3, ""deletions"": 1, ""lines"": 4}, ""runtime/doc/tagsrch.txt"": {""insertions"": 2, ""deletions"": 2, ""lines"": 4}, ""runtime/doc/testing.txt"": {""insertions"": 6, ""deletions"": 3, ""lines"": 9}, ""runtime/doc/todo.txt"": {""insertions"": 14, ""deletions"": 6, ""lines"": 20}, ""runtime/doc/usr_23.txt"": {""insertions"": 9, ""deletions"": 9, ""lines"": 18}, ""runtime/doc/usr_41.txt"": {""insertions"": 2, ""deletions"": 2, ""lines"": 4}, ""runtime/doc/version5.txt"": {""insertions"": 2, ""deletions"": 2, ""lines"": 4}, ""runtime/doc/vim9.txt"": {""insertions"": 32, ""deletions"": 8, ""lines"": 40}, ""runtime/doc/windows.txt"": {""insertions"": 6, ""deletions"": 6, ""lines"": 12}, ""runtime/ftplugin/css.vim"": {""insertions"": 3, ""deletions"": 2, ""lines"": 5}, ""runtime/ftplugin/spec.vim"": {""insertions"": 18, ""deletions"": 18, ""lines"": 36}, ""runtime/indent/html.vim"": {""insertions"": 2, ""deletions"": 2, ""lines"": 4}, ""runtime/macros/less.vim"": {""insertions"": 11, ""deletions"": 3, ""lines"": 14}, ""runtime/syntax/doxygen.vim"": {""insertions"": 20, ""deletions"": 14, ""lines"": 34}, ""runtime/syntax/php.vim"": {""insertions"": 37, ""deletions"": 16, ""lines"": 53}, ""runtime/syntax/sil.vim"": {""insertions"": 1, ""deletions"": 0, ""lines"": 1}, ""runtime/syntax/swift.vim"": {""insertions"": 13, ""deletions"": 4, ""lines"": 17}, ""runtime/syntax/vim.vim"": {""insertions"": 28, ""deletions"": 24, ""lines"": 52}, ""src/INSTALLmac.txt"": {""insertions"": 1, ""deletions"": 1, ""lines"": 2}}"
2020-12-23 11:50:20,9f63a65f22b6a899925ba15adbb711e86251114e,Bram Moolenaar,4,2,6,2,"{""src/testdir/test_registers.vim"": {""insertions"": 2, ""deletions"": 2, ""lines"": 4}, ""src/version.c"": {""insertions"": 2, ""deletions"": 0, ""lines"": 2}}"
2020-12-23 11:33:42,abcbb0e9ad43fc25077e1681528e72ddcbeed300,Bram Moolenaar,6,4,10,3,"{""src/auto/configure"": {""insertions"": 2, ""deletions"": 2, ""lines"": 4}, ""src/configure.ac"": {""insertions"": 2, ""deletions"": 2, ""lines"": 4}, ""src/version.c"": {""insertions"": 2, ""deletions"": 0, ""lines"": 2}}"
2020-12-22 21:07:30,1dcf55d4f1aa34b6d22001038d43f3e46407fa2e,Bram Moolenaar,8,8,16,4,"{""src/eval.c"": {""insertions"": 3, ""deletions"": 3, ""lines"": 6}, ""src/evalvars.c"": {""insertions"": 2, ""deletions"": 4, ""lines"": 6}, ""src/testdir/test_vim9_func.vim"": {""insertions"": 1, ""deletions"": 1, ""lines"": 2}, ""src/version.c"": {""insertions"": 2, ""deletions"": 0, ""lines"": 2}}"
2020-12-22 20:19:39,89b474dd4f0de878b4c48eeb9e223f0c22ee1442,Bram Moolenaar,70,15,85,5,"{""src/evalvars.c"": {""insertions"": 20, ""deletions"": 13, ""lines"": 33}, ""src/testdir/test_vim9_assign.vim"": {""insertions"": 46, ""deletions"": 0, ""lines"": 46}, ""src/testdir/test_vim9_func.vim"": {""insertions"": 1, ""deletions"": 1, ""lines"": 2}, ""src/version.c"": {""insertions"": 2, ""deletions"": 0, ""lines"": 2}, ""src/vim.h"": {""insertions"": 1, ""deletions"": 1, ""lines"": 2}}"
2020-12-22 19:35:40,3bdc90b7dfab314768a8f56454ea62929524f05c,Bram Moolenaar,39,10,49,5,"{""src/evalvars.c"": {""insertions"": 17, ""deletions"": 7, ""lines"": 24}, ""src/proto/evalvars.pro"": {""insertions"": 1, ""deletions"": 0, ""lines"": 1}, ""src/testdir/test_vim9_func.vim"": {""insertions"": 11, ""deletions"": 0, ""lines"": 11}, ""src/version.c"": {""insertions"": 2, ""deletions"": 0, ""lines"": 2}, ""src/vim9execute.c"": {""insertions"": 8, ""deletions"": 3, ""lines"": 11}}"
2020-12-22 18:05:33,e5492609b3a153c631f1d600ecdef1af1c913bef,Bram Moolenaar,6,6,12,3,"{"".github/workflows/ci.yml"": {""insertions"": 3, ""deletions"": 5, ""lines"": 8}, ""Filelist"": {""insertions"": 1, ""deletions"": 1, ""lines"": 2}, ""src/version.c"": {""insertions"": 2, ""deletions"": 0, ""lines"": 2}}"
2020-12-22 17:56:55,58a52f215a568b32c8a3aec0ccdb383f1a76dba0,Bram Moolenaar,46,13,59,3,"{""src/testdir/test_vim9_func.vim"": {""insertions"": 13, ""deletions"": 0, ""lines"": 13}, ""src/version.c"": {""insertions"": 2, ""deletions"": 0, ""lines"": 2}, ""src/vim9compile.c"": {""insertions"": 31, ""deletions"": 13, ""lines"": 44}}"
2020-12-22 17:33:27,077a42318c20ec9e71250edd8c4346edef72281b,Bram Moolenaar,27,2,29,3,"{""src/testdir/test_vim9_func.vim"": {""insertions"": 22, ""deletions"": 0, ""lines"": 22}, ""src/version.c"": {""insertions"": 2, ""deletions"": 0, ""lines"": 2}, ""src/vim9compile.c"": {""insertions"": 3, ""deletions"": 2, ""lines"": 5}}"
2020-12-22 16:59:35,032a2d050b82b146d70d6ff714838ee62c07d8ad,Bram Moolenaar,22,2,24,4,"{""src/ops.c"": {""insertions"": 1, ""deletions"": 1, ""lines"": 2}, ""src/register.c"": {""insertions"": 8, ""deletions"": 1, ""lines"": 9}, ""src/testdir/test_registers.vim"": {""insertions"": 11, ""deletions"": 0, ""lines"": 11}, ""src/version.c"": {""insertions"": 2, ""deletions"": 0, ""lines"": 2}}"
2020-12-22 16:35:54,cd45ed03bfdd7fac53d562ad402df74bd26e7754,Bram Moolenaar,143,91,234,10,"{""src/proto/userfunc.pro"": {""insertions"": 1, ""deletions"": 1, ""lines"": 2}, ""src/proto/vim9compile.pro"": {""insertions"": 1, ""deletions"": 1, ""lines"": 2}, ""src/proto/vim9execute.pro"": {""insertions"": 1, ""deletions"": 0, ""lines"": 1}, ""src/structs.h"": {""insertions"": 1, ""deletions"": 0, ""lines"": 1}, ""src/testdir/test_vim9_func.vim"": {""insertions"": 20, ""deletions"": 0, ""lines"": 20}, ""src/userfunc.c"": {""insertions"": 78, ""deletions"": 56, ""lines"": 134}, ""src/version.c"": {""insertions"": 2, ""deletions"": 0, ""lines"": 2}, ""src/vim9.h"": {""insertions"": 2, ""deletions"": 0, ""lines"": 2}, ""src/vim9compile.c"": {""insertions"": 22, ""deletions"": 12, ""lines"": 34}, ""src/vim9execute.c"": {""insertions"": 15, ""deletions"": 21, ""lines"": 36}}"
2020-12-22 11:50:10,07761a3b965ec3be0c8d52aae9b6dc09c2127d27,Bram Moolenaar,8,5,13,2,"{""src/testdir/test_python3.vim"": {""insertions"": 6, ""deletions"": 5, ""lines"": 11}, ""src/version.c"": {""insertions"": 2, ""deletions"": 0, ""lines"": 2}}"
2020-12-22 11:20:08,5b3d1bb0f5180266c4de4d815b3ea856a2fb3519,Bram Moolenaar,39,5,44,5,"{""src/eval.c"": {""insertions"": 20, ""deletions"": 4, ""lines"": 24}, ""src/ops.c"": {""insertions"": 1, ""deletions"": 1, ""lines"": 2}, ""src/proto/eval.pro"": {""insertions"": 1, ""deletions"": 0, ""lines"": 1}, ""src/testdir/test_vim9_func.vim"": {""insertions"": 15, ""deletions"": 0, ""lines"": 15}, ""src/version.c"": {""insertions"": 2, ""deletions"": 0, ""lines"": 2}}"
2020-12-22 11:18:11,c882e4d169fd5e0364bc91642040337efe7327a6,Bram Moolenaar,2,0,2,1,"{""src/version.c"": {""insertions"": 2, ""deletions"": 0, ""lines"": 2}}"
2020-12-22 10:40:45,1cfb9bb5c06c07f14475f39c4eb57fea1f0dfb69,Bram Moolenaar,108,85,193,2,"{""src/quickfix.c"": {""insertions"": 1, ""deletions"": 1, ""lines"": 2}, ""src/testdir/test_autocmd.vim"": {""insertions"": 107, ""deletions"": 84, ""lines"": 191}}"
2020-12-21 20:58:46,9a963377b4811e4e0419ec8825856ff4b01331ac,Bram Moolenaar,21,3,24,5,"{""src/evalfunc.c"": {""insertions"": 2, ""deletions"": 0, ""lines"": 2}, ""src/testdir/test_cursor_func.vim"": {""insertions"": 1, ""deletions"": 1, ""lines"": 2}, ""src/testdir/test_vim9_builtin.vim"": {""insertions"": 14, ""deletions"": 0, ""lines"": 14}, ""src/typval.c"": {""insertions"": 2, ""deletions"": 2, ""lines"": 4}, ""src/version.c"": {""insertions"": 2, ""deletions"": 0, ""lines"": 2}}"
2020-12-21 19:32:43,60f63100b9bc1d24b7b80c81f43cf2fc3da95987,Bram Moolenaar,24,0,24,3,"{""src/ex_cmds.c"": {""insertions"": 9, ""deletions"": 0, ""lines"": 9}, ""src/testdir/test_vim9_cmd.vim"": {""insertions"": 13, ""deletions"": 0, ""lines"": 13}, ""src/version.c"": {""insertions"": 2, ""deletions"": 0, ""lines"": 2}}"
2020-12-21 18:59:08,f4e2099e39ed4d71aed0f9a9579455aed5ec6cc2,Bram Moolenaar,98,42,140,17,"{""src/arglist.c"": {""insertions"": 1, ""deletions"": 1, ""lines"": 2}, ""src/buffer.c"": {""insertions"": 1, ""deletions"": 1, ""lines"": 2}, ""src/cmdexpand.c"": {""insertions"": 3, ""deletions"": 3, ""lines"": 6}, ""src/ex_cmds.c"": {""insertions"": 7, ""deletions"": 6, ""lines"": 13}, ""src/ex_cmds.h"": {""insertions"": 2, ""deletions"": 2, ""lines"": 4}, ""src/ex_docmd.c"": {""insertions"": 7, ""deletions"": 7, ""lines"": 14}, ""src/ex_getln.c"": {""insertions"": 7, ""deletions"": 7, ""lines"": 14}, ""src/globals.h"": {""insertions"": 5, ""deletions"": 0, ""lines"": 5}, ""src/insexpand.c"": {""insertions"": 2, ""deletions"": 2, ""lines"": 4}, ""src/normal.c"": {""insertions"": 2, ""deletions"": 2, ""lines"": 4}, ""src/option.c"": {""insertions"": 19, ""deletions"": 0, ""lines"": 19}, ""src/proto/option.pro"": {""insertions"": 1, ""deletions"": 0, ""lines"": 1}, ""src/search.c"": {""insertions"": 8, ""deletions"": 5, ""lines"": 13}, ""src/structs.h"": {""insertions"": 6, ""deletions"": 0, ""lines"": 6}, ""src/tag.c"": {""insertions"": 7, ""deletions"": 6, ""lines"": 13}, ""src/testdir/test_vim9_cmd.vim"": {""insertions"": 18, ""deletions"": 0, ""lines"": 18}, ""src/version.c"": {""insertions"": 2, ""deletions"": 0, ""lines"": 2}}"
2020-12-21 17:24:00,a3d10a508c404a32485adc86284725e0bdc5b602,Bram Moolenaar,32,24,56,3,"{""src/regexp_bt.c"": {""insertions"": 15, ""deletions"": 12, ""lines"": 27}, ""src/regexp_nfa.c"": {""insertions"": 15, ""deletions"": 12, ""lines"": 27}, ""src/version.c"": {""insertions"": 2, ""deletions"": 0, ""lines"": 2}}"
2020-12-21 17:11:24,6f17a3f0237302b82cc31fb889d9094b51856948,Bram Moolenaar,6,1,7,2,"{""src/testdir/test_vim9_script.vim"": {""insertions"": 4, ""deletions"": 1, ""lines"": 5}, ""src/version.c"": {""insertions"": 2, ""deletions"": 0, ""lines"": 2}}"
2020-12-21 16:30:50,4f5e39775616795ac7d1c01bf15a1bd316feb387,Bram Moolenaar,232,129,361,7,"{""src/errors.h"": {""insertions"": 4, ""deletions"": 0, ""lines"": 4}, ""src/testdir/test_vim9_assign.vim"": {""insertions"": 28, ""deletions"": 2, ""lines"": 30}, ""src/testdir/test_vim9_disassemble.vim"": {""insertions"": 24, ""deletions"": 0, ""lines"": 24}, ""src/version.c"": {""insertions"": 2, ""deletions"": 0, ""lines"": 2}, ""src/vim9.h"": {""insertions"": 3, ""deletions"": 2, ""lines"": 5}, ""src/vim9compile.c"": {""insertions"": 21, ""deletions"": 27, ""lines"": 48}, ""src/vim9execute.c"": {""insertions"": 150, ""deletions"": 98, ""lines"": 248}}"
2020-12-21 15:03:02,2e2f52a4a0fd560d37a11a7383a4d52b63ca6cfc,Bram Moolenaar,34,9,43,6,"{""src/if_py_both.h"": {""insertions"": 7, ""deletions"": 5, ""lines"": 12}, ""src/if_python.c"": {""insertions"": 4, ""deletions"": 0, ""lines"": 4}, ""src/if_python3.c"": {""insertions"": 7, ""deletions"": 4, ""lines"": 11}, ""src/testdir/test_python2.vim"": {""insertions"": 7, ""deletions"": 0, ""lines"": 7}, ""src/testdir/test_python3.vim"": {""insertions"": 7, ""deletions"": 0, ""lines"": 7}, ""src/version.c"": {""insertions"": 2, ""deletions"": 0, ""lines"": 2}}"
2020-12-21 13:54:32,ef2dff52de52c17fe1bd7c06cbb32d8955901f5a,Bram Moolenaar,18,3,21,3,"{""src/regexp_nfa.c"": {""insertions"": 5, ""deletions"": 3, ""lines"": 8}, ""src/testdir/test_regexp_utf8.vim"": {""insertions"": 11, ""deletions"": 0, ""lines"": 11}, ""src/version.c"": {""insertions"": 2, ""deletions"": 0, ""lines"": 2}}"
2020-12-21 13:01:41,6a78f328442073c32d58eafc13ce5a1ca7729eeb,Bram Moolenaar,10,1,11,3,"{""src/fold.c"": {""insertions"": 1, ""deletions"": 1, ""lines"": 2}, ""src/testdir/test_fold.vim"": {""insertions"": 7, ""deletions"": 0, ""lines"": 7}, ""src/version.c"": {""insertions"": 2, ""deletions"": 0, ""lines"": 2}}"
2020-12-21 12:37:28,9aff970204234193045cfee205d51e2393e93bfd,Bram Moolenaar,18,13,31,2,"{"".github/workflows/ci.yml"": {""insertions"": 16, ""deletions"": 13, ""lines"": 29}, ""src/version.c"": {""insertions"": 2, ""deletions"": 0, ""lines"": 2}}"
2020-12-21 12:05:57,8c9d98a8af5351a3ac98cf11dede9f0268461511,Bram Moolenaar,7,0,7,1,"{""src/version.c"": {""insertions"": 7, ""deletions"": 0, ""lines"": 7}}"
2020-12-20 20:43:35,52c124d3303d3cc3e4504708881906d17d6d6c55,Bram Moolenaar,19,4,23,5,"{""src/errors.h"": {""insertions"": 2, ""deletions"": 0, ""lines"": 2}, ""src/testdir/test_vim9_cmd.vim"": {""insertions"": 11, ""deletions"": 0, ""lines"": 11}, ""src/version.c"": {""insertions"": 2, ""deletions"": 0, ""lines"": 2}, ""src/vim9compile.c"": {""insertions"": 3, ""deletions"": 2, ""lines"": 5}, ""src/vim9execute.c"": {""insertions"": 1, ""deletions"": 2, ""lines"": 3}}"
2020-12-20 20:10:17,5082471f91dd42ed8c35e0f649d0a6572e6fe3fc,Bram Moolenaar,55,8,63,6,"{""src/proto/userfunc.pro"": {""insertions"": 1, ""deletions"": 0, ""lines"": 1}, ""src/testdir/test_vim9_func.vim"": {""insertions"": 19, ""deletions"": 0, ""lines"": 19}, ""src/testdir/test_vim9_script.vim"": {""insertions"": 2, ""deletions"": 2, ""lines"": 4}, ""src/userfunc.c"": {""insertions"": 20, ""deletions"": 6, ""lines"": 26}, ""src/version.c"": {""insertions"": 2, ""deletions"": 0, ""lines"": 2}, ""src/vim9execute.c"": {""insertions"": 11, ""deletions"": 0, ""lines"": 11}}"
2020-12-20 16:59:53,61e07b2394e12f757160cac421ec5c45dc4c074d,Bram Moolenaar,3,1,4,2,"{""src/regexp_nfa.c"": {""insertions"": 1, ""deletions"": 1, ""lines"": 2}, ""src/version.c"": {""insertions"": 2, ""deletions"": 0, ""lines"": 2}}"
2020-12-20 16:47:52,f112f30a82f17114d8b08a0fb90928cd19440581,Bram Moolenaar,114,45,159,6,"{""src/proto/userfunc.pro"": {""insertions"": 1, ""deletions"": 1, ""lines"": 2}, ""src/structs.h"": {""insertions"": 3, ""deletions"": 0, ""lines"": 3}, ""src/testdir/test_vim9_func.vim"": {""insertions"": 23, ""deletions"": 0, ""lines"": 23}, ""src/userfunc.c"": {""insertions"": 10, ""deletions"": 5, ""lines"": 15}, ""src/version.c"": {""insertions"": 2, ""deletions"": 0, ""lines"": 2}, ""src/vim9execute.c"": {""insertions"": 75, ""deletions"": 39, ""lines"": 114}}"
2020-12-20 14:43:31,090728ad4d54287c911894ef42bfe92844ce0fa5,Bram Moolenaar,50,22,72,3,"{""src/testdir/test_vim9_script.vim"": {""insertions"": 2, ""deletions"": 1, ""lines"": 3}, ""src/testdir/vim9.vim"": {""insertions"": 46, ""deletions"": 21, ""lines"": 67}, ""src/version.c"": {""insertions"": 2, ""deletions"": 0, ""lines"": 2}}"
2020-12-20 14:20:56,d24602f43cf1f3c37136fe275b83153c26a406e7,Bram Moolenaar,15,5,20,3,"{""src/testdir/test_vim9_assign.vim"": {""insertions"": 6, ""deletions"": 0, ""lines"": 6}, ""src/version.c"": {""insertions"": 2, ""deletions"": 0, ""lines"": 2}, ""src/vim9compile.c"": {""insertions"": 7, ""deletions"": 5, ""lines"": 12}}"
2020-12-20 13:49:42,d88dc4d4e950d937b44c523b9965d485f3fae4be,Bram Moolenaar,17,1,18,2,"{""src/testdir/test_vim9_assign.vim"": {""insertions"": 15, ""deletions"": 1, ""lines"": 16}, ""src/version.c"": {""insertions"": 2, ""deletions"": 0, ""lines"": 2}}"
2020-12-20 12:07:48,d0a1dee3f197d41434df4cf0271066b6aeb690fc,Bram Moolenaar,15,0,15,3,"{""src/ops.c"": {""insertions"": 1, ""deletions"": 0, ""lines"": 1}, ""src/testdir/test_textformat.vim"": {""insertions"": 12, ""deletions"": 0, ""lines"": 12}, ""src/version.c"": {""insertions"": 2, ""deletions"": 0, ""lines"": 2}}"
2020-12-19 21:10:13,8f22f5c3aa0aa96e3843a57f29405625d8514c74,Bram Moolenaar,20,6,26,5,"{""src/eval.c"": {""insertions"": 7, ""deletions"": 0, ""lines"": 7}, ""src/evalvars.c"": {""insertions"": 2, ""deletions"": 1, ""lines"": 3}, ""src/ex_docmd.c"": {""insertions"": 2, ""deletions"": 0, ""lines"": 2}, ""src/version.c"": {""insertions"": 2, ""deletions"": 0, ""lines"": 2}, ""src/vim.h"": {""insertions"": 7, ""deletions"": 5, ""lines"": 12}}"
2020-12-19 20:23:42,17f700ac8b55f27ddb519ecaa8acaa43fc1ae60a,Bram Moolenaar,23,1,24,3,"{""src/testdir/test_vim9_script.vim"": {""insertions"": 10, ""deletions"": 0, ""lines"": 10}, ""src/userfunc.c"": {""insertions"": 11, ""deletions"": 1, ""lines"": 12}, ""src/version.c"": {""insertions"": 2, ""deletions"": 0, ""lines"": 2}}"
2020-12-19 16:55:54,13656f02e457fb68cd7e72412fc24ccac02fb06e,Bram Moolenaar,6,5,11,2,"{""src/ex_eval.c"": {""insertions"": 4, ""deletions"": 5, ""lines"": 9}, ""src/version.c"": {""insertions"": 2, ""deletions"": 0, ""lines"": 2}}"
2020-12-19 15:30:44,03290b8444b69c6d7307755770467bc488384e1a,Bram Moolenaar,106,15,121,10,"{""src/dict.c"": {""insertions"": 1, ""deletions"": 1, ""lines"": 2}, ""src/eval.c"": {""insertions"": 1, ""deletions"": 1, ""lines"": 2}, ""src/evalvars.c"": {""insertions"": 7, ""deletions"": 5, ""lines"": 12}, ""src/proto/evalvars.pro"": {""insertions"": 1, ""deletions"": 1, ""lines"": 2}, ""src/testdir/test_vim9_disassemble.vim"": {""insertions"": 12, ""deletions"": 2, ""lines"": 14}, ""src/testdir/test_vim9_script.vim"": {""insertions"": 31, ""deletions"": 1, ""lines"": 32}, ""src/version.c"": {""insertions"": 2, ""deletions"": 0, ""lines"": 2}, ""src/vim9.h"": {""insertions"": 2, ""deletions"": 0, ""lines"": 2}, ""src/vim9compile.c"": {""insertions"": 20, ""deletions"": 4, ""lines"": 24}, ""src/vim9execute.c"": {""insertions"": 29, ""deletions"": 0, ""lines"": 29}}"
2020-12-19 12:32:07,1f33e0a7c4cd278158b37f91a2aa44f0bcd1f21a,Bram Moolenaar,49,0,49,2,"{""src/testdir/test_startup.vim"": {""insertions"": 47, ""deletions"": 0, ""lines"": 47}, ""src/version.c"": {""insertions"": 2, ""deletions"": 0, ""lines"": 2}}"
2020-12-18 18:49:56,8e7d6223f630690b72b387eaed704bf01f3f29d2,Bram Moolenaar,54,51,105,39,"{""src/bufwrite.c"": {""insertions"": 1, ""deletions"": 1, ""lines"": 2}, ""src/cindent.c"": {""insertions"": 1, ""deletions"": 1, ""lines"": 2}, ""src/cmdexpand.c"": {""insertions"": 1, ""deletions"": 1, ""lines"": 2}, ""src/eval.c"": {""insertions"": 1, ""deletions"": 1, ""lines"": 2}, ""src/ex_cmds.c"": {""insertions"": 1, ""deletions"": 1, ""lines"": 2}, ""src/feature.h"": {""insertions"": 1, ""deletions"": 1, ""lines"": 2}, ""src/getchar.c"": {""insertions"": 1, ""deletions"": 1, ""lines"": 2}, ""src/gui_haiku.cc"": {""insertions"": 1, ""deletions"": 1, ""lines"": 2}, ""src/gui_xmdlg.c"": {""insertions"": 1, ""deletions"": 1, ""lines"": 2}, ""src/help.c"": {""insertions"": 3, ""deletions"": 1, ""lines"": 4}, ""src/if_ole.cpp"": {""insertions"": 1, ""deletions"": 1, ""lines"": 2}, ""src/insexpand.c"": {""insertions"": 1, ""deletions"": 1, ""lines"": 2}, ""src/list.c"": {""insertions"": 1, ""deletions"": 1, ""lines"": 2}, ""src/map.c"": {""insertions"": 1, ""deletions"": 1, ""lines"": 2}, ""src/memline.c"": {""insertions"": 1, ""deletions"": 1, ""lines"": 2}, ""src/normal.c"": {""insertions"": 1, ""deletions"": 1, ""lines"": 2}, ""src/os_win32.c"": {""insertions"": 6, ""deletions"": 7, ""lines"": 13}, ""src/search.c"": {""insertions"": 1, ""deletions"": 1, ""lines"": 2}, ""src/term.c"": {""insertions"": 2, ""deletions"": 2, ""lines"": 4}, ""src/testdir/test_arglist.vim"": {""insertions"": 1, ""deletions"": 1, ""lines"": 2}, ""src/testdir/test_autocmd.vim"": {""insertions"": 1, ""deletions"": 1, ""lines"": 2}, ""src/testdir/test_debugger.vim"": {""insertions"": 1, ""deletions"": 1, ""lines"": 2}, ""src/testdir/test_increment.vim"": {""insertions"": 1, ""deletions"": 1, ""lines"": 2}, ""src/testdir/test_menu.vim"": {""insertions"": 1, ""deletions"": 1, ""lines"": 2}, ""src/testdir/test_netbeans.vim"": {""insertions"": 1, ""deletions"": 1, ""lines"": 2}, ""src/testdir/test_popupwin.vim"": {""insertions"": 1, ""deletions"": 1, ""lines"": 2}, ""src/testdir/test_python2.vim"": {""insertions"": 1, ""deletions"": 1, ""lines"": 2}, ""src/testdir/test_python3.vim"": {""insertions"": 1, ""deletions"": 1, ""lines"": 2}, ""src/testdir/test_sort.vim"": {""insertions"": 1, ""deletions"": 1, ""lines"": 2}, ""src/testdir/test_terminal2.vim"": {""insertions"": 2, ""deletions"": 2, ""lines"": 4}, ""src/testdir/test_terminal3.vim"": {""insertions"": 1, ""deletions"": 1, ""lines"": 2}, ""src/testdir/test_vartabs.vim"": {""insertions"": 1, ""deletions"": 1, ""lines"": 2}, ""src/testdir/test_vimscript.vim"": {""insertions"": 1, ""deletions"": 1, ""lines"": 2}, ""src/textprop.c"": {""insertions"": 2, ""deletions"": 2, ""lines"": 4}, ""src/userfunc.c"": {""insertions"": 1, ""deletions"": 1, ""lines"": 2}, ""src/version.c"": {""insertions"": 2, ""deletions"": 0, ""lines"": 2}, ""src/vim9.h"": {""insertions"": 1, ""deletions"": 1, ""lines"": 2}, ""src/vim9compile.c"": {""insertions"": 5, ""deletions"": 5, ""lines"": 10}, ""src/vim9execute.c"": {""insertions"": 1, ""deletions"": 1, ""lines"": 2}}"
2020-12-18 16:23:14,3beaf9cd8efa3ba83e07187215004d140b89d529,Bram Moolenaar,35,1,36,3,"{""src/testdir/test_vim9_assign.vim"": {""insertions"": 12, ""deletions"": 1, ""lines"": 13}, ""src/version.c"": {""insertions"": 2, ""deletions"": 0, ""lines"": 2}, ""src/vim9execute.c"": {""insertions"": 21, ""deletions"": 0, ""lines"": 21}}"
2020-12-18 15:29:25,6e562fcc07c71ad1437c89c3d3cc423efb691f0a,Bram Moolenaar,5,1,6,3,"{"".cirrus.yml"": {""insertions"": 2, ""deletions"": 0, ""lines"": 2}, "".github/workflows/ci.yml"": {""insertions"": 1, ""deletions"": 1, ""lines"": 2}, ""src/version.c"": {""insertions"": 2, ""deletions"": 0, ""lines"": 2}}"
2020-12-18 14:38:00,9aed729fe9e62536236875a42fb170d2c8fb3046,Bram Moolenaar,20,0,20,3,"{""src/evalvars.c"": {""insertions"": 10, ""deletions"": 0, ""lines"": 10}, ""src/testdir/test_vim9_assign.vim"": {""insertions"": 8, ""deletions"": 0, ""lines"": 8}, ""src/version.c"": {""insertions"": 2, ""deletions"": 0, ""lines"": 2}}"
2020-12-18 12:31:31,b5b77378bc35cb268c384e98c59f2bf8cb406270,Bram Moolenaar,13,9,22,3,"{"".github/workflows/ci.yml"": {""insertions"": 11, ""deletions"": 5, ""lines"": 16}, "".github/workflows/codeql-analysis.yml"": {""insertions"": 0, ""deletions"": 4, ""lines"": 4}, ""src/version.c"": {""insertions"": 2, ""deletions"": 0, ""lines"": 2}}"
2020-12-18 12:15:20,18f69229c581a0f738145cdec70df66723a518fc,Bram Moolenaar,2,5,7,2,"{"".github/workflows/codeql-analysis.yml"": {""insertions"": 0, ""deletions"": 5, ""lines"": 5}, ""src/version.c"": {""insertions"": 2, ""deletions"": 0, ""lines"": 2}}"
2020-12-17 21:27:38,0353f56ddb379e7f1a68172fa4743355e04df21e,Bram Moolenaar,6,3,9,2,"{""src/testdir/test_popupwin.vim"": {""insertions"": 4, ""deletions"": 3, ""lines"": 7}, ""src/version.c"": {""insertions"": 2, ""deletions"": 0, ""lines"": 2}}"
2020-12-17 20:56:09,b125b535bb0456ab43c10683307a4bc359442d44,Bram Moolenaar,6,0,6,2,"{""src/testdir/test_popupwin.vim"": {""insertions"": 4, ""deletions"": 0, ""lines"": 4}, ""src/version.c"": {""insertions"": 2, ""deletions"": 0, ""lines"": 2}}"
2020-12-17 20:35:29,8dd46e72cfb13b8de793c808ee009c45e881903a,Bram Moolenaar,8,1,9,3,"{""src/move.c"": {""insertions"": 1, ""deletions"": 1, ""lines"": 2}, ""src/testdir/test_cursor_func.vim"": {""insertions"": 5, ""deletions"": 0, ""lines"": 5}, ""src/version.c"": {""insertions"": 2, ""deletions"": 0, ""lines"": 2}}"
2020-12-17 19:50:25,a79a8944dade9115ccaa5a06a076dfb257e56c62,Bram Moolenaar,4,2,6,3,"{""src/auto/configure"": {""insertions"": 1, ""deletions"": 1, ""lines"": 2}, ""src/configure.ac"": {""insertions"": 1, ""deletions"": 1, ""lines"": 2}, ""src/version.c"": {""insertions"": 2, ""deletions"": 0, ""lines"": 2}}"
2020-12-17 19:27:26,8ea05de6aa1d133cba3381bcc36adf1736b08e00,Bram Moolenaar,660,331,991,8,"{"".coveralls.yml"": {""insertions"": 1, ""deletions"": 0, ""lines"": 1}, "".github/workflows/ci-windows.yaml"": {""insertions"": 0, ""deletions"": 230, ""lines"": 230}, "".github/workflows/ci.yml"": {""insertions"": 519, ""deletions"": 0, ""lines"": 519}, "".travis.yml"": {""insertions"": 100, ""deletions"": 100, ""lines"": 200}, ""README.md"": {""insertions"": 2, ""deletions"": 1, ""lines"": 3}, ""ci/build-snd-dummy.sh"": {""insertions"": 19, ""deletions"": 0, ""lines"": 19}, ""ci/setup-xvfb.sh"": {""insertions"": 17, ""deletions"": 0, ""lines"": 17}, ""src/version.c"": {""insertions"": 2, ""deletions"": 0, ""lines"": 2}}"
2020-12-17 16:45:59,4c5bdb99ad632d703e94fffafba11b91861fea48,Bram Moolenaar,5,0,5,2,"{""src/testdir/test_popupwin.vim"": {""insertions"": 3, ""deletions"": 0, ""lines"": 3}, ""src/version.c"": {""insertions"": 2, ""deletions"": 0, ""lines"": 2}}"
2020-12-16 20:43:54,1c0aa97827f30e3051ee50a0690555c2c23c0ceb,Bram Moolenaar,12,1,13,3,"{""src/ex_docmd.c"": {""insertions"": 1, ""deletions"": 1, ""lines"": 2}, ""src/testdir/test_vim9_cmd.vim"": {""insertions"": 9, ""deletions"": 0, ""lines"": 9}, ""src/version.c"": {""insertions"": 2, ""deletions"": 0, ""lines"": 2}}"
2020-12-16 20:02:56,530bed993e41bda6f717a8ddd0acb39464f95336,Bram Moolenaar,38,7,45,3,"{""src/quickfix.c"": {""insertions"": 12, ""deletions"": 7, ""lines"": 19}, ""src/testdir/test_quickfix.vim"": {""insertions"": 24, ""deletions"": 0, ""lines"": 24}, ""src/version.c"": {""insertions"": 2, ""deletions"": 0, ""lines"": 2}}"
2020-12-15 20:41:56,9987fb0b4b591e6450fb1dfbe8f615f365057f2a,Bram Moolenaar,15,0,15,3,"{""src/dict.c"": {""insertions"": 5, ""deletions"": 0, ""lines"": 5}, ""src/testdir/test_vim9_expr.vim"": {""insertions"": 8, ""deletions"": 0, ""lines"": 8}, ""src/version.c"": {""insertions"": 2, ""deletions"": 0, ""lines"": 2}}"
2020-12-15 20:28:57,399ea8108c8da3fcdf5d738a0f8eae67155b4b10,Bram Moolenaar,35,6,41,3,"{""src/testdir/test_vim9_expr.vim"": {""insertions"": 17, ""deletions"": 0, ""lines"": 17}, ""src/version.c"": {""insertions"": 2, ""deletions"": 0, ""lines"": 2}, ""src/vim9compile.c"": {""insertions"": 16, ""deletions"": 6, ""lines"": 22}}"
2020-12-14 17:31:27,025cb1ca8605055383c53bf2c823d7093cf29b82,Bram Moolenaar,27,12,39,3,"{""src/testdir/test_vim9_cmd.vim"": {""insertions"": 17, ""deletions"": 0, ""lines"": 17}, ""src/testdir/test_vim9_script.vim"": {""insertions"": 8, ""deletions"": 12, ""lines"": 20}, ""src/version.c"": {""insertions"": 2, ""deletions"": 0, ""lines"": 2}}"
2020-12-13 20:26:56,ec792290eb902e01c9edfc0cb71e5235833df56a,Bram Moolenaar,3,7,10,2,"{""src/version.c"": {""insertions"": 2, ""deletions"": 0, ""lines"": 2}, ""src/vim9compile.c"": {""insertions"": 1, ""deletions"": 7, ""lines"": 8}}"
2020-12-13 20:16:55,fffdf4754f4fd789c64596bdd9ea069725e63784,Bram Moolenaar,3,0,3,2,"{""src/userfunc.c"": {""insertions"": 1, ""deletions"": 0, ""lines"": 1}, ""src/version.c"": {""insertions"": 2, ""deletions"": 0, ""lines"": 2}}"
2020-12-13 19:26:29,8143a53c533bc7776c57e5db063d185bdd5750f3,Bram Moolenaar,34,4,38,4,"{""src/eval.c"": {""insertions"": 4, ""deletions"": 1, ""lines"": 5}, ""src/testdir/test_trycatch.vim"": {""insertions"": 25, ""deletions"": 0, ""lines"": 25}, ""src/testdir/test_vimscript.vim"": {""insertions"": 3, ""deletions"": 3, ""lines"": 6}, ""src/version.c"": {""insertions"": 2, ""deletions"": 0, ""lines"": 2}}"
2020-12-13 18:22:27,2a3cd3af455973d678f70303ebdd486f3478bc0d,Bram Moolenaar,4,0,4,2,"{""src/ex_docmd.c"": {""insertions"": 2, ""deletions"": 0, ""lines"": 2}, ""src/version.c"": {""insertions"": 2, ""deletions"": 0, ""lines"": 2}}"
2020-12-13 17:44:43,acbae18df528b6aee72ecfd66e344dc8be7b3775,Bram Moolenaar,14,4,18,3,"{""src/testdir/test_vim9_assign.vim"": {""insertions"": 12, ""deletions"": 0, ""lines"": 12}, ""src/version.c"": {""insertions"": 2, ""deletions"": 0, ""lines"": 2}, ""src/vim9compile.c"": {""insertions"": 0, ""deletions"": 4, ""lines"": 4}}"
2020-12-13 16:50:20,b5b9480ee936ef4cd0e350c468ef8c5f42fa398b,Bram Moolenaar,59,18,77,8,"{""src/errors.h"": {""insertions"": 5, ""deletions"": 1, ""lines"": 6}, ""src/ex_cmds.h"": {""insertions"": 9, ""deletions"": 8, ""lines"": 17}, ""src/ex_docmd.c"": {""insertions"": 9, ""deletions"": 1, ""lines"": 10}, ""src/testdir/test_let.vim"": {""insertions"": 2, ""deletions"": 2, ""lines"": 4}, ""src/testdir/test_vim9_assign.vim"": {""insertions"": 12, ""deletions"": 1, ""lines"": 13}, ""src/testdir/test_vim9_script.vim"": {""insertions"": 8, ""deletions"": 1, ""lines"": 9}, ""src/userfunc.c"": {""insertions"": 12, ""deletions"": 4, ""lines"": 16}, ""src/version.c"": {""insertions"": 2, ""deletions"": 0, ""lines"": 2}}"
2020-12-13 13:19:25,e4984290870565a2413cca660b0131f4702b7665,Bram Moolenaar,51,26,77,5,"{""src/errors.h"": {""insertions"": 3, ""deletions"": 1, ""lines"": 4}, ""src/testdir/test_vim9_disassemble.vim"": {""insertions"": 22, ""deletions"": 8, ""lines"": 30}, ""src/testdir/test_vim9_script.vim"": {""insertions"": 6, ""deletions"": 5, ""lines"": 11}, ""src/version.c"": {""insertions"": 2, ""deletions"": 0, ""lines"": 2}, ""src/vim9compile.c"": {""insertions"": 18, ""deletions"": 12, ""lines"": 30}}"
2020-12-13 11:25:35,c530852315517a44354edbbd6c3375355bbec37e,Bram Moolenaar,7,4,11,2,"{""src/filepath.c"": {""insertions"": 5, ""deletions"": 4, ""lines"": 9}, ""src/version.c"": {""insertions"": 2, ""deletions"": 0, ""lines"": 2}}"
2020-12-12 20:25:56,93f82cbee515e13b564f51ddcd5e3d6694358ba4,Bram Moolenaar,17,2,19,3,"{""src/ex_docmd.c"": {""insertions"": 1, ""deletions"": 2, ""lines"": 3}, ""src/testdir/test_vim9_script.vim"": {""insertions"": 14, ""deletions"": 0, ""lines"": 14}, ""src/version.c"": {""insertions"": 2, ""deletions"": 0, ""lines"": 2}}"
2020-12-12 19:42:19,57f799e6a4a56f41570c752c66dc2f692b1f2c2f,Bram Moolenaar,23,1,24,3,"{""src/testdir/test_vim9_func.vim"": {""insertions"": 20, ""deletions"": 0, ""lines"": 20}, ""src/version.c"": {""insertions"": 2, ""deletions"": 0, ""lines"": 2}, ""src/vim9execute.c"": {""insertions"": 1, ""deletions"": 1, ""lines"": 2}}"
2020-12-12 17:58:40,2a9d5d386bea8455b37c1accebc45683ec51d6fb,Bram Moolenaar,59,24,83,6,"{""src/errors.h"": {""insertions"": 2, ""deletions"": 0, ""lines"": 2}, ""src/filepath.c"": {""insertions"": 4, ""deletions"": 4, ""lines"": 8}, ""src/proto/typval.pro"": {""insertions"": 1, ""deletions"": 0, ""lines"": 1}, ""src/testdir/test_vim9_builtin.vim"": {""insertions"": 32, ""deletions"": 16, ""lines"": 48}, ""src/typval.c"": {""insertions"": 18, ""deletions"": 4, ""lines"": 22}, ""src/version.c"": {""insertions"": 2, ""deletions"": 0, ""lines"": 2}}"
2020-12-12 17:18:06,3ae50c775c00b098cdfc9e90b17c4cc07f00e08d,Bram Moolenaar,39,8,47,5,"{""src/popupwin.c"": {""insertions"": 7, ""deletions"": 8, ""lines"": 15}, ""src/testdir/dumps/Test_popupwin_longtitle_3.dump"": {""insertions"": 10, ""deletions"": 0, ""lines"": 10}, ""src/testdir/dumps/Test_popupwin_longtitle_4.dump"": {""insertions"": 10, ""deletions"": 0, ""lines"": 10}, ""src/testdir/test_popupwin.vim"": {""insertions"": 10, ""deletions"": 0, ""lines"": 10}, ""src/version.c"": {""insertions"": 2, ""deletions"": 0, ""lines"": 2}}"
2020-12-12 13:33:41,709664cca0b59b69caa1ed40ebfcf00b2c672693,Bram Moolenaar,66,47,113,7,"{""src/evalvars.c"": {""insertions"": 14, ""deletions"": 11, ""lines"": 25}, ""src/ex_docmd.c"": {""insertions"": 2, ""deletions"": 2, ""lines"": 4}, ""src/proto/evalvars.pro"": {""insertions"": 1, ""deletions"": 1, ""lines"": 2}, ""src/proto/ex_docmd.pro"": {""insertions"": 1, ""deletions"": 1, ""lines"": 2}, ""src/testdir/test_vim9_func.vim"": {""insertions"": 6, ""deletions"": 0, ""lines"": 6}, ""src/version.c"": {""insertions"": 2, ""deletions"": 0, ""lines"": 2}, ""src/vim9compile.c"": {""insertions"": 40, ""deletions"": 32, ""lines"": 72}}"
2020-12-12 12:32:07,cc2335896ba707bf0d8cf03cca2de7c66fab62a0,Bram Moolenaar,24,1,25,3,"{""src/insexpand.c"": {""insertions"": 9, ""deletions"": 0, ""lines"": 9}, ""src/testdir/test_ins_complete.vim"": {""insertions"": 13, ""deletions"": 1, ""lines"": 14}, ""src/version.c"": {""insertions"": 2, ""deletions"": 0, ""lines"": 2}}"
2020-12-11 19:10:50,0ea7421ae6618fe8efe9e3afc8fdcf7a4d89739a,Bram Moolenaar,9,15,24,2,"{""src/os_mswin.c"": {""insertions"": 7, ""deletions"": 15, ""lines"": 22}, ""src/version.c"": {""insertions"": 2, ""deletions"": 0, ""lines"": 2}}"
2020-12-11 18:30:34,100118c73ac068137cd298d22953896242752523,Bram Moolenaar,67,1,68,7,"{""runtime/doc/autocmd.txt"": {""insertions"": 14, ""deletions"": 0, ""lines"": 14}, ""src/autocmd.c"": {""insertions"": 2, ""deletions"": 0, ""lines"": 2}, ""src/ex_docmd.c"": {""insertions"": 2, ""deletions"": 0, ""lines"": 2}, ""src/normal.c"": {""insertions"": 1, ""deletions"": 1, ""lines"": 2}, ""src/testdir/test_suspend.vim"": {""insertions"": 44, ""deletions"": 0, ""lines"": 44}, ""src/version.c"": {""insertions"": 2, ""deletions"": 0, ""lines"": 2}, ""src/vim.h"": {""insertions"": 2, ""deletions"": 0, ""lines"": 2}}"
2020-12-10 20:11:27,1b884a0053982335f644eec6c71027706bf3c522,Bram Moolenaar,1744,213,1957,20,"{"".github/CODEOWNERS"": {""insertions"": 24, ""deletions"": 0, ""lines"": 24}, ""runtime/doc/autocmd.txt"": {""insertions"": 3, ""deletions"": 2, ""lines"": 5}, ""runtime/doc/eval.txt"": {""insertions"": 12, ""deletions"": 11, ""lines"": 23}, ""runtime/doc/helphelp.txt"": {""insertions"": 20, ""deletions"": 1, ""lines"": 21}, ""runtime/doc/map.txt"": {""insertions"": 20, ""deletions"": 15, ""lines"": 35}, ""runtime/doc/pattern.txt"": {""insertions"": 12, ""deletions"": 11, ""lines"": 23}, ""runtime/doc/syntax.txt"": {""insertions"": 19, ""deletions"": 1, ""lines"": 20}, ""runtime/doc/tags"": {""insertions"": 6, ""deletions"": 0, ""lines"": 6}, ""runtime/doc/todo.txt"": {""insertions"": 21, ""deletions"": 28, ""lines"": 49}, ""runtime/doc/undo.txt"": {""insertions"": 5, ""deletions"": 5, ""lines"": 10}, ""runtime/doc/vim9.txt"": {""insertions"": 6, ""deletions"": 5, ""lines"": 11}, ""runtime/filetype.vim"": {""insertions"": 1, ""deletions"": 1, ""lines"": 2}, ""runtime/pack/dist/opt/termdebug/plugin/termdebug.vim"": {""insertions"": 7, ""deletions"": 3, ""lines"": 10}, ""runtime/syntax/aidl.vim"": {""insertions"": 2, ""deletions"": 2, ""lines"": 4}, ""runtime/syntax/diff.vim"": {""insertions"": 4, ""deletions"": 2, ""lines"": 6}, ""runtime/tools/emoji_list.vim"": {""insertions"": 2, ""deletions"": 2, ""lines"": 4}, ""runtime/tutor/tutor.fr"": {""insertions"": 3, ""deletions"": 3, ""lines"": 6}, ""runtime/tutor/tutor.fr.utf-8"": {""insertions"": 3, ""deletions"": 3, ""lines"": 6}, ""src/INSTALLx.txt"": {""insertions"": 0, ""deletions"": 9, ""lines"": 9}, ""src/po/tr.po"": {""insertions"": 1574, ""deletions"": 109, ""lines"": 1683}}"
2020-12-10 20:01:30,70249ee831df357c1a5475473fc84c40d101a67d,Bram Moolenaar,23,0,23,2,"{""src/testdir/test_vim9_script.vim"": {""insertions"": 21, ""deletions"": 0, ""lines"": 21}, ""src/version.c"": {""insertions"": 2, ""deletions"": 0, ""lines"": 2}}"
2020-12-10 19:50:34,0e12140550a63bb1e45771edb89b941959440cfe,Bram Moolenaar,6,0,6,2,"{""src/if_ruby.c"": {""insertions"": 4, ""deletions"": 0, ""lines"": 4}, ""src/version.c"": {""insertions"": 2, ""deletions"": 0, ""lines"": 2}}"
2020-12-10 19:21:24,8f1bf2ef785e48a4ca08e014b7713fdee2824631,Bram Moolenaar,3,1,4,2,"{""src/scriptfile.c"": {""insertions"": 1, ""deletions"": 1, ""lines"": 2}, ""src/version.c"": {""insertions"": 2, ""deletions"": 0, ""lines"": 2}}"
2020-12-10 18:43:40,08597875b2a1e7d118b0346c652a96e7527e7d8b,Bram Moolenaar,128,12,140,6,"{""src/testdir/test_vim9_cmd.vim"": {""insertions"": 11, ""deletions"": 0, ""lines"": 11}, ""src/testdir/test_vim9_disassemble.vim"": {""insertions"": 15, ""deletions"": 0, ""lines"": 15}, ""src/version.c"": {""insertions"": 2, ""deletions"": 0, ""lines"": 2}, ""src/vim9.h"": {""insertions"": 6, ""deletions"": 0, ""lines"": 6}, ""src/vim9compile.c"": {""insertions"": 53, ""deletions"": 10, ""lines"": 63}, ""src/vim9execute.c"": {""insertions"": 41, ""deletions"": 2, ""lines"": 43}}"
2020-12-09 17:13:44,d356fc65d273959efa9b05bfa0f07ce1c9ff85a4,Bram Moolenaar,6,0,6,3,"{""src/popupmenu.c"": {""insertions"": 1, ""deletions"": 0, ""lines"": 1}, ""src/testdir/test_popupwin.vim"": {""insertions"": 3, ""deletions"": 0, ""lines"": 3}, ""src/version.c"": {""insertions"": 2, ""deletions"": 0, ""lines"": 2}}"
2020-12-09 16:16:59,9ec7026f24e9ac51654300e32afd2b7540cab5f8,Bram Moolenaar,14,2,16,3,"{""src/scriptfile.c"": {""insertions"": 1, ""deletions"": 2, ""lines"": 3}, ""src/testdir/test_vim9_script.vim"": {""insertions"": 11, ""deletions"": 0, ""lines"": 11}, ""src/version.c"": {""insertions"": 2, ""deletions"": 0, ""lines"": 2}}"
2020-12-09 15:36:04,a7a691cc142439e266f4ceb1f208bb952b57aa71,Bram Moolenaar,43,0,43,4,"{""src/regexp_bt.c"": {""insertions"": 17, ""deletions"": 0, ""lines"": 17}, ""src/regexp_nfa.c"": {""insertions"": 17, ""deletions"": 0, ""lines"": 17}, ""src/testdir/test_regexp_latin.vim"": {""insertions"": 7, ""deletions"": 0, ""lines"": 7}, ""src/version.c"": {""insertions"": 2, ""deletions"": 0, ""lines"": 2}}"
2020-12-09 15:05:45,730677a0dafe6f2e72888ef59f74f66f2d0a573e,Bram Moolenaar,21,2,23,2,"{""src/testdir/test_perl.vim"": {""insertions"": 19, ""deletions"": 2, ""lines"": 21}, ""src/version.c"": {""insertions"": 2, ""deletions"": 0, ""lines"": 2}}"
2020-12-09 14:53:27,7988a6f0e9999d1103271024ab4ed26e5599de17,Bram Moolenaar,10,5,15,2,"{""src/gui_gtk_x11.c"": {""insertions"": 8, ""deletions"": 5, ""lines"": 13}, ""src/version.c"": {""insertions"": 2, ""deletions"": 0, ""lines"": 2}}"
2020-12-09 12:16:13,f46bf5204c3c55d23921b501db21a906d526eb45,Bram Moolenaar,8,3,11,2,"{""src/job.c"": {""insertions"": 6, ""deletions"": 3, ""lines"": 9}, ""src/version.c"": {""insertions"": 2, ""deletions"": 0, ""lines"": 2}}"
2020-12-09 11:41:50,7bb4e74c38642682cfdd0cb4052adfa5efdd7dd1,Bram Moolenaar,113,13,126,7,"{""src/filepath.c"": {""insertions"": 23, ""deletions"": 6, ""lines"": 29}, ""src/mbyte.c"": {""insertions"": 1, ""deletions"": 6, ""lines"": 7}, ""src/proto/typval.pro"": {""insertions"": 1, ""deletions"": 0, ""lines"": 1}, ""src/testdir/test_vim9_builtin.vim"": {""insertions"": 69, ""deletions"": 0, ""lines"": 69}, ""src/testdir/test_vim9_expr.vim"": {""insertions"": 1, ""deletions"": 1, ""lines"": 2}, ""src/typval.c"": {""insertions"": 16, ""deletions"": 0, ""lines"": 16}, ""src/version.c"": {""insertions"": 2, ""deletions"": 0, ""lines"": 2}}"
2020-12-09 11:01:03,2c78a772fdb5f6a16d16a47e7f218051c4dcb845,Bram Moolenaar,12,5,17,2,"{""src/testdir/test_gui.vim"": {""insertions"": 10, ""deletions"": 5, ""lines"": 15}, ""src/version.c"": {""insertions"": 2, ""deletions"": 0, ""lines"": 2}}"
2020-12-08 21:08:51,7257af477bc5f33153f8f700b643551525f1105b,Bram Moolenaar,9,5,14,3,"{""src/testdir/test_vim9_assign.vim"": {""insertions"": 7, ""deletions"": 0, ""lines"": 7}, ""src/version.c"": {""insertions"": 2, ""deletions"": 0, ""lines"": 2}, ""src/vim9compile.c"": {""insertions"": 0, ""deletions"": 5, ""lines"": 5}}"
2020-12-08 20:53:28,61265b4000b172ce891b3ded221bc0f624d9b55b,Bram Moolenaar,2,10,12,2,"{""src/version.c"": {""insertions"": 2, ""deletions"": 0, ""lines"": 2}, ""src/vim9compile.c"": {""insertions"": 0, ""deletions"": 10, ""lines"": 10}}"
2020-12-08 20:12:40,1b3e0727ce86ca4cfa47f8b5421d82ed47a9bec1,Bram Moolenaar,11,1,12,3,"{""src/gui_dwrite.cpp"": {""insertions"": 2, ""deletions"": 1, ""lines"": 3}, ""src/testdir/test_gui.vim"": {""insertions"": 7, ""deletions"": 0, ""lines"": 7}, ""src/version.c"": {""insertions"": 2, ""deletions"": 0, ""lines"": 2}}"
2020-12-08 19:39:15,ac665c24c97582a64ae2d151a812eca92c1ff2d6,Bram Moolenaar,9,6,15,4,"{""src/testdir/test_filetype.vim"": {""insertions"": 1, ""deletions"": 1, ""lines"": 2}, ""src/testdir/test_messages.vim"": {""insertions"": 1, ""deletions"": 1, ""lines"": 2}, ""src/testdir/test_mksession.vim"": {""insertions"": 5, ""deletions"": 4, ""lines"": 9}, ""src/version.c"": {""insertions"": 2, ""deletions"": 0, ""lines"": 2}}"
2020-12-08 19:31:16,023fd5d21323fe6dffa080bd20c4d39e1212d353,Bram Moolenaar,9,7,16,2,"{""src/gui_gtk_x11.c"": {""insertions"": 7, ""deletions"": 7, ""lines"": 14}, ""src/version.c"": {""insertions"": 2, ""deletions"": 0, ""lines"": 2}}"
2020-12-08 18:36:21,8e1cbb55c389bdc4eade7a67309d5042fbcdca7d,Bram Moolenaar,10,1,11,2,"{""src/main.c"": {""insertions"": 8, ""deletions"": 1, ""lines"": 9}, ""src/version.c"": {""insertions"": 2, ""deletions"": 0, ""lines"": 2}}"
2020-12-08 18:18:37,8a3da6a368ca7e761939366e355528bccb6dffa3,Bram Moolenaar,9,3,12,2,"{""src/os_unix.c"": {""insertions"": 7, ""deletions"": 3, ""lines"": 10}, ""src/version.c"": {""insertions"": 2, ""deletions"": 0, ""lines"": 2}}"
2020-12-08 10:29:40,083966f671475ae1b67f746f0b3f5309a45dfd8f,Bram Moolenaar,12,6,18,2,"{""src/testdir/test_vim9_assign.vim"": {""insertions"": 10, ""deletions"": 6, ""lines"": 16}, ""src/version.c"": {""insertions"": 2, ""deletions"": 0, ""lines"": 2}}"
2020-12-07 20:49:52,8ff16e0183e0b07f34c0db8160cf6a472c427eb8,Bram Moolenaar,56,14,70,4,"{""src/testdir/test_vim9_assign.vim"": {""insertions"": 40, ""deletions"": 1, ""lines"": 41}, ""src/testdir/test_vim9_expr.vim"": {""insertions"": 12, ""deletions"": 12, ""lines"": 24}, ""src/version.c"": {""insertions"": 2, ""deletions"": 0, ""lines"": 2}, ""src/vim9compile.c"": {""insertions"": 2, ""deletions"": 1, ""lines"": 3}}"
2020-12-07 17:05:02,b237ae7b837a31922d31c3a27b7c66e63468b8a8,Bram Moolenaar,6,0,6,3,"{""runtime/filetype.vim"": {""insertions"": 3, ""deletions"": 0, ""lines"": 3}, ""src/testdir/test_filetype.vim"": {""insertions"": 1, ""deletions"": 0, ""lines"": 1}, ""src/version.c"": {""insertions"": 2, ""deletions"": 0, ""lines"": 2}}"
2020-12-06 20:43:44,7b130b9738c3d3975721ce9b84f91320e8d4857c,Bram Moolenaar,10,9,19,2,"{""src/testdir/test_sound.vim"": {""insertions"": 8, ""deletions"": 9, ""lines"": 17}, ""src/version.c"": {""insertions"": 2, ""deletions"": 0, ""lines"": 2}}"
2020-12-06 20:11:31,d5a986f460019a924627d79350552f446505cffb,Bram Moolenaar,24,12,36,4,"{""src/auto/configure"": {""insertions"": 1, ""deletions"": 2, ""lines"": 3}, ""src/configure.ac"": {""insertions"": 1, ""deletions"": 2, ""lines"": 3}, ""src/if_ruby.c"": {""insertions"": 20, ""deletions"": 8, ""lines"": 28}, ""src/version.c"": {""insertions"": 2, ""deletions"": 0, ""lines"": 2}}"
2020-12-06 19:12:43,41d6196e302af5f1a99aeeac587b5c662c410166,Bram Moolenaar,4,12,16,2,"{""src/version.c"": {""insertions"": 2, ""deletions"": 0, ""lines"": 2}, ""src/vim9compile.c"": {""insertions"": 2, ""deletions"": 12, ""lines"": 14}}"
2020-12-06 17:50:36,5402175815a9b9b05772f339efa3ec9f73bdae09,Bram Moolenaar,52,16,68,2,"{""src/testdir/test_vim9_func.vim"": {""insertions"": 50, ""deletions"": 16, ""lines"": 66}, ""src/version.c"": {""insertions"": 2, ""deletions"": 0, ""lines"": 2}}"
2020-12-06 15:03:55,8bb0f5472c740458708fd3edabbb8d5193a96241,Bram Moolenaar,6,0,6,3,"{""src/dict.c"": {""insertions"": 1, ""deletions"": 0, ""lines"": 1}, ""src/version.c"": {""insertions"": 2, ""deletions"": 0, ""lines"": 2}, ""src/vim9compile.c"": {""insertions"": 3, ""deletions"": 0, ""lines"": 3}}"
2020-12-06 14:03:19,67322bf74a106b6476b093e75da87d61e2181b76,Bram Moolenaar,41,2,43,5,"{""src/testdir/test_functions.vim"": {""insertions"": 1, ""deletions"": 0, ""lines"": 1}, ""src/testdir/test_lambda.vim"": {""insertions"": 5, ""deletions"": 0, ""lines"": 5}, ""src/testdir/test_signals.vim"": {""insertions"": 1, ""deletions"": 2, ""lines"": 3}, ""src/testdir/test_user_func.vim"": {""insertions"": 32, ""deletions"": 0, ""lines"": 32}, ""src/version.c"": {""insertions"": 2, ""deletions"": 0, ""lines"": 2}}"
2020-12-06 13:37:08,918a4249176a8ccec3a34c9c7ef7bf4163676a63,Bram Moolenaar,94,7,101,4,"{""src/testdir/test_vim9_expr.vim"": {""insertions"": 72, ""deletions"": 0, ""lines"": 72}, ""src/testdir/test_vim9_script.vim"": {""insertions"": 12, ""deletions"": 0, ""lines"": 12}, ""src/version.c"": {""insertions"": 2, ""deletions"": 0, ""lines"": 2}, ""src/vim9compile.c"": {""insertions"": 8, ""deletions"": 7, ""lines"": 15}}"
2020-12-05 20:47:06,08cf0c0d82c7edfcbfe60db34f92759b7fee939a,Bram Moolenaar,26,2,28,2,"{""src/testdir/test_vim9_builtin.vim"": {""insertions"": 24, ""deletions"": 2, ""lines"": 26}, ""src/version.c"": {""insertions"": 2, ""deletions"": 0, ""lines"": 2}}"
2020-12-05 20:22:08,56602ba153af7130b76daf83933922aaea3e2646,Bram Moolenaar,43,2,45,5,"{""src/globals.h"": {""insertions"": 6, ""deletions"": 0, ""lines"": 6}, ""src/message.c"": {""insertions"": 6, ""deletions"": 0, ""lines"": 6}, ""src/testdir/test_vim9_func.vim"": {""insertions"": 16, ""deletions"": 0, ""lines"": 16}, ""src/version.c"": {""insertions"": 2, ""deletions"": 0, ""lines"": 2}, ""src/vim9execute.c"": {""insertions"": 13, ""deletions"": 2, ""lines"": 15}}"
2020-12-05 18:17:16,f665e97ffa06817975810cb511b13dbaa83ec630,Bram Moolenaar,50,12,62,4,"{""src/testdir/test_vim9_func.vim"": {""insertions"": 42, ""deletions"": 1, ""lines"": 43}, ""src/version.c"": {""insertions"": 2, ""deletions"": 0, ""lines"": 2}, ""src/vim9compile.c"": {""insertions"": 5, ""deletions"": 11, ""lines"": 16}, ""src/vim9execute.c"": {""insertions"": 1, ""deletions"": 0, ""lines"": 1}}"
2020-12-05 17:13:27,4029cabbe7c68a304ab8becb495bd6d91c6e97b1,Bram Moolenaar,30,0,30,3,"{""src/testdir/test_vim9_func.vim"": {""insertions"": 19, ""deletions"": 0, ""lines"": 19}, ""src/version.c"": {""insertions"": 2, ""deletions"": 0, ""lines"": 2}, ""src/vim9execute.c"": {""insertions"": 9, ""deletions"": 0, ""lines"": 9}}"
2020-12-05 16:11:12,d0fe620cbbf5f5e00446efa89893036265c5c302,Bram Moolenaar,19,1,20,3,"{""src/eval.c"": {""insertions"": 4, ""deletions"": 1, ""lines"": 5}, ""src/testdir/test_vim9_cmd.vim"": {""insertions"": 13, ""deletions"": 0, ""lines"": 13}, ""src/version.c"": {""insertions"": 2, ""deletions"": 0, ""lines"": 2}}"
2020-12-05 13:44:37,c0913d023b8bb728e9832727fe1657dbddf685d0,Bram Moolenaar,5,1,6,2,"{""src/version.c"": {""insertions"": 2, ""deletions"": 0, ""lines"": 2}, ""src/vim9script.c"": {""insertions"": 3, ""deletions"": 1, ""lines"": 4}}"
2020-12-05 12:41:01,2d870f8d9ebad22d32799d0d0ee30943d0a0e49d,Bram Moolenaar,61,21,82,6,"{""src/testdir/test_quickfix.vim"": {""insertions"": 1, ""deletions"": 1, ""lines"": 2}, ""src/testdir/test_vim9_assign.vim"": {""insertions"": 1, ""deletions"": 0, ""lines"": 1}, ""src/testdir/test_vim9_func.vim"": {""insertions"": 16, ""deletions"": 0, ""lines"": 16}, ""src/testdir/test_vim9_script.vim"": {""insertions"": 5, ""deletions"": 0, ""lines"": 5}, ""src/testdir/vim9.vim"": {""insertions"": 36, ""deletions"": 20, ""lines"": 56}, ""src/version.c"": {""insertions"": 2, ""deletions"": 0, ""lines"": 2}}"
2020-12-04 18:42:52,29d2f45c8855fd98897c5db92d896c161e95d0f1,Bram Moolenaar,12,1,13,3,"{""src/message.c"": {""insertions"": 1, ""deletions"": 1, ""lines"": 2}, ""src/os_win32.c"": {""insertions"": 9, ""deletions"": 0, ""lines"": 9}, ""src/version.c"": {""insertions"": 2, ""deletions"": 0, ""lines"": 2}}"
2020-12-04 18:12:14,c5e6a7179d7dee4315b412b56e172bb1ff092d3e,Bram Moolenaar,83,29,112,6,"{""runtime/doc/vim9.txt"": {""insertions"": 14, ""deletions"": 8, ""lines"": 22}, ""src/dict.c"": {""insertions"": 51, ""deletions"": 3, ""lines"": 54}, ""src/proto/dict.pro"": {""insertions"": 1, ""deletions"": 0, ""lines"": 1}, ""src/testdir/test_vim9_expr.vim"": {""insertions"": 2, ""deletions"": 1, ""lines"": 3}, ""src/version.c"": {""insertions"": 2, ""deletions"": 0, ""lines"": 2}, ""src/vim9compile.c"": {""insertions"": 13, ""deletions"": 17, ""lines"": 30}}"
2020-12-04 17:09:54,6cd42db9dc1251b052b97d47bafc063eacac1b3e,Bram Moolenaar,8,0,8,3,"{""src/auto/configure"": {""insertions"": 2, ""deletions"": 0, ""lines"": 2}, ""src/configure.ac"": {""insertions"": 4, ""deletions"": 0, ""lines"": 4}, ""src/version.c"": {""insertions"": 2, ""deletions"": 0, ""lines"": 2}}"
2020-12-04 16:38:00,f6c177ab3acda131d693f2cab0796df16da5b732,Bram Moolenaar,3,0,3,2,"{""src/testdir/test_vim9_script.vim"": {""insertions"": 1, ""deletions"": 0, ""lines"": 1}, ""src/version.c"": {""insertions"": 2, ""deletions"": 0, ""lines"": 2}}"
2020-12-04 11:43:29,21e51221f2c4f301912a5d59c748351b02c3df9e,Bram Moolenaar,6,0,6,2,"{""src/version.c"": {""insertions"": 2, ""deletions"": 0, ""lines"": 2}, ""src/vim9compile.c"": {""insertions"": 4, ""deletions"": 0, ""lines"": 4}}"
2020-12-03 20:24:07,476268c387a05cfda9feaca8d1a5eeb535ed9f49,Bram Moolenaar,7,9,16,5,"{"".travis.yml"": {""insertions"": 0, ""deletions"": 2, ""lines"": 2}, ""src/Makefile"": {""insertions"": 3, ""deletions"": 4, ""lines"": 7}, ""src/libvterm/Makefile"": {""insertions"": 1, ""deletions"": 1, ""lines"": 2}, ""src/libvterm/t/run-test.pl"": {""insertions"": 1, ""deletions"": 2, ""lines"": 3}, ""src/version.c"": {""insertions"": 2, ""deletions"": 0, ""lines"": 2}}"
2020-12-03 20:08:37,c0d670ce16d0e148b7d39ac354571b3d284a0b53,Bram Moolenaar,26,3,29,3,"{""runtime/filetype.vim"": {""insertions"": 7, ""deletions"": 2, ""lines"": 9}, ""src/testdir/test_filetype.vim"": {""insertions"": 17, ""deletions"": 1, ""lines"": 18}, ""src/version.c"": {""insertions"": 2, ""deletions"": 0, ""lines"": 2}}"
2020-12-03 18:54:42,0684e36a7ee0743f2889698fb8e0e14f7acae423,Bram Moolenaar,35,30,65,7,"{""src/edit.c"": {""insertions"": 10, ""deletions"": 10, ""lines"": 20}, ""src/ex_getln.c"": {""insertions"": 6, ""deletions"": 12, ""lines"": 18}, ""src/getchar.c"": {""insertions"": 4, ""deletions"": 5, ""lines"": 9}, ""src/normal.c"": {""insertions"": 2, ""deletions"": 2, ""lines"": 4}, ""src/proto/edit.pro"": {""insertions"": 1, ""deletions"": 1, ""lines"": 2}, ""src/testdir/test_termcodes.vim"": {""insertions"": 10, ""deletions"": 0, ""lines"": 10}, ""src/version.c"": {""insertions"": 2, ""deletions"": 0, ""lines"": 2}}"
2020-12-02 19:51:22,af0df47a7671a39f2cde950587ba48800188bfb9,Bram Moolenaar,22,4,26,3,"{""src/testdir/test_vim9_func.vim"": {""insertions"": 14, ""deletions"": 0, ""lines"": 14}, ""src/version.c"": {""insertions"": 2, ""deletions"": 0, ""lines"": 2}, ""src/vim9execute.c"": {""insertions"": 6, ""deletions"": 4, ""lines"": 10}}"
2020-12-02 16:36:54,e0de171ecd2ff7acd56deda2cf81f0d13a69c803,Bram Moolenaar,260,272,532,14,"{""src/dict.c"": {""insertions"": 18, ""deletions"": 9, ""lines"": 27}, ""src/eval.c"": {""insertions"": 1, ""deletions"": 1, ""lines"": 2}, ""src/proto/dict.pro"": {""insertions"": 1, ""deletions"": 0, ""lines"": 1}, ""src/testdir/test_popupwin.vim"": {""insertions"": 2, ""deletions"": 2, ""lines"": 4}, ""src/testdir/test_textprop.vim"": {""insertions"": 6, ""deletions"": 6, ""lines"": 12}, ""src/testdir/test_vim9_assign.vim"": {""insertions"": 28, ""deletions"": 28, ""lines"": 56}, ""src/testdir/test_vim9_builtin.vim"": {""insertions"": 22, ""deletions"": 22, ""lines"": 44}, ""src/testdir/test_vim9_cmd.vim"": {""insertions"": 7, ""deletions"": 7, ""lines"": 14}, ""src/testdir/test_vim9_disassemble.vim"": {""insertions"": 9, ""deletions"": 9, ""lines"": 18}, ""src/testdir/test_vim9_expr.vim"": {""insertions"": 105, ""deletions"": 96, ""lines"": 201}, ""src/testdir/test_vim9_func.vim"": {""insertions"": 18, ""deletions"": 18, ""lines"": 36}, ""src/testdir/test_vim9_script.vim"": {""insertions"": 20, ""deletions"": 20, ""lines"": 40}, ""src/version.c"": {""insertions"": 2, ""deletions"": 0, ""lines"": 2}, ""src/vim9compile.c"": {""insertions"": 21, ""deletions"": 54, ""lines"": 75}}"
2020-12-02 14:11:18,7f76494aac512b1d603d9be4132184241f43872c,Bram Moolenaar,23,3,26,4,"{""src/testdir/test_vim9_assign.vim"": {""insertions"": 15, ""deletions"": 0, ""lines"": 15}, ""src/testdir/test_vim9_expr.vim"": {""insertions"": 0, ""deletions"": 1, ""lines"": 1}, ""src/version.c"": {""insertions"": 2, ""deletions"": 0, ""lines"": 2}, ""src/vim9compile.c"": {""insertions"": 6, ""deletions"": 2, ""lines"": 8}}"
2020-12-02 13:24:30,ea87069d7814497181483877651aef6d97182120,Bram Moolenaar,29,0,29,3,"{""src/testdir/test_vim9_script.vim"": {""insertions"": 21, ""deletions"": 0, ""lines"": 21}, ""src/version.c"": {""insertions"": 2, ""deletions"": 0, ""lines"": 2}, ""src/vim9compile.c"": {""insertions"": 6, ""deletions"": 0, ""lines"": 6}}"
2020-12-02 12:23:36,38bd8de551225bfca133805f21cee2592f0c759d,Bram Moolenaar,33,2,35,3,"{""src/testdir/test_vim9_script.vim"": {""insertions"": 22, ""deletions"": 0, ""lines"": 22}, ""src/version.c"": {""insertions"": 2, ""deletions"": 0, ""lines"": 2}, ""src/vim9compile.c"": {""insertions"": 9, ""deletions"": 2, ""lines"": 11}}"
2020-12-02 11:37:37,1cbfc9914db1cb06aaa092fa42eb7a2fc3dc7ad7,Bram Moolenaar,16,1,17,3,"{""src/message.c"": {""insertions"": 5, ""deletions"": 1, ""lines"": 6}, ""src/testdir/test_utf8.vim"": {""insertions"": 9, ""deletions"": 0, ""lines"": 9}, ""src/version.c"": {""insertions"": 2, ""deletions"": 0, ""lines"": 2}}"
2020-12-01 20:47:59,a452b808b4da2d272ca4a50865eb8ca89a58f239,Bram Moolenaar,9,1,10,3,"{""src/ex_docmd.c"": {""insertions"": 5, ""deletions"": 1, ""lines"": 6}, ""src/structs.h"": {""insertions"": 2, ""deletions"": 0, ""lines"": 2}, ""src/version.c"": {""insertions"": 2, ""deletions"": 0, ""lines"": 2}}"
2020-12-01 20:27:51,c478ee3d83fab0dba46740f2023c35f743f88316,Bram Moolenaar,9,19,28,2,"{""src/os_win32.c"": {""insertions"": 7, ""deletions"": 19, ""lines"": 26}, ""src/version.c"": {""insertions"": 2, ""deletions"": 0, ""lines"": 2}}"
2020-12-01 20:08:05,57cf4973a283941c92744554474b2c52ce892fd1,Bram Moolenaar,11,3,14,3,"{""src/list.c"": {""insertions"": 3, ""deletions"": 3, ""lines"": 6}, ""src/testdir/test_filter_map.vim"": {""insertions"": 6, ""deletions"": 0, ""lines"": 6}, ""src/version.c"": {""insertions"": 2, ""deletions"": 0, ""lines"": 2}}"
2020-12-01 19:12:24,4324d87a4432721d9dbc72c1e336350bc6b7ebc3,Bram Moolenaar,22,3,25,4,"{""src/ex_docmd.c"": {""insertions"": 6, ""deletions"": 3, ""lines"": 9}, ""src/structs.h"": {""insertions"": 1, ""deletions"": 0, ""lines"": 1}, ""src/testdir/test_vim9_script.vim"": {""insertions"": 13, ""deletions"": 0, ""lines"": 13}, ""src/version.c"": {""insertions"": 2, ""deletions"": 0, ""lines"": 2}}"
2020-12-01 15:30:44,4b8a065145bb53762b869cd6b8e55b7ad7341761,Bram Moolenaar,322,230,552,3,"{""src/testdir/test_vim9_script.vim"": {""insertions"": 41, ""deletions"": 14, ""lines"": 55}, ""src/version.c"": {""insertions"": 2, ""deletions"": 0, ""lines"": 2}, ""src/vim9compile.c"": {""insertions"": 279, ""deletions"": 216, ""lines"": 495}}"
2020-11-30 20:40:03,004d9b00ba600a167746ad7af88e0baa77c95d8f,Bram Moolenaar,28,2,30,3,"{""src/testdir/test_vim9_assign.vim"": {""insertions"": 18, ""deletions"": 0, ""lines"": 18}, ""src/version.c"": {""insertions"": 2, ""deletions"": 0, ""lines"": 2}, ""src/vim9compile.c"": {""insertions"": 8, ""deletions"": 2, ""lines"": 10}}"
2020-11-30 20:12:19,da7c20c9531739bdefa9d4418e6765fb181066e9,Bram Moolenaar,37,25,62,3,"{""src/ex_docmd.c"": {""insertions"": 8, ""deletions"": 1, ""lines"": 9}, ""src/testdir/test_vim9_assign.vim"": {""insertions"": 27, ""deletions"": 24, ""lines"": 51}, ""src/version.c"": {""insertions"": 2, ""deletions"": 0, ""lines"": 2}}"
2020-11-30 16:42:10,f0068c5154a99b86b2c4515a4b93c003b2445cf4,Bram Moolenaar,49,2,51,7,"{""runtime/doc/autocmd.txt"": {""insertions"": 2, ""deletions"": 0, ""lines"": 2}, ""runtime/doc/eval.txt"": {""insertions"": 7, ""deletions"": 0, ""lines"": 7}, ""src/evalvars.c"": {""insertions"": 2, ""deletions"": 0, ""lines"": 2}, ""src/main.c"": {""insertions"": 7, ""deletions"": 1, ""lines"": 8}, ""src/testdir/test_exit.vim"": {""insertions"": 27, ""deletions"": 0, ""lines"": 27}, ""src/version.c"": {""insertions"": 2, ""deletions"": 0, ""lines"": 2}, ""src/vim.h"": {""insertions"": 2, ""deletions"": 1, ""lines"": 3}}"
2020-11-29 13:36:24,23515b4ef7580af8b9d3b964a558ab2007cacda5,Bram Moolenaar,17402,2340,19742,31,"{""runtime/autoload/tar.vim"": {""insertions"": 36, ""deletions"": 1, ""lines"": 37}, ""runtime/compiler/zsh.vim"": {""insertions"": 23, ""deletions"": 0, ""lines"": 23}, ""runtime/doc/filetype.txt"": {""insertions"": 14, ""deletions"": 14, ""lines"": 28}, ""runtime/doc/syntax.txt"": {""insertions"": 7, ""deletions"": 1, ""lines"": 8}, ""runtime/doc/terminal.txt"": {""insertions"": 10, ""deletions"": 8, ""lines"": 18}, ""runtime/doc/todo.txt"": {""insertions"": 14, ""deletions"": 19, ""lines"": 33}, ""runtime/doc/version8.txt"": {""insertions"": 1, ""deletions"": 1, ""lines"": 2}, ""runtime/doc/vim9.txt"": {""insertions"": 6, ""deletions"": 3, ""lines"": 9}, ""runtime/filetype.vim"": {""insertions"": 1, ""deletions"": 1, ""lines"": 2}, ""runtime/ftplugin/nroff.vim"": {""insertions"": 8, ""deletions"": 2, ""lines"": 10}, ""runtime/ftplugin/zsh.vim"": {""insertions"": 13, ""deletions"": 12, ""lines"": 25}, ""runtime/gvim.desktop"": {""insertions"": 2, ""deletions"": 3, ""lines"": 5}, ""runtime/indent/xml.vim"": {""insertions"": 31, ""deletions"": 5, ""lines"": 36}, ""runtime/keymap/korean-dubeolsik_utf-8.vim"": {""insertions"": 11237, ""deletions"": 0, ""lines"": 11237}, ""runtime/keymap/korean.vim"": {""insertions"": 23, ""deletions"": 0, ""lines"": 23}, ""runtime/plugin/tarPlugin.vim"": {""insertions"": 2, ""deletions"": 0, ""lines"": 2}, ""runtime/syntax/cabal.vim"": {""insertions"": 22, ""deletions"": 3, ""lines"": 25}, ""runtime/syntax/cabalconfig.vim"": {""insertions"": 30, ""deletions"": 0, ""lines"": 30}, ""runtime/syntax/cabalproject.vim"": {""insertions"": 28, ""deletions"": 0, ""lines"": 28}, ""runtime/syntax/cs.vim"": {""insertions"": 21, ""deletions"": 18, ""lines"": 39}, ""runtime/syntax/debchangelog.vim"": {""insertions"": 3, ""deletions"": 3, ""lines"": 6}, ""runtime/syntax/debsources.vim"": {""insertions"": 3, ""deletions"": 3, ""lines"": 6}, ""runtime/syntax/lex.vim"": {""insertions"": 1, ""deletions"": 1, ""lines"": 2}, ""runtime/syntax/sh.vim"": {""insertions"": 33, ""deletions"": 25, ""lines"": 58}, ""runtime/syntax/sshdconfig.vim"": {""insertions"": 20, ""deletions"": 3, ""lines"": 23}, ""runtime/syntax/zsh.vim"": {""insertions"": 18, ""deletions"": 13, ""lines"": 31}, ""runtime/vim.desktop"": {""insertions"": 2, ""deletions"": 3, ""lines"": 5}, ""src/INSTALLpc.txt"": {""insertions"": 1, ""deletions"": 1, ""lines"": 2}, ""src/INSTALLvms.txt"": {""insertions"": 10, ""deletions"": 10, ""lines"": 20}, ""src/po/de.po"": {""insertions"": 2700, ""deletions"": 1154, ""lines"": 3854}, ""src/po/sr.po"": {""insertions"": 3082, ""deletions"": 1033, ""lines"": 4115}}"
2020-11-29 13:20:27,287153c5d481a09ffe98a95ad78390ff580bb557,Bram Moolenaar,64,2,66,3,"{""src/quickfix.c"": {""insertions"": 4, ""deletions"": 2, ""lines"": 6}, ""src/testdir/test_quickfix.vim"": {""insertions"": 58, ""deletions"": 0, ""lines"": 58}, ""src/version.c"": {""insertions"": 2, ""deletions"": 0, ""lines"": 2}}"
2020-11-29 13:11:41,b46f57e87b3706a8c4b97d8e03f7853a7938b061,Bram Moolenaar,98,2,100,3,"{""src/syntax.c"": {""insertions"": 0, ""deletions"": 2, ""lines"": 2}, ""src/testdir/test_syntax.vim"": {""insertions"": 96, ""deletions"": 0, ""lines"": 96}, ""src/version.c"": {""insertions"": 2, ""deletions"": 0, ""lines"": 2}}"
2020-11-28 20:56:06,f5452691ba30e33b38c5b06c51ba40b58457d5d8,Bram Moolenaar,15,7,22,3,"{""src/terminal.c"": {""insertions"": 2, ""deletions"": 4, ""lines"": 6}, ""src/testdir/test_popupwin.vim"": {""insertions"": 11, ""deletions"": 3, ""lines"": 14}, ""src/version.c"": {""insertions"": 2, ""deletions"": 0, ""lines"": 2}}"
2020-11-28 20:21:17,ce2c5444e2556d8d156ab447d6d196f9ecd11ddc,Bram Moolenaar,22,16,38,4,"{""src/eval.c"": {""insertions"": 2, ""deletions"": 1, ""lines"": 3}, ""src/ex_docmd.c"": {""insertions"": 7, ""deletions"": 3, ""lines"": 10}, ""src/testdir/test_vim9_assign.vim"": {""insertions"": 11, ""deletions"": 12, ""lines"": 23}, ""src/version.c"": {""insertions"": 2, ""deletions"": 0, ""lines"": 2}}"
2020-11-28 19:32:29,f8ca03bf9161ab9ee1a29db1d13c02b317c10029,Bram Moolenaar,85,27,112,3,"{""src/list.c"": {""insertions"": 79, ""deletions"": 27, ""lines"": 106}, ""src/testdir/test_functions.vim"": {""insertions"": 4, ""deletions"": 0, ""lines"": 4}, ""src/version.c"": {""insertions"": 2, ""deletions"": 0, ""lines"": 2}}"
2020-11-28 19:22:06,ebec3e29b83e6b5ccdd67a79993628871cda4b5b,Bram Moolenaar,15,10,25,3,"{""src/popupwin.c"": {""insertions"": 3, ""deletions"": 0, ""lines"": 3}, ""src/terminal.c"": {""insertions"": 10, ""deletions"": 10, ""lines"": 20}, ""src/version.c"": {""insertions"": 2, ""deletions"": 0, ""lines"": 2}}"
2020-11-28 17:52:33,dc234caff22131bdc1ff9ea50d67e11843d0d73e,Bram Moolenaar,168,15,183,4,"{""src/errors.h"": {""insertions"": 2, ""deletions"": 0, ""lines"": 2}, ""src/testdir/test_vim9_assign.vim"": {""insertions"": 72, ""deletions"": 0, ""lines"": 72}, ""src/version.c"": {""insertions"": 2, ""deletions"": 0, ""lines"": 2}, ""src/vim9compile.c"": {""insertions"": 92, ""deletions"": 15, ""lines"": 107}}"
2020-11-28 13:43:26,4a44120e3dc1d40dd7109658afd5e078360b1d8f,Bram Moolenaar,15,0,15,3,"{""src/getchar.c"": {""insertions"": 8, ""deletions"": 0, ""lines"": 8}, ""src/testdir/test_mapping.vim"": {""insertions"": 5, ""deletions"": 0, ""lines"": 5}, ""src/version.c"": {""insertions"": 2, ""deletions"": 0, ""lines"": 2}}"
2020-11-27 19:55:00,4d05af0a64c2e26b13d2ad571debbf5f3b6d384e,Bram Moolenaar,11,9,20,3,"{""src/terminal.c"": {""insertions"": 1, ""deletions"": 1, ""lines"": 2}, ""src/testdir/test_termcodes.vim"": {""insertions"": 8, ""deletions"": 8, ""lines"": 16}, ""src/version.c"": {""insertions"": 2, ""deletions"": 0, ""lines"": 2}}"
2020-11-27 18:13:28,aeb313f355cd67638e3c611354ce401d86f56afe,Bram Moolenaar,12,24,36,7,"{""src/testdir/test_autocmd.vim"": {""insertions"": 1, ""deletions"": 3, ""lines"": 4}, ""src/testdir/test_compiler.vim"": {""insertions"": 1, ""deletions"": 3, ""lines"": 4}, ""src/testdir/test_delete.vim"": {""insertions"": 5, ""deletions"": 9, ""lines"": 14}, ""src/testdir/test_diffmode.vim"": {""insertions"": 1, ""deletions"": 3, ""lines"": 4}, ""src/testdir/test_expr.vim"": {""insertions"": 1, ""deletions"": 3, ""lines"": 4}, ""src/testdir/test_fold.vim"": {""insertions"": 1, ""deletions"": 3, ""lines"": 4}, ""src/version.c"": {""insertions"": 2, ""deletions"": 0, ""lines"": 2}}"
2020-11-27 18:01:31,6ee874d378829b62e0944063a9a029e81b5debfb,Bram Moolenaar,11,12,23,2,"{""src/main.c"": {""insertions"": 9, ""deletions"": 12, ""lines"": 21}, ""src/version.c"": {""insertions"": 2, ""deletions"": 0, ""lines"": 2}}"
2020-11-27 10:00:38,3482be6a33c3a00fe1e8e604310ad3034f593045,Bram Moolenaar,76,3,79,4,"{""src/ex_docmd.c"": {""insertions"": 2, ""deletions"": 1, ""lines"": 3}, ""src/session.c"": {""insertions"": 2, ""deletions"": 2, ""lines"": 4}, ""src/testdir/test_mksession.vim"": {""insertions"": 70, ""deletions"": 0, ""lines"": 70}, ""src/version.c"": {""insertions"": 2, ""deletions"": 0, ""lines"": 2}}"
2020-11-26 19:34:00,fccbf068f8c85474db8d8dead1530321d1f3e5b8,Bram Moolenaar,62,2,64,5,"{""src/clipboard.c"": {""insertions"": 5, ""deletions"": 0, ""lines"": 5}, ""src/normal.c"": {""insertions"": 32, ""deletions"": 0, ""lines"": 32}, ""src/register.c"": {""insertions"": 1, ""deletions"": 2, ""lines"": 3}, ""src/testdir/test_autocmd.vim"": {""insertions"": 22, ""deletions"": 0, ""lines"": 22}, ""src/version.c"": {""insertions"": 2, ""deletions"": 0, ""lines"": 2}}"
2020-11-26 19:11:11,ce7be3a0e6f19bc85990bb8fcfe5e208944777b4,Bram Moolenaar,20,2,22,3,"{""src/auto/configure"": {""insertions"": 9, ""deletions"": 1, ""lines"": 10}, ""src/configure.ac"": {""insertions"": 9, ""deletions"": 1, ""lines"": 10}, ""src/version.c"": {""insertions"": 2, ""deletions"": 0, ""lines"": 2}}"
2020-11-26 18:47:28,2472a74be4dedfeaff22314f31cf9787618163d1,Bram Moolenaar,11,2,13,2,"{""src/fileio.c"": {""insertions"": 9, ""deletions"": 2, ""lines"": 11}, ""src/version.c"": {""insertions"": 2, ""deletions"": 0, ""lines"": 2}}"
2020-11-25 20:55:45,d49a35a1c3b736637733b36011fccbee7ef43fcf,Bram Moolenaar,3,1,4,2,"{""src/feature.h"": {""insertions"": 1, ""deletions"": 1, ""lines"": 2}, ""src/version.c"": {""insertions"": 2, ""deletions"": 0, ""lines"": 2}}"
2020-11-25 20:30:11,c2ca935d26b3fc64a13d4e7d0583fc787efe61d0,Bram Moolenaar,6,1,7,3,"{""src/eval.c"": {""insertions"": 1, ""deletions"": 1, ""lines"": 2}, ""src/testdir/test_vim9_expr.vim"": {""insertions"": 3, ""deletions"": 0, ""lines"": 3}, ""src/version.c"": {""insertions"": 2, ""deletions"": 0, ""lines"": 2}}"
2020-11-25 19:12:11,47a2abf0bc3c3dac0433754ad0365ebad152df8c,Bram Moolenaar,41,12,53,6,"{""src/ex_cmds.c"": {""insertions"": 1, ""deletions"": 1, ""lines"": 2}, ""src/ex_docmd.c"": {""insertions"": 24, ""deletions"": 11, ""lines"": 35}, ""src/proto/ex_docmd.pro"": {""insertions"": 1, ""deletions"": 0, ""lines"": 1}, ""src/testdir/test_vim9_cmd.vim"": {""insertions"": 12, ""deletions"": 0, ""lines"": 12}, ""src/version.c"": {""insertions"": 2, ""deletions"": 0, ""lines"": 2}, ""src/vim.h"": {""insertions"": 1, ""deletions"": 0, ""lines"": 1}}"
2020-11-25 18:15:19,34c54eb6cbda5dbc14376c8b1c62ad11d4852793,Bram Moolenaar,42,5,47,3,"{""src/testdir/test_vim9_func.vim"": {""insertions"": 23, ""deletions"": 0, ""lines"": 23}, ""src/version.c"": {""insertions"": 2, ""deletions"": 0, ""lines"": 2}, ""src/vim9execute.c"": {""insertions"": 17, ""deletions"": 5, ""lines"": 22}}"
2020-11-25 16:41:20,6bed0dbc8500be3ea751cc527a6ee89ca073a4d1,Bram Moolenaar,4,6,10,2,"{""src/testdir/test_search.vim"": {""insertions"": 2, ""deletions"": 6, ""lines"": 8}, ""src/version.c"": {""insertions"": 2, ""deletions"": 0, ""lines"": 2}}"
2020-11-25 16:00:43,d653293c806c8bea976737b88006264e7a8ea6d6,Bram Moolenaar,2,11,13,2,"{""src/memfile.c"": {""insertions"": 0, ""deletions"": 11, ""lines"": 11}, ""src/version.c"": {""insertions"": 2, ""deletions"": 0, ""lines"": 2}}"
2020-11-25 14:52:31,3a3b6910421ee1d03c222efc62d61b9fb879d931,Bram Moolenaar,2,8,10,2,"{""src/gui.c"": {""insertions"": 0, ""deletions"": 8, ""lines"": 8}, ""src/version.c"": {""insertions"": 2, ""deletions"": 0, ""lines"": 2}}"
2020-11-25 14:45:38,36fe7b287e13a7534c9aa6dcf0c3d7f8363f6060,Bram Moolenaar,4,2,6,2,"{""src/feature.h"": {""insertions"": 2, ""deletions"": 2, ""lines"": 4}, ""src/version.c"": {""insertions"": 2, ""deletions"": 0, ""lines"": 2}}"
2020-11-25 13:15:12,5dc4e2f883896c99ebe83355822ac6067970b031,Bram Moolenaar,14,22,36,3,"{""src/testdir/test_autocmd.vim"": {""insertions"": 7, ""deletions"": 7, ""lines"": 14}, ""src/testdir/test_backspace_opt.vim"": {""insertions"": 5, ""deletions"": 15, ""lines"": 20}, ""src/version.c"": {""insertions"": 2, ""deletions"": 0, ""lines"": 2}}"
2020-11-25 12:49:27,448465e6872905967c97a56cd45307530795653c,Bram Moolenaar,64,1,65,8,"{""src/drawline.c"": {""insertions"": 1, ""deletions"": 1, ""lines"": 2}, ""src/testdir/dumps/Test_incsearch_newline1.dump"": {""insertions"": 5, ""deletions"": 0, ""lines"": 5}, ""src/testdir/dumps/Test_incsearch_newline2.dump"": {""insertions"": 5, ""deletions"": 0, ""lines"": 5}, ""src/testdir/dumps/Test_incsearch_newline3.dump"": {""insertions"": 5, ""deletions"": 0, ""lines"": 5}, ""src/testdir/dumps/Test_incsearch_newline4.dump"": {""insertions"": 5, ""deletions"": 0, ""lines"": 5}, ""src/testdir/dumps/Test_incsearch_newline5.dump"": {""insertions"": 5, ""deletions"": 0, ""lines"": 5}, ""src/testdir/test_search.vim"": {""insertions"": 36, ""deletions"": 0, ""lines"": 36}, ""src/version.c"": {""insertions"": 2, ""deletions"": 0, ""lines"": 2}}"
2020-11-25 11:43:28,5ee0981fb5259f94900ab25207caddf1fa61010d,Bram Moolenaar,40,4,44,3,"{"".github/workflows/ci-windows.yaml"": {""insertions"": 2, ""deletions"": 1, ""lines"": 3}, ""src/testdir/test_swap.vim"": {""insertions"": 36, ""deletions"": 3, ""lines"": 39}, ""src/version.c"": {""insertions"": 2, ""deletions"": 0, ""lines"": 2}}"
2020-11-25 11:25:47,ff94bd9e4779b918f3761035f43a97ba7175b3ce,Bram Moolenaar,4,2,6,2,"{""src/gui_gtk_x11.c"": {""insertions"": 2, ""deletions"": 2, ""lines"": 4}, ""src/version.c"": {""insertions"": 2, ""deletions"": 0, ""lines"": 2}}"
2020-11-25 10:47:39,813196784ad2a3a8cd65be5e975769d9768a728e,Bram Moolenaar,4,2,6,2,"{""src/syntax.c"": {""insertions"": 2, ""deletions"": 2, ""lines"": 4}, ""src/version.c"": {""insertions"": 2, ""deletions"": 0, ""lines"": 2}}"
2020-11-24 19:13:26,a09bee322e605c8a076fa23c3d3259495a1129d2,Bram Moolenaar,5,9,14,3,"{""runtime/filetype.vim"": {""insertions"": 1, ""deletions"": 7, ""lines"": 8}, ""src/testdir/test_filetype.vim"": {""insertions"": 2, ""deletions"": 2, ""lines"": 4}, ""src/version.c"": {""insertions"": 2, ""deletions"": 0, ""lines"": 2}}"
2020-11-24 18:36:16,c9f8b849b6de9661e543d0d1431e233725dd956f,Bram Moolenaar,27,1,28,3,"{""src/buffer.c"": {""insertions"": 5, ""deletions"": 0, ""lines"": 5}, ""src/testdir/test_terminal.vim"": {""insertions"": 20, ""deletions"": 1, ""lines"": 21}, ""src/version.c"": {""insertions"": 2, ""deletions"": 0, ""lines"": 2}}"
2020-11-23 21:01:26,8e6be34338f13a6a625f19bcef82019c9adc65f2,Bram Moolenaar,38,0,38,3,"{""src/bufwrite.c"": {""insertions"": 6, ""deletions"": 0, ""lines"": 6}, ""src/testdir/test_viminfo.vim"": {""insertions"": 30, ""deletions"": 0, ""lines"": 30}, ""src/version.c"": {""insertions"": 2, ""deletions"": 0, ""lines"": 2}}"
2020-11-23 20:39:14,142f23544c7045b22e56fa6ee35808aceb6342f2,Bram Moolenaar,4,1,5,2,"{""src/testdir/test_compiler.vim"": {""insertions"": 2, ""deletions"": 1, ""lines"": 3}, ""src/version.c"": {""insertions"": 2, ""deletions"": 0, ""lines"": 2}}"
2020-11-23 20:24:58,60bc8e7244080b7ead009cfabebc3401f272ddbe,Bram Moolenaar,13,4,17,2,"{""src/testdir/test_compiler.vim"": {""insertions"": 11, ""deletions"": 4, ""lines"": 15}, ""src/version.c"": {""insertions"": 2, ""deletions"": 0, ""lines"": 2}}"
2020-11-23 19:15:08,9e40c4b15ebfbc84947a3f34b1bd53e397b57f51,Bram Moolenaar,55,3,58,4,"{""src/quickfix.c"": {""insertions"": 5, ""deletions"": 3, ""lines"": 8}, ""src/testdir/dumps/Test_quickfix_window_fails.dump"": {""insertions"": 13, ""deletions"": 0, ""lines"": 13}, ""src/testdir/test_quickfix.vim"": {""insertions"": 35, ""deletions"": 0, ""lines"": 35}, ""src/version.c"": {""insertions"": 2, ""deletions"": 0, ""lines"": 2}}"
2020-11-23 17:14:56,f637bceb6135139dc1891a15de8fa134c2ca2d97,Bram Moolenaar,21,3,24,4,"{""src/testdir/test_channel.vim"": {""insertions"": 8, ""deletions"": 2, ""lines"": 10}, ""src/testdir/test_ex_mode.vim"": {""insertions"": 1, ""deletions"": 0, ""lines"": 1}, ""src/testdir/test_functions.vim"": {""insertions"": 10, ""deletions"": 1, ""lines"": 11}, ""src/version.c"": {""insertions"": 2, ""deletions"": 0, ""lines"": 2}}"
2020-11-23 07:31:18,792f786aad8409ca9ab895392742643a5b6aed8f,Bram Moolenaar,269,35,304,8,"{""src/errors.h"": {""insertions"": 6, ""deletions"": 0, ""lines"": 6}, ""src/eval.c"": {""insertions"": 2, ""deletions"": 2, ""lines"": 4}, ""src/testdir/test_vim9_disassemble.vim"": {""insertions"": 34, ""deletions"": 0, ""lines"": 34}, ""src/testdir/test_vim9_script.vim"": {""insertions"": 38, ""deletions"": 0, ""lines"": 38}, ""src/version.c"": {""insertions"": 2, ""deletions"": 0, ""lines"": 2}, ""src/vim9.h"": {""insertions"": 8, ""deletions"": 0, ""lines"": 8}, ""src/vim9compile.c"": {""insertions"": 99, ""deletions"": 30, ""lines"": 129}, ""src/vim9execute.c"": {""insertions"": 80, ""deletions"": 3, ""lines"": 83}}"
2020-11-22 17:15:44,6abdcf82859e158713a3d5aa6b1012748ea5c2a0,Bram Moolenaar,127,9,136,9,"{""src/ex_docmd.c"": {""insertions"": 0, ""deletions"": 1, ""lines"": 1}, ""src/proto/userfunc.pro"": {""insertions"": 1, ""deletions"": 0, ""lines"": 1}, ""src/testdir/test_vim9_disassemble.vim"": {""insertions"": 23, ""deletions"": 0, ""lines"": 23}, ""src/testdir/test_vim9_func.vim"": {""insertions"": 27, ""deletions"": 0, ""lines"": 27}, ""src/userfunc.c"": {""insertions"": 1, ""deletions"": 1, ""lines"": 2}, ""src/version.c"": {""insertions"": 2, ""deletions"": 0, ""lines"": 2}, ""src/vim9.h"": {""insertions"": 1, ""deletions"": 0, ""lines"": 1}, ""src/vim9compile.c"": {""insertions"": 49, ""deletions"": 7, ""lines"": 56}, ""src/vim9execute.c"": {""insertions"": 23, ""deletions"": 0, ""lines"": 23}}"
2020-11-22 14:51:24,dcbab75db3ba5e812f119e08cda6a02c6b028a14,Bram Moolenaar,17,2,19,3,"{""runtime/filetype.vim"": {""insertions"": 13, ""deletions"": 2, ""lines"": 15}, ""src/testdir/test_filetype.vim"": {""insertions"": 2, ""deletions"": 0, ""lines"": 2}, ""src/version.c"": {""insertions"": 2, ""deletions"": 0, ""lines"": 2}}"
2020-11-22 13:24:00,18dc355395f2eac72ab83d984cacd26ae61c791f,Bram Moolenaar,30,18,48,6,"{""src/testdir/test_channel.vim"": {""insertions"": 9, ""deletions"": 6, ""lines"": 15}, ""src/testdir/test_clientserver.vim"": {""insertions"": 3, ""deletions"": 2, ""lines"": 5}, ""src/testdir/test_debugger.vim"": {""insertions"": 12, ""deletions"": 7, ""lines"": 19}, ""src/testdir/test_quotestar.vim"": {""insertions"": 3, ""deletions"": 2, ""lines"": 5}, ""src/testdir/test_vim9_func.vim"": {""insertions"": 1, ""deletions"": 1, ""lines"": 2}, ""src/version.c"": {""insertions"": 2, ""deletions"": 0, ""lines"": 2}}"
2020-11-21 20:41:41,4b2ce1297e6e991bf6a674f9465d26d28e648de7,Bram Moolenaar,48,3,51,5,"{""src/testdir/runtest.vim"": {""insertions"": 7, ""deletions"": 0, ""lines"": 7}, ""src/testdir/test_cmdline.vim"": {""insertions"": 31, ""deletions"": 2, ""lines"": 33}, ""src/testdir/test_options.vim"": {""insertions"": 7, ""deletions"": 1, ""lines"": 8}, ""src/testdir/test_popupwin.vim"": {""insertions"": 1, ""deletions"": 0, ""lines"": 1}, ""src/version.c"": {""insertions"": 2, ""deletions"": 0, ""lines"": 2}}"
2020-11-21 13:16:22,5546688fb6798d37a770f366c13dedfa7e4cb417,Bram Moolenaar,6,3,9,2,"{""src/ops.c"": {""insertions"": 4, ""deletions"": 3, ""lines"": 7}, ""src/version.c"": {""insertions"": 2, ""deletions"": 0, ""lines"": 2}}"
2020-11-21 13:03:43,896ad2c33e562e4b674b7e0efbd43be85a64acc8,Bram Moolenaar,3,1,4,2,"{""src/eval.c"": {""insertions"": 1, ""deletions"": 1, ""lines"": 2}, ""src/version.c"": {""insertions"": 2, ""deletions"": 0, ""lines"": 2}}"
2020-11-21 12:58:50,9681f713924f4c51fa2ba3d6639639d4b1dba08a,Bram Moolenaar,3,0,3,2,"{""src/list.c"": {""insertions"": 1, ""deletions"": 0, ""lines"": 1}, ""src/version.c"": {""insertions"": 2, ""deletions"": 0, ""lines"": 2}}"
2020-11-21 12:51:16,e79cdb69a4905ccf766494265d4c6f8701d10c39,Bram Moolenaar,3,0,3,2,"{""src/memline.c"": {""insertions"": 1, ""deletions"": 0, ""lines"": 1}, ""src/version.c"": {""insertions"": 2, ""deletions"": 0, ""lines"": 2}}"
2020-11-21 12:16:30,4466ad6baa22485abb1147aca3340cced4778a66,Bram Moolenaar,203,112,315,21,"{""README_VIM9.md"": {""insertions"": 9, ""deletions"": 9, ""lines"": 18}, ""runtime/autoload/ccomplete.vim"": {""insertions"": 18, ""deletions"": 18, ""lines"": 36}, ""runtime/doc/autocmd.txt"": {""insertions"": 5, ""deletions"": 1, ""lines"": 6}, ""runtime/doc/change.txt"": {""insertions"": 3, ""deletions"": 1, ""lines"": 4}, ""runtime/doc/eval.txt"": {""insertions"": 16, ""deletions"": 9, ""lines"": 25}, ""runtime/doc/map.txt"": {""insertions"": 8, ""deletions"": 5, ""lines"": 13}, ""runtime/doc/popup.txt"": {""insertions"": 2, ""deletions"": 2, ""lines"": 4}, ""runtime/doc/syntax.txt"": {""insertions"": 1, ""deletions"": 1, ""lines"": 2}, ""runtime/doc/tags"": {""insertions"": 8, ""deletions"": 1, ""lines"": 9}, ""runtime/doc/terminal.txt"": {""insertions"": 14, ""deletions"": 10, ""lines"": 24}, ""runtime/doc/todo.txt"": {""insertions"": 29, ""deletions"": 33, ""lines"": 62}, ""runtime/doc/usr_41.txt"": {""insertions"": 1, ""deletions"": 1, ""lines"": 2}, ""runtime/doc/various.txt"": {""insertions"": 13, ""deletions"": 11, ""lines"": 24}, ""runtime/doc/version6.txt"": {""insertions"": 1, ""deletions"": 1, ""lines"": 2}, ""runtime/doc/version8.txt"": {""insertions"": 1, ""deletions"": 1, ""lines"": 2}, ""runtime/doc/vim9.txt"": {""insertions"": 2, ""deletions"": 2, ""lines"": 4}, ""runtime/ftplugin/pbtxt.vim"": {""insertions"": 21, ""deletions"": 0, ""lines"": 21}, ""runtime/synmenu.vim"": {""insertions"": 1, ""deletions"": 0, ""lines"": 1}, ""runtime/syntax/pbtxt.vim"": {""insertions"": 44, ""deletions"": 0, ""lines"": 44}, ""runtime/tutor/tutor"": {""insertions"": 3, ""deletions"": 3, ""lines"": 6}, ""runtime/tutor/tutor.utf-8"": {""insertions"": 3, ""deletions"": 3, ""lines"": 6}}"
2020-11-21 11:44:56,2d718267f4b7dcd65261c9f2acd59a6f6bdc8641,Bram Moolenaar,3,1,4,2,"{""src/term.c"": {""insertions"": 1, ""deletions"": 1, ""lines"": 2}, ""src/version.c"": {""insertions"": 2, ""deletions"": 0, ""lines"": 2}}"
2020-11-21 11:42:09,d91467f830236ae35eb4108d329a1e26a3f1ebc6,Bram Moolenaar,57,23,80,2,"{""src/popupwin.c"": {""insertions"": 55, ""deletions"": 23, ""lines"": 78}, ""src/version.c"": {""insertions"": 2, ""deletions"": 0, ""lines"": 2}}"
2020-11-21 10:45:50,c71ee829efa948eefec3b8f0dbacf172fc1a4992,Bram Moolenaar,8,0,8,2,"{""src/version.c"": {""insertions"": 2, ""deletions"": 0, ""lines"": 2}, ""src/vim9execute.c"": {""insertions"": 6, ""deletions"": 0, ""lines"": 6}}"
2020-11-20 20:07:00,95388e3179f6b995dbc4acd3f23e3856bb0286fd,Bram Moolenaar,21,0,21,3,"{""src/ex_docmd.c"": {""insertions"": 5, ""deletions"": 0, ""lines"": 5}, ""src/testdir/test_vim9_cmd.vim"": {""insertions"": 14, ""deletions"": 0, ""lines"": 14}, ""src/version.c"": {""insertions"": 2, ""deletions"": 0, ""lines"": 2}}"
2020-11-20 18:26:48,eeece9e4885df6190d2615b199efa2b1d22c4bdb,Bram Moolenaar,37,9,46,5,"{""src/ex_docmd.c"": {""insertions"": 11, ""deletions"": 0, ""lines"": 11}, ""src/globals.h"": {""insertions"": 2, ""deletions"": 0, ""lines"": 2}, ""src/testdir/test_vim9_func.vim"": {""insertions"": 14, ""deletions"": 0, ""lines"": 14}, ""src/version.c"": {""insertions"": 2, ""deletions"": 0, ""lines"": 2}, ""src/vim9execute.c"": {""insertions"": 8, ""deletions"": 9, ""lines"": 17}}"
2020-11-20 17:59:19,bebaa0d5c034eb2c4c4dcac86ae6a859b24d2693,Bram Moolenaar,6,4,10,3,"{""src/proto/vim9compile.pro"": {""insertions"": 1, ""deletions"": 1, ""lines"": 2}, ""src/version.c"": {""insertions"": 2, ""deletions"": 0, ""lines"": 2}, ""src/vim9compile.c"": {""insertions"": 3, ""deletions"": 3, ""lines"": 6}}"
2020-11-20 08:10:15,80d868ec25094615f2531a1e01ed1e729366c3bc,Bram Moolenaar,5,2,7,2,"{""src/testdir/test_swap.vim"": {""insertions"": 3, ""deletions"": 2, ""lines"": 5}, ""src/version.c"": {""insertions"": 2, ""deletions"": 0, ""lines"": 2}}"
2020-11-19 20:47:56,2ea95b61f4bec9b71cf916eebe8d11abc76617a0,Bram Moolenaar,33,1,34,3,"{""src/evalvars.c"": {""insertions"": 22, ""deletions"": 1, ""lines"": 23}, ""src/testdir/test_vim9_func.vim"": {""insertions"": 9, ""deletions"": 0, ""lines"": 9}, ""src/version.c"": {""insertions"": 2, ""deletions"": 0, ""lines"": 2}}"
2020-11-19 18:01:43,67d1c68f095eb6cbb6355b04972e384d23065c2c,Bram Moolenaar,29,4,33,2,"{""src/dict.c"": {""insertions"": 27, ""deletions"": 4, ""lines"": 31}, ""src/version.c"": {""insertions"": 2, ""deletions"": 0, ""lines"": 2}}"
2020-11-19 17:57:23,c6ca9f3a29bfd6f5269749036f79f63ce6289692,Bram Moolenaar,4,2,6,2,"{""src/testdir/test_swap.vim"": {""insertions"": 2, ""deletions"": 2, ""lines"": 4}, ""src/version.c"": {""insertions"": 2, ""deletions"": 0, ""lines"": 2}}"
2020-11-19 17:53:18,2bede173a177e227e6224a8713f5b88a38d011af,Bram Moolenaar,70,22,92,9,"{""runtime/doc/vim9.txt"": {""insertions"": 24, ""deletions"": 5, ""lines"": 29}, ""src/errors.h"": {""insertions"": 2, ""deletions"": 0, ""lines"": 2}, ""src/proto/vim9compile.pro"": {""insertions"": 1, ""deletions"": 0, ""lines"": 1}, ""src/testdir/test_vim9_builtin.vim"": {""insertions"": 1, ""deletions"": 1, ""lines"": 2}, ""src/testdir/test_vim9_expr.vim"": {""insertions"": 11, ""deletions"": 5, ""lines"": 16}, ""src/testdir/test_vim9_func.vim"": {""insertions"": 1, ""deletions"": 1, ""lines"": 2}, ""src/testdir/test_vim9_script.vim"": {""insertions"": 2, ""deletions"": 2, ""lines"": 4}, ""src/version.c"": {""insertions"": 2, ""deletions"": 0, ""lines"": 2}, ""src/vim9compile.c"": {""insertions"": 26, ""deletions"": 8, ""lines"": 34}}"
2020-11-19 17:46:25,ee8b787bcd15f63a938243770065e704c9b5c85f,Bram Moolenaar,7,2,9,3,"{""src/job.c"": {""insertions"": 1, ""deletions"": 1, ""lines"": 2}, ""src/testdir/test_prompt_buffer.vim"": {""insertions"": 4, ""deletions"": 1, ""lines"": 5}, ""src/version.c"": {""insertions"": 2, ""deletions"": 0, ""lines"": 2}}"
2020-11-18 16:39:05,79cdf80bed3192add70882bc0aaeede91cc74300,Bram Moolenaar,23,2,25,3,"{""src/testdir/test_vim9_expr.vim"": {""insertions"": 19, ""deletions"": 2, ""lines"": 21}, ""src/version.c"": {""insertions"": 2, ""deletions"": 0, ""lines"": 2}, ""src/vim9compile.c"": {""insertions"": 2, ""deletions"": 0, ""lines"": 2}}"
2020-11-18 16:17:15,d92cc130fbb1beacf6411ee5837545f46f9be90e,Bram Moolenaar,15,1,16,4,"{""src/errors.h"": {""insertions"": 2, ""deletions"": 0, ""lines"": 2}, ""src/testdir/test_vim9_expr.vim"": {""insertions"": 7, ""deletions"": 0, ""lines"": 7}, ""src/typval.c"": {""insertions"": 4, ""deletions"": 1, ""lines"": 5}, ""src/version.c"": {""insertions"": 2, ""deletions"": 0, ""lines"": 2}}"
2020-11-18 15:53:23,9950280d377a5c0706d141017fcef9cad598b8b0,Bram Moolenaar,29,14,43,3,"{""src/syntax.c"": {""insertions"": 24, ""deletions"": 14, ""lines"": 38}, ""src/testdir/test_syntax.vim"": {""insertions"": 3, ""deletions"": 0, ""lines"": 3}, ""src/version.c"": {""insertions"": 2, ""deletions"": 0, ""lines"": 2}}"
2020-11-18 15:35:02,8e02faf4e903e33e41961ba042bb5146213813a5,Bram Moolenaar,24,14,38,3,"{""src/testdir/test_vim9_disassemble.vim"": {""insertions"": 6, ""deletions"": 0, ""lines"": 6}, ""src/version.c"": {""insertions"": 2, ""deletions"": 0, ""lines"": 2}, ""src/vim9compile.c"": {""insertions"": 16, ""deletions"": 14, ""lines"": 30}}"
2020-11-18 14:30:09,382319211a96adce089673c80eda982cc5259d0d,Bram Moolenaar,13,68,81,2,"{""src/GvimExt/gvimext.cpp"": {""insertions"": 11, ""deletions"": 68, ""lines"": 79}, ""src/version.c"": {""insertions"": 2, ""deletions"": 0, ""lines"": 2}}"
2020-11-18 14:21:50,032f40afb88b24043f96655aa248267a4f54faa8,Bram Moolenaar,8,3,11,2,"{""src/gui_w32.c"": {""insertions"": 6, ""deletions"": 3, ""lines"": 9}, ""src/version.c"": {""insertions"": 2, ""deletions"": 0, ""lines"": 2}}"
2020-11-18 11:24:01,17ab28daa060c3c263841329e74befb9c6e8b588,Bram Moolenaar,3,1,4,2,"{""src/testdir/test_terminal.vim"": {""insertions"": 1, ""deletions"": 1, ""lines"": 2}, ""src/version.c"": {""insertions"": 2, ""deletions"": 0, ""lines"": 2}}"
2020-11-18 11:12:39,88774a30c0b1957a6177cdb69d2becedae610299,Bram Moolenaar,4,0,4,3,"{""runtime/filetype.vim"": {""insertions"": 1, ""deletions"": 0, ""lines"": 1}, ""src/testdir/test_filetype.vim"": {""insertions"": 1, ""deletions"": 0, ""lines"": 1}, ""src/version.c"": {""insertions"": 2, ""deletions"": 0, ""lines"": 2}}"
2020-11-18 10:34:37,c77534c303721df4024fd6cfd51098d593b7d4da,Bram Moolenaar,43,8,51,4,"{""src/getchar.c"": {""insertions"": 1, ""deletions"": 5, ""lines"": 6}, ""src/ops.c"": {""insertions"": 4, ""deletions"": 3, ""lines"": 7}, ""src/testdir/test_mapping.vim"": {""insertions"": 36, ""deletions"": 0, ""lines"": 36}, ""src/version.c"": {""insertions"": 2, ""deletions"": 0, ""lines"": 2}}"
2020-11-17 18:56:09,b3a01946b30f33e7be0358b3ff2736b94973a659,Bram Moolenaar,3,1,4,2,"{""src/version.c"": {""insertions"": 2, ""deletions"": 0, ""lines"": 2}, ""src/vim9compile.c"": {""insertions"": 1, ""deletions"": 1, ""lines"": 2}}"
2020-11-17 18:22:06,1efefda623283d941705d8f6ad0e9cfe0ac76079,Bram Moolenaar,6,2,8,2,"{""src/drawline.c"": {""insertions"": 4, ""deletions"": 2, ""lines"": 6}, ""src/version.c"": {""insertions"": 2, ""deletions"": 0, ""lines"": 2}}"
2020-11-17 17:50:44,52bf81c2d5f0d57443a29525b68b88707f5ad87c,Bram Moolenaar,24,7,31,3,"{""src/testdir/test_vim9_func.vim"": {""insertions"": 9, ""deletions"": 0, ""lines"": 9}, ""src/version.c"": {""insertions"": 2, ""deletions"": 0, ""lines"": 2}, ""src/vim9compile.c"": {""insertions"": 13, ""deletions"": 7, ""lines"": 20}}"
2020-11-17 17:23:19,0ba48e8c2741bd65d547fe6bf1d9873f411b25b4,Bram Moolenaar,99,8,107,5,"{""src/proto/userfunc.pro"": {""insertions"": 4, ""deletions"": 0, ""lines"": 4}, ""src/testdir/test_vim9_func.vim"": {""insertions"": 30, ""deletions"": 0, ""lines"": 30}, ""src/userfunc.c"": {""insertions"": 48, ""deletions"": 8, ""lines"": 56}, ""src/version.c"": {""insertions"": 2, ""deletions"": 0, ""lines"": 2}, ""src/vim9execute.c"": {""insertions"": 15, ""deletions"": 0, ""lines"": 15}}"
2020-11-16 21:11:49,fc74d03e7694bac3b50d8d6b6b78b40a71818744,Bram Moolenaar,35,12,47,3,"{""src/testdir/test_vim9_assign.vim"": {""insertions"": 10, ""deletions"": 1, ""lines"": 11}, ""src/version.c"": {""insertions"": 2, ""deletions"": 0, ""lines"": 2}, ""src/vim9compile.c"": {""insertions"": 23, ""deletions"": 11, ""lines"": 34}}"
2020-11-16 20:10:34,e6329e4c55cd81b6134820eab6a10b02c11c1277,Bram Moolenaar,4,2,6,2,"{""src/testdir/test_terminal.vim"": {""insertions"": 2, ""deletions"": 2, ""lines"": 4}, ""src/version.c"": {""insertions"": 2, ""deletions"": 0, ""lines"": 2}}"
2020-11-16 20:02:28,27f4f6baeeb25e1597a7827f4a509ecf2eb8e6e2,Bram Moolenaar,4,3,7,2,"{""src/testdir/test_terminal.vim"": {""insertions"": 2, ""deletions"": 3, ""lines"": 5}, ""src/version.c"": {""insertions"": 2, ""deletions"": 0, ""lines"": 2}}"
2020-11-16 19:47:31,8adc8d9b73121b647476a33d91d31d25e1c2d987,Bram Moolenaar,28,0,28,3,"{""src/testdir/test_terminal.vim"": {""insertions"": 17, ""deletions"": 0, ""lines"": 17}, ""src/version.c"": {""insertions"": 2, ""deletions"": 0, ""lines"": 2}, ""src/window.c"": {""insertions"": 9, ""deletions"": 0, ""lines"": 9}}"
2020-11-16 19:08:35,193f6201b4d5c76f8dc1faa1dcf369575d93fe3a,Bram Moolenaar,36,5,41,7,"{""src/evalfunc.c"": {""insertions"": 4, ""deletions"": 4, ""lines"": 8}, ""src/proto/vim9compile.pro"": {""insertions"": 1, ""deletions"": 0, ""lines"": 1}, ""src/proto/vim9type.pro"": {""insertions"": 1, ""deletions"": 0, ""lines"": 1}, ""src/testdir/test_vim9_builtin.vim"": {""insertions"": 13, ""deletions"": 0, ""lines"": 13}, ""src/version.c"": {""insertions"": 2, ""deletions"": 0, ""lines"": 2}, ""src/vim9compile.c"": {""insertions"": 1, ""deletions"": 1, ""lines"": 2}, ""src/vim9type.c"": {""insertions"": 14, ""deletions"": 0, ""lines"": 14}}"
2020-11-16 18:12:00,714cbe5b212abbecb578b90424d89f47142e8f25,Bram Moolenaar,21,5,26,2,"{""src/popupmenu.c"": {""insertions"": 19, ""deletions"": 5, ""lines"": 24}, ""src/version.c"": {""insertions"": 2, ""deletions"": 0, ""lines"": 2}}"
2020-11-16 17:49:47,c4390fe6c0d1b47b1acd373d7e8ef986412c0600,Bram Moolenaar,10,8,18,2,"{""src/Make_cyg_ming.mak"": {""insertions"": 8, ""deletions"": 8, ""lines"": 16}, ""src/version.c"": {""insertions"": 2, ""deletions"": 0, ""lines"": 2}}"
2020-11-16 17:39:43,50dc3ecc642ee88348cb353cf85d08eac26c75dd,Bram Moolenaar,4,2,6,2,"{""src/testdir/test_netbeans.vim"": {""insertions"": 2, ""deletions"": 2, ""lines"": 4}, ""src/version.c"": {""insertions"": 2, ""deletions"": 0, ""lines"": 2}}"
2020-11-15 20:11:18,4792a679f9e08fc6026a596be3d364cecb70b049,Bram Moolenaar,4,0,4,2,"{""src/move.c"": {""insertions"": 2, ""deletions"": 0, ""lines"": 2}, ""src/version.c"": {""insertions"": 2, ""deletions"": 0, ""lines"": 2}}"
2020-11-15 19:49:41,ca359cbedd0d603124776e7a6ca0ae79ffc34cdc,Bram Moolenaar,7,1,8,2,"{""src/getchar.c"": {""insertions"": 5, ""deletions"": 1, ""lines"": 6}, ""src/version.c"": {""insertions"": 2, ""deletions"": 0, ""lines"": 2}}"
2020-11-15 19:32:58,6a07644db30cb5f3d0c6dc5eb2c348b6289da553,Bram Moolenaar,41,16,57,7,"{""src/drawline.c"": {""insertions"": 1, ""deletions"": 0, ""lines"": 1}, ""src/move.c"": {""insertions"": 4, ""deletions"": 0, ""lines"": 4}, ""src/popupwin.c"": {""insertions"": 9, ""deletions"": 5, ""lines"": 14}, ""src/structs.h"": {""insertions"": 20, ""deletions"": 9, ""lines"": 29}, ""src/terminal.c"": {""insertions"": 3, ""deletions"": 0, ""lines"": 3}, ""src/testdir/dumps/Test_terminal_popup_m1.dump"": {""insertions"": 2, ""deletions"": 2, ""lines"": 4}, ""src/version.c"": {""insertions"": 2, ""deletions"": 0, ""lines"": 2}}"
2020-11-15 13:09:37,2dfae04f376a58d4c5a801cb652c8eae65900672,Bram Moolenaar,14,0,14,3,"{""src/popupmenu.c"": {""insertions"": 8, ""deletions"": 0, ""lines"": 8}, ""src/testdir/test_popupwin.vim"": {""insertions"": 4, ""deletions"": 0, ""lines"": 4}, ""src/version.c"": {""insertions"": 2, ""deletions"": 0, ""lines"": 2}}"
2020-11-14 20:34:59,e41decc892a115335259096c3bc0204dd99b372b,Bram Moolenaar,25,0,25,3,"{""src/edit.c"": {""insertions"": 5, ""deletions"": 0, ""lines"": 5}, ""src/testdir/test_terminal.vim"": {""insertions"": 18, ""deletions"": 0, ""lines"": 18}, ""src/version.c"": {""insertions"": 2, ""deletions"": 0, ""lines"": 2}}"
2020-11-14 20:04:33,6453cc8078af403956d0e8c1849cf5ec0aae86b2,Bram Moolenaar,3,24,27,3,"{""src/INSTALLpc.txt"": {""insertions"": 0, ""deletions"": 5, ""lines"": 5}, ""src/Make_mvc.mak"": {""insertions"": 1, ""deletions"": 19, ""lines"": 20}, ""src/version.c"": {""insertions"": 2, ""deletions"": 0, ""lines"": 2}}"
2020-11-14 19:57:20,a065a141156c8c4017e21dfc9b99a05cfd0b63d6,Bram Moolenaar,10,5,15,2,"{""src/testdir/test_vim9_expr.vim"": {""insertions"": 8, ""deletions"": 5, ""lines"": 13}, ""src/version.c"": {""insertions"": 2, ""deletions"": 0, ""lines"": 2}}"
2020-11-14 19:21:55,02764713a715c55e316e2bef5c9ade2fb767ee78,Bram Moolenaar,15,3,18,3,"{""src/terminal.c"": {""insertions"": 1, ""deletions"": 3, ""lines"": 4}, ""src/testdir/test_terminal.vim"": {""insertions"": 12, ""deletions"": 0, ""lines"": 12}, ""src/version.c"": {""insertions"": 2, ""deletions"": 0, ""lines"": 2}}"
2020-11-14 16:25:51,33aecb1f2c85711d53858b71f5f3c2cbe076435f,Bram Moolenaar,66,4,70,3,"{""src/ex_cmds.h"": {""insertions"": 4, ""deletions"": 4, ""lines"": 8}, ""src/testdir/test_quickfix.vim"": {""insertions"": 60, ""deletions"": 0, ""lines"": 60}, ""src/version.c"": {""insertions"": 2, ""deletions"": 0, ""lines"": 2}}"
2020-11-14 13:22:28,f4d61bc559f8cb6adc4880183a4fd216865c0c30,Bram Moolenaar,56,4,60,4,"{""src/ex_getln.c"": {""insertions"": 10, ""deletions"": 3, ""lines"": 13}, ""src/testdir/dumps/Test_terminal_from_cmd.dump"": {""insertions"": 20, ""deletions"": 0, ""lines"": 20}, ""src/testdir/test_terminal.vim"": {""insertions"": 24, ""deletions"": 1, ""lines"": 25}, ""src/version.c"": {""insertions"": 2, ""deletions"": 0, ""lines"": 2}}"
2020-11-14 12:15:24,2ce7790348dab9cbfcc5d02c8258d0dd7ecacf95,Bram Moolenaar,20,2,22,3,"{""src/quickfix.c"": {""insertions"": 5, ""deletions"": 2, ""lines"": 7}, ""src/testdir/test_quickfix.vim"": {""insertions"": 13, ""deletions"": 0, ""lines"": 13}, ""src/version.c"": {""insertions"": 2, ""deletions"": 0, ""lines"": 2}}"
2020-11-13 16:47:33,8496c9eadbf4ea3bf69e2e01456831eee2bddf0a,Bram Moolenaar,9,1,10,2,"{""src/Make_cyg_ming.mak"": {""insertions"": 7, ""deletions"": 1, ""lines"": 8}, ""src/version.c"": {""insertions"": 2, ""deletions"": 0, ""lines"": 2}}"
2020-11-12 19:16:39,659bb2275e1c407709e2ac949044d6b256de5550,Bram Moolenaar,734,721,1455,5,"{""src/eval.c"": {""insertions"": 9, ""deletions"": 1, ""lines"": 10}, ""src/list.c"": {""insertions"": 1, ""deletions"": 1, ""lines"": 2}, ""src/scriptfile.c"": {""insertions"": 3, ""deletions"": 0, ""lines"": 3}, ""src/testdir/test_vim9_expr.vim"": {""insertions"": 719, ""deletions"": 719, ""lines"": 1438}, ""src/version.c"": {""insertions"": 2, ""deletions"": 0, ""lines"": 2}}"
2020-11-12 14:12:15,47c5ea44b975adca00eaacecee5c4108996178d9,Bram Moolenaar,18,10,28,3,"{""src/terminal.c"": {""insertions"": 13, ""deletions"": 9, ""lines"": 22}, ""src/testdir/test_terminal.vim"": {""insertions"": 3, ""deletions"": 1, ""lines"": 4}, ""src/version.c"": {""insertions"": 2, ""deletions"": 0, ""lines"": 2}}"
2020-11-12 13:21:06,957cf67d50516ba98716f59c9e1cb6412ec1535d,Bram Moolenaar,646,17,663,19,"{""runtime/doc/autocmd.txt"": {""insertions"": 5, ""deletions"": 2, ""lines"": 7}, ""runtime/doc/eval.txt"": {""insertions"": 1, ""deletions"": 0, ""lines"": 1}, ""runtime/doc/map.txt"": {""insertions"": 36, ""deletions"": 2, ""lines"": 38}, ""src/edit.c"": {""insertions"": 4, ""deletions"": 0, ""lines"": 4}, ""src/errors.h"": {""insertions"": 6, ""deletions"": 0, ""lines"": 6}, ""src/ex_docmd.c"": {""insertions"": 3, ""deletions"": 0, ""lines"": 3}, ""src/ex_getln.c"": {""insertions"": 4, ""deletions"": 0, ""lines"": 4}, ""src/getchar.c"": {""insertions"": 93, ""deletions"": 0, ""lines"": 93}, ""src/insexpand.c"": {""insertions"": 1, ""deletions"": 1, ""lines"": 2}, ""src/keymap.h"": {""insertions"": 6, ""deletions"": 3, ""lines"": 9}, ""src/map.c"": {""insertions"": 1, ""deletions"": 2, ""lines"": 3}, ""src/misc2.c"": {""insertions"": 1, ""deletions"": 0, ""lines"": 1}, ""src/normal.c"": {""insertions"": 7, ""deletions"": 5, ""lines"": 12}, ""src/ops.c"": {""insertions"": 1, ""deletions"": 1, ""lines"": 2}, ""src/proto/getchar.pro"": {""insertions"": 1, ""deletions"": 0, ""lines"": 1}, ""src/screen.c"": {""insertions"": 2, ""deletions"": 1, ""lines"": 3}, ""src/terminal.c"": {""insertions"": 4, ""deletions"": 0, ""lines"": 4}, ""src/testdir/test_mapping.vim"": {""insertions"": 468, ""deletions"": 0, ""lines"": 468}, ""src/version.c"": {""insertions"": 2, ""deletions"": 0, ""lines"": 2}}"
2020-11-12 11:08:51,ea2d407f9c144bb634c59017944e4930ed7f80a2,Bram Moolenaar,83,53,136,9,"{""src/errors.h"": {""insertions"": 4, ""deletions"": 2, ""lines"": 6}, ""src/proto/vim9execute.pro"": {""insertions"": 1, ""deletions"": 0, ""lines"": 1}, ""src/testdir/test_vim9_cmd.vim"": {""insertions"": 6, ""deletions"": 6, ""lines"": 12}, ""src/testdir/test_vim9_disassemble.vim"": {""insertions"": 16, ""deletions"": 13, ""lines"": 29}, ""src/testdir/test_vim9_expr.vim"": {""insertions"": 6, ""deletions"": 3, ""lines"": 9}, ""src/typval.c"": {""insertions"": 1, ""deletions"": 1, ""lines"": 2}, ""src/version.c"": {""insertions"": 2, ""deletions"": 0, ""lines"": 2}, ""src/vim9compile.c"": {""insertions"": 37, ""deletions"": 27, ""lines"": 64}, ""src/vim9execute.c"": {""insertions"": 10, ""deletions"": 1, ""lines"": 11}}"
2020-11-11 19:52:40,6f6244855fbce5aaa718cd5001a29aac3c5c15d6,Bram Moolenaar,15,2,17,3,"{""src/edit.c"": {""insertions"": 5, ""deletions"": 2, ""lines"": 7}, ""src/testdir/test_prompt_buffer.vim"": {""insertions"": 8, ""deletions"": 0, ""lines"": 8}, ""src/version.c"": {""insertions"": 2, ""deletions"": 0, ""lines"": 2}}"
2020-11-10 21:03:40,bbf9f344afd08954163191ed678352fb554fc254,Bram Moolenaar,5,0,5,2,"{""src/os_win32.c"": {""insertions"": 3, ""deletions"": 0, ""lines"": 3}, ""src/version.c"": {""insertions"": 2, ""deletions"": 0, ""lines"": 2}}"
2020-11-10 19:58:00,29b281ba8ddf176ae34b22e6a9b8e0ddcbcce665,Bram Moolenaar,3,1,4,2,"{""src/evalfunc.c"": {""insertions"": 1, ""deletions"": 1, ""lines"": 2}, ""src/version.c"": {""insertions"": 2, ""deletions"": 0, ""lines"": 2}}"
2020-11-10 19:54:29,232f4612e2b0a6a205ae385740078f6b8af05e75,Bram Moolenaar,16,6,22,1,"{""src/version.c"": {""insertions"": 16, ""deletions"": 6, ""lines"": 22}}"
2020-11-10 17:23:52,5e1f22ff614821b8fc7294c9dd22765acd403aeb,Bram Moolenaar,16,1,17,3,"{""src/fold.c"": {""insertions"": 4, ""deletions"": 1, ""lines"": 5}, ""src/testdir/test_fold.vim"": {""insertions"": 10, ""deletions"": 0, ""lines"": 10}, ""src/version.c"": {""insertions"": 2, ""deletions"": 0, ""lines"": 2}}"
2020-11-10 10:43:56,c56936e2ba4fd219f56aab616fcb283132455697,Bram Moolenaar,8,1,9,2,"{""src/list.c"": {""insertions"": 6, ""deletions"": 1, ""lines"": 7}, ""src/version.c"": {""insertions"": 2, ""deletions"": 0, ""lines"": 2}}"
2020-11-09 20:04:17,f883508e36c209d60388b944e04e22a3fcf603cf,Bram Moolenaar,77,3,80,3,"{""src/memline.c"": {""insertions"": 29, ""deletions"": 3, ""lines"": 32}, ""src/testdir/test_swap.vim"": {""insertions"": 46, ""deletions"": 0, ""lines"": 46}, ""src/version.c"": {""insertions"": 2, ""deletions"": 0, ""lines"": 2}}"
2020-11-09 17:31:39,ea696852e7abcdebaf7f17a7f23dc90df1f5e2ed,Bram Moolenaar,204,52,256,7,"{""runtime/doc/eval.txt"": {""insertions"": 22, ""deletions"": 10, ""lines"": 32}, ""runtime/doc/usr_41.txt"": {""insertions"": 2, ""deletions"": 0, ""lines"": 2}, ""src/evalfunc.c"": {""insertions"": 15, ""deletions"": 2, ""lines"": 17}, ""src/list.c"": {""insertions"": 141, ""deletions"": 40, ""lines"": 181}, ""src/proto/list.pro"": {""insertions"": 1, ""deletions"": 0, ""lines"": 1}, ""src/testdir/test_filter_map.vim"": {""insertions"": 21, ""deletions"": 0, ""lines"": 21}, ""src/version.c"": {""insertions"": 2, ""deletions"": 0, ""lines"": 2}}"
2020-11-08 11:49:47,8cebd43e9774d2624af43ee5b86939886f2ba490,Bram Moolenaar,141,1,142,5,"{""src/evalfunc.c"": {""insertions"": 67, ""deletions"": 0, ""lines"": 67}, ""src/proto/evalfunc.pro"": {""insertions"": 1, ""deletions"": 0, ""lines"": 1}, ""src/testdir/test_vim9_disassemble.vim"": {""insertions"": 69, ""deletions"": 0, ""lines"": 69}, ""src/version.c"": {""insertions"": 2, ""deletions"": 0, ""lines"": 2}, ""src/vim9compile.c"": {""insertions"": 2, ""deletions"": 1, ""lines"": 3}}"
2020-11-07 17:41:10,59d8e56e048eb5d384649284fb35363931fc3697,Bram Moolenaar,74,37,111,9,"{""runtime/doc/windows.txt"": {""insertions"": 6, ""deletions"": 1, ""lines"": 7}, ""src/ex_cmdidxs.h"": {""insertions"": 26, ""deletions"": 26, ""lines"": 52}, ""src/ex_cmds.c"": {""insertions"": 12, ""deletions"": 7, ""lines"": 19}, ""src/ex_cmds.h"": {""insertions"": 3, ""deletions"": 0, ""lines"": 3}, ""src/ex_docmd.c"": {""insertions"": 4, ""deletions"": 3, ""lines"": 7}, ""src/session.c"": {""insertions"": 13, ""deletions"": 0, ""lines"": 13}, ""src/testdir/test_buffer.vim"": {""insertions"": 7, ""deletions"": 0, ""lines"": 7}, ""src/version.c"": {""insertions"": 2, ""deletions"": 0, ""lines"": 2}, ""src/vim.h"": {""insertions"": 1, ""deletions"": 0, ""lines"": 1}}"
2020-11-07 15:58:59,cbcd9cbd77acc8cc97c0d44683d96c01d3dd0fa7,Bram Moolenaar,62,22,84,6,"{""src/autocmd.c"": {""insertions"": 16, ""deletions"": 15, ""lines"": 31}, ""src/proto/window.pro"": {""insertions"": 1, ""deletions"": 0, ""lines"": 1}, ""src/structs.h"": {""insertions"": 7, ""deletions"": 7, ""lines"": 14}, ""src/testdir/test_popupwin.vim"": {""insertions"": 21, ""deletions"": 0, ""lines"": 21}, ""src/version.c"": {""insertions"": 2, ""deletions"": 0, ""lines"": 2}, ""src/window.c"": {""insertions"": 15, ""deletions"": 0, ""lines"": 15}}"
2020-11-07 12:09:18,46f479c756c0255e3b6d473590c1857678eff5c6,Bram Moolenaar,29,19,48,2,"{""src/testdir/test_vim9_expr.vim"": {""insertions"": 27, ""deletions"": 19, ""lines"": 46}, ""src/version.c"": {""insertions"": 2, ""deletions"": 0, ""lines"": 2}}"
2020-11-06 17:52:55,faebda8cc1ecc4d6a197e06e968df46a2841ed79,Bram Moolenaar,4,2,6,3,"{""runtime/filetype.vim"": {""insertions"": 1, ""deletions"": 1, ""lines"": 2}, ""src/testdir/test_filetype.vim"": {""insertions"": 1, ""deletions"": 1, ""lines"": 2}, ""src/version.c"": {""insertions"": 2, ""deletions"": 0, ""lines"": 2}}"
2020-11-06 16:58:35,927495b1fef835a8f83c089bb3aa3608b617e972,Bram Moolenaar,42,5,47,4,"{""src/screen.c"": {""insertions"": 2, ""deletions"": 1, ""lines"": 3}, ""src/terminal.c"": {""insertions"": 16, ""deletions"": 4, ""lines"": 20}, ""src/testdir/test_popupwin.vim"": {""insertions"": 22, ""deletions"": 0, ""lines"": 22}, ""src/version.c"": {""insertions"": 2, ""deletions"": 0, ""lines"": 2}}"
2020-11-06 12:44:21,32e5ec0b017adb68fe36adb9a9a362abdaffe7f4,Bram Moolenaar,49,9,58,3,"{""src/netbeans.c"": {""insertions"": 4, ""deletions"": 6, ""lines"": 10}, ""src/testdir/test_netbeans.vim"": {""insertions"": 43, ""deletions"": 3, ""lines"": 46}, ""src/version.c"": {""insertions"": 2, ""deletions"": 0, ""lines"": 2}}"
2020-11-06 11:03:08,85d9b03f84f59c4c6013d6bd7e6d1bb8091ee8c5,Bram Moolenaar,0,2,2,1,"{""src/version.c"": {""insertions"": 0, ""deletions"": 2, ""lines"": 2}}"
2020-11-05 19:50:51,22286895fce0e45e42126c7f2e35ebf43bc625d9,Bram Moolenaar,9,3,12,7,"{""src/dict.c"": {""insertions"": 1, ""deletions"": 0, ""lines"": 1}, ""src/gui_motif.c"": {""insertions"": 0, ""deletions"": 1, ""lines"": 1}, ""src/structs.h"": {""insertions"": 2, ""deletions"": 1, ""lines"": 3}, ""src/testdir/shared.vim"": {""insertions"": 1, ""deletions"": 1, ""lines"": 2}, ""src/testdir/test_netbeans.vim"": {""insertions"": 1, ""deletions"": 0, ""lines"": 1}, ""src/time.c"": {""insertions"": 2, ""deletions"": 0, ""lines"": 2}, ""src/version.c"": {""insertions"": 2, ""deletions"": 0, ""lines"": 2}}"
2020-11-05 19:46:32,0fd797eacd569a0680a86452c18713eacf6608fe,Bram Moolenaar,5,1,6,2,"{""src/evalfunc.c"": {""insertions"": 1, ""deletions"": 1, ""lines"": 2}, ""src/version.c"": {""insertions"": 4, ""deletions"": 0, ""lines"": 4}}"
2020-11-05 19:41:49,3132cddd209ee510bde48b6520290cb26c8f604a,Bram Moolenaar,351,253,604,19,"{"".github/CODEOWNERS"": {""insertions"": 4, ""deletions"": 0, ""lines"": 4}, ""runtime/doc/change.txt"": {""insertions"": 10, ""deletions"": 8, ""lines"": 18}, ""runtime/doc/eval.txt"": {""insertions"": 32, ""deletions"": 19, ""lines"": 51}, ""runtime/doc/netbeans.txt"": {""insertions"": 1, ""deletions"": 1, ""lines"": 2}, ""runtime/doc/sign.txt"": {""insertions"": 10, ""deletions"": 6, ""lines"": 16}, ""runtime/doc/todo.txt"": {""insertions"": 7, ""deletions"": 7, ""lines"": 14}, ""runtime/doc/vim.1"": {""insertions"": 3, ""deletions"": 0, ""lines"": 3}, ""runtime/doc/vim.man"": {""insertions"": 3, ""deletions"": 0, ""lines"": 3}, ""runtime/ftplugin/awk.vim"": {""insertions"": 4, ""deletions"": 3, ""lines"": 7}, ""runtime/optwin.vim"": {""insertions"": 3, ""deletions"": 3, ""lines"": 6}, ""runtime/pack/dist/opt/termdebug/plugin/termdebug.vim"": {""insertions"": 2, ""deletions"": 2, ""lines"": 4}, ""runtime/syntax/asm.vim"": {""insertions"": 67, ""deletions"": 33, ""lines"": 100}, ""runtime/syntax/asmh8300.vim"": {""insertions"": 19, ""deletions"": 29, ""lines"": 48}, ""runtime/syntax/awk.vim"": {""insertions"": 4, ""deletions"": 3, ""lines"": 7}, ""runtime/syntax/debchangelog.vim"": {""insertions"": 5, ""deletions"": 5, ""lines"": 10}, ""runtime/syntax/debcontrol.vim"": {""insertions"": 9, ""deletions"": 7, ""lines"": 16}, ""runtime/syntax/debsources.vim"": {""insertions"": 5, ""deletions"": 5, ""lines"": 10}, ""runtime/syntax/proto.vim"": {""insertions"": 35, ""deletions"": 25, ""lines"": 60}, ""runtime/syntax/typescriptcommon.vim"": {""insertions"": 128, ""deletions"": 97, ""lines"": 225}}"
2020-11-05 18:36:38,00806bceb6dc9c8dcd308e5f7e50f720f7dc71b0,Bram Moolenaar,30,4,34,5,"{""src/buffer.c"": {""insertions"": 12, ""deletions"": 1, ""lines"": 13}, ""src/proto/buffer.pro"": {""insertions"": 1, ""deletions"": 0, ""lines"": 1}, ""src/terminal.c"": {""insertions"": 5, ""deletions"": 3, ""lines"": 8}, ""src/testdir/test_terminal.vim"": {""insertions"": 10, ""deletions"": 0, ""lines"": 10}, ""src/version.c"": {""insertions"": 2, ""deletions"": 0, ""lines"": 2}}"
2020-11-05 18:34:41,b885b435d126d34475714e39ec1125bd4e1c77c6,Bram Moolenaar,3,1,4,2,"{""src/popupwin.c"": {""insertions"": 1, ""deletions"": 1, ""lines"": 2}, ""src/version.c"": {""insertions"": 2, ""deletions"": 0, ""lines"": 2}}"
2020-11-05 18:07:21,fabc3ca896751277f18a3a68e5661179728db3ad,Bram Moolenaar,121,1,122,7,"{""src/drawline.c"": {""insertions"": 6, ""deletions"": 1, ""lines"": 7}, ""src/testdir/dumps/Test_diff_cuc_01.dump"": {""insertions"": 20, ""deletions"": 0, ""lines"": 20}, ""src/testdir/dumps/Test_diff_cuc_02.dump"": {""insertions"": 20, ""deletions"": 0, ""lines"": 20}, ""src/testdir/dumps/Test_diff_cuc_03.dump"": {""insertions"": 20, ""deletions"": 0, ""lines"": 20}, ""src/testdir/dumps/Test_diff_cuc_04.dump"": {""insertions"": 20, ""deletions"": 0, ""lines"": 20}, ""src/testdir/test_diffmode.vim"": {""insertions"": 33, ""deletions"": 0, ""lines"": 33}, ""src/version.c"": {""insertions"": 2, ""deletions"": 0, ""lines"": 2}}"
2020-11-05 17:45:46,b4d16cb11d92b363503b71673921774548230e94,Bram Moolenaar,178,78,256,7,"{""src/eval.c"": {""insertions"": 2, ""deletions"": 2, ""lines"": 4}, ""src/proto/userfunc.pro"": {""insertions"": 2, ""deletions"": 2, ""lines"": 4}, ""src/testdir/test_vim9_disassemble.vim"": {""insertions"": 22, ""deletions"": 0, ""lines"": 22}, ""src/testdir/test_vim9_func.vim"": {""insertions"": 11, ""deletions"": 2, ""lines"": 13}, ""src/userfunc.c"": {""insertions"": 110, ""deletions"": 68, ""lines"": 178}, ""src/version.c"": {""insertions"": 2, ""deletions"": 0, ""lines"": 2}, ""src/vim9compile.c"": {""insertions"": 29, ""deletions"": 4, ""lines"": 33}}"
2020-11-04 17:53:35,66669fc6647201649e75a214e72b768fc86b7ed3,Bram Moolenaar,58,21,79,2,"{""src/testdir/test_vim9_cmd.vim"": {""insertions"": 56, ""deletions"": 21, ""lines"": 77}, ""src/version.c"": {""insertions"": 2, ""deletions"": 0, ""lines"": 2}}"
2020-11-04 17:02:44,f65b35b4465d3622128bd82bd3775f833542eb1f,Bram Moolenaar,46,5,51,3,"{""src/ex_cmds.c"": {""insertions"": 10, ""deletions"": 0, ""lines"": 10}, ""src/testdir/test_vim9_cmd.vim"": {""insertions"": 34, ""deletions"": 5, ""lines"": 39}, ""src/version.c"": {""insertions"": 2, ""deletions"": 0, ""lines"": 2}}"
2020-11-04 14:07:16,631e8f93458b102091d54c502f489c03e454d4da,Bram Moolenaar,49,9,58,5,"{""src/testdir/test_assert.vim"": {""insertions"": 6, ""deletions"": 6, ""lines"": 12}, ""src/testdir/test_vim9_script.vim"": {""insertions"": 22, ""deletions"": 0, ""lines"": 22}, ""src/testing.c"": {""insertions"": 10, ""deletions"": 1, ""lines"": 11}, ""src/version.c"": {""insertions"": 2, ""deletions"": 0, ""lines"": 2}, ""src/vim9execute.c"": {""insertions"": 9, ""deletions"": 2, ""lines"": 11}}"
2020-11-04 12:38:28,c7f7f6db3e9d3b6b723ed17d5244c83859583832,Bram Moolenaar,10,3,13,3,"{""src/testdir/test_vim9_expr.vim"": {""insertions"": 2, ""deletions"": 0, ""lines"": 2}, ""src/version.c"": {""insertions"": 2, ""deletions"": 0, ""lines"": 2}, ""src/vim9execute.c"": {""insertions"": 6, ""deletions"": 3, ""lines"": 9}}"
2020-11-04 11:23:06,64ffa9b5fb34adb0b20fc22e8127604274bc3010,Bram Moolenaar,33,19,52,4,"{""src/testdir/test_listdict.vim"": {""insertions"": 27, ""deletions"": 14, ""lines"": 41}, ""src/testdir/test_python2.vim"": {""insertions"": 2, ""deletions"": 2, ""lines"": 4}, ""src/testdir/test_python3.vim"": {""insertions"": 2, ""deletions"": 3, ""lines"": 5}, ""src/version.c"": {""insertions"": 2, ""deletions"": 0, ""lines"": 2}}"
2020-11-04 11:00:53,9c13f76275047a4d6302c077fb40bc9c397ff027,Bram Moolenaar,23,2,25,3,"{""src/testdir/test_vim9_expr.vim"": {""insertions"": 18, ""deletions"": 0, ""lines"": 18}, ""src/version.c"": {""insertions"": 2, ""deletions"": 0, ""lines"": 2}, ""src/vim9type.c"": {""insertions"": 3, ""deletions"": 2, ""lines"": 5}}"
2020-11-04 10:36:35,348be7ed07d164970ec0004bc278e254eb0cf5bf,Bram Moolenaar,82,7,89,5,"{""src/errors.h"": {""insertions"": 4, ""deletions"": 0, ""lines"": 4}, ""src/evalvars.c"": {""insertions"": 15, ""deletions"": 0, ""lines"": 15}, ""src/list.c"": {""insertions"": 12, ""deletions"": 4, ""lines"": 16}, ""src/testdir/test_vim9_assign.vim"": {""insertions"": 49, ""deletions"": 3, ""lines"": 52}, ""src/version.c"": {""insertions"": 2, ""deletions"": 0, ""lines"": 2}}"
2020-11-04 10:03:12,4778b4d0e147793a4254cbda9c0e270250e970f5,Bram Moolenaar,18,1,19,4,"{""src/getchar.c"": {""insertions"": 2, ""deletions"": 1, ""lines"": 3}, ""src/globals.h"": {""insertions"": 6, ""deletions"": 0, ""lines"": 6}, ""src/version.c"": {""insertions"": 2, ""deletions"": 0, ""lines"": 2}, ""src/window.c"": {""insertions"": 8, ""deletions"": 0, ""lines"": 8}}"
2020-11-03 19:05:40,c136a3528b7ebb825c3863d701af44f023381181,Bram Moolenaar,13,0,13,3,"{""src/fold.c"": {""insertions"": 2, ""deletions"": 0, ""lines"": 2}, ""src/testdir/test_fold.vim"": {""insertions"": 9, ""deletions"": 0, ""lines"": 9}, ""src/version.c"": {""insertions"": 2, ""deletions"": 0, ""lines"": 2}}"
2020-11-03 17:51:54,35efa22ff2b98126363098db9304796b5624f97f,Bram Moolenaar,10,5,15,2,"{""src/testdir/test_sort.vim"": {""insertions"": 8, ""deletions"": 5, ""lines"": 13}, ""src/version.c"": {""insertions"": 2, ""deletions"": 0, ""lines"": 2}}"
2020-11-03 17:20:19,0d90e728fe089ff1bb34d6a17f5591a96b57f734,Bram Moolenaar,12,2,14,4,"{""src/errors.h"": {""insertions"": 2, ""deletions"": 0, ""lines"": 2}, ""src/list.c"": {""insertions"": 5, ""deletions"": 2, ""lines"": 7}, ""src/testdir/test_listdict.vim"": {""insertions"": 3, ""deletions"": 0, ""lines"": 3}, ""src/version.c"": {""insertions"": 2, ""deletions"": 0, ""lines"": 2}}"
2020-11-03 10:53:29,6fd3a4ba2320c4a95f02daef5f2ac76d3105d013,Bram Moolenaar,4,0,4,2,"{""src/testdir/test_netbeans.vim"": {""insertions"": 2, ""deletions"": 0, ""lines"": 2}, ""src/version.c"": {""insertions"": 2, ""deletions"": 0, ""lines"": 2}}"
2020-11-02 20:08:47,36113e46b4a7e8c33aa1ed1c9cfa6591c952183d,Bram Moolenaar,22,4,26,3,"{""src/ex_docmd.c"": {""insertions"": 11, ""deletions"": 4, ""lines"": 15}, ""src/testdir/test_vim9_cmd.vim"": {""insertions"": 9, ""deletions"": 0, ""lines"": 9}, ""src/version.c"": {""insertions"": 2, ""deletions"": 0, ""lines"": 2}}"
2020-11-02 19:04:22,dbfa795d8b66c99ee758b132d6043871b9061563,Bram Moolenaar,199,18,217,6,"{""runtime/doc/netbeans.txt"": {""insertions"": 4, ""deletions"": 3, ""lines"": 7}, ""src/mouse.c"": {""insertions"": 4, ""deletions"": 2, ""lines"": 6}, ""src/testdir/test_netbeans.py"": {""insertions"": 14, ""deletions"": 5, ""lines"": 19}, ""src/testdir/test_netbeans.vim"": {""insertions"": 171, ""deletions"": 8, ""lines"": 179}, ""src/testdir/test_quickfix.vim"": {""insertions"": 4, ""deletions"": 0, ""lines"": 4}, ""src/version.c"": {""insertions"": 2, ""deletions"": 0, ""lines"": 2}}"
2020-11-01 21:31:08,399db046ed7cc64b68ffa68b543c1b1c20baeee3,Bram Moolenaar,3,0,3,2,"{""src/testdir/test_ex_mode.vim"": {""insertions"": 1, ""deletions"": 0, ""lines"": 1}, ""src/version.c"": {""insertions"": 2, ""deletions"": 0, ""lines"": 2}}"
2020-11-01 21:15:44,97a19005e1a9cecc2c114affbecaf61177844fa4,Bram Moolenaar,7,3,10,2,"{""src/testdir/test_vim9_cmd.vim"": {""insertions"": 5, ""deletions"": 3, ""lines"": 8}, ""src/version.c"": {""insertions"": 2, ""deletions"": 0, ""lines"": 2}}"
2020-11-01 20:56:40,3b6d57f2ce87dc5a4b1a50e1b0fd2aeaf72faae2,Bram Moolenaar,28,0,28,3,"{""src/move.c"": {""insertions"": 1, ""deletions"": 0, ""lines"": 1}, ""src/testdir/test_ex_mode.vim"": {""insertions"": 25, ""deletions"": 0, ""lines"": 25}, ""src/version.c"": {""insertions"": 2, ""deletions"": 0, ""lines"": 2}}"
2020-11-01 19:58:26,a46765a79745ff27b4a44659fb8389519c961977,Bram Moolenaar,5,4,9,4,"{""src/testdir/term_util.vim"": {""insertions"": 2, ""deletions"": 2, ""lines"": 4}, ""src/testdir/test_terminal.vim"": {""insertions"": 1, ""deletions"": 1, ""lines"": 2}, ""src/testdir/test_terminal3.vim"": {""insertions"": 0, ""deletions"": 1, ""lines"": 1}, ""src/version.c"": {""insertions"": 2, ""deletions"": 0, ""lines"": 2}}"
2020-11-01 19:04:57,645cd3eb1fae784579fab11feea634bfaff9af49,Bram Moolenaar,12,1,13,3,"{""src/testdir/term_util.vim"": {""insertions"": 6, ""deletions"": 1, ""lines"": 7}, ""src/testdir/test_vim9_cmd.vim"": {""insertions"": 4, ""deletions"": 0, ""lines"": 4}, ""src/version.c"": {""insertions"": 2, ""deletions"": 0, ""lines"": 2}}"
2020-11-01 16:40:54,388908352f88e7391accb3545b082db0fc89d9f7,Bram Moolenaar,17,2,19,3,"{""src/session.c"": {""insertions"": 2, ""deletions"": 2, ""lines"": 4}, ""src/testdir/test_mksession.vim"": {""insertions"": 13, ""deletions"": 0, ""lines"": 13}, ""src/version.c"": {""insertions"": 2, ""deletions"": 0, ""lines"": 2}}"
2020-11-01 16:19:07,578f4cc7d0ce67101832b25cf77246fcd630e3c0,Bram Moolenaar,19,13,32,2,"{""src/testdir/test_sort.vim"": {""insertions"": 17, ""deletions"": 13, ""lines"": 30}, ""src/version.c"": {""insertions"": 2, ""deletions"": 0, ""lines"": 2}}"
2020-11-01 16:03:37,e88c8e802cf5ee59a2a6649a5b46c9e80de823ad,Bram Moolenaar,160,8,168,4,"{""src/ex_docmd.c"": {""insertions"": 16, ""deletions"": 3, ""lines"": 19}, ""src/testdir/test_vim9_cmd.vim"": {""insertions"": 131, ""deletions"": 1, ""lines"": 132}, ""src/version.c"": {""insertions"": 2, ""deletions"": 0, ""lines"": 2}, ""src/vim9compile.c"": {""insertions"": 11, ""deletions"": 4, ""lines"": 15}}"
2020-11-01 12:57:44,55e29611d20bca14fa5efc61385bc8a6b7acd9e2,Bram Moolenaar,112,12,124,6,"{""runtime/doc/change.txt"": {""insertions"": 10, ""deletions"": 3, ""lines"": 13}, ""runtime/doc/eval.txt"": {""insertions"": 7, ""deletions"": 0, ""lines"": 7}, ""src/ex_cmds.c"": {""insertions"": 13, ""deletions"": 6, ""lines"": 19}, ""src/list.c"": {""insertions"": 10, ""deletions"": 3, ""lines"": 13}, ""src/testdir/test_sort.vim"": {""insertions"": 70, ""deletions"": 0, ""lines"": 70}, ""src/version.c"": {""insertions"": 2, ""deletions"": 0, ""lines"": 2}}"
2020-11-01 12:33:49,963734e316bd17dd7290abcac28b875435d06381,Bram Moolenaar,35,14,49,2,"{""src/gui_at_fs.c"": {""insertions"": 33, ""deletions"": 14, ""lines"": 47}, ""src/version.c"": {""insertions"": 2, ""deletions"": 0, ""lines"": 2}}"
2020-10-31 18:33:38,fbcbffe1ad327f4f0da518abfd5fd7be7fec22b5,Bram Moolenaar,84,3,87,3,"{""src/evalfunc.c"": {""insertions"": 64, ""deletions"": 3, ""lines"": 67}, ""src/testdir/test_vim9_builtin.vim"": {""insertions"": 18, ""deletions"": 0, ""lines"": 18}, ""src/version.c"": {""insertions"": 2, ""deletions"": 0, ""lines"": 2}}"
2020-10-31 15:33:47,749bc9521d9c1b3b3250faef25a3710206cf277d,Bram Moolenaar,28,2,30,3,"{""src/term.c"": {""insertions"": 9, ""deletions"": 2, ""lines"": 11}, ""src/testdir/test_termcodes.vim"": {""insertions"": 17, ""deletions"": 0, ""lines"": 17}, ""src/version.c"": {""insertions"": 2, ""deletions"": 0, ""lines"": 2}}"
2020-10-31 12:05:11,0289065e41ce3148f929e16a55aa3b161c80576f,Bram Moolenaar,5,2,7,2,"{""src/if_perl.xs"": {""insertions"": 3, ""deletions"": 2, ""lines"": 5}, ""src/version.c"": {""insertions"": 2, ""deletions"": 0, ""lines"": 2}}"
2020-10-30 20:49:40,cd030c4b604bea92311e9c418aefe5143dee9201,Bram Moolenaar,23,1,24,3,"{""src/testdir/test_vim9_func.vim"": {""insertions"": 17, ""deletions"": 1, ""lines"": 18}, ""src/version.c"": {""insertions"": 2, ""deletions"": 0, ""lines"": 2}, ""src/vim9execute.c"": {""insertions"": 4, ""deletions"": 0, ""lines"": 4}}"
2020-10-30 19:46:26,d66960bf578410e83ef96ad2f4206b26a139d817,Bram Moolenaar,8,8,16,3,"{""src/version.c"": {""insertions"": 2, ""deletions"": 0, ""lines"": 2}, ""src/vim9compile.c"": {""insertions"": 3, ""deletions"": 5, ""lines"": 8}, ""src/vim9execute.c"": {""insertions"": 3, ""deletions"": 3, ""lines"": 6}}"
2020-10-30 18:25:09,b2620202c7778d8c709941fb430eeeeab6e63a6a,Bram Moolenaar,4,2,6,3,"{""src/spell.c"": {""insertions"": 1, ""deletions"": 1, ""lines"": 2}, ""src/testdir/gen_opt_test.vim"": {""insertions"": 1, ""deletions"": 1, ""lines"": 2}, ""src/version.c"": {""insertions"": 2, ""deletions"": 0, ""lines"": 2}}"
2020-10-30 18:06:18,6d967125ad87b1c2a9467357286c3514d5dd1c40,Bram Moolenaar,4,2,6,2,"{""src/testdir/test_listdict.vim"": {""insertions"": 2, ""deletions"": 2, ""lines"": 4}, ""src/version.c"": {""insertions"": 2, ""deletions"": 0, ""lines"": 2}}"
2020-10-30 17:33:02,086fc9a585afa4317046fa0a36c7b896286e5128,Bram Moolenaar,6,1,7,4,"{""src/globals.h"": {""insertions"": 1, ""deletions"": 1, ""lines"": 2}, ""src/testdir/test_vim9_expr.vim"": {""insertions"": 1, ""deletions"": 0, ""lines"": 1}, ""src/version.c"": {""insertions"": 2, ""deletions"": 0, ""lines"": 2}, ""src/vim9execute.c"": {""insertions"": 2, ""deletions"": 0, ""lines"": 2}}"
2020-10-29 19:24:34,4f6b6ed208a15552f0eb7f27b7ca945f59f22c1d,Bram Moolenaar,15,1,16,3,"{""src/ex_docmd.c"": {""insertions"": 1, ""deletions"": 1, ""lines"": 2}, ""src/testdir/test_vim9_cmd.vim"": {""insertions"": 12, ""deletions"": 0, ""lines"": 12}, ""src/version.c"": {""insertions"": 2, ""deletions"": 0, ""lines"": 2}}"
2020-10-29 19:08:21,185577e47e5004a5d08a5405a02ab6a261078e42,Bram Moolenaar,51,10,61,2,"{""src/gui_w32.c"": {""insertions"": 49, ""deletions"": 10, ""lines"": 59}, ""src/version.c"": {""insertions"": 2, ""deletions"": 0, ""lines"": 2}}"
2020-10-29 17:58:01,dcdd42a8ccb9bafd857735d694b074269f337333,Bram Moolenaar,13,7,20,3,"{""src/search.c"": {""insertions"": 9, ""deletions"": 7, ""lines"": 16}, ""src/testdir/test_matchfuzzy.vim"": {""insertions"": 2, ""deletions"": 0, ""lines"": 2}, ""src/version.c"": {""insertions"": 2, ""deletions"": 0, ""lines"": 2}}"
2020-10-28 21:46:42,cf4d454df0619ee41ef40e7e91fce3fb061d7d5b,Bram Moolenaar,3,1,4,3,"{""src/testdir/Make_all.mak"": {""insertions"": 1, ""deletions"": 0, ""lines"": 1}, ""src/testdir/test_alot_utf8.vim"": {""insertions"": 0, ""deletions"": 1, ""lines"": 1}, ""src/version.c"": {""insertions"": 2, ""deletions"": 0, ""lines"": 2}}"
2020-10-28 19:20:00,28ee892ac4197421b3317f195512ca64cc56a5b4,Bram Moolenaar,44,36,80,19,"{""src/buffer.c"": {""insertions"": 1, ""deletions"": 1, ""lines"": 2}, ""src/change.c"": {""insertions"": 1, ""deletions"": 1, ""lines"": 2}, ""src/fileio.c"": {""insertions"": 1, ""deletions"": 1, ""lines"": 2}, ""src/globals.h"": {""insertions"": 2, ""deletions"": 1, ""lines"": 3}, ""src/insexpand.c"": {""insertions"": 1, ""deletions"": 1, ""lines"": 2}, ""src/message.c"": {""insertions"": 1, ""deletions"": 1, ""lines"": 2}, ""src/misc1.c"": {""insertions"": 2, ""deletions"": 1, ""lines"": 3}, ""src/normal.c"": {""insertions"": 1, ""deletions"": 0, ""lines"": 1}, ""src/screen.c"": {""insertions"": 2, ""deletions"": 1, ""lines"": 3}, ""src/term.c"": {""insertions"": 1, ""deletions"": 1, ""lines"": 2}, ""src/testdir/gen_opt_test.vim"": {""insertions"": 2, ""deletions"": 2, ""lines"": 4}, ""src/testdir/test_autocmd.vim"": {""insertions"": 2, ""deletions"": 2, ""lines"": 4}, ""src/testdir/test_mapping.vim"": {""insertions"": 1, ""deletions"": 1, ""lines"": 2}, ""src/testdir/test_popup.vim"": {""insertions"": 1, ""deletions"": 1, ""lines"": 2}, ""src/testdir/test_terminal.vim"": {""insertions"": 3, ""deletions"": 3, ""lines"": 6}, ""src/testdir/test_vim9_func.vim"": {""insertions"": 11, ""deletions"": 12, ""lines"": 23}, ""src/testing.c"": {""insertions"": 7, ""deletions"": 4, ""lines"": 11}, ""src/version.c"": {""insertions"": 2, ""deletions"": 0, ""lines"": 2}, ""src/vim9execute.c"": {""insertions"": 2, ""deletions"": 2, ""lines"": 4}}"
2020-10-28 16:55:31,3e2534ed1a6557445747e6c1439ad26ec8eabfc4,Bram Moolenaar,5,3,8,3,"{""src/errors.h"": {""insertions"": 2, ""deletions"": 2, ""lines"": 4}, ""src/version.c"": {""insertions"": 2, ""deletions"": 0, ""lines"": 2}, ""src/vim9script.c"": {""insertions"": 1, ""deletions"": 1, ""lines"": 2}}"
2020-10-28 16:21:26,159563b439d1b2a61d1003430b6c9f2a8509b5c5,Bram Moolenaar,16,0,16,2,"{""src/testdir/test_man.vim"": {""insertions"": 14, ""deletions"": 0, ""lines"": 14}, ""src/version.c"": {""insertions"": 2, ""deletions"": 0, ""lines"": 2}}"
2020-10-28 15:54:47,171fb923b8f8da9fb0db1c8c86e35cf4e1339000,Bram Moolenaar,36,3,39,3,"{""src/testdir/test_vim9_func.vim"": {""insertions"": 29, ""deletions"": 0, ""lines"": 29}, ""src/version.c"": {""insertions"": 2, ""deletions"": 0, ""lines"": 2}, ""src/vim9execute.c"": {""insertions"": 5, ""deletions"": 3, ""lines"": 8}}"
2020-10-28 13:31:16,6cf7e3b026727818cd137e2b317b1f6d7c072703,Bram Moolenaar,7,3,10,3,"{""src/testdir/test_vim9_func.vim"": {""insertions"": 3, ""deletions"": 1, ""lines"": 4}, ""src/version.c"": {""insertions"": 2, ""deletions"": 0, ""lines"": 2}, ""src/vim9compile.c"": {""insertions"": 2, ""deletions"": 2, ""lines"": 4}}"
2020-10-28 12:53:50,b4bcea474d9006e4db1fa5d6828773e739af14bb,Bram Moolenaar,46,11,57,8,"{""src/eval.c"": {""insertions"": 15, ""deletions"": 4, ""lines"": 19}, ""src/ex_docmd.c"": {""insertions"": 6, ""deletions"": 1, ""lines"": 7}, ""src/misc2.c"": {""insertions"": 1, ""deletions"": 1, ""lines"": 2}, ""src/proto/eval.pro"": {""insertions"": 1, ""deletions"": 0, ""lines"": 1}, ""src/proto/register.pro"": {""insertions"": 1, ""deletions"": 1, ""lines"": 2}, ""src/register.c"": {""insertions"": 8, ""deletions"": 4, ""lines"": 12}, ""src/testdir/test_vim9_script.vim"": {""insertions"": 12, ""deletions"": 0, ""lines"": 12}, ""src/version.c"": {""insertions"": 2, ""deletions"": 0, ""lines"": 2}}"
2020-10-27 19:43:26,70cf45810cb9be5bd17074f7fb4ee238f2c4d57b,Bram Moolenaar,6,3,9,2,"{""src/gui_gtk_x11.c"": {""insertions"": 4, ""deletions"": 3, ""lines"": 7}, ""src/version.c"": {""insertions"": 2, ""deletions"": 0, ""lines"": 2}}"
2020-10-27 18:59:10,68a48ee55e55c189b03a6718a0d06af1dfedcd16,Bram Moolenaar,15,1,16,2,"{""src/testdir/test_python3.vim"": {""insertions"": 13, ""deletions"": 1, ""lines"": 14}, ""src/version.c"": {""insertions"": 2, ""deletions"": 0, ""lines"": 2}}"
2020-10-27 08:12:45,977fd0b327ed46a71c80d2cd62cbe149d43b9a69,Bram Moolenaar,4,1,5,2,"{""src/insexpand.c"": {""insertions"": 2, ""deletions"": 1, ""lines"": 3}, ""src/version.c"": {""insertions"": 2, ""deletions"": 0, ""lines"": 2}}"
2020-10-26 20:39:13,caf73dcfade0a435ea3f989285b43f07c40c9948,Bram Moolenaar,12,2,14,3,"{""src/ex_docmd.c"": {""insertions"": 3, ""deletions"": 2, ""lines"": 5}, ""src/testdir/test_edit.vim"": {""insertions"": 7, ""deletions"": 0, ""lines"": 7}, ""src/version.c"": {""insertions"": 2, ""deletions"": 0, ""lines"": 2}}"
2020-10-26 20:12:46,cb80aa2d53e56d3aba3b3c439fb467f29a750c5e,Bram Moolenaar,169,248,417,83,"{""runtime/autoload/zip.vim"": {""insertions"": 3, ""deletions"": 3, ""lines"": 6}, ""runtime/doc/autocmd.txt"": {""insertions"": 3, ""deletions"": 3, ""lines"": 6}, ""runtime/doc/channel.txt"": {""insertions"": 6, ""deletions"": 2, ""lines"": 8}, ""runtime/doc/editing.txt"": {""insertions"": 7, ""deletions"": 3, ""lines"": 10}, ""runtime/doc/eval.txt"": {""insertions"": 13, ""deletions"": 11, ""lines"": 24}, ""runtime/doc/if_mzsch.txt"": {""insertions"": 2, ""deletions"": 2, ""lines"": 4}, ""runtime/doc/insert.txt"": {""insertions"": 2, ""deletions"": 1, ""lines"": 3}, ""runtime/doc/motion.txt"": {""insertions"": 6, ""deletions"": 3, ""lines"": 9}, ""runtime/doc/pi_zip.txt"": {""insertions"": 1, ""deletions"": 1, ""lines"": 2}, ""runtime/doc/popup.txt"": {""insertions"": 2, ""deletions"": 1, ""lines"": 3}, ""runtime/doc/tabpage.txt"": {""insertions"": 4, ""deletions"": 4, ""lines"": 8}, ""runtime/doc/tags"": {""insertions"": 1, ""deletions"": 1, ""lines"": 2}, ""runtime/doc/textprop.txt"": {""insertions"": 3, ""deletions"": 3, ""lines"": 6}, ""runtime/doc/todo.txt"": {""insertions"": 9, ""deletions"": 34, ""lines"": 43}, ""runtime/doc/undo.txt"": {""insertions"": 2, ""deletions"": 2, ""lines"": 4}, ""runtime/doc/usr_11.txt"": {""insertions"": 2, ""deletions"": 2, ""lines"": 4}, ""runtime/doc/version7.txt"": {""insertions"": 2, ""deletions"": 2, ""lines"": 4}, ""runtime/doc/version8.txt"": {""insertions"": 2, ""deletions"": 2, ""lines"": 4}, ""runtime/doc/vim9.txt"": {""insertions"": 7, ""deletions"": 7, ""lines"": 14}, ""runtime/filetype.vim"": {""insertions"": 5, ""deletions"": 4, ""lines"": 9}, ""runtime/ftplugin/erlang.vim"": {""insertions"": 2, ""deletions"": 2, ""lines"": 4}, ""runtime/ftplugin/make.vim"": {""insertions"": 3, ""deletions"": 3, ""lines"": 6}, ""runtime/ftplugin/man.vim"": {""insertions"": 17, ""deletions"": 14, ""lines"": 31}, ""runtime/ftplugin/rpl.vim"": {""insertions"": 1, ""deletions"": 1, ""lines"": 2}, ""runtime/indent/rpl.vim"": {""insertions"": 1, ""deletions"": 1, ""lines"": 2}, ""runtime/indent/tilde.vim"": {""insertions"": 1, ""deletions"": 1, ""lines"": 2}, ""runtime/optwin.vim"": {""insertions"": 16, ""deletions"": 33, ""lines"": 49}, ""runtime/pack/dist/opt/termdebug/plugin/termdebug.vim"": {""insertions"": 23, ""deletions"": 3, ""lines"": 26}, ""runtime/plugin/zipPlugin.vim"": {""insertions"": 2, ""deletions"": 2, ""lines"": 4}, ""runtime/syntax/elf.vim"": {""insertions"": 1, ""deletions"": 1, ""lines"": 2}, ""runtime/syntax/forth.vim"": {""insertions"": 1, ""deletions"": 1, ""lines"": 2}, ""runtime/syntax/fortran.vim"": {""insertions"": 3, ""deletions"": 3, ""lines"": 6}, ""runtime/syntax/groff.vim"": {""insertions"": 1, ""deletions"": 1, ""lines"": 2}, ""runtime/syntax/initng.vim"": {""insertions"": 1, ""deletions"": 1, ""lines"": 2}, ""runtime/syntax/iss.vim"": {""insertions"": 1, ""deletions"": 1, ""lines"": 2}, ""runtime/syntax/lout.vim"": {""insertions"": 1, ""deletions"": 1, ""lines"": 2}, ""runtime/syntax/mmix.vim"": {""insertions"": 1, ""deletions"": 1, ""lines"": 2}, ""runtime/syntax/moo.vim"": {""insertions"": 2, ""deletions"": 2, ""lines"": 4}, ""runtime/syntax/nroff.vim"": {""insertions"": 2, ""deletions"": 2, ""lines"": 4}, ""runtime/syntax/pascal.vim"": {""insertions"": 1, ""deletions"": 1, ""lines"": 2}, ""runtime/syntax/robots.vim"": {""insertions"": 1, ""deletions"": 1, ""lines"": 2}, ""runtime/syntax/rpl.vim"": {""insertions"": 1, ""deletions"": 1, ""lines"": 2}, ""runtime/syntax/rtf.vim"": {""insertions"": 1, ""deletions"": 1, ""lines"": 2}, ""runtime/syntax/tilde.vim"": {""insertions"": 1, ""deletions"": 1, ""lines"": 2}, ""runtime/syntax/xkb.vim"": {""insertions"": 2, ""deletions"": 2, ""lines"": 4}, ""src/po/af.po"": {""insertions"": 0, ""deletions"": 2, ""lines"": 2}, ""src/po/ca.po"": {""insertions"": 0, ""deletions"": 2, ""lines"": 2}, ""src/po/da.po"": {""insertions"": 0, ""deletions"": 2, ""lines"": 2}, ""src/po/de.po"": {""insertions"": 0, ""deletions"": 2, ""lines"": 2}, ""src/po/en_GB.po"": {""insertions"": 0, ""deletions"": 2, ""lines"": 2}, ""src/po/eo.po"": {""insertions"": 0, ""deletions"": 2, ""lines"": 2}, ""src/po/es.po"": {""insertions"": 0, ""deletions"": 2, ""lines"": 2}, ""src/po/fi.po"": {""insertions"": 0, ""deletions"": 2, ""lines"": 2}, ""src/po/fr.po"": {""insertions"": 0, ""deletions"": 2, ""lines"": 2}, ""src/po/ga.po"": {""insertions"": 0, ""deletions"": 2, ""lines"": 2}, ""src/po/it.po"": {""insertions"": 0, ""deletions"": 2, ""lines"": 2}, ""src/po/ja.euc-jp.po"": {""insertions"": 0, ""deletions"": 2, ""lines"": 2}, ""src/po/ja.po"": {""insertions"": 0, ""deletions"": 2, ""lines"": 2}, ""src/po/ja.sjis.po"": {""insertions"": 0, ""deletions"": 2, ""lines"": 2}, ""src/po/ko.UTF-8.po"": {""insertions"": 0, ""deletions"": 2, ""lines"": 2}, ""src/po/ko.po"": {""insertions"": 0, ""deletions"": 2, ""lines"": 2}, ""src/po/nb.po"": {""insertions"": 0, ""deletions"": 2, ""lines"": 2}, ""src/po/nl.po"": {""insertions"": 0, ""deletions"": 2, ""lines"": 2}, ""src/po/no.po"": {""insertions"": 0, ""deletions"": 2, ""lines"": 2}, ""src/po/pl.UTF-8.po"": {""insertions"": 0, ""deletions"": 2, ""lines"": 2}, ""src/po/pl.cp1250.po"": {""insertions"": 0, ""deletions"": 2, ""lines"": 2}, ""src/po/pl.po"": {""insertions"": 0, ""deletions"": 2, ""lines"": 2}, ""src/po/pt_BR.po"": {""insertions"": 0, ""deletions"": 2, ""lines"": 2}, ""src/po/ru.cp1251.po"": {""insertions"": 0, ""deletions"": 2, ""lines"": 2}, ""src/po/ru.po"": {""insertions"": 0, ""deletions"": 2, ""lines"": 2}, ""src/po/sk.cp1250.po"": {""insertions"": 0, ""deletions"": 2, ""lines"": 2}, ""src/po/sk.po"": {""insertions"": 0, ""deletions"": 2, ""lines"": 2}, ""src/po/sr.po"": {""insertions"": 0, ""deletions"": 2, ""lines"": 2}, ""src/po/sv.po"": {""insertions"": 0, ""deletions"": 2, ""lines"": 2}, ""src/po/tr.po"": {""insertions"": 0, ""deletions"": 2, ""lines"": 2}, ""src/po/uk.cp1251.po"": {""insertions"": 0, ""deletions"": 2, ""lines"": 2}, ""src/po/uk.po"": {""insertions"": 0, ""deletions"": 2, ""lines"": 2}, ""src/po/vi.po"": {""insertions"": 0, ""deletions"": 2, ""lines"": 2}, ""src/po/zh_CN.UTF-8.po"": {""insertions"": 0, ""deletions"": 2, ""lines"": 2}, ""src/po/zh_CN.cp936.po"": {""insertions"": 0, ""deletions"": 2, ""lines"": 2}, ""src/po/zh_CN.po"": {""insertions"": 0, ""deletions"": 2, ""lines"": 2}, ""src/po/zh_TW.UTF-8.po"": {""insertions"": 0, ""deletions"": 2, ""lines"": 2}, ""src/po/zh_TW.po"": {""insertions"": 0, ""deletions"": 2, ""lines"": 2}}"
2020-10-26 20:05:27,8133cc6bf454eb90bb0868f7cf806fce5c0c9fe6,Bram Moolenaar,164,117,281,10,"{""runtime/doc/options.txt"": {""insertions"": 1, ""deletions"": 1, ""lines"": 2}, ""src/buffer.c"": {""insertions"": 138, ""deletions"": 102, ""lines"": 240}, ""src/optionstr.c"": {""insertions"": 1, ""deletions"": 6, ""lines"": 7}, ""src/proto/buffer.pro"": {""insertions"": 1, ""deletions"": 1, ""lines"": 2}, ""src/screen.c"": {""insertions"": 3, ""deletions"": 3, ""lines"": 6}, ""src/structs.h"": {""insertions"": 3, ""deletions"": 2, ""lines"": 5}, ""src/testdir/test_options.vim"": {""insertions"": 0, ""deletions"": 1, ""lines"": 1}, ""src/testdir/test_statusline.vim"": {""insertions"": 15, ""deletions"": 0, ""lines"": 15}, ""src/version.c"": {""insertions"": 2, ""deletions"": 0, ""lines"": 2}, ""src/vim.h"": {""insertions"": 0, ""deletions"": 1, ""lines"": 1}}"
2020-10-26 19:18:08,c8970b94645d0730f4a7cc42388ff32665398e8b,Bram Moolenaar,20,9,29,3,"{""src/if_lua.c"": {""insertions"": 10, ""deletions"": 9, ""lines"": 19}, ""src/testdir/test_lua.vim"": {""insertions"": 8, ""deletions"": 0, ""lines"": 8}, ""src/version.c"": {""insertions"": 2, ""deletions"": 0, ""lines"": 2}}"
2020-10-26 18:22:42,f9d51354de069dddc049b9e109b1932c92e5aee6,Bram Moolenaar,61,51,112,3,"{""src/insexpand.c"": {""insertions"": 58, ""deletions"": 50, ""lines"": 108}, ""src/testdir/test_ins_complete.vim"": {""insertions"": 1, ""deletions"": 1, ""lines"": 2}, ""src/version.c"": {""insertions"": 2, ""deletions"": 0, ""lines"": 2}}"
2020-10-26 17:46:53,a360dbe3b63bdca93bbf8cc431578a446e8ce14c,Bram Moolenaar,6,4,10,4,"{""src/proto/usercmd.pro"": {""insertions"": 1, ""deletions"": 1, ""lines"": 2}, ""src/usercmd.c"": {""insertions"": 2, ""deletions"": 2, ""lines"": 4}, ""src/version.c"": {""insertions"": 2, ""deletions"": 0, ""lines"": 2}, ""src/vim9execute.c"": {""insertions"": 1, ""deletions"": 1, ""lines"": 2}}"
2020-10-25 16:55:09,4882d983397057ea91c584c5a54aaccf15016d18,Bram Moolenaar,39,8,47,4,"{""src/buffer.c"": {""insertions"": 17, ""deletions"": 8, ""lines"": 25}, ""src/proto/buffer.pro"": {""insertions"": 1, ""deletions"": 0, ""lines"": 1}, ""src/version.c"": {""insertions"": 2, ""deletions"": 0, ""lines"": 2}, ""src/window.c"": {""insertions"": 19, ""deletions"": 0, ""lines"": 19}}"
2020-10-25 16:09:50,89b693e5627715cde080c3580c7b641c9bf0c06a,Bram Moolenaar,25,9,34,5,"{""src/buffer.c"": {""insertions"": 17, ""deletions"": 7, ""lines"": 24}, ""src/ex_cmds.c"": {""insertions"": 4, ""deletions"": 1, ""lines"": 5}, ""src/testdir/test_buffer.vim"": {""insertions"": 1, ""deletions"": 1, ""lines"": 2}, ""src/version.c"": {""insertions"": 2, ""deletions"": 0, ""lines"": 2}, ""src/vim.h"": {""insertions"": 1, ""deletions"": 0, ""lines"": 1}}"
2020-10-25 15:18:26,37e4e03c67dacfc4a065e95492ffc4c7f490b44b,Bram Moolenaar,4,2,6,2,"{""src/testdir/test_buffer.vim"": {""insertions"": 2, ""deletions"": 2, ""lines"": 4}, ""src/version.c"": {""insertions"": 2, ""deletions"": 0, ""lines"": 2}}"
2020-10-25 14:02:51,e974fa7b2b98e53a59d5ef16a6a1291f12a32e33,Bram Moolenaar,17,1,18,3,"{""src/ex_cmds.c"": {""insertions"": 3, ""deletions"": 1, ""lines"": 4}, ""src/testdir/test_buffer.vim"": {""insertions"": 12, ""deletions"": 0, ""lines"": 12}, ""src/version.c"": {""insertions"": 2, ""deletions"": 0, ""lines"": 2}}"
2020-10-25 12:22:42,4ff2f2fb6bef01a06bd726bae8dfa8dd6355d594,Bram Moolenaar,41,2,43,3,"{""src/evalvars.c"": {""insertions"": 14, ""deletions"": 2, ""lines"": 16}, ""src/testdir/test_ins_complete.vim"": {""insertions"": 25, ""deletions"": 0, ""lines"": 25}, ""src/version.c"": {""insertions"": 2, ""deletions"": 0, ""lines"": 2}}"
2020-10-24 21:08:38,02194d2bd54eacd0b7b9a017a3fe1702ecb80971,Bram Moolenaar,161,113,274,8,"{""src/proto/usercmd.pro"": {""insertions"": 2, ""deletions"": 1, ""lines"": 3}, ""src/scriptfile.c"": {""insertions"": 1, ""deletions"": 1, ""lines"": 2}, ""src/testdir/test_vim9_disassemble.vim"": {""insertions"": 4, ""deletions"": 4, ""lines"": 8}, ""src/usercmd.c"": {""insertions"": 76, ""deletions"": 64, ""lines"": 140}, ""src/version.c"": {""insertions"": 2, ""deletions"": 0, ""lines"": 2}, ""src/vim9.h"": {""insertions"": 8, ""deletions"": 2, ""lines"": 10}, ""src/vim9compile.c"": {""insertions"": 31, ""deletions"": 17, ""lines"": 48}, ""src/vim9execute.c"": {""insertions"": 37, ""deletions"": 24, ""lines"": 61}}"
2020-10-24 18:58:06,67def64a4e4590a5f3b55ebfc33c42a3dcd7b559,Bram Moolenaar,5,0,5,2,"{""src/ex_cmds.c"": {""insertions"": 3, ""deletions"": 0, ""lines"": 3}, ""src/version.c"": {""insertions"": 2, ""deletions"": 0, ""lines"": 2}}"
2020-10-24 18:49:43,e10044015841711b989f9a898d427bcc1fdb4c32,Bram Moolenaar,284,271,555,38,"{""src/arglist.c"": {""insertions"": 3, ""deletions"": 3, ""lines"": 6}, ""src/buffer.c"": {""insertions"": 8, ""deletions"": 8, ""lines"": 16}, ""src/bufwrite.c"": {""insertions"": 2, ""deletions"": 2, ""lines"": 4}, ""src/change.c"": {""insertions"": 1, ""deletions"": 1, ""lines"": 2}, ""src/cmdhist.c"": {""insertions"": 1, ""deletions"": 1, ""lines"": 2}, ""src/diff.c"": {""insertions"": 10, ""deletions"": 10, ""lines"": 20}, ""src/edit.c"": {""insertions"": 1, ""deletions"": 1, ""lines"": 2}, ""src/ex_cmds.c"": {""insertions"": 29, ""deletions"": 26, ""lines"": 55}, ""src/ex_cmds2.c"": {""insertions"": 4, ""deletions"": 4, ""lines"": 8}, ""src/ex_docmd.c"": {""insertions"": 87, ""deletions"": 82, ""lines"": 169}, ""src/ex_getln.c"": {""insertions"": 5, ""deletions"": 5, ""lines"": 10}, ""src/fileio.c"": {""insertions"": 1, ""deletions"": 1, ""lines"": 2}, ""src/filepath.c"": {""insertions"": 3, ""deletions"": 3, ""lines"": 6}, ""src/gui.c"": {""insertions"": 2, ""deletions"": 2, ""lines"": 4}, ""src/gui_gtk_x11.c"": {""insertions"": 2, ""deletions"": 2, ""lines"": 4}, ""src/help.c"": {""insertions"": 6, ""deletions"": 5, ""lines"": 11}, ""src/if_cscope.c"": {""insertions"": 2, ""deletions"": 2, ""lines"": 4}, ""src/indent.c"": {""insertions"": 1, ""deletions"": 1, ""lines"": 2}, ""src/mark.c"": {""insertions"": 6, ""deletions"": 5, ""lines"": 11}, ""src/memline.c"": {""insertions"": 4, ""deletions"": 3, ""lines"": 7}, ""src/message.c"": {""insertions"": 3, ""deletions"": 3, ""lines"": 6}, ""src/ops.c"": {""insertions"": 9, ""deletions"": 9, ""lines"": 18}, ""src/option.c"": {""insertions"": 2, ""deletions"": 2, ""lines"": 4}, ""src/os_unix.c"": {""insertions"": 4, ""deletions"": 4, ""lines"": 8}, ""src/proto/ex_docmd.pro"": {""insertions"": 2, ""deletions"": 2, ""lines"": 4}, ""src/quickfix.c"": {""insertions"": 10, ""deletions"": 9, ""lines"": 19}, ""src/register.c"": {""insertions"": 2, ""deletions"": 2, ""lines"": 4}, ""src/scriptfile.c"": {""insertions"": 1, ""deletions"": 1, ""lines"": 2}, ""src/search.c"": {""insertions"": 3, ""deletions"": 2, ""lines"": 5}, ""src/session.c"": {""insertions"": 1, ""deletions"": 1, ""lines"": 2}, ""src/structs.h"": {""insertions"": 21, ""deletions"": 24, ""lines"": 45}, ""src/tag.c"": {""insertions"": 1, ""deletions"": 1, ""lines"": 2}, ""src/terminal.c"": {""insertions"": 4, ""deletions"": 3, ""lines"": 7}, ""src/textformat.c"": {""insertions"": 2, ""deletions"": 2, ""lines"": 4}, ""src/usercmd.c"": {""insertions"": 22, ""deletions"": 22, ""lines"": 44}, ""src/version.c"": {""insertions"": 2, ""deletions"": 0, ""lines"": 2}, ""src/vim9compile.c"": {""insertions"": 10, ""deletions"": 12, ""lines"": 22}, ""src/window.c"": {""insertions"": 7, ""deletions"": 5, ""lines"": 12}}"
2020-10-24 15:19:16,5661ed6c833e05467cab33cb9b1c535e7e5cc570,Bram Moolenaar,115,82,197,6,"{""src/ex_cmds.h"": {""insertions"": 0, ""deletions"": 6, ""lines"": 6}, ""src/ex_docmd.c"": {""insertions"": 87, ""deletions"": 68, ""lines"": 155}, ""src/proto/ex_docmd.pro"": {""insertions"": 2, ""deletions"": 1, ""lines"": 3}, ""src/structs.h"": {""insertions"": 20, ""deletions"": 3, ""lines"": 23}, ""src/version.c"": {""insertions"": 2, ""deletions"": 0, ""lines"": 2}, ""src/vim9compile.c"": {""insertions"": 4, ""deletions"": 4, ""lines"": 8}}"
2020-10-24 11:30:51,e1be11864d1f4383171e3af3eb77e61d41140c4e,Bram Moolenaar,7,2,9,2,"{""src/os_unix.c"": {""insertions"": 5, ""deletions"": 2, ""lines"": 7}, ""src/version.c"": {""insertions"": 2, ""deletions"": 0, ""lines"": 2}}"
2020-10-23 16:51:06,210681c5090266af1a41a77e0fe64838a69993fb,Bram Moolenaar,5,0,5,2,"{""src/ex_docmd.c"": {""insertions"": 3, ""deletions"": 0, ""lines"": 3}, ""src/version.c"": {""insertions"": 2, ""deletions"": 0, ""lines"": 2}}"
2020-10-23 16:02:32,f4c6e1e75c2a7f2ca3a7f4529e7da31dc98557e9,Bram Moolenaar,120,3,123,8,"{""src/evalvars.c"": {""insertions"": 4, ""deletions"": 2, ""lines"": 6}, ""src/structs.h"": {""insertions"": 2, ""deletions"": 0, ""lines"": 2}, ""src/testdir/test_vim9_cmd.vim"": {""insertions"": 12, ""deletions"": 0, ""lines"": 12}, ""src/testdir/test_vim9_disassemble.vim"": {""insertions"": 24, ""deletions"": 0, ""lines"": 24}, ""src/version.c"": {""insertions"": 2, ""deletions"": 0, ""lines"": 2}, ""src/vim9.h"": {""insertions"": 3, ""deletions"": 0, ""lines"": 3}, ""src/vim9compile.c"": {""insertions"": 43, ""deletions"": 1, ""lines"": 44}, ""src/vim9execute.c"": {""insertions"": 30, ""deletions"": 0, ""lines"": 30}}"
2020-10-23 14:50:30,8ded5b647aa4b3338da721b343e0bce0f86655f6,Bram Moolenaar,195,59,254,4,"{""runtime/doc/eval.txt"": {""insertions"": 17, ""deletions"": 2, ""lines"": 19}, ""src/search.c"": {""insertions"": 130, ""deletions"": 41, ""lines"": 171}, ""src/testdir/test_matchfuzzy.vim"": {""insertions"": 46, ""deletions"": 16, ""lines"": 62}, ""src/version.c"": {""insertions"": 2, ""deletions"": 0, ""lines"": 2}}"
2020-10-23 13:40:39,9c24cd11e2048e16e25271a7a7dbef4593890a18,Bram Moolenaar,4,1,5,2,"{""src/terminal.c"": {""insertions"": 2, ""deletions"": 1, ""lines"": 3}, ""src/version.c"": {""insertions"": 2, ""deletions"": 0, ""lines"": 2}}"
2020-10-22 19:22:58,683581eb4980eda27d6438caab85c0a9cf551c24,Bram Moolenaar,22,10,32,7,"{""src/eval.c"": {""insertions"": 2, ""deletions"": 2, ""lines"": 4}, ""src/ex_docmd.c"": {""insertions"": 4, ""deletions"": 5, ""lines"": 9}, ""src/misc1.c"": {""insertions"": 1, ""deletions"": 1, ""lines"": 2}, ""src/proto/eval.pro"": {""insertions"": 1, ""deletions"": 1, ""lines"": 2}, ""src/testdir/test_vim9_cmd.vim"": {""insertions"": 7, ""deletions"": 0, ""lines"": 7}, ""src/version.c"": {""insertions"": 2, ""deletions"": 0, ""lines"": 2}, ""src/vim9compile.c"": {""insertions"": 5, ""deletions"": 1, ""lines"": 6}}"
2020-10-22 18:09:43,081db1a66d17e46ac3b03b7514f11a004a35009a,Bram Moolenaar,27,3,30,3,"{""src/eval.c"": {""insertions"": 12, ""deletions"": 2, ""lines"": 14}, ""src/testdir/test_vim9_expr.vim"": {""insertions"": 13, ""deletions"": 1, ""lines"": 14}, ""src/version.c"": {""insertions"": 2, ""deletions"": 0, ""lines"": 2}}"
2020-10-22 17:00:01,b07a39de485db5709a6b3e2f96e66ab06dd76279,Bram Moolenaar,9,1,10,3,"{""src/dict.c"": {""insertions"": 1, ""deletions"": 1, ""lines"": 2}, ""src/testdir/test_vim9_expr.vim"": {""insertions"": 6, ""deletions"": 0, ""lines"": 6}, ""src/version.c"": {""insertions"": 2, ""deletions"": 0, ""lines"": 2}}"
2020-10-22 16:23:38,e6e70a10f118ecfa9df2425e8724bc009bd09929,Bram Moolenaar,14,8,22,3,"{""src/evalbuffer.c"": {""insertions"": 10, ""deletions"": 8, ""lines"": 18}, ""src/testdir/test_vim9_builtin.vim"": {""insertions"": 2, ""deletions"": 0, ""lines"": 2}, ""src/version.c"": {""insertions"": 2, ""deletions"": 0, ""lines"": 2}}"
2020-10-22 15:33:17,15ab48f088842de512ca5f13aa39a4dc7cac8477,Bram Moolenaar,4,1,5,2,"{"".github/workflows/ci-windows.yaml"": {""insertions"": 2, ""deletions"": 1, ""lines"": 3}, ""src/version.c"": {""insertions"": 2, ""deletions"": 0, ""lines"": 2}}"
2020-10-22 11:44:54,371806e1642bbe17792f1e0fc7abe2ae13794635,Bram Moolenaar,7,4,11,3,"{""src/popupwin.c"": {""insertions"": 4, ""deletions"": 4, ""lines"": 8}, ""src/testdir/test_popupwin.vim"": {""insertions"": 1, ""deletions"": 0, ""lines"": 1}, ""src/version.c"": {""insertions"": 2, ""deletions"": 0, ""lines"": 2}}"
2020-10-22 10:33:32,2733779a1a36c06f5f900666ac94bfe4c25ea39b,Bram Moolenaar,4,0,4,2,"{""src/testdir/test_filetype.vim"": {""insertions"": 2, ""deletions"": 0, ""lines"": 2}, ""src/version.c"": {""insertions"": 2, ""deletions"": 0, ""lines"": 2}}"
2020-10-22 10:31:49,a1224cb706f4aefbf85a524cdcfa804570022136,Bram Moolenaar,9,1,10,3,"{""src/evalfunc.c"": {""insertions"": 6, ""deletions"": 0, ""lines"": 6}, ""src/version.c"": {""insertions"": 2, ""deletions"": 0, ""lines"": 2}, ""src/vim9compile.c"": {""insertions"": 1, ""deletions"": 1, ""lines"": 2}}"
2020-10-21 19:01:59,4ce5fe4c87820c7d22964d6e91d7b07e96640e6f,Bram Moolenaar,55,50,105,4,"{""src/if_py_both.h"": {""insertions"": 39, ""deletions"": 36, ""lines"": 75}, ""src/if_python.c"": {""insertions"": 8, ""deletions"": 8, ""lines"": 16}, ""src/if_python3.c"": {""insertions"": 6, ""deletions"": 6, ""lines"": 12}, ""src/version.c"": {""insertions"": 2, ""deletions"": 0, ""lines"": 2}}"
2020-10-21 18:58:52,c58f5456e5c5f21193e960cecc434e367ef1281e,Bram Moolenaar,6,14,20,4,"{""src/evalvars.c"": {""insertions"": 1, ""deletions"": 6, ""lines"": 7}, ""src/version.c"": {""insertions"": 2, ""deletions"": 0, ""lines"": 2}, ""src/vim.h"": {""insertions"": 1, ""deletions"": 2, ""lines"": 3}, ""src/vim9compile.c"": {""insertions"": 2, ""deletions"": 6, ""lines"": 8}}"
2020-10-21 15:28:27,692d1a51e74fea2db3c7e9ae7c7c6c3a1a1945ee,Bram Moolenaar,21,10,31,2,"{""src/gui_gtk_f.c"": {""insertions"": 19, ""deletions"": 10, ""lines"": 29}, ""src/version.c"": {""insertions"": 2, ""deletions"": 0, ""lines"": 2}}"
2020-10-21 14:49:17,af7a9066a956db23a8bc67bc1f82466e3eff55ea,Bram Moolenaar,8,4,12,2,"{""src/version.c"": {""insertions"": 2, ""deletions"": 0, ""lines"": 2}, ""src/vim9compile.c"": {""insertions"": 6, ""deletions"": 4, ""lines"": 10}}"
2020-10-21 14:42:22,ca17453e73fe69dc25a9d703804877a60763b685,Bram Moolenaar,59,9,68,5,"{""src/evalfunc.c"": {""insertions"": 47, ""deletions"": 6, ""lines"": 53}, ""src/proto/evalfunc.pro"": {""insertions"": 1, ""deletions"": 1, ""lines"": 2}, ""src/testdir/test_vim9_builtin.vim"": {""insertions"": 8, ""deletions"": 1, ""lines"": 9}, ""src/version.c"": {""insertions"": 2, ""deletions"": 0, ""lines"": 2}, ""src/vim9compile.c"": {""insertions"": 1, ""deletions"": 1, ""lines"": 2}}"
2020-10-21 14:10:21,8a99e66b4f7616d9b0b9cefe742f82f9122087d5,Bram Moolenaar,109,128,237,5,"{""src/gui_gtk.c"": {""insertions"": 3, ""deletions"": 3, ""lines"": 6}, ""src/gui_gtk_f.c"": {""insertions"": 91, ""deletions"": 108, ""lines"": 199}, ""src/gui_gtk_f.h"": {""insertions"": 9, ""deletions"": 13, ""lines"": 22}, ""src/gui_gtk_x11.c"": {""insertions"": 4, ""deletions"": 4, ""lines"": 8}, ""src/version.c"": {""insertions"": 2, ""deletions"": 0, ""lines"": 2}}"
2020-10-21 12:49:08,b8f519e5382f9876ae7f8bc64d9814d07a8ef972,Bram Moolenaar,16,14,30,2,"{""src/evalfunc.c"": {""insertions"": 14, ""deletions"": 14, ""lines"": 28}, ""src/version.c"": {""insertions"": 2, ""deletions"": 0, ""lines"": 2}}"
2020-10-21 12:25:07,94738d8fab09c5563e1512f1695e047c715ad274,Bram Moolenaar,1644,1051,2695,7,"{""src/evalfunc.c"": {""insertions"": 1075, ""deletions"": 507, ""lines"": 1582}, ""src/proto/evalfunc.pro"": {""insertions"": 1, ""deletions"": 0, ""lines"": 1}, ""src/testdir/Make_all.mak"": {""insertions"": 2, ""deletions"": 0, ""lines"": 2}, ""src/testdir/test_vim9_builtin.vim"": {""insertions"": 554, ""deletions"": 0, ""lines"": 554}, ""src/testdir/test_vim9_func.vim"": {""insertions"": 0, ""deletions"": 537, ""lines"": 537}, ""src/version.c"": {""insertions"": 2, ""deletions"": 0, ""lines"": 2}, ""src/vim9compile.c"": {""insertions"": 10, ""deletions"": 7, ""lines"": 17}}"
2020-10-21 10:38:00,3da855c8e28140d9f02b1572e445f8d4f977cf64,Bram Moolenaar,4,2,6,2,"{""src/gui_gtk_f.c"": {""insertions"": 2, ""deletions"": 2, ""lines"": 4}, ""src/version.c"": {""insertions"": 2, ""deletions"": 0, ""lines"": 2}}"
2020-10-21 10:19:53,b53e13a91ab2fc9d52bd044715daa84972f4ce47,Bram Moolenaar,27,5,32,6,"{""runtime/doc/autocmd.txt"": {""insertions"": 7, ""deletions"": 2, ""lines"": 9}, ""src/autocmd.c"": {""insertions"": 1, ""deletions"": 0, ""lines"": 1}, ""src/edit.c"": {""insertions"": 3, ""deletions"": 0, ""lines"": 3}, ""src/testdir/test_edit.vim"": {""insertions"": 10, ""deletions"": 1, ""lines"": 11}, ""src/version.c"": {""insertions"": 2, ""deletions"": 0, ""lines"": 2}, ""src/vim.h"": {""insertions"": 4, ""deletions"": 2, ""lines"": 6}}"
2020-10-20 21:11:33,20d89e0ac65686481f97657008deede0b39ef5db,Bram Moolenaar,22,1,23,3,"{""src/testdir/test_vim9_cmd.vim"": {""insertions"": 18, ""deletions"": 0, ""lines"": 18}, ""src/usercmd.c"": {""insertions"": 2, ""deletions"": 1, ""lines"": 3}, ""src/version.c"": {""insertions"": 2, ""deletions"": 0, ""lines"": 2}}"
2020-10-20 17:01:30,e9f9f16387554e5b34ba42ce00c42c28dd66af58,Bram Moolenaar,23,7,30,3,"{""src/search.c"": {""insertions"": 3, ""deletions"": 2, ""lines"": 5}, ""src/testdir/test_matchfuzzy.vim"": {""insertions"": 18, ""deletions"": 5, ""lines"": 23}, ""src/version.c"": {""insertions"": 2, ""deletions"": 0, ""lines"": 2}}"
2020-10-20 12:59:12,c95940c06a125d3afe6516f11f8b2f5697a6b3b9,Bram Moolenaar,20,1,21,3,"{""src/quickfix.c"": {""insertions"": 3, ""deletions"": 1, ""lines"": 4}, ""src/testdir/test_quickfix.vim"": {""insertions"": 15, ""deletions"": 0, ""lines"": 15}, ""src/version.c"": {""insertions"": 2, ""deletions"": 0, ""lines"": 2}}"
2020-10-20 12:25:07,39ca4127a094d8aca6f77c01be4f3fea506d5cb7,Bram Moolenaar,76,19,95,7,"{""src/ex_eval.c"": {""insertions"": 8, ""deletions"": 2, ""lines"": 10}, ""src/proto/vim9script.pro"": {""insertions"": 1, ""deletions"": 1, ""lines"": 2}, ""src/structs.h"": {""insertions"": 2, ""deletions"": 0, ""lines"": 2}, ""src/testdir/test_vim9_script.vim"": {""insertions"": 19, ""deletions"": 0, ""lines"": 19}, ""src/userfunc.c"": {""insertions"": 14, ""deletions"": 6, ""lines"": 20}, ""src/version.c"": {""insertions"": 2, ""deletions"": 0, ""lines"": 2}, ""src/vim9script.c"": {""insertions"": 30, ""deletions"": 10, ""lines"": 40}}"
2020-10-19 21:01:46,955347cc7e78352a5d49540573ae958ad45e6386,Bram Moolenaar,3,0,3,2,"{""src/version.c"": {""insertions"": 2, ""deletions"": 0, ""lines"": 2}, ""src/vim9execute.c"": {""insertions"": 1, ""deletions"": 0, ""lines"": 1}}"
2020-10-19 19:45:07,9a13e185e5de95b150555134b34030bd47c4e22b,Bram Moolenaar,8,0,8,3,"{""src/testdir/test_vim9_expr.vim"": {""insertions"": 1, ""deletions"": 0, ""lines"": 1}, ""src/version.c"": {""insertions"": 2, ""deletions"": 0, ""lines"": 2}, ""src/vim9compile.c"": {""insertions"": 5, ""deletions"": 0, ""lines"": 5}}"
2020-10-19 18:45:36,80b0e5ea1132d1d7cf78c77bc14c686c836a0d25,Bram Moolenaar,106,5,111,7,"{""src/errors.h"": {""insertions"": 2, ""deletions"": 0, ""lines"": 2}, ""src/testdir/test_vim9_disassemble.vim"": {""insertions"": 28, ""deletions"": 0, ""lines"": 28}, ""src/testdir/test_vim9_func.vim"": {""insertions"": 19, ""deletions"": 3, ""lines"": 22}, ""src/version.c"": {""insertions"": 2, ""deletions"": 0, ""lines"": 2}, ""src/vim9.h"": {""insertions"": 1, ""deletions"": 0, ""lines"": 1}, ""src/vim9compile.c"": {""insertions"": 30, ""deletions"": 2, ""lines"": 32}, ""src/vim9execute.c"": {""insertions"": 24, ""deletions"": 0, ""lines"": 24}}"
2020-10-19 18:21:03,66fa5fd54f550c0790d36c20124c49493b323bfa,Bram Moolenaar,9,0,9,3,"{""src/blob.c"": {""insertions"": 1, ""deletions"": 0, ""lines"": 1}, ""src/testdir/test_vim9_func.vim"": {""insertions"": 6, ""deletions"": 0, ""lines"": 6}, ""src/version.c"": {""insertions"": 2, ""deletions"": 0, ""lines"": 2}}"
2020-10-19 17:02:42,1dcae59957301b6b19aef49af648715f911a1378,Bram Moolenaar,122,4,126,7,"{""src/errors.h"": {""insertions"": 2, ""deletions"": 0, ""lines"": 2}, ""src/testdir/test_vim9_disassemble.vim"": {""insertions"": 29, ""deletions"": 1, ""lines"": 30}, ""src/testdir/test_vim9_func.vim"": {""insertions"": 18, ""deletions"": 0, ""lines"": 18}, ""src/version.c"": {""insertions"": 2, ""deletions"": 0, ""lines"": 2}, ""src/vim9.h"": {""insertions"": 3, ""deletions"": 2, ""lines"": 5}, ""src/vim9compile.c"": {""insertions"": 46, ""deletions"": 1, ""lines"": 47}, ""src/vim9execute.c"": {""insertions"": 22, ""deletions"": 0, ""lines"": 22}}"
2020-10-19 14:07:42,334a8b4bde55e1095533f70616ac1e6ec337c62c,Bram Moolenaar,103,41,144,3,"{""src/testdir/test_vim9_assign.vim"": {""insertions"": 6, ""deletions"": 0, ""lines"": 6}, ""src/version.c"": {""insertions"": 2, ""deletions"": 0, ""lines"": 2}, ""src/vim9compile.c"": {""insertions"": 95, ""deletions"": 41, ""lines"": 136}}"
2020-10-19 11:12:33,e3c65ce4e59143736bb2e0fba93c21283aa92a35,Bram Moolenaar,13,1,14,2,"{""src/testdir/test_json.vim"": {""insertions"": 11, ""deletions"": 1, ""lines"": 12}, ""src/version.c"": {""insertions"": 2, ""deletions"": 0, ""lines"": 2}}"
2020-10-18 21:32:13,2ea79ad83584f5d668adfb935be67ee0e0e9995b,Bram Moolenaar,5,0,5,2,"{""src/version.c"": {""insertions"": 2, ""deletions"": 0, ""lines"": 2}, ""src/vim9compile.c"": {""insertions"": 3, ""deletions"": 0, ""lines"": 3}}"
2020-10-18 16:03:17,a2c026d0fd470d68d679616fddfc285cb4834412,Bram Moolenaar,20,19,39,3,"{""src/dict.c"": {""insertions"": 10, ""deletions"": 18, ""lines"": 28}, ""src/testdir/test_vim9_expr.vim"": {""insertions"": 8, ""deletions"": 1, ""lines"": 9}, ""src/version.c"": {""insertions"": 2, ""deletions"": 0, ""lines"": 2}}"
2020-10-17 20:58:21,335e67132265b068f39f3671e5dff2aecd1bf403,Bram Moolenaar,3,0,3,2,"{""src/version.c"": {""insertions"": 2, ""deletions"": 0, ""lines"": 2}, ""src/vim9execute.c"": {""insertions"": 1, ""deletions"": 0, ""lines"": 1}}"
2020-10-17 20:04:08,352134bbfbff4831a3f6a3383d9e2d8660016243,Bram Moolenaar,47,0,47,4,"{""src/testdir/test_vim9_assign.vim"": {""insertions"": 3, ""deletions"": 0, ""lines"": 3}, ""src/testdir/test_vim9_script.vim"": {""insertions"": 22, ""deletions"": 0, ""lines"": 22}, ""src/version.c"": {""insertions"": 2, ""deletions"": 0, ""lines"": 2}, ""src/vim9execute.c"": {""insertions"": 20, ""deletions"": 0, ""lines"": 20}}"
2020-10-17 17:29:51,403dc31f5a03b5858f62e72c3407ffaf827b3005,Bram Moolenaar,27,4,31,4,"{""src/evalfunc.c"": {""insertions"": 7, ""deletions"": 2, ""lines"": 9}, ""src/popupwin.c"": {""insertions"": 4, ""deletions"": 2, ""lines"": 6}, ""src/testdir/test_vim9_func.vim"": {""insertions"": 14, ""deletions"": 0, ""lines"": 14}, ""src/version.c"": {""insertions"": 2, ""deletions"": 0, ""lines"": 2}}"
2020-10-17 16:51:52,218450ad5ea1f9f033b06754a29502d86100ff65,Bram Moolenaar,19,4,23,3,"{""src/job.c"": {""insertions"": 13, ""deletions"": 4, ""lines"": 17}, ""src/testdir/test_vim9_assign.vim"": {""insertions"": 4, ""deletions"": 0, ""lines"": 4}, ""src/version.c"": {""insertions"": 2, ""deletions"": 0, ""lines"": 2}}"
2020-10-17 15:39:55,9668cc57a1e70c99163f90f58202e206d12f40c8,Bram Moolenaar,8,2,10,3,"{""src/ex_docmd.c"": {""insertions"": 2, ""deletions"": 2, ""lines"": 4}, ""src/testdir/test_window_cmd.vim"": {""insertions"": 4, ""deletions"": 0, ""lines"": 4}, ""src/version.c"": {""insertions"": 2, ""deletions"": 0, ""lines"": 2}}"
2020-10-16 21:16:47,e13bdec6b90b3a0fce4f021e3ee986e731cea3b5,Bram Moolenaar,9,5,14,4,"{""src/errors.h"": {""insertions"": 1, ""deletions"": 1, ""lines"": 2}, ""src/version.c"": {""insertions"": 2, ""deletions"": 0, ""lines"": 2}, ""src/vim9compile.c"": {""insertions"": 4, ""deletions"": 2, ""lines"": 6}, ""src/vim9execute.c"": {""insertions"": 2, ""deletions"": 2, ""lines"": 4}}"
2020-10-16 18:25:23,1e021e63c565bbb30783a557b4e883cc27f56403,Bram Moolenaar,28,0,28,4,"{""src/errors.h"": {""insertions"": 2, ""deletions"": 0, ""lines"": 2}, ""src/testdir/test_vim9_script.vim"": {""insertions"": 15, ""deletions"": 0, ""lines"": 15}, ""src/version.c"": {""insertions"": 2, ""deletions"": 0, ""lines"": 2}, ""src/vim9execute.c"": {""insertions"": 9, ""deletions"": 0, ""lines"": 9}}"
2020-10-16 17:56:12,7a66a17190f2f64688a697ea29d58388612122ce,Bram Moolenaar,7,2,9,3,"{""src/ex_docmd.c"": {""insertions"": 1, ""deletions"": 1, ""lines"": 2}, ""src/testdir/test_vim9_assign.vim"": {""insertions"": 4, ""deletions"": 1, ""lines"": 5}, ""src/version.c"": {""insertions"": 2, ""deletions"": 0, ""lines"": 2}}"
2020-10-15 20:29:17,ffdf8adfa8108d4765fdc68abbd2fe49a4292b25,Bram Moolenaar,10,6,16,4,"{""src/list.c"": {""insertions"": 3, ""deletions"": 2, ""lines"": 5}, ""src/testdir/test_blob.vim"": {""insertions"": 1, ""deletions"": 0, ""lines"": 1}, ""src/testdir/test_filter_map.vim"": {""insertions"": 4, ""deletions"": 4, ""lines"": 8}, ""src/version.c"": {""insertions"": 2, ""deletions"": 0, ""lines"": 2}}"
2020-10-15 19:54:56,27491cd3ef86c10a2b64bcb657f29e1d0fccb183,Bram Moolenaar,28,6,34,4,"{""src/eval.c"": {""insertions"": 4, ""deletions"": 0, ""lines"": 4}, ""src/testdir/test_vim9_expr.vim"": {""insertions"": 17, ""deletions"": 2, ""lines"": 19}, ""src/version.c"": {""insertions"": 2, ""deletions"": 0, ""lines"": 2}, ""src/vim9compile.c"": {""insertions"": 5, ""deletions"": 4, ""lines"": 9}}"
2020-10-15 19:23:28,a604ccc959c3bff88d3d5bc3c965819fc326d239,Bram Moolenaar,16,2,18,3,"{""src/testdir/test_textobjects.vim"": {""insertions"": 12, ""deletions"": 0, ""lines"": 12}, ""src/textobject.c"": {""insertions"": 2, ""deletions"": 2, ""lines"": 4}, ""src/version.c"": {""insertions"": 2, ""deletions"": 0, ""lines"": 2}}"
2020-10-15 18:42:20,ed234f24f3a6d697ba9b786d0bc74d4682bfdf47,Bram Moolenaar,41,11,52,3,"{""src/evalvars.c"": {""insertions"": 14, ""deletions"": 2, ""lines"": 16}, ""src/testdir/test_vim9_script.vim"": {""insertions"": 25, ""deletions"": 9, ""lines"": 34}, ""src/version.c"": {""insertions"": 2, ""deletions"": 0, ""lines"": 2}}"
2020-10-15 17:10:56,74f8eece5e481220e3c0767487c0bb59fa916ed6,Bram Moolenaar,16,2,18,3,"{""src/popupwin.c"": {""insertions"": 4, ""deletions"": 2, ""lines"": 6}, ""src/testdir/test_popupwin.vim"": {""insertions"": 10, ""deletions"": 0, ""lines"": 10}, ""src/version.c"": {""insertions"": 2, ""deletions"": 0, ""lines"": 2}}"
2020-10-15 11:57:56,209f0208f7831c6ab8f3f1cab473cb21e7985fc3,Bram Moolenaar,3,1,4,2,"{""src/version.c"": {""insertions"": 2, ""deletions"": 0, ""lines"": 2}, ""src/vim9compile.c"": {""insertions"": 1, ""deletions"": 1, ""lines"": 2}}"
2020-10-15 10:46:44,fbbcd00367e1a4fafd047d42ffce0e5dce88925c,Bram Moolenaar,239,65,304,11,"{""src/ex_eval.c"": {""insertions"": 8, ""deletions"": 2, ""lines"": 10}, ""src/proto/userfunc.pro"": {""insertions"": 1, ""deletions"": 1, ""lines"": 2}, ""src/proto/vim9compile.pro"": {""insertions"": 1, ""deletions"": 1, ""lines"": 2}, ""src/proto/vim9script.pro"": {""insertions"": 2, ""deletions"": 2, ""lines"": 4}, ""src/structs.h"": {""insertions"": 4, ""deletions"": 1, ""lines"": 5}, ""src/testdir/test_vim9_script.vim"": {""insertions"": 40, ""deletions"": 9, ""lines"": 49}, ""src/userfunc.c"": {""insertions"": 19, ""deletions"": 3, ""lines"": 22}, ""src/version.c"": {""insertions"": 2, ""deletions"": 0, ""lines"": 2}, ""src/vim9compile.c"": {""insertions"": 130, ""deletions"": 33, ""lines"": 163}, ""src/vim9execute.c"": {""insertions"": 8, ""deletions"": 4, ""lines"": 12}, ""src/vim9script.c"": {""insertions"": 24, ""deletions"": 9, ""lines"": 33}}"
2020-10-14 17:39:19,8d739de43b84ef7817b3b5b826d1cbfe7572a62a,Bram Moolenaar,209,61,270,7,"{""src/evalvars.c"": {""insertions"": 4, ""deletions"": 24, ""lines"": 28}, ""src/ex_eval.c"": {""insertions"": 18, ""deletions"": 24, ""lines"": 42}, ""src/proto/vim9script.pro"": {""insertions"": 4, ""deletions"": 1, ""lines"": 5}, ""src/scriptfile.c"": {""insertions"": 4, ""deletions"": 3, ""lines"": 7}, ""src/structs.h"": {""insertions"": 52, ""deletions"": 7, ""lines"": 59}, ""src/version.c"": {""insertions"": 2, ""deletions"": 0, ""lines"": 2}, ""src/vim9script.c"": {""insertions"": 125, ""deletions"": 2, ""lines"": 127}}"
2020-10-13 20:15:56,3d30af8783bf43fbfece641ec81ad8d2f01b3735,Bram Moolenaar,33,2,35,4,"{""src/message.c"": {""insertions"": 8, ""deletions"": 2, ""lines"": 10}, ""src/testdir/dumps/Test_quit_long_message.dump"": {""insertions"": 6, ""deletions"": 0, ""lines"": 6}, ""src/testdir/test_messages.vim"": {""insertions"": 17, ""deletions"": 0, ""lines"": 17}, ""src/version.c"": {""insertions"": 2, ""deletions"": 0, ""lines"": 2}}"
2020-10-13 19:11:13,b9616af23f31fc18721a92643c21f42b69854efe,Bram Moolenaar,12,2,14,2,"{""src/netbeans.c"": {""insertions"": 10, ""deletions"": 2, ""lines"": 12}, ""src/version.c"": {""insertions"": 2, ""deletions"": 0, ""lines"": 2}}"
2020-10-13 17:08:24,21cbe175eece17fad21d7403b00422445b587138,Bram Moolenaar,24,2,26,4,"{""src/ex_cmds.c"": {""insertions"": 2, ""deletions"": 1, ""lines"": 3}, ""src/ex_docmd.c"": {""insertions"": 2, ""deletions"": 1, ""lines"": 3}, ""src/testdir/test_edit.vim"": {""insertions"": 18, ""deletions"": 0, ""lines"": 18}, ""src/version.c"": {""insertions"": 2, ""deletions"": 0, ""lines"": 2}}"
2020-10-13 16:38:11,2b9b17ea5daaaa693d0891e9a999d711f0e0f743,Bram Moolenaar,8,2,10,2,"{""src/testdir/test_vim9_func.vim"": {""insertions"": 6, ""deletions"": 2, ""lines"": 8}, ""src/version.c"": {""insertions"": 2, ""deletions"": 0, ""lines"": 2}}"
2020-10-12 20:07:13,f4e8cdd3d2156ab52aea1c7a392df66b7210e5eb,Bram Moolenaar,46,1,47,5,"{""src/globals.h"": {""insertions"": 3, ""deletions"": 0, ""lines"": 3}, ""src/message.c"": {""insertions"": 6, ""deletions"": 1, ""lines"": 7}, ""src/testdir/test_vim9_func.vim"": {""insertions"": 32, ""deletions"": 0, ""lines"": 32}, ""src/version.c"": {""insertions"": 2, ""deletions"": 0, ""lines"": 2}, ""src/vim9compile.c"": {""insertions"": 3, ""deletions"": 0, ""lines"": 3}}"
2020-10-12 18:31:26,fc8aa6d02d85b0df703e0a790137891c91503c9e,Bram Moolenaar,18,7,25,4,"{""src/testdir/Make_all.mak"": {""insertions"": 2, ""deletions"": 0, ""lines"": 2}, ""src/testdir/test_vim9_assign.vim"": {""insertions"": 4, ""deletions"": 7, ""lines"": 11}, ""src/testdir/test_vim9_fails.vim"": {""insertions"": 10, ""deletions"": 0, ""lines"": 10}, ""src/version.c"": {""insertions"": 2, ""deletions"": 0, ""lines"": 2}}"
2020-10-11 19:34:41,93be1644db2848659b0610477968c83f53619da1,Bram Moolenaar,107,1,108,3,"{""src/eval.c"": {""insertions"": 24, ""deletions"": 1, ""lines"": 25}, ""src/testdir/test_vim9_expr.vim"": {""insertions"": 81, ""deletions"": 0, ""lines"": 81}, ""src/version.c"": {""insertions"": 2, ""deletions"": 0, ""lines"": 2}}"
2020-10-11 18:44:15,c07b7f701fb30d26112051e4ec737c7e3db72357,Bram Moolenaar,38,3,41,3,"{""src/search.c"": {""insertions"": 20, ""deletions"": 3, ""lines"": 23}, ""src/testdir/test_gn.vim"": {""insertions"": 16, ""deletions"": 0, ""lines"": 16}, ""src/version.c"": {""insertions"": 2, ""deletions"": 0, ""lines"": 2}}"
2020-10-11 18:08:44,62cd26a2294b7a5eead7c145e9bbc7c75f3bb801,Bram Moolenaar,10,3,13,2,"{""src/testdir/test_autocmd.vim"": {""insertions"": 8, ""deletions"": 3, ""lines"": 11}, ""src/version.c"": {""insertions"": 2, ""deletions"": 0, ""lines"": 2}}"
2020-10-11 17:08:33,6eb36ade9883f54c84c739c6a3504ddfa3343063,Bram Moolenaar,64,28,92,3,"{""src/help.c"": {""insertions"": 52, ""deletions"": 28, ""lines"": 80}, ""src/testdir/test_help_tagjump.vim"": {""insertions"": 10, ""deletions"": 0, ""lines"": 10}, ""src/version.c"": {""insertions"": 2, ""deletions"": 0, ""lines"": 2}}"
2020-10-11 16:05:02,efc0d94afc48a03b07955e91315e7e67945cd079,Bram Moolenaar,17,14,31,3,"{""src/if_py_both.h"": {""insertions"": 4, ""deletions"": 4, ""lines"": 8}, ""src/if_python3.c"": {""insertions"": 11, ""deletions"": 10, ""lines"": 21}, ""src/version.c"": {""insertions"": 2, ""deletions"": 0, ""lines"": 2}}"
2020-10-11 12:58:46,204ade6bcb85f48f56e52e040d1ebf40548d92be,Bram Moolenaar,7,10,17,2,"{""src/main.c"": {""insertions"": 5, ""deletions"": 10, ""lines"": 15}, ""src/version.c"": {""insertions"": 2, ""deletions"": 0, ""lines"": 2}}"
2020-10-11 12:28:11,aab9fada4a9b9725ff42dffe9c7daff20f0fd85f,Bram Moolenaar,6,2,8,3,"{""src/fileio.c"": {""insertions"": 2, ""deletions"": 2, ""lines"": 4}, ""src/testdir/test_functions.vim"": {""insertions"": 2, ""deletions"": 0, ""lines"": 2}, ""src/version.c"": {""insertions"": 2, ""deletions"": 0, ""lines"": 2}}"
2020-10-11 12:22:22,ef16c90423ae579927e6294c1ccfd17c5a1c113c,Bram Moolenaar,3,0,3,2,"{""Filelist"": {""insertions"": 1, ""deletions"": 0, ""lines"": 1}, ""src/version.c"": {""insertions"": 2, ""deletions"": 0, ""lines"": 2}}"
2020-10-11 11:57:40,4f4d51a942cc2c6b3e936ee0f93f00c2d000065c,Bram Moolenaar,287,233,520,30,"{"".github/CODEOWNERS"": {""insertions"": 2, ""deletions"": 0, ""lines"": 2}, ""README_VIM9.md"": {""insertions"": 1, ""deletions"": 1, ""lines"": 2}, ""runtime/autoload/python3complete.vim"": {""insertions"": 4, ""deletions"": 3, ""lines"": 7}, ""runtime/autoload/pythoncomplete.vim"": {""insertions"": 4, ""deletions"": 3, ""lines"": 7}, ""runtime/colors/README.txt"": {""insertions"": 1, ""deletions"": 1, ""lines"": 2}, ""runtime/defaults.vim"": {""insertions"": 1, ""deletions"": 1, ""lines"": 2}, ""runtime/doc/eval.txt"": {""insertions"": 3, ""deletions"": 3, ""lines"": 6}, ""runtime/doc/index.txt"": {""insertions"": 5, ""deletions"": 3, ""lines"": 8}, ""runtime/doc/map.txt"": {""insertions"": 12, ""deletions"": 1, ""lines"": 13}, ""runtime/doc/options.txt"": {""insertions"": 3, ""deletions"": 3, ""lines"": 6}, ""runtime/doc/repeat.txt"": {""insertions"": 4, ""deletions"": 1, ""lines"": 5}, ""runtime/doc/tags"": {""insertions"": 6, ""deletions"": 0, ""lines"": 6}, ""runtime/doc/todo.txt"": {""insertions"": 64, ""deletions"": 57, ""lines"": 121}, ""runtime/doc/version8.txt"": {""insertions"": 1, ""deletions"": 1, ""lines"": 2}, ""runtime/doc/vim9.txt"": {""insertions"": 33, ""deletions"": 17, ""lines"": 50}, ""runtime/filetype.vim"": {""insertions"": 1, ""deletions"": 1, ""lines"": 2}, ""runtime/ftplugin/falcon.vim"": {""insertions"": 2, ""deletions"": 1, ""lines"": 3}, ""runtime/ftplugin/fortran.vim"": {""insertions"": 6, ""deletions"": 6, ""lines"": 12}, ""runtime/ftplugin/python.vim"": {""insertions"": 13, ""deletions"": 29, ""lines"": 42}, ""runtime/indent/fortran.vim"": {""insertions"": 6, ""deletions"": 6, ""lines"": 12}, ""runtime/syntax/apache.vim"": {""insertions"": 3, ""deletions"": 1, ""lines"": 4}, ""runtime/syntax/asterisk.vim"": {""insertions"": 2, ""deletions"": 2, ""lines"": 4}, ""runtime/syntax/cabal.vim"": {""insertions"": 5, ""deletions"": 2, ""lines"": 7}, ""runtime/syntax/css.vim"": {""insertions"": 2, ""deletions"": 2, ""lines"": 4}, ""runtime/syntax/fortran.vim"": {""insertions"": 19, ""deletions"": 11, ""lines"": 30}, ""runtime/syntax/haskell.vim"": {""insertions"": 49, ""deletions"": 40, ""lines"": 89}, ""runtime/syntax/ia64.vim"": {""insertions"": 19, ""deletions"": 20, ""lines"": 39}, ""runtime/syntax/less.vim"": {""insertions"": 1, ""deletions"": 2, ""lines"": 3}, ""runtime/syntax/vim.vim"": {""insertions"": 14, ""deletions"": 14, ""lines"": 28}, ""runtime/syntax/xkb.vim"": {""insertions"": 1, ""deletions"": 1, ""lines"": 2}}"
2020-10-10 21:26:28,c6ed254d9fda0ff54cdedce5597ff3e0d0218d18,Bram Moolenaar,27,9,36,2,"{""src/if_python3.c"": {""insertions"": 25, ""deletions"": 9, ""lines"": 34}, ""src/version.c"": {""insertions"": 2, ""deletions"": 0, ""lines"": 2}}"
2020-10-10 20:34:36,bd6428b9e79ed85b54ea7eaa11871fa09d63ab6f,Bram Moolenaar,4,2,6,2,"{"".github/workflows/ci-windows.yaml"": {""insertions"": 2, ""deletions"": 2, ""lines"": 4}, ""src/version.c"": {""insertions"": 2, ""deletions"": 0, ""lines"": 2}}"
2020-10-10 20:26:52,1b1e9df78b9ff98cc5ccff359bead37ce5c54d6b,Bram Moolenaar,4,0,4,2,"{""src/ex_docmd.c"": {""insertions"": 2, ""deletions"": 0, ""lines"": 2}, ""src/version.c"": {""insertions"": 2, ""deletions"": 0, ""lines"": 2}}"
2020-10-10 19:50:25,10a1a534d1ae1d798bb695f9a521052ebbf1e289,Bram Moolenaar,107,96,203,3,"{""runtime/filetype.vim"": {""insertions"": 0, ""deletions"": 7, ""lines"": 7}, ""src/testdir/test_filetype.vim"": {""insertions"": 105, ""deletions"": 89, ""lines"": 194}, ""src/version.c"": {""insertions"": 2, ""deletions"": 0, ""lines"": 2}}"
2020-10-10 19:33:48,9becdf2b98e56d5eb193f3413d706ea433269216,Bram Moolenaar,76,5,81,9,"{""src/errors.h"": {""insertions"": 2, ""deletions"": 0, ""lines"": 2}, ""src/ex_cmdidxs.h"": {""insertions"": 1, ""deletions"": 1, ""lines"": 2}, ""src/ex_cmds.h"": {""insertions"": 6, ""deletions"": 0, ""lines"": 6}, ""src/ex_docmd.c"": {""insertions"": 8, ""deletions"": 2, ""lines"": 10}, ""src/ex_eval.c"": {""insertions"": 33, ""deletions"": 2, ""lines"": 35}, ""src/proto/ex_eval.pro"": {""insertions"": 2, ""deletions"": 0, ""lines"": 2}, ""src/structs.h"": {""insertions"": 1, ""deletions"": 0, ""lines"": 1}, ""src/testdir/test_vim9_script.vim"": {""insertions"": 21, ""deletions"": 0, ""lines"": 21}, ""src/version.c"": {""insertions"": 2, ""deletions"": 0, ""lines"": 2}}"
2020-10-10 18:31:37,d747548c664815bb6e8520afa90b6108e1997591,Bram Moolenaar,21,13,34,2,"{""src/ex_eval.c"": {""insertions"": 19, ""deletions"": 13, ""lines"": 32}, ""src/version.c"": {""insertions"": 2, ""deletions"": 0, ""lines"": 2}}"
2020-10-10 17:07:09,fcdc5d83fbfd7ddce634769ea902e58c87f27f20,Bram Moolenaar,112,14,126,6,"{""src/evalvars.c"": {""insertions"": 1, ""deletions"": 2, ""lines"": 3}, ""src/ex_eval.c"": {""insertions"": 56, ""deletions"": 12, ""lines"": 68}, ""src/proto/evalvars.pro"": {""insertions"": 1, ""deletions"": 0, ""lines"": 1}, ""src/structs.h"": {""insertions"": 2, ""deletions"": 0, ""lines"": 2}, ""src/testdir/test_vim9_script.vim"": {""insertions"": 50, ""deletions"": 0, ""lines"": 50}, ""src/version.c"": {""insertions"": 2, ""deletions"": 0, ""lines"": 2}}"
2020-10-10 14:45:25,28f224b2c1bd2fcdee7b4fe2c64826e1cff08f39,Bram Moolenaar,13,2,15,3,"{""src/search.c"": {""insertions"": 1, ""deletions"": 1, ""lines"": 2}, ""src/testdir/test_gn.vim"": {""insertions"": 10, ""deletions"": 1, ""lines"": 11}, ""src/version.c"": {""insertions"": 2, ""deletions"": 0, ""lines"": 2}}"
2020-10-10 14:42:39,f57497276bc616d3856eeff9824c080941faa51b,Bram Moolenaar,6,2,8,2,"{""src/testdir/test_listdict.vim"": {""insertions"": 4, ""deletions"": 2, ""lines"": 6}, ""src/version.c"": {""insertions"": 2, ""deletions"": 0, ""lines"": 2}}"
2020-10-10 13:37:58,1a73923705744ab8297dd856d194e20297563456,Bram Moolenaar,27,6,33,3,"{""src/list.c"": {""insertions"": 13, ""deletions"": 6, ""lines"": 19}, ""src/testdir/test_vim9_assign.vim"": {""insertions"": 12, ""deletions"": 0, ""lines"": 12}, ""src/version.c"": {""insertions"": 2, ""deletions"": 0, ""lines"": 2}}"
2020-10-10 13:05:23,820d55a50bbc8c0ad0505b7e4302a734896b6bab,Bram Moolenaar,6,0,6,2,"{""src/ex_docmd.c"": {""insertions"": 4, ""deletions"": 0, ""lines"": 4}, ""src/version.c"": {""insertions"": 2, ""deletions"": 0, ""lines"": 2}}"
2020-10-10 12:13:01,85d5e2b723e6fc233e53252dd5c523944146fbc2,Bram Moolenaar,143,110,253,7,"{""src/eval.c"": {""insertions"": 14, ""deletions"": 15, ""lines"": 29}, ""src/proto/vim9execute.pro"": {""insertions"": 1, ""deletions"": 0, ""lines"": 1}, ""src/structs.h"": {""insertions"": 3, ""deletions"": 0, ""lines"": 3}, ""src/testdir/test_vim9_disassemble.vim"": {""insertions"": 36, ""deletions"": 36, ""lines"": 72}, ""src/testdir/test_vim9_func.vim"": {""insertions"": 38, ""deletions"": 40, ""lines"": 78}, ""src/version.c"": {""insertions"": 2, ""deletions"": 0, ""lines"": 2}, ""src/vim9execute.c"": {""insertions"": 49, ""deletions"": 19, ""lines"": 68}}"
2020-10-09 21:04:47,8956023920bb1b6f9c381739e59b9ddab4bf7798,Bram Moolenaar,6,2,8,2,"{""src/os_unix.c"": {""insertions"": 4, ""deletions"": 2, ""lines"": 6}, ""src/version.c"": {""insertions"": 2, ""deletions"": 0, ""lines"": 2}}"
2020-10-09 20:04:29,e8211a33dcb0ac6e29aad6699160fdc2e5fa2024,Bram Moolenaar,29,3,32,3,"{""src/testdir/test_vim9_func.vim"": {""insertions"": 18, ""deletions"": 0, ""lines"": 18}, ""src/version.c"": {""insertions"": 2, ""deletions"": 0, ""lines"": 2}, ""src/vim9compile.c"": {""insertions"": 9, ""deletions"": 3, ""lines"": 12}}"
2020-10-09 08:20:53,11416321ff45e2bf3d456f332dc9d1836a8d171a,Bram Moolenaar,42,38,80,2,"{""src/testdir/test_vim9_func.vim"": {""insertions"": 40, ""deletions"": 38, ""lines"": 78}, ""src/version.c"": {""insertions"": 2, ""deletions"": 0, ""lines"": 2}}"
2020-10-08 21:21:21,6a61421f646961b7d719432c02382f0a70702a80,Bram Moolenaar,38,35,73,2,"{""src/testdir/test_vim9_disassemble.vim"": {""insertions"": 36, ""deletions"": 35, ""lines"": 71}, ""src/version.c"": {""insertions"": 2, ""deletions"": 0, ""lines"": 2}}"
2020-10-08 19:30:40,922acbda3d4e250c8683db223f444d0ec8c6fd03,Bram Moolenaar,3,1,4,2,"{""src/evalvars.c"": {""insertions"": 1, ""deletions"": 1, ""lines"": 2}, ""src/version.c"": {""insertions"": 2, ""deletions"": 0, ""lines"": 2}}"
2020-10-08 19:16:42,10c65860f83589e0ca2498393d3cfef1115b7fe8,Bram Moolenaar,75,23,98,7,"{""src/eval.c"": {""insertions"": 24, ""deletions"": 0, ""lines"": 24}, ""src/proto/evalvars.pro"": {""insertions"": 1, ""deletions"": 0, ""lines"": 1}, ""src/proto/vim9script.pro"": {""insertions"": 1, ""deletions"": 0, ""lines"": 1}, ""src/structs.h"": {""insertions"": 1, ""deletions"": 0, ""lines"": 1}, ""src/testdir/test_vim9_script.vim"": {""insertions"": 9, ""deletions"": 0, ""lines"": 9}, ""src/version.c"": {""insertions"": 2, ""deletions"": 0, ""lines"": 2}, ""src/vim9script.c"": {""insertions"": 37, ""deletions"": 23, ""lines"": 60}}"
2020-10-07 17:08:04,0876c78527469ddf50c23244566dd5bc35004307,Bram Moolenaar,20,2,22,3,"{""src/testdir/test_vim9_func.vim"": {""insertions"": 14, ""deletions"": 0, ""lines"": 14}, ""src/version.c"": {""insertions"": 2, ""deletions"": 0, ""lines"": 2}, ""src/vim9execute.c"": {""insertions"": 4, ""deletions"": 2, ""lines"": 6}}"
2020-10-07 15:29:48,9a033d7b18651acbb7eda4b7f39a27c01748fb70,Bram Moolenaar,36,3,39,4,"{""runtime/doc/map.txt"": {""insertions"": 9, ""deletions"": 2, ""lines"": 11}, ""src/misc2.c"": {""insertions"": 7, ""deletions"": 1, ""lines"": 8}, ""src/testdir/test_termcodes.vim"": {""insertions"": 18, ""deletions"": 0, ""lines"": 18}, ""src/version.c"": {""insertions"": 2, ""deletions"": 0, ""lines"": 2}}"
2020-10-07 14:54:52,d7e5e9430ae192c76f1f03c3ac53fae823d94c33,Bram Moolenaar,99,2,101,3,"{""src/testdir/test_charsearch.vim"": {""insertions"": 29, ""deletions"": 2, ""lines"": 31}, ""src/testdir/test_normal.vim"": {""insertions"": 68, ""deletions"": 0, ""lines"": 68}, ""src/version.c"": {""insertions"": 2, ""deletions"": 0, ""lines"": 2}}"
2020-10-07 14:12:37,4e2114e988f5d8635f2ad748be3cafcc44289138,Bram Moolenaar,56,10,66,7,"{""src/gui_gtk_x11.c"": {""insertions"": 3, ""deletions"": 4, ""lines"": 7}, ""src/gui_x11.c"": {""insertions"": 3, ""deletions"": 0, ""lines"": 3}, ""src/misc2.c"": {""insertions"": 26, ""deletions"": 0, ""lines"": 26}, ""src/proto/misc2.pro"": {""insertions"": 1, ""deletions"": 0, ""lines"": 1}, ""src/term.c"": {""insertions"": 3, ""deletions"": 6, ""lines"": 9}, ""src/testdir/test_termcodes.vim"": {""insertions"": 18, ""deletions"": 0, ""lines"": 18}, ""src/version.c"": {""insertions"": 2, ""deletions"": 0, ""lines"": 2}}"
2020-10-07 10:58:44,f12f0022e6698831681f0931a4e7e5298f6ef0d8,Bram Moolenaar,40,0,40,2,"{""src/testdir/test_spell.vim"": {""insertions"": 38, ""deletions"": 0, ""lines"": 38}, ""src/version.c"": {""insertions"": 2, ""deletions"": 0, ""lines"": 2}}"
2020-10-06 18:46:49,349f609f8990a3aca9a4b8faa0585d75e03116db,Bram Moolenaar,11,0,11,3,"{""src/help.c"": {""insertions"": 3, ""deletions"": 0, ""lines"": 3}, ""src/testdir/test_popupwin.vim"": {""insertions"": 6, ""deletions"": 0, ""lines"": 6}, ""src/version.c"": {""insertions"": 2, ""deletions"": 0, ""lines"": 2}}"
2020-10-06 17:59:06,253b16a4abdad1df350b9ddd9a709520b063934c,Bram Moolenaar,11,6,17,2,"{""src/if_python3.c"": {""insertions"": 9, ""deletions"": 6, ""lines"": 15}, ""src/version.c"": {""insertions"": 2, ""deletions"": 0, ""lines"": 2}}"
2020-10-05 19:39:25,80361a5f2b134c88597d60b3d363b52084e712a1,Bram Moolenaar,10,4,14,2,"{""src/os_unix.c"": {""insertions"": 8, ""deletions"": 4, ""lines"": 12}, ""src/version.c"": {""insertions"": 2, ""deletions"": 0, ""lines"": 2}}"
2020-10-05 18:38:06,50c4e9e08fb0981892e33afb9fe3751aa6df1fa4,Bram Moolenaar,5,1,6,3,"{""src/filepath.c"": {""insertions"": 1, ""deletions"": 1, ""lines"": 2}, ""src/testdir/test_functions.vim"": {""insertions"": 2, ""deletions"": 0, ""lines"": 2}, ""src/version.c"": {""insertions"": 2, ""deletions"": 0, ""lines"": 2}}"
2020-10-05 18:07:18,afe8cf617013fd8c3f0189f1e1fa7a2a6a8f7511,Bram Moolenaar,15,2,17,5,"{""src/testdir/test_arglist.vim"": {""insertions"": 6, ""deletions"": 2, ""lines"": 8}, ""src/testdir/test_cmdline.vim"": {""insertions"": 4, ""deletions"": 0, ""lines"": 4}, ""src/testdir/test_json.vim"": {""insertions"": 1, ""deletions"": 0, ""lines"": 1}, ""src/testdir/test_listdict.vim"": {""insertions"": 2, ""deletions"": 0, ""lines"": 2}, ""src/version.c"": {""insertions"": 2, ""deletions"": 0, ""lines"": 2}}"
2020-10-05 17:23:59,44aefffaad067886d266999cd17cf852b2a7e0b9,Bram Moolenaar,7,0,7,3,"{""src/testdir/test_vim9_expr.vim"": {""insertions"": 2, ""deletions"": 0, ""lines"": 2}, ""src/version.c"": {""insertions"": 2, ""deletions"": 0, ""lines"": 2}, ""src/vim9compile.c"": {""insertions"": 3, ""deletions"": 0, ""lines"": 3}}"
2020-10-04 17:56:39,55b419b871dd35f5b05dd2aed65f14461b493ba9,Bram Moolenaar,27,2,29,3,"{""src/ex_cmds.c"": {""insertions"": 5, ""deletions"": 2, ""lines"": 7}, ""src/testdir/test_undo.vim"": {""insertions"": 20, ""deletions"": 0, ""lines"": 20}, ""src/version.c"": {""insertions"": 2, ""deletions"": 0, ""lines"": 2}}"
2020-10-04 15:24:29,dda749ce85cc07000faa86bfd2ceaecd8e4805fc,Bram Moolenaar,3,1,4,2,"{""src/version.c"": {""insertions"": 2, ""deletions"": 0, ""lines"": 2}, ""src/vim9compile.c"": {""insertions"": 1, ""deletions"": 1, ""lines"": 2}}"
2020-10-04 14:16:54,d1ad99b65470d3e754f6a0588a6b0dc2214a1eab,Bram Moolenaar,122,24,146,8,"{""src/testdir/test_gf.vim"": {""insertions"": 15, ""deletions"": 0, ""lines"": 15}, ""src/testdir/test_goto.vim"": {""insertions"": 18, ""deletions"": 0, ""lines"": 18}, ""src/testdir/test_normal.vim"": {""insertions"": 40, ""deletions"": 1, ""lines"": 41}, ""src/testdir/test_registers.vim"": {""insertions"": 3, ""deletions"": 0, ""lines"": 3}, ""src/testdir/test_startup.vim"": {""insertions"": 0, ""deletions"": 2, ""lines"": 2}, ""src/testdir/test_tabpage.vim"": {""insertions"": 10, ""deletions"": 6, ""lines"": 16}, ""src/testdir/test_visual.vim"": {""insertions"": 34, ""deletions"": 15, ""lines"": 49}, ""src/version.c"": {""insertions"": 2, ""deletions"": 0, ""lines"": 2}}"
2020-10-04 14:06:05,1310660557470a669cc64b359e20666b116e5dbd,Bram Moolenaar,216,37,253,10,"{""runtime/doc/vim9.txt"": {""insertions"": 30, ""deletions"": 15, ""lines"": 45}, ""src/eval.c"": {""insertions"": 9, ""deletions"": 6, ""lines"": 15}, ""src/testdir/test_expr.vim"": {""insertions"": 10, ""deletions"": 0, ""lines"": 10}, ""src/testdir/test_vim9_cmd.vim"": {""insertions"": 68, ""deletions"": 0, ""lines"": 68}, ""src/testdir/test_vim9_expr.vim"": {""insertions"": 38, ""deletions"": 11, ""lines"": 49}, ""src/testdir/test_vim9_script.vim"": {""insertions"": 1, ""deletions"": 1, ""lines"": 2}, ""src/testdir/vim9.vim"": {""insertions"": 7, ""deletions"": 0, ""lines"": 7}, ""src/version.c"": {""insertions"": 2, ""deletions"": 0, ""lines"": 2}, ""src/vim9compile.c"": {""insertions"": 49, ""deletions"": 3, ""lines"": 52}, ""src/vim9execute.c"": {""insertions"": 2, ""deletions"": 1, ""lines"": 3}}"
2020-10-04 12:17:32,6abd3dc257cf56a8262db38eb15c7cc754e8e002,Bram Moolenaar,23,0,23,2,"{""src/testdir/test_vim9_func.vim"": {""insertions"": 21, ""deletions"": 0, ""lines"": 21}, ""src/version.c"": {""insertions"": 2, ""deletions"": 0, ""lines"": 2}}"
2020-10-04 11:42:34,7b5d5442696d86daab062592d5c86c829757c352,Bram Moolenaar,36,1,37,3,"{""src/testdir/test_vim9_func.vim"": {""insertions"": 26, ""deletions"": 0, ""lines"": 26}, ""src/userfunc.c"": {""insertions"": 8, ""deletions"": 1, ""lines"": 9}, ""src/version.c"": {""insertions"": 2, ""deletions"": 0, ""lines"": 2}}"
2020-10-03 20:52:39,2bb2658bef9fb25b320f87147261b7154494a86f,Bram Moolenaar,255,217,472,12,"{""runtime/doc/vim9.txt"": {""insertions"": 32, ""deletions"": 28, ""lines"": 60}, ""src/eval.c"": {""insertions"": 43, ""deletions"": 59, ""lines"": 102}, ""src/structs.h"": {""insertions"": 1, ""deletions"": 2, ""lines"": 3}, ""src/testdir/test_vim9_assign.vim"": {""insertions"": 5, ""deletions"": 5, ""lines"": 10}, ""src/testdir/test_vim9_cmd.vim"": {""insertions"": 2, ""deletions"": 2, ""lines"": 4}, ""src/testdir/test_vim9_disassemble.vim"": {""insertions"": 13, ""deletions"": 12, ""lines"": 25}, ""src/testdir/test_vim9_expr.vim"": {""insertions"": 75, ""deletions"": 74, ""lines"": 149}, ""src/version.c"": {""insertions"": 2, ""deletions"": 0, ""lines"": 2}, ""src/vim9.h"": {""insertions"": 6, ""deletions"": 3, ""lines"": 9}, ""src/vim9compile.c"": {""insertions"": 36, ""deletions"": 20, ""lines"": 56}, ""src/vim9execute.c"": {""insertions"": 35, ""deletions"": 5, ""lines"": 40}, ""src/vim9type.c"": {""insertions"": 5, ""deletions"": 7, ""lines"": 12}}"
2020-10-03 18:17:30,92f26c256e06277ff2ec4ce7adea1eb58c85abe0,Bram Moolenaar,257,97,354,8,"{""runtime/doc/eval.txt"": {""insertions"": 43, ""deletions"": 3, ""lines"": 46}, ""src/eval.c"": {""insertions"": 54, ""deletions"": 44, ""lines"": 98}, ""src/testdir/test_expr.vim"": {""insertions"": 22, ""deletions"": 0, ""lines"": 22}, ""src/testdir/test_vim9_disassemble.vim"": {""insertions"": 27, ""deletions"": 0, ""lines"": 27}, ""src/testdir/test_vim9_expr.vim"": {""insertions"": 31, ""deletions"": 3, ""lines"": 34}, ""src/version.c"": {""insertions"": 2, ""deletions"": 0, ""lines"": 2}, ""src/vim9compile.c"": {""insertions"": 74, ""deletions"": 47, ""lines"": 121}, ""src/vim9type.c"": {""insertions"": 4, ""deletions"": 0, ""lines"": 4}}"
2020-10-03 15:04:37,c8fe645c198e2ca55c4e3446efbbdb9b995c63ce,Bram Moolenaar,45,10,55,3,"{""src/fileio.c"": {""insertions"": 18, ""deletions"": 10, ""lines"": 28}, ""src/testdir/test_edit.vim"": {""insertions"": 25, ""deletions"": 0, ""lines"": 25}, ""src/version.c"": {""insertions"": 2, ""deletions"": 0, ""lines"": 2}}"
2020-10-03 12:24:19,588d241d44fc25ad4c5a635ee4fdeafdfcee0fde,Bram Moolenaar,8,0,8,3,"{""src/auto/configure"": {""insertions"": 3, ""deletions"": 0, ""lines"": 3}, ""src/configure.ac"": {""insertions"": 3, ""deletions"": 0, ""lines"": 3}, ""src/version.c"": {""insertions"": 2, ""deletions"": 0, ""lines"": 2}}"
2020-10-03 12:14:56,1bdae4032359081325578cc74739a0a097e008ff,Bram Moolenaar,3,1,4,2,"{""src/testdir/test_debugger.vim"": {""insertions"": 1, ""deletions"": 1, ""lines"": 2}, ""src/version.c"": {""insertions"": 2, ""deletions"": 0, ""lines"": 2}}"
2020-10-03 11:57:13,794771cfd83af2a0d1926bed301e784447e7290b,Bram Moolenaar,6,4,10,2,"{""src/if_python3.c"": {""insertions"": 4, ""deletions"": 4, ""lines"": 8}, ""src/version.c"": {""insertions"": 2, ""deletions"": 0, ""lines"": 2}}"
2020-10-03 11:41:53,c1f0066b642fb62e37b300033223ff3ee4aafcd6,Bram Moolenaar,18,1,19,4,"{""src/errors.h"": {""insertions"": 2, ""deletions"": 0, ""lines"": 2}, ""src/testdir/test_vim9_expr.vim"": {""insertions"": 10, ""deletions"": 0, ""lines"": 10}, ""src/version.c"": {""insertions"": 2, ""deletions"": 0, ""lines"": 2}, ""src/vim9compile.c"": {""insertions"": 4, ""deletions"": 1, ""lines"": 5}}"
2020-10-03 10:57:27,016faaa1b2fe242022725b29e1353c42105d045c,Bram Moolenaar,7,5,12,3,"{""src/evalvars.c"": {""insertions"": 5, ""deletions"": 2, ""lines"": 7}, ""src/testdir/runtest.vim"": {""insertions"": 0, ""deletions"": 3, ""lines"": 3}, ""src/version.c"": {""insertions"": 2, ""deletions"": 0, ""lines"": 2}}"
2020-10-02 18:36:01,795aaa1e84d76a6fe066694de9876b8a21cbe40c,Bram Moolenaar,31,1,32,3,"{""src/search.c"": {""insertions"": 15, ""deletions"": 1, ""lines"": 16}, ""src/testdir/test_search.vim"": {""insertions"": 14, ""deletions"": 0, ""lines"": 14}, ""src/version.c"": {""insertions"": 2, ""deletions"": 0, ""lines"": 2}}"
2020-10-02 16:48:07,8a9bc95eaec53f4e0c951ff8f2686ae5113a5709,Bram Moolenaar,208,30,238,7,"{""src/testdir/test_normal.vim"": {""insertions"": 149, ""deletions"": 19, ""lines"": 168}, ""src/testdir/test_regexp_utf8.vim"": {""insertions"": 2, ""deletions"": 2, ""lines"": 4}, ""src/testdir/test_registers.vim"": {""insertions"": 6, ""deletions"": 0, ""lines"": 6}, ""src/testdir/test_spellfile.vim"": {""insertions"": 12, ""deletions"": 0, ""lines"": 12}, ""src/testdir/test_tagjump.vim"": {""insertions"": 12, ""deletions"": 1, ""lines"": 13}, ""src/testdir/test_visual.vim"": {""insertions"": 25, ""deletions"": 8, ""lines"": 33}, ""src/version.c"": {""insertions"": 2, ""deletions"": 0, ""lines"": 2}}"
2020-10-02 16:11:56,3f974ff45e0ea4b85fea7d8768f005d8a2c7941e,Bram Moolenaar,5,2,7,2,"{""src/dict.c"": {""insertions"": 3, ""deletions"": 2, ""lines"": 5}, ""src/version.c"": {""insertions"": 2, ""deletions"": 0, ""lines"": 2}}"
2020-10-02 08:29:45,fa79be6b10e1d34fd697a56e85f6c0ce101f3d62,Bram Moolenaar,73,0,73,2,"{"".github/workflows/codeql-analysis.yml"": {""insertions"": 71, ""deletions"": 0, ""lines"": 71}, ""src/version.c"": {""insertions"": 2, ""deletions"": 0, ""lines"": 2}}"
2020-10-01 20:37:40,bdf931c25b4fe78877106ca529baee7899d0f6a4,Bram Moolenaar,16,4,20,5,"{""src/autocmd.c"": {""insertions"": 7, ""deletions"": 3, ""lines"": 10}, ""src/proto/window.pro"": {""insertions"": 1, ""deletions"": 0, ""lines"": 1}, ""src/testdir/runtest.vim"": {""insertions"": 5, ""deletions"": 0, ""lines"": 5}, ""src/version.c"": {""insertions"": 2, ""deletions"": 0, ""lines"": 2}, ""src/window.c"": {""insertions"": 1, ""deletions"": 1, ""lines"": 2}}"
2020-10-01 19:37:21,74273e66914e46eb5814c13a1b888e45358859b6,Bram Moolenaar,11,1,12,3,"{""src/map.c"": {""insertions"": 1, ""deletions"": 1, ""lines"": 2}, ""src/testdir/test_vim9_func.vim"": {""insertions"": 8, ""deletions"": 0, ""lines"": 8}, ""src/version.c"": {""insertions"": 2, ""deletions"": 0, ""lines"": 2}}"
2020-10-01 18:03:04,4537bcc88956f86267c25edf8008e0dbde598652,Bram Moolenaar,36,1,37,3,"{""src/autocmd.c"": {""insertions"": 1, ""deletions"": 1, ""lines"": 2}, ""src/testdir/test_prompt_buffer.vim"": {""insertions"": 33, ""deletions"": 0, ""lines"": 33}, ""src/version.c"": {""insertions"": 2, ""deletions"": 0, ""lines"": 2}}"
2020-10-01 17:06:35,668008be66326ed9e5b1122abede34ed3d2de2d8,Bram Moolenaar,22,5,27,3,"{""src/testdir/test_statusline.vim"": {""insertions"": 17, ""deletions"": 0, ""lines"": 17}, ""src/version.c"": {""insertions"": 2, ""deletions"": 0, ""lines"": 2}, ""src/window.c"": {""insertions"": 3, ""deletions"": 5, ""lines"": 8}}"
2020-10-01 14:54:07,0022675aa362da0969666e48ced252b57ca1f79e,Bram Moolenaar,4,1,5,3,"{""runtime/filetype.vim"": {""insertions"": 1, ""deletions"": 1, ""lines"": 2}, ""src/testdir/test_filetype.vim"": {""insertions"": 1, ""deletions"": 0, ""lines"": 1}, ""src/version.c"": {""insertions"": 2, ""deletions"": 0, ""lines"": 2}}"
2020-10-01 11:01:34,5366e1aecfff4546df6af86cf98013f23ed5c3bd,Bram Moolenaar,31,6,37,4,"{""src/testdir/test_vim9_func.vim"": {""insertions"": 15, ""deletions"": 0, ""lines"": 15}, ""src/version.c"": {""insertions"": 2, ""deletions"": 0, ""lines"": 2}, ""src/vim9.h"": {""insertions"": 6, ""deletions"": 4, ""lines"": 10}, ""src/vim9execute.c"": {""insertions"": 8, ""deletions"": 2, ""lines"": 10}}"
2020-09-30 20:59:42,55759b522814995af36803823d342d51d68c0b67,Bram Moolenaar,197,194,391,3,"{""src/testdir/test_vim9_assign.vim"": {""insertions"": 195, ""deletions"": 0, ""lines"": 195}, ""src/testdir/test_vim9_script.vim"": {""insertions"": 0, ""deletions"": 194, ""lines"": 194}, ""src/version.c"": {""insertions"": 2, ""deletions"": 0, ""lines"": 2}}"
2020-09-30 20:45:39,17bb4d4607a95e13e913519af106f1bf8b26c178,Bram Moolenaar,13,11,24,2,"{""runtime/defaults.vim"": {""insertions"": 11, ""deletions"": 11, ""lines"": 22}, ""src/version.c"": {""insertions"": 2, ""deletions"": 0, ""lines"": 2}}"
2020-09-29 20:47:03,8ec92c977976d9e9225183e36a80e6b0cdbf1f51,Bram Moolenaar,24,4,28,3,"{""src/quickfix.c"": {""insertions"": 10, ""deletions"": 4, ""lines"": 14}, ""src/testdir/test_quickfix.vim"": {""insertions"": 12, ""deletions"": 0, ""lines"": 12}, ""src/version.c"": {""insertions"": 2, ""deletions"": 0, ""lines"": 2}}"
2020-09-29 20:16:09,32fbc4f247a31e35ade0939542e11aa033a2554f,Bram Moolenaar,7,2,9,2,"{""src/gui_gtk_x11.c"": {""insertions"": 5, ""deletions"": 2, ""lines"": 7}, ""src/version.c"": {""insertions"": 2, ""deletions"": 0, ""lines"": 2}}"
2020-09-29 19:45:41,1b9129809d8269acb8e7c79d8fc99c7976b4f76e,Bram Moolenaar,6,0,6,3,"{""src/map.c"": {""insertions"": 2, ""deletions"": 0, ""lines"": 2}, ""src/testdir/test_maparg.vim"": {""insertions"": 2, ""deletions"": 0, ""lines"": 2}, ""src/version.c"": {""insertions"": 2, ""deletions"": 0, ""lines"": 2}}"
2020-09-29 19:23:25,f43e7ac4eee22dbb26fc069ec9a3d1598ec8dfe9,Bram Moolenaar,22,2,24,3,"{""src/terminal.c"": {""insertions"": 3, ""deletions"": 2, ""lines"": 5}, ""src/testdir/test_terminal.vim"": {""insertions"": 17, ""deletions"": 0, ""lines"": 17}, ""src/version.c"": {""insertions"": 2, ""deletions"": 0, ""lines"": 2}}"
2020-09-29 18:59:17,391c36279415d0b8c5dba1ba11b668add04be963,Bram Moolenaar,15,3,18,5,"{""runtime/doc/eval.txt"": {""insertions"": 3, ""deletions"": 1, ""lines"": 4}, ""src/evalfunc.c"": {""insertions"": 3, ""deletions"": 1, ""lines"": 4}, ""src/highlight.c"": {""insertions"": 6, ""deletions"": 1, ""lines"": 7}, ""src/testdir/test_highlight.vim"": {""insertions"": 1, ""deletions"": 0, ""lines"": 1}, ""src/version.c"": {""insertions"": 2, ""deletions"": 0, ""lines"": 2}}"
2020-09-28 21:13:15,d569a9e74684cd17f9cea63e804281388728e513,Bram Moolenaar,26,1,27,3,"{""src/spell.c"": {""insertions"": 1, ""deletions"": 1, ""lines"": 2}, ""src/testdir/test_spell.vim"": {""insertions"": 23, ""deletions"": 0, ""lines"": 23}, ""src/version.c"": {""insertions"": 2, ""deletions"": 0, ""lines"": 2}}"
2020-09-28 20:29:58,4934ad0e448bfa03ba19c7c5b411c457a9910442,Bram Moolenaar,27,31,58,9,"{""runtime/doc/popup.txt"": {""insertions"": 6, ""deletions"": 1, ""lines"": 7}, ""src/evalfunc.c"": {""insertions"": 4, ""deletions"": 4, ""lines"": 8}, ""src/ex_docmd.c"": {""insertions"": 0, ""deletions"": 4, ""lines"": 4}, ""src/getchar.c"": {""insertions"": 3, ""deletions"": 4, ""lines"": 7}, ""src/globals.h"": {""insertions"": 3, ""deletions"": 6, ""lines"": 9}, ""src/menu.c"": {""insertions"": 0, ""deletions"": 4, ""lines"": 4}, ""src/testdir/dumps/Test_popupwin_normal_cmd.dump"": {""insertions"": 5, ""deletions"": 5, ""lines"": 10}, ""src/testdir/test_popupwin.vim"": {""insertions"": 4, ""deletions"": 3, ""lines"": 7}, ""src/version.c"": {""insertions"": 2, ""deletions"": 0, ""lines"": 2}}"
2020-09-28 19:48:16,d58a3bf7dac8d53faf42e13cc1152b110f12c404,Bram Moolenaar,218,73,291,16,"{""runtime/compiler/shellcheck.vim"": {""insertions"": 25, ""deletions"": 0, ""lines"": 25}, ""runtime/doc/autocmd.txt"": {""insertions"": 2, ""deletions"": 2, ""lines"": 4}, ""runtime/doc/eval.txt"": {""insertions"": 2, ""deletions"": 2, ""lines"": 4}, ""runtime/doc/filetype.txt"": {""insertions"": 8, ""deletions"": 1, ""lines"": 9}, ""runtime/doc/gui.txt"": {""insertions"": 26, ""deletions"": 18, ""lines"": 44}, ""runtime/doc/popup.txt"": {""insertions"": 2, ""deletions"": 2, ""lines"": 4}, ""runtime/doc/starting.txt"": {""insertions"": 3, ""deletions"": 1, ""lines"": 4}, ""runtime/doc/tags"": {""insertions"": 4, ""deletions"": 0, ""lines"": 4}, ""runtime/doc/todo.txt"": {""insertions"": 22, ""deletions"": 9, ""lines"": 31}, ""runtime/doc/vim9.txt"": {""insertions"": 29, ""deletions"": 0, ""lines"": 29}, ""runtime/filetype.vim"": {""insertions"": 2, ""deletions"": 2, ""lines"": 4}, ""runtime/ftplugin/awk.vim"": {""insertions"": 39, ""deletions"": 2, ""lines"": 41}, ""runtime/indent/vim.vim"": {""insertions"": 4, ""deletions"": 4, ""lines"": 8}, ""runtime/syntax/man.vim"": {""insertions"": 3, ""deletions"": 3, ""lines"": 6}, ""runtime/syntax/sh.vim"": {""insertions"": 34, ""deletions"": 18, ""lines"": 52}, ""runtime/syntax/vim.vim"": {""insertions"": 13, ""deletions"": 9, ""lines"": 22}}"
2020-09-28 19:41:49,b45cd36bd90f71e4a35b1ef1f75a3bedef6d8bac,Bram Moolenaar,21,1,22,3,"{""runtime/menu.vim"": {""insertions"": 16, ""deletions"": 1, ""lines"": 17}, ""src/testdir/test_gui.vim"": {""insertions"": 3, ""deletions"": 0, ""lines"": 3}, ""src/version.c"": {""insertions"": 2, ""deletions"": 0, ""lines"": 2}}"
2020-09-27 21:33:59,727345ebea07284ada118590d805329e6dbee014,Bram Moolenaar,3,1,4,2,"{""src/testdir/test_vim9_func.vim"": {""insertions"": 1, ""deletions"": 1, ""lines"": 2}, ""src/version.c"": {""insertions"": 2, ""deletions"": 0, ""lines"": 2}}"
2020-09-27 20:47:05,7a9cbca00a8ec53306f8a5852e332feb79091793,Bram Moolenaar,177,187,364,11,"{""src/testdir/runtest.vim"": {""insertions"": 3, ""deletions"": 0, ""lines"": 3}, ""src/testdir/test_maparg.vim"": {""insertions"": 4, ""deletions"": 4, ""lines"": 8}, ""src/testdir/test_popupwin.vim"": {""insertions"": 1, ""deletions"": 1, ""lines"": 2}, ""src/testdir/test_textprop.vim"": {""insertions"": 2, ""deletions"": 2, ""lines"": 4}, ""src/testdir/test_vim9_assign.vim"": {""insertions"": 0, ""deletions"": 3, ""lines"": 3}, ""src/testdir/test_vim9_cmd.vim"": {""insertions"": 0, ""deletions"": 3, ""lines"": 3}, ""src/testdir/test_vim9_disassemble.vim"": {""insertions"": 0, ""deletions"": 3, ""lines"": 3}, ""src/testdir/test_vim9_expr.vim"": {""insertions"": 0, ""deletions"": 3, ""lines"": 3}, ""src/testdir/test_vim9_func.vim"": {""insertions"": 165, ""deletions"": 165, ""lines"": 330}, ""src/testdir/test_vim9_script.vim"": {""insertions"": 0, ""deletions"": 3, ""lines"": 3}, ""src/version.c"": {""insertions"": 2, ""deletions"": 0, ""lines"": 2}}"
2020-09-27 19:58:45,9830938e77b0d36d65b0c31eadf09f7b9d394c29,Bram Moolenaar,76,74,150,3,"{""src/testdir/test_vim9_assign.vim"": {""insertions"": 27, ""deletions"": 27, ""lines"": 54}, ""src/testdir/test_vim9_expr.vim"": {""insertions"": 47, ""deletions"": 47, ""lines"": 94}, ""src/version.c"": {""insertions"": 2, ""deletions"": 0, ""lines"": 2}}"
2020-09-27 19:27:40,06f9c6940a88d132c85eb2a1b5034fa7653518ce,Bram Moolenaar,13,1,14,3,"{""src/testdir/test_vim9_assign.vim"": {""insertions"": 10, ""deletions"": 0, ""lines"": 10}, ""src/version.c"": {""insertions"": 2, ""deletions"": 0, ""lines"": 2}, ""src/vim9compile.c"": {""insertions"": 1, ""deletions"": 1, ""lines"": 2}}"
2020-09-27 19:16:45,6c542f77eba73a95447f285149b3fcb011aa9675,Bram Moolenaar,21,15,36,3,"{""src/popupwin.c"": {""insertions"": 3, ""deletions"": 3, ""lines"": 6}, ""src/testdir/test_popupwin.vim"": {""insertions"": 16, ""deletions"": 12, ""lines"": 28}, ""src/version.c"": {""insertions"": 2, ""deletions"": 0, ""lines"": 2}}"
2020-09-27 18:13:03,d0e1b7103c14eb0d175c6b245b4b6ed93a204da9,Bram Moolenaar,39,0,39,4,"{""src/edit.c"": {""insertions"": 3, ""deletions"": 0, ""lines"": 3}, ""src/testdir/dumps/Test_pum_stopped_by_timer.dump"": {""insertions"": 12, ""deletions"": 0, ""lines"": 12}, ""src/testdir/test_ins_complete.vim"": {""insertions"": 22, ""deletions"": 0, ""lines"": 22}, ""src/version.c"": {""insertions"": 2, ""deletions"": 0, ""lines"": 2}}"
2020-09-27 17:05:33,ac564082f118ccdca828980c5f10b65a40bffb4d,Bram Moolenaar,209,198,407,4,"{""src/testdir/test_vim9_assign.vim"": {""insertions"": 3, ""deletions"": 0, ""lines"": 3}, ""src/testdir/test_vim9_cmd.vim"": {""insertions"": 28, ""deletions"": 25, ""lines"": 53}, ""src/testdir/test_vim9_disassemble.vim"": {""insertions"": 176, ""deletions"": 173, ""lines"": 349}, ""src/version.c"": {""insertions"": 2, ""deletions"": 0, ""lines"": 2}}"
2020-09-27 16:24:03,2914a20abc78d4ace94d48d6e6ab9f0da894dd7e,Bram Moolenaar,19,1,20,3,"{""src/testdir/test_vim9_assign.vim"": {""insertions"": 16, ""deletions"": 0, ""lines"": 16}, ""src/version.c"": {""insertions"": 2, ""deletions"": 0, ""lines"": 2}, ""src/vim9compile.c"": {""insertions"": 1, ""deletions"": 1, ""lines"": 2}}"
2020-09-27 15:57:43,37ce6d3a6ab7c7864de6788feb67377e8bbffa63,Bram Moolenaar,375,371,746,2,"{""src/testdir/test_vim9_expr.vim"": {""insertions"": 373, ""deletions"": 371, ""lines"": 744}, ""src/version.c"": {""insertions"": 2, ""deletions"": 0, ""lines"": 2}}"
2020-09-27 15:45:03,5597ba046790e5ffd76dfc327d7898c56df65d3f,Bram Moolenaar,13,5,18,3,"{""src/testdir/test_vim9_expr.vim"": {""insertions"": 4, ""deletions"": 0, ""lines"": 4}, ""src/version.c"": {""insertions"": 2, ""deletions"": 0, ""lines"": 2}, ""src/vim9type.c"": {""insertions"": 7, ""deletions"": 5, ""lines"": 12}}"
2020-09-27 14:03:15,a5fe91e6dc610bc823bc3201e2c88179989b13fb,Bram Moolenaar,30,2,32,3,"{""src/os_mac_conv.c"": {""insertions"": 7, ""deletions"": 2, ""lines"": 9}, ""src/testdir/test_environ.vim"": {""insertions"": 21, ""deletions"": 0, ""lines"": 21}, ""src/version.c"": {""insertions"": 2, ""deletions"": 0, ""lines"": 2}}"
2020-09-27 13:19:27,cfcd011fcd8021da52fba62dabf7a2497f1879b7,Bram Moolenaar,240,213,453,7,"{""src/errors.h"": {""insertions"": 2, ""deletions"": 0, ""lines"": 2}, ""src/evalvars.c"": {""insertions"": 7, ""deletions"": 0, ""lines"": 7}, ""src/testdir/test_vim9_script.vim"": {""insertions"": 213, ""deletions"": 205, ""lines"": 418}, ""src/userfunc.c"": {""insertions"": 8, ""deletions"": 7, ""lines"": 15}, ""src/version.c"": {""insertions"": 2, ""deletions"": 0, ""lines"": 2}, ""src/vim.h"": {""insertions"": 2, ""deletions"": 1, ""lines"": 3}, ""src/vim9compile.c"": {""insertions"": 6, ""deletions"": 0, ""lines"": 6}}"
2020-09-27 12:22:48,c0e29010f68a0ebe439f9bd78493799c60b7bfd3,Bram Moolenaar,17,2,19,4,"{""src/evalvars.c"": {""insertions"": 3, ""deletions"": 2, ""lines"": 5}, ""src/testdir/test_vim9_assign.vim"": {""insertions"": 10, ""deletions"": 0, ""lines"": 10}, ""src/version.c"": {""insertions"": 2, ""deletions"": 0, ""lines"": 2}, ""src/vim9compile.c"": {""insertions"": 2, ""deletions"": 0, ""lines"": 2}}"
2020-09-27 11:58:38,8c7ad3631af570f68b2da2658cf966a9a19cb6c4,Bram Moolenaar,39,0,39,2,"{""src/testdir/test_spell.vim"": {""insertions"": 37, ""deletions"": 0, ""lines"": 37}, ""src/version.c"": {""insertions"": 2, ""deletions"": 0, ""lines"": 2}}"
2020-09-27 11:51:14,f6a44f714a383a69db05cb47e26abffd966cd6a5,Bram Moolenaar,7,0,7,2,"{""src/evalvars.c"": {""insertions"": 5, ""deletions"": 0, ""lines"": 5}, ""src/version.c"": {""insertions"": 2, ""deletions"": 0, ""lines"": 2}}"
2020-09-27 11:16:46,daff0fb73851ef368ede180dbb3b772e55304ba7,Bram Moolenaar,22,6,28,5,"{""src/gui_w32.c"": {""insertions"": 1, ""deletions"": 2, ""lines"": 3}, ""src/gui_x11.c"": {""insertions"": 1, ""deletions"": 2, ""lines"": 3}, ""src/misc2.c"": {""insertions"": 4, ""deletions"": 2, ""lines"": 6}, ""src/testdir/test_termcodes.vim"": {""insertions"": 14, ""deletions"": 0, ""lines"": 14}, ""src/version.c"": {""insertions"": 2, ""deletions"": 0, ""lines"": 2}}"
2020-09-26 20:39:24,bade44e5cad1b08c85d4a8ba08d94a30458dddfb,Bram Moolenaar,10,5,15,5,"{""src/evalfunc.c"": {""insertions"": 2, ""deletions"": 2, ""lines"": 4}, ""src/testdir/test_search.vim"": {""insertions"": 3, ""deletions"": 0, ""lines"": 3}, ""src/testdir/test_terminal2.vim"": {""insertions"": 2, ""deletions"": 2, ""lines"": 4}, ""src/typval.c"": {""insertions"": 1, ""deletions"": 1, ""lines"": 2}, ""src/version.c"": {""insertions"": 2, ""deletions"": 0, ""lines"": 2}}"
2020-09-26 20:03:00,3697c9bbae755831d3cf2f11179aaff29e343f51,Bram Moolenaar,102,24,126,8,"{""src/move.c"": {""insertions"": 4, ""deletions"": 0, ""lines"": 4}, ""src/popupwin.c"": {""insertions"": 32, ""deletions"": 21, ""lines"": 53}, ""src/proto/popupwin.pro"": {""insertions"": 1, ""deletions"": 0, ""lines"": 1}, ""src/testdir/dumps/Test_popupwin_set_firstline_1.dump"": {""insertions"": 16, ""deletions"": 0, ""lines"": 16}, ""src/testdir/dumps/Test_popupwin_set_firstline_2.dump"": {""insertions"": 16, ""deletions"": 0, ""lines"": 16}, ""src/testdir/dumps/Test_popupwin_win_execute_cursorline.dump"": {""insertions"": 3, ""deletions"": 3, ""lines"": 6}, ""src/testdir/test_popupwin.vim"": {""insertions"": 28, ""deletions"": 0, ""lines"": 28}, ""src/version.c"": {""insertions"": 2, ""deletions"": 0, ""lines"": 2}}"
2020-09-26 17:59:38,c70bdab0b8a8262a3784084aa1e6271fee8452f1,Bram Moolenaar,25,6,31,3,"{""src/testdir/test_vim9_func.vim"": {""insertions"": 14, ""deletions"": 0, ""lines"": 14}, ""src/version.c"": {""insertions"": 2, ""deletions"": 0, ""lines"": 2}, ""src/vim9execute.c"": {""insertions"": 9, ""deletions"": 6, ""lines"": 15}}"
2020-09-26 17:11:39,f3c51bbff1256a52bdd9ede7887f40062be2628c,Bram Moolenaar,24,5,29,3,"{""src/testdir/test_winbuf_close.vim"": {""insertions"": 17, ""deletions"": 1, ""lines"": 18}, ""src/version.c"": {""insertions"": 2, ""deletions"": 0, ""lines"": 2}, ""src/window.c"": {""insertions"": 5, ""deletions"": 4, ""lines"": 9}}"
2020-09-26 16:47:11,8f187fc6304222956f94a700758a490cc8c0af99,Bram Moolenaar,26,2,28,3,"{""src/evalfunc.c"": {""insertions"": 9, ""deletions"": 0, ""lines"": 9}, ""src/testdir/test_ins_complete.vim"": {""insertions"": 15, ""deletions"": 2, ""lines"": 17}, ""src/version.c"": {""insertions"": 2, ""deletions"": 0, ""lines"": 2}}"
2020-09-26 15:20:53,373863ed48c02b5df52574aa7d50aeecb1037d40,Bram Moolenaar,12,5,17,4,"{""src/ex_docmd.c"": {""insertions"": 4, ""deletions"": 0, ""lines"": 4}, ""src/testdir/test_trycatch.vim"": {""insertions"": 4, ""deletions"": 3, ""lines"": 7}, ""src/testdir/test_vim9_script.vim"": {""insertions"": 2, ""deletions"": 2, ""lines"": 4}, ""src/version.c"": {""insertions"": 2, ""deletions"": 0, ""lines"": 2}}"
2020-09-26 13:20:42,d47f50b3312af2b8baf37505b7a589daf3f7d942,Bram Moolenaar,3,0,3,2,"{""src/ex_docmd.c"": {""insertions"": 1, ""deletions"": 0, ""lines"": 1}, ""src/version.c"": {""insertions"": 2, ""deletions"": 0, ""lines"": 2}}"
2020-09-26 13:09:30,30fd8204cecb317d842b964d624d492088d6d15f,Bram Moolenaar,515,385,900,16,"{""runtime/doc/vim9.txt"": {""insertions"": 187, ""deletions"": 128, ""lines"": 315}, ""src/cmdexpand.c"": {""insertions"": 2, ""deletions"": 0, ""lines"": 2}, ""src/errors.h"": {""insertions"": 4, ""deletions"": 0, ""lines"": 4}, ""src/eval.c"": {""insertions"": 11, ""deletions"": 11, ""lines"": 22}, ""src/evalvars.c"": {""insertions"": 50, ""deletions"": 20, ""lines"": 70}, ""src/ex_cmdidxs.h"": {""insertions"": 23, ""deletions"": 23, ""lines"": 46}, ""src/ex_cmds.h"": {""insertions"": 6, ""deletions"": 0, ""lines"": 6}, ""src/ex_docmd.c"": {""insertions"": 6, ""deletions"": 4, ""lines"": 10}, ""src/proto/evalvars.pro"": {""insertions"": 1, ""deletions"": 0, ""lines"": 1}, ""src/testdir/test_vim9_assign.vim"": {""insertions"": 171, ""deletions"": 170, ""lines"": 341}, ""src/testdir/test_vim9_script.vim"": {""insertions"": 20, ""deletions"": 14, ""lines"": 34}, ""src/version.c"": {""insertions"": 2, ""deletions"": 0, ""lines"": 2}, ""src/vim.h"": {""insertions"": 3, ""deletions"": 3, ""lines"": 6}, ""src/vim9compile.c"": {""insertions"": 21, ""deletions"": 9, ""lines"": 30}, ""src/vim9execute.c"": {""insertions"": 1, ""deletions"": 1, ""lines"": 2}, ""src/vim9script.c"": {""insertions"": 7, ""deletions"": 2, ""lines"": 9}}"
2020-09-25 21:49:01,273af497cac345897cf6369baa87a070876a5815,Bram Moolenaar,65,63,128,2,"{""src/filepath.c"": {""insertions"": 63, ""deletions"": 63, ""lines"": 126}, ""src/version.c"": {""insertions"": 2, ""deletions"": 0, ""lines"": 2}}"
2020-09-25 21:12:51,7e9210ea5320e0c3fd9fd93e3f3f1a59e029cf46,Bram Moolenaar,8,1,9,2,"{""src/testdir/test_vim9_script.vim"": {""insertions"": 6, ""deletions"": 1, ""lines"": 7}, ""src/version.c"": {""insertions"": 2, ""deletions"": 0, ""lines"": 2}}"
2020-09-25 20:42:48,6a33ef0deb5c75c003a9f3bd1c57f3ca5e77327e,Bram Moolenaar,103,48,151,6,"{""runtime/doc/eval.txt"": {""insertions"": 8, ""deletions"": 4, ""lines"": 12}, ""src/evalfunc.c"": {""insertions"": 1, ""deletions"": 1, ""lines"": 2}, ""src/filepath.c"": {""insertions"": 73, ""deletions"": 42, ""lines"": 115}, ""src/proto/filepath.pro"": {""insertions"": 1, ""deletions"": 1, ""lines"": 2}, ""src/testdir/test_functions.vim"": {""insertions"": 18, ""deletions"": 0, ""lines"": 18}, ""src/version.c"": {""insertions"": 2, ""deletions"": 0, ""lines"": 2}}"
2020-09-25 20:13:05,58dbef330c42511f9d7d3b3990c73387041f3f3f,Bram Moolenaar,4,0,4,2,"{""src/testdir/test_vim9_script.vim"": {""insertions"": 2, ""deletions"": 0, ""lines"": 2}, ""src/version.c"": {""insertions"": 2, ""deletions"": 0, ""lines"": 2}}"
2020-09-25 19:47:28,9c4f55204fdf8909f4e3515a32a542044bf9f943,Bram Moolenaar,29,3,32,3,"{""src/testdir/test_vim9_script.vim"": {""insertions"": 23, ""deletions"": 2, ""lines"": 25}, ""src/version.c"": {""insertions"": 2, ""deletions"": 0, ""lines"": 2}, ""src/vim9compile.c"": {""insertions"": 4, ""deletions"": 1, ""lines"": 5}}"
2020-09-24 21:08:19,509f8031b2b347c033327ef33f3e5573a0595dbc,Bram Moolenaar,6,0,6,2,"{""src/os_mac_conv.c"": {""insertions"": 4, ""deletions"": 0, ""lines"": 4}, ""src/version.c"": {""insertions"": 2, ""deletions"": 0, ""lines"": 2}}"
2020-09-24 20:57:31,10476521f51d5902d191f2189307781fc48a3a16,Bram Moolenaar,50,4,54,4,"{""src/popupwin.c"": {""insertions"": 5, ""deletions"": 0, ""lines"": 5}, ""src/testdir/dumps/Test_popupwin_win_execute_cursorline.dump"": {""insertions"": 14, ""deletions"": 0, ""lines"": 14}, ""src/testdir/test_popupwin.vim"": {""insertions"": 29, ""deletions"": 4, ""lines"": 33}, ""src/version.c"": {""insertions"": 2, ""deletions"": 0, ""lines"": 2}}"
2020-09-23 20:38:05,531be47ac5522807b265c6287021a01c9b895ac9,Bram Moolenaar,47,1,48,18,"{""src/testdir/gen_opt_test.vim"": {""insertions"": 1, ""deletions"": 1, ""lines"": 2}, ""src/testdir/test_arglist.vim"": {""insertions"": 1, ""deletions"": 0, ""lines"": 1}, ""src/testdir/test_autocmd.vim"": {""insertions"": 1, ""deletions"": 0, ""lines"": 1}, ""src/testdir/test_buffer.vim"": {""insertions"": 1, ""deletions"": 0, ""lines"": 1}, ""src/testdir/test_checkpath.vim"": {""insertions"": 15, ""deletions"": 0, ""lines"": 15}, ""src/testdir/test_cmdline.vim"": {""insertions"": 2, ""deletions"": 0, ""lines"": 2}, ""src/testdir/test_debugger.vim"": {""insertions"": 1, ""deletions"": 0, ""lines"": 1}, ""src/testdir/test_functions.vim"": {""insertions"": 1, ""deletions"": 0, ""lines"": 1}, ""src/testdir/test_history.vim"": {""insertions"": 1, ""deletions"": 0, ""lines"": 1}, ""src/testdir/test_listdict.vim"": {""insertions"": 1, ""deletions"": 0, ""lines"": 1}, ""src/testdir/test_options.vim"": {""insertions"": 1, ""deletions"": 0, ""lines"": 1}, ""src/testdir/test_search_stat.vim"": {""insertions"": 8, ""deletions"": 0, ""lines"": 8}, ""src/testdir/test_sort.vim"": {""insertions"": 1, ""deletions"": 0, ""lines"": 1}, ""src/testdir/test_substitute.vim"": {""insertions"": 1, ""deletions"": 0, ""lines"": 1}, ""src/testdir/test_syntax.vim"": {""insertions"": 2, ""deletions"": 0, ""lines"": 2}, ""src/testdir/test_tagjump.vim"": {""insertions"": 4, ""deletions"": 0, ""lines"": 4}, ""src/testdir/test_user_func.vim"": {""insertions"": 3, ""deletions"": 0, ""lines"": 3}, ""src/version.c"": {""insertions"": 2, ""deletions"": 0, ""lines"": 2}}"
2020-09-23 20:27:22,851d108313317a062371a6750e6c6bf370a9bafa,Bram Moolenaar,4,2,6,2,"{"".github/workflows/ci-windows.yaml"": {""insertions"": 2, ""deletions"": 2, ""lines"": 4}, ""src/version.c"": {""insertions"": 2, ""deletions"": 0, ""lines"": 2}}"
2020-09-23 19:57:23,148ce7ae62e92ecf6487a4ba5902ddb7e699074b,Bram Moolenaar,93,64,157,6,"{""src/testdir/test_vim9_disassemble.vim"": {""insertions"": 1, ""deletions"": 1, ""lines"": 2}, ""src/testdir/test_vim9_func.vim"": {""insertions"": 1, ""deletions"": 1, ""lines"": 2}, ""src/version.c"": {""insertions"": 2, ""deletions"": 0, ""lines"": 2}, ""src/vim9.h"": {""insertions"": 1, ""deletions"": 2, ""lines"": 3}, ""src/vim9compile.c"": {""insertions"": 6, ""deletions"": 5, ""lines"": 11}, ""src/vim9execute.c"": {""insertions"": 82, ""deletions"": 55, ""lines"": 137}}"
2020-09-23 16:51:11,4ee711f21389066fa157961feed17692fc16bf8e,Bram Moolenaar,5,0,5,2,"{""src/version.c"": {""insertions"": 2, ""deletions"": 0, ""lines"": 2}, ""src/vim9compile.c"": {""insertions"": 3, ""deletions"": 0, ""lines"": 3}}"
2020-09-23 15:41:26,6bf1b52ba2816dffdbd0d994320abfb1586bf666,Bram Moolenaar,59,4,63,5,"{""src/popupwin.c"": {""insertions"": 20, ""deletions"": 4, ""lines"": 24}, ""src/testdir/dumps/Test_popupwin_win_execute.dump"": {""insertions"": 10, ""deletions"": 0, ""lines"": 10}, ""src/testdir/term_util.vim"": {""insertions"": 3, ""deletions"": 0, ""lines"": 3}, ""src/testdir/test_popupwin.vim"": {""insertions"": 24, ""deletions"": 0, ""lines"": 24}, ""src/version.c"": {""insertions"": 2, ""deletions"": 0, ""lines"": 2}}"
2020-09-23 13:56:50,81ed4960482f8baabdd7f95b4d5e39744be88ae7,Bram Moolenaar,40,4,44,3,"{""src/eval.c"": {""insertions"": 24, ""deletions"": 4, ""lines"": 28}, ""src/testdir/test_vim9_assign.vim"": {""insertions"": 14, ""deletions"": 0, ""lines"": 14}, ""src/version.c"": {""insertions"": 2, ""deletions"": 0, ""lines"": 2}}"
2020-09-23 11:25:32,04bdd573d0a48e789eb92ed2a81e0dd732761391,Bram Moolenaar,32,1,33,3,"{""src/testdir/test_vim9_assign.vim"": {""insertions"": 27, ""deletions"": 0, ""lines"": 27}, ""src/version.c"": {""insertions"": 2, ""deletions"": 0, ""lines"": 2}, ""src/vim9compile.c"": {""insertions"": 3, ""deletions"": 1, ""lines"": 4}}"
2020-09-23 10:29:11,189832bf661168df7ebd428e4088737718775fbd,Bram Moolenaar,53,1,54,8,"{""src/evalfunc.c"": {""insertions"": 6, ""deletions"": 0, ""lines"": 6}, ""src/ex_docmd.c"": {""insertions"": 4, ""deletions"": 0, ""lines"": 4}, ""src/getchar.c"": {""insertions"": 5, ""deletions"": 1, ""lines"": 6}, ""src/globals.h"": {""insertions"": 5, ""deletions"": 0, ""lines"": 5}, ""src/menu.c"": {""insertions"": 4, ""deletions"": 0, ""lines"": 4}, ""src/testdir/dumps/Test_popupwin_normal_cmd.dump"": {""insertions"": 10, ""deletions"": 0, ""lines"": 10}, ""src/testdir/test_popupwin.vim"": {""insertions"": 17, ""deletions"": 0, ""lines"": 17}, ""src/version.c"": {""insertions"": 2, ""deletions"": 0, ""lines"": 2}}"
2020-09-22 20:08:32,c53e9c57a9846655c2d3169788f4beefa6d22d90,Bram Moolenaar,3,1,4,2,"{""src/search.c"": {""insertions"": 1, ""deletions"": 1, ""lines"": 2}, ""src/version.c"": {""insertions"": 2, ""deletions"": 0, ""lines"": 2}}"
2020-09-22 19:55:41,99ca9c4868bb1669706b9e3de9a9218bd11cc459,Bram Moolenaar,89,14,103,7,"{""runtime/doc/eval.txt"": {""insertions"": 13, ""deletions"": 5, ""lines"": 18}, ""src/evalfunc.c"": {""insertions"": 18, ""deletions"": 7, ""lines"": 25}, ""src/evalwindow.c"": {""insertions"": 16, ""deletions"": 0, ""lines"": 16}, ""src/popupwin.c"": {""insertions"": 15, ""deletions"": 2, ""lines"": 17}, ""src/testdir/test_functions.vim"": {""insertions"": 12, ""deletions"": 0, ""lines"": 12}, ""src/testdir/test_popupwin.vim"": {""insertions"": 13, ""deletions"": 0, ""lines"": 13}, ""src/version.c"": {""insertions"": 2, ""deletions"": 0, ""lines"": 2}}"
2020-09-22 18:33:50,4f73b8e9cc83f647b34002554a8bdf9abec0a82f,Bram Moolenaar,629,167,796,9,"{""runtime/doc/eval.txt"": {""insertions"": 48, ""deletions"": 7, ""lines"": 55}, ""runtime/doc/usr_41.txt"": {""insertions"": 1, ""deletions"": 0, ""lines"": 1}, ""src/evalfunc.c"": {""insertions"": 2, ""deletions"": 1, ""lines"": 3}, ""src/proto/search.pro"": {""insertions"": 1, ""deletions"": 0, ""lines"": 1}, ""src/search.c"": {""insertions"": 385, ""deletions"": 135, ""lines"": 520}, ""src/testdir/Make_all.mak"": {""insertions"": 2, ""deletions"": 0, ""lines"": 2}, ""src/testdir/test_functions.vim"": {""insertions"": 0, ""deletions"": 24, ""lines"": 24}, ""src/testdir/test_matchfuzzy.vim"": {""insertions"": 188, ""deletions"": 0, ""lines"": 188}, ""src/version.c"": {""insertions"": 2, ""deletions"": 0, ""lines"": 2}}"
2020-09-22 17:15:31,44aaf5416e0121500dd52b7cab306d7618b4fe53,Bram Moolenaar,8,6,14,3,"{""runtime/filetype.vim"": {""insertions"": 4, ""deletions"": 4, ""lines"": 8}, ""src/testdir/test_filetype.vim"": {""insertions"": 2, ""deletions"": 2, ""lines"": 4}, ""src/version.c"": {""insertions"": 2, ""deletions"": 0, ""lines"": 2}}"
2020-09-21 20:21:42,971caf53b81b7d1b6fb0bdf32990632975d54631,Bram Moolenaar,697,680,1377,6,"{""src/testdir/Make_all.mak"": {""insertions"": 2, ""deletions"": 0, ""lines"": 2}, ""src/testdir/test_vim9_assign.vim"": {""insertions"": 693, ""deletions"": 0, ""lines"": 693}, ""src/testdir/test_vim9_cmd.vim"": {""insertions"": 0, ""deletions"": 34, ""lines"": 34}, ""src/testdir/test_vim9_expr.vim"": {""insertions"": 0, ""deletions"": 12, ""lines"": 12}, ""src/testdir/test_vim9_script.vim"": {""insertions"": 0, ""deletions"": 634, ""lines"": 634}, ""src/version.c"": {""insertions"": 2, ""deletions"": 0, ""lines"": 2}}"
2020-09-21 20:02:49,280227270c1c54794a6d88a305fac56d4b0c92a5,Bram Moolenaar,12,1,13,3,"{""src/testdir/test_vim9_func.vim"": {""insertions"": 9, ""deletions"": 0, ""lines"": 9}, ""src/userfunc.c"": {""insertions"": 1, ""deletions"": 1, ""lines"": 2}, ""src/version.c"": {""insertions"": 2, ""deletions"": 0, ""lines"": 2}}"
2020-09-21 19:48:21,dbd759309b4b6abea96b18d61770e100cf4264b5,Bram Moolenaar,19,1,20,3,"{""src/testdir/test_vim9_expr.vim"": {""insertions"": 12, ""deletions"": 0, ""lines"": 12}, ""src/version.c"": {""insertions"": 2, ""deletions"": 0, ""lines"": 2}, ""src/vim9type.c"": {""insertions"": 5, ""deletions"": 1, ""lines"": 6}}"
2020-09-21 19:29:57,7f9c9c51a3680f120e1c3f2bb7239c9fa115b27f,Bram Moolenaar,3,1,4,2,"{""nsis/lang/russian.nsi"": {""insertions"": 1, ""deletions"": 1, ""lines"": 2}, ""src/version.c"": {""insertions"": 2, ""deletions"": 0, ""lines"": 2}}"
2020-09-21 18:35:55,078269bdce7e75d5693c7313d92a229786bb95ee,Bram Moolenaar,20,7,27,3,"{""src/testdir/test_vim9_script.vim"": {""insertions"": 8, ""deletions"": 0, ""lines"": 8}, ""src/version.c"": {""insertions"": 2, ""deletions"": 0, ""lines"": 2}, ""src/vim9compile.c"": {""insertions"": 10, ""deletions"": 7, ""lines"": 17}}"
2020-09-20 20:43:52,10e4f12bf4cd08328618bbf4e57a15435296e586,Bram Moolenaar,13,0,13,4,"{""src/errors.h"": {""insertions"": 2, ""deletions"": 0, ""lines"": 2}, ""src/testdir/test_vim9_expr.vim"": {""insertions"": 1, ""deletions"": 0, ""lines"": 1}, ""src/version.c"": {""insertions"": 2, ""deletions"": 0, ""lines"": 2}, ""src/vim9compile.c"": {""insertions"": 8, ""deletions"": 0, ""lines"": 8}}"
2020-09-20 20:04:00,b816dae16dbeec91ccb6fd1c0289b86b4ad5d7b3,Bram Moolenaar,14,2,16,3,"{""src/testdir/test_vim9_func.vim"": {""insertions"": 9, ""deletions"": 0, ""lines"": 9}, ""src/userfunc.c"": {""insertions"": 3, ""deletions"": 2, ""lines"": 5}, ""src/version.c"": {""insertions"": 2, ""deletions"": 0, ""lines"": 2}}"
2020-09-20 19:43:03,809fcecddce59ccb59384d63f5e0505c89f69209,Bram Moolenaar,290,0,290,3,"{""nsis/gvim.nsi"": {""insertions"": 1, ""deletions"": 0, ""lines"": 1}, ""nsis/lang/russian.nsi"": {""insertions"": 287, ""deletions"": 0, ""lines"": 287}, ""src/version.c"": {""insertions"": 2, ""deletions"": 0, ""lines"": 2}}"
2020-09-20 19:32:03,b5cfff0b34d1be87f7d0458e4b9addd71c5d5b1d,Bram Moolenaar,19,16,35,2,"{""runtime/optwin.vim"": {""insertions"": 17, ""deletions"": 16, ""lines"": 33}, ""src/version.c"": {""insertions"": 2, ""deletions"": 0, ""lines"": 2}}"
2020-09-20 19:13:27,26cd3063b2e2084cfd17989e7584c64f278aaaef,Bram Moolenaar,4,2,6,2,"{""src/gui_motif.c"": {""insertions"": 2, ""deletions"": 2, ""lines"": 4}, ""src/version.c"": {""insertions"": 2, ""deletions"": 0, ""lines"": 2}}"
2020-09-20 19:04:35,8902b31f1b31c117915defc23ac45cdc1f5c671b,Bram Moolenaar,19,0,19,3,"{""src/testdir/test_textprop.vim"": {""insertions"": 13, ""deletions"": 0, ""lines"": 13}, ""src/textprop.c"": {""insertions"": 4, ""deletions"": 0, ""lines"": 4}, ""src/version.c"": {""insertions"": 2, ""deletions"": 0, ""lines"": 2}}"
2020-09-20 17:57:15,7795bfea6d30c85f2c05d986a0cfe4019df4d74d,Bram Moolenaar,6,0,6,2,"{""src/gui_motif.c"": {""insertions"": 4, ""deletions"": 0, ""lines"": 4}, ""src/version.c"": {""insertions"": 2, ""deletions"": 0, ""lines"": 2}}"
2020-09-19 16:50:13,1d59aa1fdfb191d9872ff87eb94652acd374b293,Bram Moolenaar,557,201,758,19,"{"".github/CODEOWNERS"": {""insertions"": 80, ""deletions"": 20, ""lines"": 100}, ""nsis/lang/italian.nsi"": {""insertions"": 3, ""deletions"": 3, ""lines"": 6}, ""runtime/autoload/netrw.vim"": {""insertions"": 89, ""deletions"": 37, ""lines"": 126}, ""runtime/autoload/netrwFileHandlers.vim"": {""insertions"": 3, ""deletions"": 3, ""lines"": 6}, ""runtime/doc/cmdline.txt"": {""insertions"": 17, ""deletions"": 8, ""lines"": 25}, ""runtime/doc/eval.txt"": {""insertions"": 4, ""deletions"": 2, ""lines"": 6}, ""runtime/doc/insert.txt"": {""insertions"": 3, ""deletions"": 1, ""lines"": 4}, ""runtime/doc/map.txt"": {""insertions"": 2, ""deletions"": 2, ""lines"": 4}, ""runtime/doc/options.txt"": {""insertions"": 7, ""deletions"": 4, ""lines"": 11}, ""runtime/doc/pi_netrw.txt"": {""insertions"": 65, ""deletions"": 15, ""lines"": 80}, ""runtime/doc/popup.txt"": {""insertions"": 7, ""deletions"": 1, ""lines"": 8}, ""runtime/doc/tags"": {""insertions"": 8, ""deletions"": 1, ""lines"": 9}, ""runtime/doc/todo.txt"": {""insertions"": 28, ""deletions"": 31, ""lines"": 59}, ""runtime/doc/version8.txt"": {""insertions"": 2, ""deletions"": 2, ""lines"": 4}, ""runtime/doc/vim9.txt"": {""insertions"": 114, ""deletions"": 39, ""lines"": 153}, ""runtime/indent/erlang.vim"": {""insertions"": 120, ""deletions"": 27, ""lines"": 147}, ""runtime/plugin/netrwPlugin.vim"": {""insertions"": 1, ""deletions"": 1, ""lines"": 2}, ""runtime/syntax/erlang.vim"": {""insertions"": 3, ""deletions"": 3, ""lines"": 6}, ""runtime/syntax/netrw.vim"": {""insertions"": 1, ""deletions"": 1, ""lines"": 2}}"
2020-09-19 16:19:19,a05e524f3aa8eadc2dbd0ad8ff6db9407ac7ac7e,Bram Moolenaar,31,10,41,4,"{""src/proto/userfunc.pro"": {""insertions"": 1, ""deletions"": 0, ""lines"": 1}, ""src/userfunc.c"": {""insertions"": 12, ""deletions"": 5, ""lines"": 17}, ""src/version.c"": {""insertions"": 2, ""deletions"": 0, ""lines"": 2}, ""src/vim9compile.c"": {""insertions"": 16, ""deletions"": 5, ""lines"": 21}}"
2020-09-19 13:16:50,fdeab65db60929e28640fd740c333f9bcfea0e15,Bram Moolenaar,45,17,62,5,"{""src/proto/vim9compile.pro"": {""insertions"": 1, ""deletions"": 0, ""lines"": 1}, ""src/userfunc.c"": {""insertions"": 19, ""deletions"": 15, ""lines"": 34}, ""src/version.c"": {""insertions"": 2, ""deletions"": 0, ""lines"": 2}, ""src/vim9compile.c"": {""insertions"": 15, ""deletions"": 0, ""lines"": 15}, ""src/vim9execute.c"": {""insertions"": 8, ""deletions"": 2, ""lines"": 10}}"
2020-09-19 12:12:34,77b20977dc31ecf753dddad7a7c7b8f7b6e0c244,Bram Moolenaar,28,1,29,3,"{""src/testdir/test_vim9_expr.vim"": {""insertions"": 12, ""deletions"": 0, ""lines"": 12}, ""src/version.c"": {""insertions"": 2, ""deletions"": 0, ""lines"": 2}, ""src/vim9type.c"": {""insertions"": 14, ""deletions"": 1, ""lines"": 15}}"
2020-09-18 21:11:10,dec07510bbdf335a2de3d63591231a90ef3e4c80,Bram Moolenaar,3,0,3,2,"{""src/version.c"": {""insertions"": 2, ""deletions"": 0, ""lines"": 2}, ""src/vim9execute.c"": {""insertions"": 1, ""deletions"": 0, ""lines"": 1}}"
2020-09-18 20:42:00,b185a4074515f576b420cfc7a5a07f840cf6b51f,Bram Moolenaar,48,2,50,3,"{""src/testdir/test_vim9_func.vim"": {""insertions"": 44, ""deletions"": 0, ""lines"": 44}, ""src/version.c"": {""insertions"": 2, ""deletions"": 0, ""lines"": 2}, ""src/vim9compile.c"": {""insertions"": 2, ""deletions"": 2, ""lines"": 4}}"
2020-09-18 19:55:26,2bbada811625ee53c7bcdf689dbf409e9975ea8f,Bram Moolenaar,4,2,6,2,"{""src/testdir/test_highlight.vim"": {""insertions"": 2, ""deletions"": 2, ""lines"": 4}, ""src/version.c"": {""insertions"": 2, ""deletions"": 0, ""lines"": 2}}"
2020-09-18 19:25:32,7cbfaa51de7b225effdc79a008c71a5551883c38,Bram Moolenaar,23,7,30,3,"{""src/testdir/test_vim9_func.vim"": {""insertions"": 14, ""deletions"": 0, ""lines"": 14}, ""src/version.c"": {""insertions"": 2, ""deletions"": 0, ""lines"": 2}, ""src/vim9execute.c"": {""insertions"": 7, ""deletions"": 7, ""lines"": 14}}"
2020-09-18 17:40:45,e8df0104985af58ee501a6fbac8ac9f886e84e5a,Bram Moolenaar,48,9,57,3,"{""src/highlight.c"": {""insertions"": 12, ""deletions"": 9, ""lines"": 21}, ""src/testdir/test_highlight.vim"": {""insertions"": 34, ""deletions"": 0, ""lines"": 34}, ""src/version.c"": {""insertions"": 2, ""deletions"": 0, ""lines"": 2}}"
2020-09-17 19:29:03,77e5dcc36a82da040072d74e3ced410d15c42757,Bram Moolenaar,50,1,51,3,"{""src/testdir/test_vim9_script.vim"": {""insertions"": 39, ""deletions"": 0, ""lines"": 39}, ""src/version.c"": {""insertions"": 2, ""deletions"": 0, ""lines"": 2}, ""src/vim9execute.c"": {""insertions"": 9, ""deletions"": 1, ""lines"": 10}}"
2020-09-17 17:59:26,213da551dec465e193619684b260bf9d5a8d6afc,Bram Moolenaar,66,19,85,4,"{""runtime/doc/syntax.txt"": {""insertions"": 1, ""deletions"": 0, ""lines"": 1}, ""src/highlight.c"": {""insertions"": 20, ""deletions"": 10, ""lines"": 30}, ""src/testdir/test_highlight.vim"": {""insertions"": 43, ""deletions"": 9, ""lines"": 52}, ""src/version.c"": {""insertions"": 2, ""deletions"": 0, ""lines"": 2}}"
2020-09-17 17:36:04,da697645d5917eb3d4168c06c3442bef9fb746bf,Bram Moolenaar,23,2,25,3,"{""src/fold.c"": {""insertions"": 2, ""deletions"": 2, ""lines"": 4}, ""src/testdir/test_fold.vim"": {""insertions"": 19, ""deletions"": 0, ""lines"": 19}, ""src/version.c"": {""insertions"": 2, ""deletions"": 0, ""lines"": 2}}"
2020-09-16 21:23:36,08e51f446bd4bf1a0342c471163b1ed083e9eedb,Bram Moolenaar,24,10,34,3,"{""src/list.c"": {""insertions"": 17, ""deletions"": 10, ""lines"": 27}, ""src/testdir/test_vim9_func.vim"": {""insertions"": 5, ""deletions"": 0, ""lines"": 5}, ""src/version.c"": {""insertions"": 2, ""deletions"": 0, ""lines"": 2}}"
2020-09-16 20:29:52,9939f57b7f1c17a0142ebfe4f9e0b634158593e1,Bram Moolenaar,23,0,23,3,"{""src/testdir/test_vim9_script.vim"": {""insertions"": 20, ""deletions"": 0, ""lines"": 20}, ""src/version.c"": {""insertions"": 2, ""deletions"": 0, ""lines"": 2}, ""src/vim9execute.c"": {""insertions"": 1, ""deletions"": 0, ""lines"": 1}}"
2020-09-16 19:41:53,916911f598718bc76bc6b87ed703d2805fa49c53,Bram Moolenaar,4,0,4,2,"{""src/errors.h"": {""insertions"": 2, ""deletions"": 0, ""lines"": 2}, ""src/version.c"": {""insertions"": 2, ""deletions"": 0, ""lines"": 2}}"
2020-09-16 19:08:28,a187c43cfe8863d48b2159d695fedcb71f8525c1,Bram Moolenaar,93,44,137,11,"{""runtime/doc/eval.txt"": {""insertions"": 13, ""deletions"": 2, ""lines"": 15}, ""src/dict.c"": {""insertions"": 2, ""deletions"": 2, ""lines"": 4}, ""src/eval.c"": {""insertions"": 5, ""deletions"": 4, ""lines"": 9}, ""src/evalvars.c"": {""insertions"": 36, ""deletions"": 13, ""lines"": 49}, ""src/list.c"": {""insertions"": 13, ""deletions"": 13, ""lines"": 26}, ""src/proto/evalvars.pro"": {""insertions"": 2, ""deletions"": 1, ""lines"": 3}, ""src/testdir/test_const.vim"": {""insertions"": 8, ""deletions"": 0, ""lines"": 8}, ""src/testdir/test_listdict.vim"": {""insertions"": 8, ""deletions"": 5, ""lines"": 13}, ""src/typval.c"": {""insertions"": 2, ""deletions"": 2, ""lines"": 4}, ""src/userfunc.c"": {""insertions"": 2, ""deletions"": 2, ""lines"": 4}, ""src/version.c"": {""insertions"": 2, ""deletions"": 0, ""lines"": 2}}"
2020-09-16 15:55:40,7707228aace9aff16434edf5377a354c6ad07316,Bram Moolenaar,69,67,136,6,"{""src/errors.h"": {""insertions"": 36, ""deletions"": 36, ""lines"": 72}, ""src/testdir/test_assert.vim"": {""insertions"": 5, ""deletions"": 5, ""lines"": 10}, ""src/testdir/test_vim9_expr.vim"": {""insertions"": 15, ""deletions"": 15, ""lines"": 30}, ""src/testdir/test_vim9_func.vim"": {""insertions"": 10, ""deletions"": 10, ""lines"": 20}, ""src/testdir/test_vim9_script.vim"": {""insertions"": 1, ""deletions"": 1, ""lines"": 2}, ""src/version.c"": {""insertions"": 2, ""deletions"": 0, ""lines"": 2}}"
2020-09-16 15:30:27,2c12f890551bbdf5605472a4d711d48a273685d7,Bram Moolenaar,2,4,6,2,"{""src/spell.c"": {""insertions"": 0, ""deletions"": 4, ""lines"": 4}, ""src/version.c"": {""insertions"": 2, ""deletions"": 0, ""lines"": 2}}"
2020-09-16 15:22:59,2f8cbc4b225ba707c3926070a3f133eb0473aed2,Bram Moolenaar,14,2,16,4,"{""src/testdir/test_vim9_func.vim"": {""insertions"": 9, ""deletions"": 0, ""lines"": 9}, ""src/version.c"": {""insertions"": 2, ""deletions"": 0, ""lines"": 2}, ""src/vim9compile.c"": {""insertions"": 2, ""deletions"": 2, ""lines"": 4}, ""src/vim9execute.c"": {""insertions"": 1, ""deletions"": 0, ""lines"": 1}}"
2020-09-16 13:46:08,573545a55afb5d42614cdb69f356abb32409270b,Bram Moolenaar,4,1,5,2,"{""src/ops.c"": {""insertions"": 2, ""deletions"": 1, ""lines"": 3}, ""src/version.c"": {""insertions"": 2, ""deletions"": 0, ""lines"": 2}}"
2020-09-16 13:43:21,05eb5b9cae123b138bbd23cc77e50657ece6b4ad,Bram Moolenaar,38,2,40,3,"{""src/highlight.c"": {""insertions"": 4, ""deletions"": 2, ""lines"": 6}, ""src/testdir/test_highlight.vim"": {""insertions"": 32, ""deletions"": 0, ""lines"": 32}, ""src/version.c"": {""insertions"": 2, ""deletions"": 0, ""lines"": 2}}"
2020-09-16 13:41:09,fb489af2ec1b181d212a8aa8151d7784b260d01b,Bram Moolenaar,3,0,3,2,"{""src/structs.h"": {""insertions"": 1, ""deletions"": 0, ""lines"": 1}, ""src/version.c"": {""insertions"": 2, ""deletions"": 0, ""lines"": 2}}"
2020-09-16 13:22:00,5e654230777ad21363a929dce3cfe0387da031a7,Bram Moolenaar,258,154,412,13,"{""src/errors.h"": {""insertions"": 1, ""deletions"": 1, ""lines"": 2}, ""src/evalfunc.c"": {""insertions"": 9, ""deletions"": 6, ""lines"": 15}, ""src/globals.h"": {""insertions"": 35, ""deletions"": 36, ""lines"": 71}, ""src/proto/vim9type.pro"": {""insertions"": 3, ""deletions"": 1, ""lines"": 4}, ""src/testdir/test_vim9_disassemble.vim"": {""insertions"": 3, ""deletions"": 3, ""lines"": 6}, ""src/testdir/test_vim9_expr.vim"": {""insertions"": 16, ""deletions"": 13, ""lines"": 29}, ""src/testdir/test_vim9_func.vim"": {""insertions"": 20, ""deletions"": 20, ""lines"": 40}, ""src/testdir/test_vim9_script.vim"": {""insertions"": 24, ""deletions"": 6, ""lines"": 30}, ""src/version.c"": {""insertions"": 2, ""deletions"": 0, ""lines"": 2}, ""src/vim9.h"": {""insertions"": 1, ""deletions"": 1, ""lines"": 2}, ""src/vim9compile.c"": {""insertions"": 36, ""deletions"": 19, ""lines"": 55}, ""src/vim9execute.c"": {""insertions"": 21, ""deletions"": 26, ""lines"": 47}, ""src/vim9type.c"": {""insertions"": 87, ""deletions"": 22, ""lines"": 109}}"
2020-09-15 19:34:18,8b51b7f0f17af149a8ce76e805050977857f9e50,Bram Moolenaar,42,2,44,5,"{""src/change.c"": {""insertions"": 1, ""deletions"": 1, ""lines"": 2}, ""src/ops.c"": {""insertions"": 7, ""deletions"": 1, ""lines"": 8}, ""src/proto/change.pro"": {""insertions"": 1, ""deletions"": 0, ""lines"": 1}, ""src/testdir/test_textprop.vim"": {""insertions"": 31, ""deletions"": 0, ""lines"": 31}, ""src/version.c"": {""insertions"": 2, ""deletions"": 0, ""lines"": 2}}"
2020-09-15 18:52:26,ad5e5631c5dc93a50bbe637be254c5e9968848ea,Bram Moolenaar,63,1,64,5,"{""src/drawline.c"": {""insertions"": 5, ""deletions"": 1, ""lines"": 6}, ""src/testdir/dumps/Test_colorcolumn_2.dump"": {""insertions"": 10, ""deletions"": 0, ""lines"": 10}, ""src/testdir/dumps/Test_colorcolumn_3.dump"": {""insertions"": 10, ""deletions"": 0, ""lines"": 10}, ""src/testdir/test_highlight.vim"": {""insertions"": 36, ""deletions"": 0, ""lines"": 36}, ""src/version.c"": {""insertions"": 2, ""deletions"": 0, ""lines"": 2}}"
2020-09-15 18:34:10,c8f12c9856df58c760fe54d81b2ec5ed4dcaffd6,Bram Moolenaar,55,5,60,3,"{""src/ops.c"": {""insertions"": 32, ""deletions"": 4, ""lines"": 36}, ""src/testdir/test_textprop.vim"": {""insertions"": 21, ""deletions"": 1, ""lines"": 22}, ""src/version.c"": {""insertions"": 2, ""deletions"": 0, ""lines"": 2}}"
2020-09-14 20:39:11,9b123d859053ad1fb91d38334726b9f24da39930,Bram Moolenaar,4,1,5,2,"{""src/version.c"": {""insertions"": 2, ""deletions"": 0, ""lines"": 2}, ""src/vim9compile.c"": {""insertions"": 2, ""deletions"": 1, ""lines"": 3}}"
2020-09-14 20:28:30,71abe4828974af495602ffaff63cf643a16de84b,Bram Moolenaar,23,2,25,3,"{""src/testdir/test_vim9_script.vim"": {""insertions"": 18, ""deletions"": 0, ""lines"": 18}, ""src/version.c"": {""insertions"": 2, ""deletions"": 0, ""lines"": 2}, ""src/vim9compile.c"": {""insertions"": 3, ""deletions"": 2, ""lines"": 5}}"
2020-09-14 19:39:44,0b4c66c67a083f25816b9cdb8e76a41e02d9f560,Bram Moolenaar,204,38,242,12,"{""runtime/doc/vim9.txt"": {""insertions"": 67, ""deletions"": 15, ""lines"": 82}, ""src/errors.h"": {""insertions"": 8, ""deletions"": 0, ""lines"": 8}, ""src/eval.c"": {""insertions"": 1, ""deletions"": 1, ""lines"": 2}, ""src/evalvars.c"": {""insertions"": 8, ""deletions"": 7, ""lines"": 15}, ""src/ex_cmds.h"": {""insertions"": 1, ""deletions"": 1, ""lines"": 2}, ""src/proto/evalvars.pro"": {""insertions"": 2, ""deletions"": 1, ""lines"": 3}, ""src/testdir/test_vim9_script.vim"": {""insertions"": 40, ""deletions"": 0, ""lines"": 40}, ""src/version.c"": {""insertions"": 2, ""deletions"": 0, ""lines"": 2}, ""src/vim.h"": {""insertions"": 2, ""deletions"": 1, ""lines"": 3}, ""src/vim9.h"": {""insertions"": 2, ""deletions"": 0, ""lines"": 2}, ""src/vim9compile.c"": {""insertions"": 35, ""deletions"": 10, ""lines"": 45}, ""src/vim9execute.c"": {""insertions"": 36, ""deletions"": 2, ""lines"": 38}}"
2020-09-14 17:11:45,efd5d8a967ba80f9e2826c35be98344d8f00af77,Bram Moolenaar,29,1,30,3,"{""src/findfile.c"": {""insertions"": 7, ""deletions"": 0, ""lines"": 7}, ""src/testdir/test_gf.vim"": {""insertions"": 20, ""deletions"": 1, ""lines"": 21}, ""src/version.c"": {""insertions"": 2, ""deletions"": 0, ""lines"": 2}}"
2020-09-14 16:35:18,2b22b113c6aedf2a1295cf7e6f2f2a5d463b3868,Bram Moolenaar,23,7,30,2,"{""src/ex_docmd.c"": {""insertions"": 21, ""deletions"": 7, ""lines"": 28}, ""src/version.c"": {""insertions"": 2, ""deletions"": 0, ""lines"": 2}}"
2020-09-14 16:15:09,dbeecb2b6bc5bf90b7345807e0a313fe890a7c7b,Bram Moolenaar,20,9,29,4,"{""src/evalvars.c"": {""insertions"": 6, ""deletions"": 4, ""lines"": 10}, ""src/testdir/test_vim9_script.vim"": {""insertions"": 7, ""deletions"": 0, ""lines"": 7}, ""src/version.c"": {""insertions"": 2, ""deletions"": 0, ""lines"": 2}, ""src/vim9compile.c"": {""insertions"": 5, ""deletions"": 5, ""lines"": 10}}"
2020-09-14 15:04:31,08052228a72074cdb0165e65f01b2fa8fce867ea,Bram Moolenaar,47,46,93,3,"{""src/testdir/test_vim9_func.vim"": {""insertions"": 5, ""deletions"": 5, ""lines"": 10}, ""src/testdir/test_vim9_script.vim"": {""insertions"": 40, ""deletions"": 41, ""lines"": 81}, ""src/version.c"": {""insertions"": 2, ""deletions"": 0, ""lines"": 2}}"
2020-09-14 14:50:05,eb26f4331f607b1639bf01f4f35ad3ce7d20cb10,Bram Moolenaar,4,0,4,3,"{""src/testdir/test_vim9_expr.vim"": {""insertions"": 1, ""deletions"": 0, ""lines"": 1}, ""src/version.c"": {""insertions"": 2, ""deletions"": 0, ""lines"": 2}, ""src/vim9execute.c"": {""insertions"": 1, ""deletions"": 0, ""lines"": 1}}"
2020-09-14 14:37:34,3bd8de40b484d3617a19092d3cc036f8b4f3d51c,Bram Moolenaar,33,13,46,8,"{""src/cmdexpand.c"": {""insertions"": 1, ""deletions"": 1, ""lines"": 2}, ""src/ex_docmd.c"": {""insertions"": 8, ""deletions"": 5, ""lines"": 13}, ""src/ex_getln.c"": {""insertions"": 7, ""deletions"": 3, ""lines"": 10}, ""src/proto/ex_docmd.pro"": {""insertions"": 1, ""deletions"": 1, ""lines"": 2}, ""src/testdir/test_vim9_cmd.vim"": {""insertions"": 11, ""deletions"": 0, ""lines"": 11}, ""src/userfunc.c"": {""insertions"": 1, ""deletions"": 1, ""lines"": 2}, ""src/version.c"": {""insertions"": 2, ""deletions"": 0, ""lines"": 2}, ""src/vim9compile.c"": {""insertions"": 2, ""deletions"": 2, ""lines"": 4}}"
2020-09-13 20:37:34,d1f76afaf963be706697279ab0570ffcb8a1f2fc,Bram Moolenaar,8,0,8,3,"{""src/syntax.c"": {""insertions"": 2, ""deletions"": 0, ""lines"": 2}, ""src/testdir/test_syntax.vim"": {""insertions"": 4, ""deletions"": 0, ""lines"": 4}, ""src/version.c"": {""insertions"": 2, ""deletions"": 0, ""lines"": 2}}"
2020-09-13 20:21:22,4d170af0a9379da64d67dc3fa7cc7297956c6f52,Bram Moolenaar,62,5,67,3,"{""src/quickfix.c"": {""insertions"": 36, ""deletions"": 5, ""lines"": 41}, ""src/testdir/test_quickfix.vim"": {""insertions"": 24, ""deletions"": 0, ""lines"": 24}, ""src/version.c"": {""insertions"": 2, ""deletions"": 0, ""lines"": 2}}"
2020-09-13 20:00:12,a4224860a498eb870280130e00fe6f376b7a2e6b,Bram Moolenaar,4,2,6,2,"{""src/os_unix.c"": {""insertions"": 2, ""deletions"": 2, ""lines"": 4}, ""src/version.c"": {""insertions"": 2, ""deletions"": 0, ""lines"": 2}}"
2020-09-13 19:01:22,05c1acd5e1564ea4dbc7d4be26908af6909f43f6,Bram Moolenaar,3,1,4,2,"{""src/testdir/Make_ming.mak"": {""insertions"": 1, ""deletions"": 1, ""lines"": 2}, ""src/version.c"": {""insertions"": 2, ""deletions"": 0, ""lines"": 2}}"
2020-09-13 16:57:47,f0afd9e18227d3459c888584d0658a1837d2aaf8,Bram Moolenaar,15,1,16,3,"{""src/testdir/test_vim9_script.vim"": {""insertions"": 8, ""deletions"": 0, ""lines"": 8}, ""src/version.c"": {""insertions"": 2, ""deletions"": 0, ""lines"": 2}, ""src/vim9script.c"": {""insertions"": 5, ""deletions"": 1, ""lines"": 6}}"
2020-09-12 20:52:57,b806aa5bd910dba94fbde586f6019b4825813d28,Bram Moolenaar,21,0,21,3,"{""src/insexpand.c"": {""insertions"": 1, ""deletions"": 0, ""lines"": 1}, ""src/testdir/test_ins_complete.vim"": {""insertions"": 18, ""deletions"": 0, ""lines"": 18}, ""src/version.c"": {""insertions"": 2, ""deletions"": 0, ""lines"": 2}}"
2020-09-12 20:10:00,4a091b9978122428e7d9154d034c640c9c8d8c13,Bram Moolenaar,4,0,4,2,"{""src/eval.c"": {""insertions"": 2, ""deletions"": 0, ""lines"": 2}, ""src/version.c"": {""insertions"": 2, ""deletions"": 0, ""lines"": 2}}"
2020-09-12 19:27:03,c6e57b74fa1e6090a27f886e2b3830fd1fa15708,Bram Moolenaar,13,1,14,3,"{""src/eval.c"": {""insertions"": 1, ""deletions"": 1, ""lines"": 2}, ""src/testdir/test_vim9_expr.vim"": {""insertions"": 10, ""deletions"": 0, ""lines"": 10}, ""src/version.c"": {""insertions"": 2, ""deletions"": 0, ""lines"": 2}}"
2020-09-12 19:04:23,8f13d82fa6ac6faa1a91076e99000a8f02180e8e,Bram Moolenaar,4,2,6,3,"{""src/memline.c"": {""insertions"": 1, ""deletions"": 1, ""lines"": 2}, ""src/option.c"": {""insertions"": 1, ""deletions"": 1, ""lines"": 2}, ""src/version.c"": {""insertions"": 2, ""deletions"": 0, ""lines"": 2}}"
2020-09-12 17:51:42,b0fa5e17c587d9c71596bd10836918af713ffff6,Bram Moolenaar,20,14,34,2,"{""src/evalvars.c"": {""insertions"": 18, ""deletions"": 14, ""lines"": 32}, ""src/version.c"": {""insertions"": 2, ""deletions"": 0, ""lines"": 2}}"
2020-09-12 17:11:23,dadaddd59f3b53c41e92dc42219ab006deb14109,Bram Moolenaar,22,5,27,3,"{""src/testdir/test_vim9_expr.vim"": {""insertions"": 3, ""deletions"": 0, ""lines"": 3}, ""src/version.c"": {""insertions"": 2, ""deletions"": 0, ""lines"": 2}, ""src/vim9execute.c"": {""insertions"": 17, ""deletions"": 5, ""lines"": 22}}"
2020-09-12 16:32:34,0f769815c82bf93812842e1ad56fcc52c10ff3e5,Bram Moolenaar,82,19,101,5,"{""src/proto/userfunc.pro"": {""insertions"": 1, ""deletions"": 0, ""lines"": 1}, ""src/testdir/test_vim9_func.vim"": {""insertions"": 30, ""deletions"": 0, ""lines"": 30}, ""src/userfunc.c"": {""insertions"": 10, ""deletions"": 1, ""lines"": 11}, ""src/version.c"": {""insertions"": 2, ""deletions"": 0, ""lines"": 2}, ""src/vim9compile.c"": {""insertions"": 39, ""deletions"": 18, ""lines"": 57}}"
2020-09-12 12:53:53,b00ef0508b22905379953a164bdb4300015d3705,Bram Moolenaar,92,31,123,3,"{""src/option.c"": {""insertions"": 60, ""deletions"": 31, ""lines"": 91}, ""src/testdir/test_options.vim"": {""insertions"": 30, ""deletions"": 0, ""lines"": 30}, ""src/version.c"": {""insertions"": 2, ""deletions"": 0, ""lines"": 2}}"
2020-09-11 20:25:15,635414dd2f3ae7d4d972d79b806348a6516cb91a,Bram Moolenaar,393,0,393,7,"{""runtime/doc/eval.txt"": {""insertions"": 24, ""deletions"": 0, ""lines"": 24}, ""runtime/doc/usr_41.txt"": {""insertions"": 1, ""deletions"": 0, ""lines"": 1}, ""src/evalfunc.c"": {""insertions"": 1, ""deletions"": 0, ""lines"": 1}, ""src/proto/search.pro"": {""insertions"": 1, ""deletions"": 0, ""lines"": 1}, ""src/search.c"": {""insertions"": 340, ""deletions"": 0, ""lines"": 340}, ""src/testdir/test_functions.vim"": {""insertions"": 24, ""deletions"": 0, ""lines"": 24}, ""src/version.c"": {""insertions"": 2, ""deletions"": 0, ""lines"": 2}}"
2020-09-11 20:10:22,c2c820563441499892359da949db3c8f7f16d109,Bram Moolenaar,40,25,65,4,"{""src/session.c"": {""insertions"": 12, ""deletions"": 20, ""lines"": 32}, ""src/terminal.c"": {""insertions"": 2, ""deletions"": 2, ""lines"": 4}, ""src/testdir/test_mksession.vim"": {""insertions"": 24, ""deletions"": 3, ""lines"": 27}, ""src/version.c"": {""insertions"": 2, ""deletions"": 0, ""lines"": 2}}"
2020-09-11 18:51:26,14944c04bd15f3bc67a6665d7234e44bd77b495d,Bram Moolenaar,442,448,890,2,"{""runtime/optwin.vim"": {""insertions"": 440, ""deletions"": 448, ""lines"": 888}, ""src/version.c"": {""insertions"": 2, ""deletions"": 0, ""lines"": 2}}"
2020-09-11 18:36:36,0e655111e9dbdbdf69fee1b199f2b9c355bf4a10,Bram Moolenaar,141,53,194,6,"{""src/hashtab.c"": {""insertions"": 1, ""deletions"": 1, ""lines"": 2}, ""src/proto/terminal.pro"": {""insertions"": 1, ""deletions"": 1, ""lines"": 2}, ""src/session.c"": {""insertions"": 75, ""deletions"": 49, ""lines"": 124}, ""src/terminal.c"": {""insertions"": 36, ""deletions"": 2, ""lines"": 38}, ""src/testdir/test_mksession.vim"": {""insertions"": 26, ""deletions"": 0, ""lines"": 26}, ""src/version.c"": {""insertions"": 2, ""deletions"": 0, ""lines"": 2}}"
2020-09-11 17:28:19,c6a67c92bcbf4ef09063814af0c65d3e0585ada0,Bram Moolenaar,4,2,6,2,"{""src/channel.c"": {""insertions"": 2, ""deletions"": 2, ""lines"": 4}, ""src/version.c"": {""insertions"": 2, ""deletions"": 0, ""lines"": 2}}"
2020-09-11 17:09:48,c0c71e9d9813f025c5fc1ce84eae309843395199,Bram Moolenaar,203,202,405,2,"{""src/testdir/test_vim9_func.vim"": {""insertions"": 201, ""deletions"": 202, ""lines"": 403}, ""src/version.c"": {""insertions"": 2, ""deletions"": 0, ""lines"": 2}}"
2020-09-11 16:11:50,96fdf4348a50cdbe6b8f18ccb4806ba5b190989e,Bram Moolenaar,34,0,34,3,"{""src/testdir/test_spell.vim"": {""insertions"": 1, ""deletions"": 0, ""lines"": 1}, ""src/testdir/test_spellfile.vim"": {""insertions"": 31, ""deletions"": 0, ""lines"": 31}, ""src/version.c"": {""insertions"": 2, ""deletions"": 0, ""lines"": 2}}"
2020-09-11 15:59:23,a810db3f17d477e057059c72062c08fd97bcea43,Bram Moolenaar,9,6,15,3,"{""src/scriptfile.c"": {""insertions"": 6, ""deletions"": 5, ""lines"": 11}, ""src/testdir/test_expand_func.vim"": {""insertions"": 1, ""deletions"": 1, ""lines"": 2}, ""src/version.c"": {""insertions"": 2, ""deletions"": 0, ""lines"": 2}}"
2020-09-10 20:28:01,8b848cafb0a88f8d8e8f46caa8d67431b4faa374,Bram Moolenaar,27,0,27,4,"{""src/errors.h"": {""insertions"": 2, ""deletions"": 0, ""lines"": 2}, ""src/testdir/test_vim9_func.vim"": {""insertions"": 17, ""deletions"": 0, ""lines"": 17}, ""src/version.c"": {""insertions"": 2, ""deletions"": 0, ""lines"": 2}, ""src/vim9compile.c"": {""insertions"": 6, ""deletions"": 0, ""lines"": 6}}"
2020-09-10 20:05:08,dfa3d5524e816c1ff7f603f9f3b7703a53a0f822,Bram Moolenaar,23,0,23,3,"{""src/testdir/test_vim9_func.vim"": {""insertions"": 20, ""deletions"": 0, ""lines"": 20}, ""src/version.c"": {""insertions"": 2, ""deletions"": 0, ""lines"": 2}, ""src/vim9execute.c"": {""insertions"": 1, ""deletions"": 0, ""lines"": 1}}"
2020-09-10 19:36:11,895a7a472d2eb4413e63cdad3213cb1ef1633458,Bram Moolenaar,11,0,11,2,"{""src/if_perl.xs"": {""insertions"": 9, ""deletions"": 0, ""lines"": 9}, ""src/version.c"": {""insertions"": 2, ""deletions"": 0, ""lines"": 2}}"
2020-09-10 19:25:45,ad9ec5e79916d206fd7677b77e36485c47ae534f,Bram Moolenaar,11,9,20,2,"{""src/channel.c"": {""insertions"": 9, ""deletions"": 9, ""lines"": 18}, ""src/version.c"": {""insertions"": 2, ""deletions"": 0, ""lines"": 2}}"
2020-09-10 17:25:05,4f25b1aba050b85fa97ca2316aa04dd4b0b22530,Bram Moolenaar,40,22,62,10,"{""src/debugger.c"": {""insertions"": 3, ""deletions"": 3, ""lines"": 6}, ""src/ex_docmd.c"": {""insertions"": 3, ""deletions"": 1, ""lines"": 4}, ""src/ex_eval.c"": {""insertions"": 2, ""deletions"": 2, ""lines"": 4}, ""src/message.c"": {""insertions"": 1, ""deletions"": 1, ""lines"": 2}, ""src/proto/scriptfile.pro"": {""insertions"": 1, ""deletions"": 1, ""lines"": 2}, ""src/scriptfile.c"": {""insertions"": 14, ""deletions"": 7, ""lines"": 21}, ""src/testdir/test_expand_func.vim"": {""insertions"": 5, ""deletions"": 4, ""lines"": 9}, ""src/testing.c"": {""insertions"": 1, ""deletions"": 1, ""lines"": 2}, ""src/version.c"": {""insertions"": 2, ""deletions"": 0, ""lines"": 2}, ""src/vim.h"": {""insertions"": 8, ""deletions"": 2, ""lines"": 10}}"
2020-09-10 12:25:25,a953b5cf4f291875b805262eebd361e502de8c92,Bram Moolenaar,38,28,66,2,"{""runtime/optwin.vim"": {""insertions"": 36, ""deletions"": 28, ""lines"": 64}, ""src/version.c"": {""insertions"": 2, ""deletions"": 0, ""lines"": 2}}"
2020-09-09 20:43:19,64e2db6dc6d7a013ff94ce302af8958cbd2704af,Bram Moolenaar,68,0,68,2,"{""src/testdir/test_spellfile.vim"": {""insertions"": 66, ""deletions"": 0, ""lines"": 66}, ""src/version.c"": {""insertions"": 2, ""deletions"": 0, ""lines"": 2}}"
2020-09-09 20:27:58,c1ec0422e43720d2e96627605532ee9806c0789f,Bram Moolenaar,92,29,121,8,"{""src/eval.c"": {""insertions"": 7, ""deletions"": 0, ""lines"": 7}, ""src/evalvars.c"": {""insertions"": 14, ""deletions"": 3, ""lines"": 17}, ""src/proto/vim9type.pro"": {""insertions"": 1, ""deletions"": 0, ""lines"": 1}, ""src/structs.h"": {""insertions"": 4, ""deletions"": 3, ""lines"": 7}, ""src/testdir/test_vim9_script.vim"": {""insertions"": 6, ""deletions"": 6, ""lines"": 12}, ""src/version.c"": {""insertions"": 2, ""deletions"": 0, ""lines"": 2}, ""src/vim9script.c"": {""insertions"": 14, ""deletions"": 1, ""lines"": 15}, ""src/vim9type.c"": {""insertions"": 44, ""deletions"": 16, ""lines"": 60}}"
2020-09-09 18:58:55,3e4cc9671c5551b73f0176cab40e676ed72a1716,Bram Moolenaar,29,6,35,2,"{""src/gui_gtk.c"": {""insertions"": 27, ""deletions"": 6, ""lines"": 33}, ""src/version.c"": {""insertions"": 2, ""deletions"": 0, ""lines"": 2}}"
2020-09-09 18:41:40,a62372be1f73b69f9d4c9413ec816d773a16a0f5,Bram Moolenaar,212,156,368,5,"{""Filelist"": {""insertions"": 1, ""deletions"": 1, ""lines"": 2}, ""src/INSTALLami.txt"": {""insertions"": 8, ""deletions"": 23, ""lines"": 31}, ""src/Make_ami.mak"": {""insertions"": 201, ""deletions"": 0, ""lines"": 201}, ""src/Make_morph.mak"": {""insertions"": 0, ""deletions"": 132, ""lines"": 132}, ""src/version.c"": {""insertions"": 2, ""deletions"": 0, ""lines"": 2}}"
2020-09-09 18:03:46,4ed124cc6c0c55385c3b2fed9f9357baf42edbcc,Bram Moolenaar,66,2,68,4,"{""src/testdir/test_vim9_disassemble.vim"": {""insertions"": 23, ""deletions"": 0, ""lines"": 23}, ""src/testdir/test_vim9_script.vim"": {""insertions"": 16, ""deletions"": 2, ""lines"": 18}, ""src/version.c"": {""insertions"": 2, ""deletions"": 0, ""lines"": 2}, ""src/vim9compile.c"": {""insertions"": 25, ""deletions"": 0, ""lines"": 25}}"
2020-09-09 17:25:09,33e3346322e40b2877f63f2f37398832c7017e2f,Bram Moolenaar,2,4,6,1,"{""src/version.c"": {""insertions"": 2, ""deletions"": 4, ""lines"": 6}}"
2020-09-09 17:05:13,81a4cf469a0f5c1603ac3130af9f011053854180,Bram Moolenaar,8,4,12,2,"{""src/gui_gtk_x11.c"": {""insertions"": 6, ""deletions"": 4, ""lines"": 10}, ""src/version.c"": {""insertions"": 2, ""deletions"": 0, ""lines"": 2}}"
2020-09-09 16:54:42,ba7c0d7b4ce03336b4aebe1959c1a8342fa6dbd4,Bram Moolenaar,43,11,54,5,"{""src/testdir/test_vim9_expr.vim"": {""insertions"": 1, ""deletions"": 1, ""lines"": 2}, ""src/testdir/test_vim9_script.vim"": {""insertions"": 21, ""deletions"": 3, ""lines"": 24}, ""src/testdir/vim9.vim"": {""insertions"": 1, ""deletions"": 1, ""lines"": 2}, ""src/version.c"": {""insertions"": 2, ""deletions"": 0, ""lines"": 2}, ""src/vim9type.c"": {""insertions"": 18, ""deletions"": 6, ""lines"": 24}}"
2020-09-09 15:08:51,96f8f499ce51ea791d9b044c266f84380fa54848,Bram Moolenaar,6,2,8,2,"{""src/userfunc.c"": {""insertions"": 4, ""deletions"": 2, ""lines"": 6}, ""src/version.c"": {""insertions"": 2, ""deletions"": 0, ""lines"": 2}}"
2020-09-09 13:10:52,4507f6ada590fb6274b21c416190dfecb23dcf1b,Bram Moolenaar,3,1,4,2,"{""runtime/optwin.vim"": {""insertions"": 1, ""deletions"": 1, ""lines"": 2}, ""src/version.c"": {""insertions"": 2, ""deletions"": 0, ""lines"": 2}}"
2020-09-09 12:55:31,29a86ffee794bc1a0efde215c203cf9529047252,Bram Moolenaar,27,1,28,6,"{""src/proto/vim9type.pro"": {""insertions"": 1, ""deletions"": 0, ""lines"": 1}, ""src/structs.h"": {""insertions"": 1, ""deletions"": 0, ""lines"": 1}, ""src/testdir/test_vim9_script.vim"": {""insertions"": 5, ""deletions"": 0, ""lines"": 5}, ""src/version.c"": {""insertions"": 2, ""deletions"": 0, ""lines"": 2}, ""src/vim9compile.c"": {""insertions"": 13, ""deletions"": 0, ""lines"": 13}, ""src/vim9type.c"": {""insertions"": 5, ""deletions"": 1, ""lines"": 6}}"
2020-09-09 11:01:27,f842cd9e285afb9d86c6f9bff400e5e576f873c0,Bram Moolenaar,3,0,3,2,"{""src/os_amiga.h"": {""insertions"": 1, ""deletions"": 0, ""lines"": 1}, ""src/version.c"": {""insertions"": 2, ""deletions"": 0, ""lines"": 2}}"
2020-09-09 10:56:30,64075b0ab18449132ed01a07874fe1d1f3f356d4,Bram Moolenaar,110,105,215,2,"{""runtime/optwin.vim"": {""insertions"": 108, ""deletions"": 105, ""lines"": 213}, ""src/version.c"": {""insertions"": 2, ""deletions"": 0, ""lines"": 2}}"
2020-09-08 20:55:26,8e9be208ea58149c4e522166a6194da18a2eced7,Bram Moolenaar,25,21,46,2,"{""src/popupwin.c"": {""insertions"": 23, ""deletions"": 21, ""lines"": 44}, ""src/version.c"": {""insertions"": 2, ""deletions"": 0, ""lines"": 2}}"
2020-09-08 20:45:35,c3516f7e4507c77424b94cb89071f6d0841f4e6a,Bram Moolenaar,158,13,171,12,"{""src/edit.c"": {""insertions"": 2, ""deletions"": 2, ""lines"": 4}, ""src/ex_docmd.c"": {""insertions"": 1, ""deletions"": 1, ""lines"": 2}, ""src/mouse.c"": {""insertions"": 3, ""deletions"": 2, ""lines"": 5}, ""src/normal.c"": {""insertions"": 2, ""deletions"": 2, ""lines"": 4}, ""src/proto/register.pro"": {""insertions"": 1, ""deletions"": 1, ""lines"": 2}, ""src/register.c"": {""insertions"": 7, ""deletions"": 5, ""lines"": 12}, ""src/testdir/test_vim9_cmd.vim"": {""insertions"": 16, ""deletions"": 0, ""lines"": 16}, ""src/testdir/test_vim9_disassemble.vim"": {""insertions"": 15, ""deletions"": 0, ""lines"": 15}, ""src/version.c"": {""insertions"": 2, ""deletions"": 0, ""lines"": 2}, ""src/vim9.h"": {""insertions"": 9, ""deletions"": 0, ""lines"": 9}, ""src/vim9compile.c"": {""insertions"": 66, ""deletions"": 0, ""lines"": 66}, ""src/vim9execute.c"": {""insertions"": 34, ""deletions"": 0, ""lines"": 34}}"
2020-09-08 20:06:44,6defa7bf0a8935cc44f3dc12e9c87bbb40f190b7,Bram Moolenaar,99,3,102,7,"{""src/popupwin.c"": {""insertions"": 28, ""deletions"": 2, ""lines"": 30}, ""src/structs.h"": {""insertions"": 1, ""deletions"": 0, ""lines"": 1}, ""src/testdir/dumps/Test_popupwin_three_errors_1.dump"": {""insertions"": 10, ""deletions"": 0, ""lines"": 10}, ""src/testdir/dumps/Test_popupwin_three_errors_2.dump"": {""insertions"": 10, ""deletions"": 0, ""lines"": 10}, ""src/testdir/dumps/Test_popupwin_wrong_name.dump"": {""insertions"": 10, ""deletions"": 0, ""lines"": 10}, ""src/testdir/test_popupwin.vim"": {""insertions"": 38, ""deletions"": 1, ""lines"": 39}, ""src/version.c"": {""insertions"": 2, ""deletions"": 0, ""lines"": 2}}"
2020-09-08 17:06:30,57ad94c5a9ee6f3626e1ec728519a8558a4346c8,Bram Moolenaar,4,0,4,3,"{""runtime/doc/digraph.txt"": {""insertions"": 1, ""deletions"": 0, ""lines"": 1}, ""src/digraph.c"": {""insertions"": 1, ""deletions"": 0, ""lines"": 1}, ""src/version.c"": {""insertions"": 2, ""deletions"": 0, ""lines"": 2}}"
2020-09-07 20:18:52,1c6737b20a5cf71751b180461cea22fc76d8870c,Bram Moolenaar,1272,307,1579,35,"{"".github/CODEOWNERS"": {""insertions"": 49, ""deletions"": 7, ""lines"": 56}, ""runtime/compiler/dart.vim"": {""insertions"": 26, ""deletions"": 0, ""lines"": 26}, ""runtime/compiler/dart2js.vim"": {""insertions"": 28, ""deletions"": 0, ""lines"": 28}, ""runtime/compiler/dart2native.vim"": {""insertions"": 28, ""deletions"": 0, ""lines"": 28}, ""runtime/compiler/dartanalyser.vim"": {""insertions"": 23, ""deletions"": 0, ""lines"": 23}, ""runtime/compiler/dartdevc.vim"": {""insertions"": 28, ""deletions"": 0, ""lines"": 28}, ""runtime/compiler/dartdoc.vim"": {""insertions"": 26, ""deletions"": 0, ""lines"": 26}, ""runtime/compiler/dartfmt.vim"": {""insertions"": 25, ""deletions"": 0, ""lines"": 25}, ""runtime/compiler/javac.vim"": {""insertions"": 12, ""deletions"": 3, ""lines"": 15}, ""runtime/compiler/rhino.vim"": {""insertions"": 30, ""deletions"": 0, ""lines"": 30}, ""runtime/compiler/xmllint.vim"": {""insertions"": 10, ""deletions"": 8, ""lines"": 18}, ""runtime/doc/eval.txt"": {""insertions"": 10, ""deletions"": 8, ""lines"": 18}, ""runtime/doc/map.txt"": {""insertions"": 37, ""deletions"": 32, ""lines"": 69}, ""runtime/doc/message.txt"": {""insertions"": 2, ""deletions"": 2, ""lines"": 4}, ""runtime/doc/options.txt"": {""insertions"": 7, ""deletions"": 4, ""lines"": 11}, ""runtime/doc/pattern.txt"": {""insertions"": 14, ""deletions"": 10, ""lines"": 24}, ""runtime/doc/tags"": {""insertions"": 3, ""deletions"": 1, ""lines"": 4}, ""runtime/doc/terminal.txt"": {""insertions"": 5, ""deletions"": 3, ""lines"": 8}, ""runtime/doc/testing.txt"": {""insertions"": 1, ""deletions"": 1, ""lines"": 2}, ""runtime/doc/todo.txt"": {""insertions"": 39, ""deletions"": 17, ""lines"": 56}, ""runtime/doc/usr_03.txt"": {""insertions"": 10, ""deletions"": 9, ""lines"": 19}, ""runtime/doc/usr_40.txt"": {""insertions"": 5, ""deletions"": 5, ""lines"": 10}, ""runtime/doc/usr_41.txt"": {""insertions"": 24, ""deletions"": 24, ""lines"": 48}, ""runtime/doc/version5.txt"": {""insertions"": 2, ""deletions"": 2, ""lines"": 4}, ""runtime/doc/vim9.txt"": {""insertions"": 67, ""deletions"": 55, ""lines"": 122}, ""runtime/doc/windows.txt"": {""insertions"": 4, ""deletions"": 4, ""lines"": 8}, ""runtime/ftplugin/spec.vim"": {""insertions"": 3, ""deletions"": 5, ""lines"": 8}, ""runtime/indent/json.vim"": {""insertions"": 12, ""deletions"": 10, ""lines"": 22}, ""runtime/keymap/french-azerty.vim"": {""insertions"": 81, ""deletions"": 0, ""lines"": 81}, ""runtime/keymap/german-qwertz.vim"": {""insertions"": 76, ""deletions"": 0, ""lines"": 76}, ""runtime/keymap/turkish-f.vim"": {""insertions"": 1, ""deletions"": 0, ""lines"": 1}, ""runtime/syntax/php.vim"": {""insertions"": 88, ""deletions"": 40, ""lines"": 128}, ""runtime/tutor/tutor"": {""insertions"": 4, ""deletions"": 2, ""lines"": 6}, ""runtime/tutor/tutor.utf-8"": {""insertions"": 4, ""deletions"": 2, ""lines"": 6}, ""src/po/tr.po"": {""insertions"": 488, ""deletions"": 53, ""lines"": 541}}"
2020-09-07 20:05:28,9c929713b7588f2e44a1533809d2ba0bbd2631be,Bram Moolenaar,277,215,492,3,"{""src/ex_getln.c"": {""insertions"": 266, ""deletions"": 215, ""lines"": 481}, ""src/testdir/test_cmdline.vim"": {""insertions"": 9, ""deletions"": 0, ""lines"": 9}, ""src/version.c"": {""insertions"": 2, ""deletions"": 0, ""lines"": 2}}"
2020-09-07 16:53:21,e83cca291112ea66f49079975e102ee36a47a24e,Bram Moolenaar,9,7,16,4,"{""src/regexp.c"": {""insertions"": 1, ""deletions"": 1, ""lines"": 2}, ""src/regexp_bt.c"": {""insertions"": 5, ""deletions"": 5, ""lines"": 10}, ""src/regexp_nfa.c"": {""insertions"": 1, ""deletions"": 1, ""lines"": 2}, ""src/version.c"": {""insertions"": 2, ""deletions"": 0, ""lines"": 2}}"
2020-09-06 20:26:57,44d6652d561d628d12e3ff7f6636ea7d1f805ced,Bram Moolenaar,63,29,92,6,"{""src/errors.h"": {""insertions"": 6, ""deletions"": 0, ""lines"": 6}, ""src/testdir/test_assert.vim"": {""insertions"": 14, ""deletions"": 0, ""lines"": 14}, ""src/testdir/test_vim9_func.vim"": {""insertions"": 1, ""deletions"": 1, ""lines"": 2}, ""src/testdir/test_vim9_script.vim"": {""insertions"": 15, ""deletions"": 15, ""lines"": 30}, ""src/testing.c"": {""insertions"": 25, ""deletions"": 13, ""lines"": 38}, ""src/version.c"": {""insertions"": 2, ""deletions"": 0, ""lines"": 2}}"
2020-09-06 19:47:48,9bd5d879c2ecfbdbb168b090e12f4b89724a302e,Bram Moolenaar,50,26,76,7,"{""runtime/doc/testing.txt"": {""insertions"": 5, ""deletions"": 1, ""lines"": 6}, ""src/evalfunc.c"": {""insertions"": 1, ""deletions"": 1, ""lines"": 2}, ""src/globals.h"": {""insertions"": 1, ""deletions"": 0, ""lines"": 1}, ""src/message.c"": {""insertions"": 3, ""deletions"": 0, ""lines"": 3}, ""src/testdir/test_vim9_func.vim"": {""insertions"": 15, ""deletions"": 15, ""lines"": 30}, ""src/testing.c"": {""insertions"": 23, ""deletions"": 9, ""lines"": 32}, ""src/version.c"": {""insertions"": 2, ""deletions"": 0, ""lines"": 2}}"
2020-09-06 19:13:00,c98cdb3bc970f04f93b4c394b4ec94c2eb5546c3,Bram Moolenaar,5,3,8,3,"{""src/testdir/test_terminal.vim"": {""insertions"": 1, ""deletions"": 1, ""lines"": 2}, ""src/testdir/test_terminal2.vim"": {""insertions"": 2, ""deletions"": 2, ""lines"": 4}, ""src/version.c"": {""insertions"": 2, ""deletions"": 0, ""lines"": 2}}"
2020-09-06 18:06:59,63969ef07e99502744114717cb7d63bd4c6e7eae,Bram Moolenaar,18,8,26,2,"{""src/testdir/test_vim9_func.vim"": {""insertions"": 16, ""deletions"": 8, ""lines"": 24}, ""src/version.c"": {""insertions"": 2, ""deletions"": 0, ""lines"": 2}}"
2020-09-06 16:39:38,418155def2aa45afd7fc034db341dc874b00af3a,Bram Moolenaar,11,1,12,3,"{""src/testdir/test_vim9_func.vim"": {""insertions"": 8, ""deletions"": 0, ""lines"": 8}, ""src/time.c"": {""insertions"": 1, ""deletions"": 1, ""lines"": 2}, ""src/version.c"": {""insertions"": 2, ""deletions"": 0, ""lines"": 2}}"
2020-09-06 16:22:53,ad30470610e228e66afb837fdbab6bea36c43de4,Bram Moolenaar,28,3,31,5,"{""src/evalfunc.c"": {""insertions"": 1, ""deletions"": 1, ""lines"": 2}, ""src/job.c"": {""insertions"": 1, ""deletions"": 1, ""lines"": 2}, ""src/terminal.c"": {""insertions"": 1, ""deletions"": 1, ""lines"": 2}, ""src/testdir/test_vim9_func.vim"": {""insertions"": 23, ""deletions"": 0, ""lines"": 23}, ""src/version.c"": {""insertions"": 2, ""deletions"": 0, ""lines"": 2}}"
2020-09-06 15:13:44,707be5f3524accb8b36e80bd2532e00b8246df55,Bram Moolenaar,3,1,4,2,"{""src/testdir/test_utf8.vim"": {""insertions"": 1, ""deletions"": 1, ""lines"": 2}, ""src/version.c"": {""insertions"": 2, ""deletions"": 0, ""lines"": 2}}"
2020-09-06 15:09:12,30d6413782c8206899cee109f521895a03c76441,Bram Moolenaar,4,2,6,2,"{""src/regexp.c"": {""insertions"": 2, ""deletions"": 2, ""lines"": 4}, ""src/version.c"": {""insertions"": 2, ""deletions"": 0, ""lines"": 2}}"
2020-09-06 14:09:04,3986b94b090ea258109630008611230a599999ab,Bram Moolenaar,18,4,22,3,"{""src/evalfunc.c"": {""insertions"": 4, ""deletions"": 4, ""lines"": 8}, ""src/testdir/test_vim9_func.vim"": {""insertions"": 12, ""deletions"": 0, ""lines"": 12}, ""src/version.c"": {""insertions"": 2, ""deletions"": 0, ""lines"": 2}}"
2020-09-06 13:58:36,d2c617055ac8ff6ff244f69e23dce1f73741c5ad,Bram Moolenaar,263,261,524,7,"{""src/testdir/test_maparg.vim"": {""insertions"": 1, ""deletions"": 1, ""lines"": 2}, ""src/testdir/test_textprop.vim"": {""insertions"": 4, ""deletions"": 4, ""lines"": 8}, ""src/testdir/test_vim9_disassemble.vim"": {""insertions"": 6, ""deletions"": 6, ""lines"": 12}, ""src/testdir/test_vim9_expr.vim"": {""insertions"": 61, ""deletions"": 61, ""lines"": 122}, ""src/testdir/test_vim9_func.vim"": {""insertions"": 34, ""deletions"": 34, ""lines"": 68}, ""src/testdir/test_vim9_script.vim"": {""insertions"": 155, ""deletions"": 155, ""lines"": 310}, ""src/version.c"": {""insertions"": 2, ""deletions"": 0, ""lines"": 2}}"
2020-09-06 13:54:00,2f3cd2e4ec5617e3697ec4f4c6e1c9449061ad30,Bram Moolenaar,504,383,887,2,"{""src/ex_getln.c"": {""insertions"": 502, ""deletions"": 383, ""lines"": 885}, ""src/version.c"": {""insertions"": 2, ""deletions"": 0, ""lines"": 2}}"
2020-09-06 13:14:45,8a0dcf43305586853f452a77fa295b0c8d54b463,Bram Moolenaar,9,0,9,3,"{""src/regexp.c"": {""insertions"": 1, ""deletions"": 0, ""lines"": 1}, ""src/testdir/test_substitute.vim"": {""insertions"": 6, ""deletions"": 0, ""lines"": 6}, ""src/version.c"": {""insertions"": 2, ""deletions"": 0, ""lines"": 2}}"
2020-09-05 21:16:00,4140c4f3fff1a441f2837f2f911ab0f0368e412a,Bram Moolenaar,3,1,4,2,"{""src/search.c"": {""insertions"": 1, ""deletions"": 1, ""lines"": 2}, ""src/version.c"": {""insertions"": 2, ""deletions"": 0, ""lines"": 2}}"
2020-09-05 20:45:55,7c27f337bf278babc1ccdcb66ac975f115d660b7,Bram Moolenaar,11,1,12,3,"{""src/evalfunc.c"": {""insertions"": 1, ""deletions"": 1, ""lines"": 2}, ""src/testdir/test_vim9_func.vim"": {""insertions"": 8, ""deletions"": 0, ""lines"": 8}, ""src/version.c"": {""insertions"": 2, ""deletions"": 0, ""lines"": 2}}"
2020-09-05 20:37:39,401f0c07982247cc6d1cd22be08b05c44f7fd040,Bram Moolenaar,10,1,11,3,"{""src/quickfix.c"": {""insertions"": 1, ""deletions"": 1, ""lines"": 2}, ""src/testdir/test_vim9_func.vim"": {""insertions"": 7, ""deletions"": 0, ""lines"": 7}, ""src/version.c"": {""insertions"": 2, ""deletions"": 0, ""lines"": 2}}"
2020-09-05 19:57:53,4b9bd692bdffba03fda04f9979e25431b53e416b,Bram Moolenaar,138,126,264,3,"{""src/evalwindow.c"": {""insertions"": 2, ""deletions"": 2, ""lines"": 4}, ""src/testdir/test_vim9_func.vim"": {""insertions"": 134, ""deletions"": 124, ""lines"": 258}, ""src/version.c"": {""insertions"": 2, ""deletions"": 0, ""lines"": 2}}"
2020-09-05 19:41:56,fcb6d7082d563acc33866b3d3a659c32ad19a9e1,Bram Moolenaar,10,1,11,3,"{""src/evalfunc.c"": {""insertions"": 1, ""deletions"": 1, ""lines"": 2}, ""src/testdir/test_vim9_func.vim"": {""insertions"": 7, ""deletions"": 0, ""lines"": 7}, ""src/version.c"": {""insertions"": 2, ""deletions"": 0, ""lines"": 2}}"
2020-09-05 19:35:16,30788d3d37a90b0702d94b7272ed26672534ba6f,Bram Moolenaar,10,4,14,3,"{""src/evalfunc.c"": {""insertions"": 4, ""deletions"": 4, ""lines"": 8}, ""src/testdir/test_vim9_func.vim"": {""insertions"": 4, ""deletions"": 0, ""lines"": 4}, ""src/version.c"": {""insertions"": 2, ""deletions"": 0, ""lines"": 2}}"
2020-09-05 19:21:16,597aaac9d2b090e0eb738ab4e2afd454b7b92393,Bram Moolenaar,18,8,26,3,"{""src/search.c"": {""insertions"": 2, ""deletions"": 8, ""lines"": 10}, ""src/testdir/test_vim9_func.vim"": {""insertions"": 14, ""deletions"": 0, ""lines"": 14}, ""src/version.c"": {""insertions"": 2, ""deletions"": 0, ""lines"": 2}}"
2020-09-05 19:00:00,fa2e38df76b3e0919dc01dd1836257dce0ba62b1,Bram Moolenaar,16,3,19,3,"{""src/testdir/test_textprop.vim"": {""insertions"": 11, ""deletions"": 0, ""lines"": 11}, ""src/textprop.c"": {""insertions"": 3, ""deletions"": 3, ""lines"": 6}, ""src/version.c"": {""insertions"": 2, ""deletions"": 0, ""lines"": 2}}"
2020-09-05 18:50:49,a5a40c569695a750cace7d29824101ec8ef2b48f,Bram Moolenaar,16,8,24,3,"{""src/testdir/test_textprop.vim"": {""insertions"": 9, ""deletions"": 0, ""lines"": 9}, ""src/textprop.c"": {""insertions"": 5, ""deletions"": 8, ""lines"": 13}, ""src/version.c"": {""insertions"": 2, ""deletions"": 0, ""lines"": 2}}"
2020-09-05 18:29:41,ed6a430fae72c077ec106c9620379b69cfec3035,Bram Moolenaar,7,1,8,3,"{""src/evalfunc.c"": {""insertions"": 1, ""deletions"": 1, ""lines"": 2}, ""src/testdir/test_vim9_func.vim"": {""insertions"": 4, ""deletions"": 0, ""lines"": 4}, ""src/version.c"": {""insertions"": 2, ""deletions"": 0, ""lines"": 2}}"
2020-09-05 18:16:57,a48f786787e8e070c1a611146fd1f0f7e141e60a,Bram Moolenaar,11,2,13,4,"{""src/evalfunc.c"": {""insertions"": 1, ""deletions"": 1, ""lines"": 2}, ""src/list.c"": {""insertions"": 1, ""deletions"": 1, ""lines"": 2}, ""src/testdir/test_vim9_func.vim"": {""insertions"": 7, ""deletions"": 0, ""lines"": 7}, ""src/version.c"": {""insertions"": 2, ""deletions"": 0, ""lines"": 2}}"
2020-09-05 18:06:33,7918238528090cd019dc19613dbe76923ac9a1d7,Bram Moolenaar,23,10,33,2,"{""src/testdir/test_vim9_expr.vim"": {""insertions"": 21, ""deletions"": 10, ""lines"": 31}, ""src/version.c"": {""insertions"": 2, ""deletions"": 0, ""lines"": 2}}"
2020-09-05 17:59:39,15183b41c4416b7638cce26de0a9a83e55948bdc,Bram Moolenaar,7,3,10,2,"{""src/getchar.c"": {""insertions"": 5, ""deletions"": 3, ""lines"": 8}, ""src/version.c"": {""insertions"": 2, ""deletions"": 0, ""lines"": 2}}"
2020-09-05 16:48:57,636c5d5399e1a42e8eb5bcb5fede318438d2347a,Bram Moolenaar,4,0,4,2,"{""src/testdir/test_vim9_func.vim"": {""insertions"": 2, ""deletions"": 0, ""lines"": 2}, ""src/version.c"": {""insertions"": 2, ""deletions"": 0, ""lines"": 2}}"
2020-09-05 16:45:29,04637e243d39f791cfc97c3ce96d99ef1bf047e1,Bram Moolenaar,7,1,8,3,"{""src/evalfunc.c"": {""insertions"": 1, ""deletions"": 1, ""lines"": 2}, ""src/testdir/test_vim9_func.vim"": {""insertions"": 4, ""deletions"": 0, ""lines"": 4}, ""src/version.c"": {""insertions"": 2, ""deletions"": 0, ""lines"": 2}}"
2020-09-05 16:40:44,b02628b8a20ad0c42a097207b3b49ae5169d04d7,Bram Moolenaar,3,1,4,2,"{"".github/CODEOWNERS"": {""insertions"": 1, ""deletions"": 1, ""lines"": 2}, ""src/version.c"": {""insertions"": 2, ""deletions"": 0, ""lines"": 2}}"
2020-09-05 16:31:33,d217a87755ba01fc626b1c178c682fcd05ab3a28,Bram Moolenaar,10,1,11,3,"{""src/cmdexpand.c"": {""insertions"": 1, ""deletions"": 1, ""lines"": 2}, ""src/testdir/test_vim9_func.vim"": {""insertions"": 7, ""deletions"": 0, ""lines"": 7}, ""src/version.c"": {""insertions"": 2, ""deletions"": 0, ""lines"": 2}}"
2020-09-05 15:51:23,c08cc72947fdfab484f53c5d9bbea662bc5a9c8f,Bram Moolenaar,7,1,8,3,"{""src/getchar.c"": {""insertions"": 1, ""deletions"": 1, ""lines"": 2}, ""src/testdir/test_vim9_func.vim"": {""insertions"": 4, ""deletions"": 0, ""lines"": 4}, ""src/version.c"": {""insertions"": 2, ""deletions"": 0, ""lines"": 2}}"
2020-09-05 15:37:07,036c2cf719e3de445779a275514030be66e26883,Bram Moolenaar,14,15,29,3,"{""src/evalbuffer.c"": {""insertions"": 4, ""deletions"": 14, ""lines"": 18}, ""src/testdir/test_vim9_func.vim"": {""insertions"": 8, ""deletions"": 1, ""lines"": 9}, ""src/version.c"": {""insertions"": 2, ""deletions"": 0, ""lines"": 2}}"
2020-09-05 15:30:44,2df47310422f4a77e85de7901a5299923a1addd3,Bram Moolenaar,7,1,8,3,"{""src/evalfunc.c"": {""insertions"": 1, ""deletions"": 1, ""lines"": 2}, ""src/testdir/test_vim9_func.vim"": {""insertions"": 4, ""deletions"": 0, ""lines"": 4}, ""src/version.c"": {""insertions"": 2, ""deletions"": 0, ""lines"": 2}}"
2020-09-05 15:18:28,44b4a246b62e0622550b963bcf3034dce3bcfc0c,Bram Moolenaar,6,2,8,4,"{""src/evalfunc.c"": {""insertions"": 1, ""deletions"": 1, ""lines"": 2}, ""src/testdir/test_listdict.vim"": {""insertions"": 1, ""deletions"": 1, ""lines"": 2}, ""src/testdir/test_vim9_func.vim"": {""insertions"": 2, ""deletions"": 0, ""lines"": 2}, ""src/version.c"": {""insertions"": 2, ""deletions"": 0, ""lines"": 2}}"
2020-09-05 15:03:40,59941cbd8035415d68683edc4e571306b10669ad,Bram Moolenaar,21,1,22,3,"{""src/quickfix.c"": {""insertions"": 1, ""deletions"": 1, ""lines"": 2}, ""src/testdir/test_quickfix.vim"": {""insertions"": 18, ""deletions"": 0, ""lines"": 18}, ""src/version.c"": {""insertions"": 2, ""deletions"": 0, ""lines"": 2}}"
2020-09-05 14:08:49,2ce14589f210dcb3d17d1d80285256f8ac10abab,Bram Moolenaar,26,10,36,3,"{""src/terminal.c"": {""insertions"": 14, ""deletions"": 10, ""lines"": 24}, ""src/testdir/test_terminal2.vim"": {""insertions"": 10, ""deletions"": 0, ""lines"": 10}, ""src/version.c"": {""insertions"": 2, ""deletions"": 0, ""lines"": 2}}"
2020-09-05 13:48:51,8b5866ded6036f7adece26b6d16962bbd2d47842,Bram Moolenaar,2131,2089,4220,15,"{""Filelist"": {""insertions"": 2, ""deletions"": 0, ""lines"": 2}, ""src/Make_cyg_ming.mak"": {""insertions"": 1, ""deletions"": 1, ""lines"": 2}, ""src/Make_mvc.mak"": {""insertions"": 7, ""deletions"": 5, ""lines"": 12}, ""src/Makefile"": {""insertions"": 9, ""deletions"": 1, ""lines"": 10}, ""src/auto/configure"": {""insertions"": 2, ""deletions"": 2, ""lines"": 4}, ""src/channel.c"": {""insertions"": 133, ""deletions"": 1970, ""lines"": 2103}, ""src/configure.ac"": {""insertions"": 2, ""deletions"": 2, ""lines"": 4}, ""src/edit.c"": {""insertions"": 9, ""deletions"": 75, ""lines"": 84}, ""src/globals.h"": {""insertions"": 3, ""deletions"": 0, ""lines"": 3}, ""src/job.c"": {""insertions"": 1918, ""deletions"": 0, ""lines"": 1918}, ""src/proto.h"": {""insertions"": 1, ""deletions"": 0, ""lines"": 1}, ""src/proto/channel.pro"": {""insertions"": 4, ""deletions"": 30, ""lines"": 34}, ""src/proto/edit.pro"": {""insertions"": 1, ""deletions"": 3, ""lines"": 4}, ""src/proto/job.pro"": {""insertions"": 37, ""deletions"": 0, ""lines"": 37}, ""src/version.c"": {""insertions"": 2, ""deletions"": 0, ""lines"": 2}}"
2020-09-05 13:05:30,7dfc5ce7cf4a7f63370d7dce2e13f7410ca0230a,Bram Moolenaar,3,1,4,2,"{""src/testdir/test_terminal3.vim"": {""insertions"": 1, ""deletions"": 1, ""lines"": 2}, ""src/version.c"": {""insertions"": 2, ""deletions"": 0, ""lines"": 2}}"
2020-09-05 12:27:24,86394aa9720c5e087d85831e42d44e042987fbc0,Bram Moolenaar,73,4,77,6,"{""src/edit.c"": {""insertions"": 6, ""deletions"": 0, ""lines"": 6}, ""src/globals.h"": {""insertions"": 4, ""deletions"": 0, ""lines"": 4}, ""src/normal.c"": {""insertions"": 6, ""deletions"": 0, ""lines"": 6}, ""src/optionstr.c"": {""insertions"": 3, ""deletions"": 0, ""lines"": 3}, ""src/term.c"": {""insertions"": 52, ""deletions"": 4, ""lines"": 56}, ""src/version.c"": {""insertions"": 2, ""deletions"": 0, ""lines"": 2}}"
2020-09-05 11:48:58,cf8aa6448b3520905bea528ea8ad6533cbef288d,Bram Moolenaar,53,0,53,3,"{"".github/CODEOWNERS"": {""insertions"": 50, ""deletions"": 0, ""lines"": 50}, ""Filelist"": {""insertions"": 1, ""deletions"": 0, ""lines"": 1}, ""src/version.c"": {""insertions"": 2, ""deletions"": 0, ""lines"": 2}}"
2020-09-04 19:18:46,e2e4075fad1326181edc5a131e48c644ef613693,Bram Moolenaar,172,170,342,43,"{""src/testdir/test_assert.vim"": {""insertions"": 2, ""deletions"": 2, ""lines"": 4}, ""src/testdir/test_autocmd.vim"": {""insertions"": 11, ""deletions"": 11, ""lines"": 22}, ""src/testdir/test_backspace_opt.vim"": {""insertions"": 5, ""deletions"": 5, ""lines"": 10}, ""src/testdir/test_channel.vim"": {""insertions"": 2, ""deletions"": 2, ""lines"": 4}, ""src/testdir/test_clientserver.vim"": {""insertions"": 1, ""deletions"": 1, ""lines"": 2}, ""src/testdir/test_cmdline.vim"": {""insertions"": 1, ""deletions"": 1, ""lines"": 2}, ""src/testdir/test_const.vim"": {""insertions"": 2, ""deletions"": 2, ""lines"": 4}, ""src/testdir/test_cscope.vim"": {""insertions"": 3, ""deletions"": 3, ""lines"": 6}, ""src/testdir/test_eval_stuff.vim"": {""insertions"": 3, ""deletions"": 3, ""lines"": 6}, ""src/testdir/test_functions.vim"": {""insertions"": 1, ""deletions"": 1, ""lines"": 2}, ""src/testdir/test_global.vim"": {""insertions"": 1, ""deletions"": 1, ""lines"": 2}, ""src/testdir/test_gui.vim"": {""insertions"": 1, ""deletions"": 1, ""lines"": 2}, ""src/testdir/test_hlsearch.vim"": {""insertions"": 1, ""deletions"": 1, ""lines"": 2}, ""src/testdir/test_lambda.vim"": {""insertions"": 1, ""deletions"": 1, ""lines"": 2}, ""src/testdir/test_let.vim"": {""insertions"": 4, ""deletions"": 4, ""lines"": 8}, ""src/testdir/test_listdict.vim"": {""insertions"": 18, ""deletions"": 18, ""lines"": 36}, ""src/testdir/test_move.vim"": {""insertions"": 2, ""deletions"": 2, ""lines"": 4}, ""src/testdir/test_normal.vim"": {""insertions"": 10, ""deletions"": 10, ""lines"": 20}, ""src/testdir/test_popupwin.vim"": {""insertions"": 2, ""deletions"": 2, ""lines"": 4}, ""src/testdir/test_put.vim"": {""insertions"": 7, ""deletions"": 7, ""lines"": 14}, ""src/testdir/test_quickfix.vim"": {""insertions"": 12, ""deletions"": 12, ""lines"": 24}, ""src/testdir/test_rename.vim"": {""insertions"": 2, ""deletions"": 2, ""lines"": 4}, ""src/testdir/test_search.vim"": {""insertions"": 4, ""deletions"": 4, ""lines"": 8}, ""src/testdir/test_signs.vim"": {""insertions"": 1, ""deletions"": 1, ""lines"": 2}, ""src/testdir/test_substitute.vim"": {""insertions"": 2, ""deletions"": 2, ""lines"": 4}, ""src/testdir/test_syntax.vim"": {""insertions"": 3, ""deletions"": 3, ""lines"": 6}, ""src/testdir/test_tagfunc.vim"": {""insertions"": 1, ""deletions"": 1, ""lines"": 2}, ""src/testdir/test_tagjump.vim"": {""insertions"": 7, ""deletions"": 7, ""lines"": 14}, ""src/testdir/test_taglist.vim"": {""insertions"": 1, ""deletions"": 1, ""lines"": 2}, ""src/testdir/test_terminal.vim"": {""insertions"": 10, ""deletions"": 10, ""lines"": 20}, ""src/testdir/test_terminal2.vim"": {""insertions"": 3, ""deletions"": 3, ""lines"": 6}, ""src/testdir/test_textprop.vim"": {""insertions"": 2, ""deletions"": 2, ""lines"": 4}, ""src/testdir/test_timers.vim"": {""insertions"": 2, ""deletions"": 2, ""lines"": 4}, ""src/testdir/test_true_false.vim"": {""insertions"": 4, ""deletions"": 4, ""lines"": 8}, ""src/testdir/test_user_func.vim"": {""insertions"": 4, ""deletions"": 4, ""lines"": 8}, ""src/testdir/test_vim9_func.vim"": {""insertions"": 3, ""deletions"": 3, ""lines"": 6}, ""src/testdir/test_vim9_script.vim"": {""insertions"": 2, ""deletions"": 2, ""lines"": 4}, ""src/testdir/test_vimscript.vim"": {""insertions"": 19, ""deletions"": 19, ""lines"": 38}, ""src/testdir/test_winbar.vim"": {""insertions"": 1, ""deletions"": 1, ""lines"": 2}, ""src/testdir/test_winbuf_close.vim"": {""insertions"": 4, ""deletions"": 4, ""lines"": 8}, ""src/testdir/test_window_cmd.vim"": {""insertions"": 4, ""deletions"": 4, ""lines"": 8}, ""src/testdir/test_writefile.vim"": {""insertions"": 1, ""deletions"": 1, ""lines"": 2}, ""src/version.c"": {""insertions"": 2, ""deletions"": 0, ""lines"": 2}}"
2020-09-04 17:50:57,24f7750ffa9730579736d779b7cc94faff325fc1,Bram Moolenaar,7,1,8,3,"{""src/evalfunc.c"": {""insertions"": 1, ""deletions"": 1, ""lines"": 2}, ""src/testdir/test_vim9_func.vim"": {""insertions"": 4, ""deletions"": 0, ""lines"": 4}, ""src/version.c"": {""insertions"": 2, ""deletions"": 0, ""lines"": 2}}"
2020-09-04 16:38:06,c05d1c043a25c7a52dbf0a740d3f715a9d2691f7,Bram Moolenaar,8,6,14,3,"{""src/testdir/test_functions.vim"": {""insertions"": 4, ""deletions"": 4, ""lines"": 8}, ""src/testdir/test_quickfix.vim"": {""insertions"": 2, ""deletions"": 2, ""lines"": 4}, ""src/version.c"": {""insertions"": 2, ""deletions"": 0, ""lines"": 2}}"
2020-09-04 16:35:26,fe136c9a85412f4bdb5de70ef8416af5fa382b28,Bram Moolenaar,7,1,8,3,"{""src/evalbuffer.c"": {""insertions"": 1, ""deletions"": 1, ""lines"": 2}, ""src/testdir/test_vim9_func.vim"": {""insertions"": 4, ""deletions"": 0, ""lines"": 4}, ""src/version.c"": {""insertions"": 2, ""deletions"": 0, ""lines"": 2}}"
2020-09-04 16:34:09,b936b79424d435b83cdebed5507a9d3800e66e6c,Bram Moolenaar,74,24,98,4,"{""src/terminal.c"": {""insertions"": 36, ""deletions"": 15, ""lines"": 51}, ""src/testdir/term_util.vim"": {""insertions"": 8, ""deletions"": 6, ""lines"": 14}, ""src/testdir/test_terminal2.vim"": {""insertions"": 28, ""deletions"": 3, ""lines"": 31}, ""src/version.c"": {""insertions"": 2, ""deletions"": 0, ""lines"": 2}}"
2020-09-04 14:35:35,077cc7aa0e0c431e97795612374fe17fe7c88803,Bram Moolenaar,97,6,103,10,"{""runtime/doc/channel.txt"": {""insertions"": 8, ""deletions"": 2, ""lines"": 10}, ""runtime/doc/eval.txt"": {""insertions"": 13, ""deletions"": 1, ""lines"": 14}, ""runtime/doc/usr_41.txt"": {""insertions"": 1, ""deletions"": 0, ""lines"": 1}, ""src/channel.c"": {""insertions"": 23, ""deletions"": 0, ""lines"": 23}, ""src/edit.c"": {""insertions"": 13, ""deletions"": 3, ""lines"": 16}, ""src/evalfunc.c"": {""insertions"": 1, ""deletions"": 0, ""lines"": 1}, ""src/proto/channel.pro"": {""insertions"": 1, ""deletions"": 0, ""lines"": 1}, ""src/proto/edit.pro"": {""insertions"": 1, ""deletions"": 0, ""lines"": 1}, ""src/testdir/test_prompt_buffer.vim"": {""insertions"": 34, ""deletions"": 0, ""lines"": 34}, ""src/version.c"": {""insertions"": 2, ""deletions"": 0, ""lines"": 2}}"
2020-09-04 13:37:31,eadee486c70946ad0e1746d77898d6f4f4acc817,Bram Moolenaar,258,213,471,4,"{""src/cmdexpand.c"": {""insertions"": 249, ""deletions"": 0, ""lines"": 249}, ""src/ex_getln.c"": {""insertions"": 4, ""deletions"": 213, ""lines"": 217}, ""src/proto/cmdexpand.pro"": {""insertions"": 3, ""deletions"": 0, ""lines"": 3}, ""src/version.c"": {""insertions"": 2, ""deletions"": 0, ""lines"": 2}}"
2020-09-04 12:41:21,fe6dce873954a216eedb686bd5006710ffff4b89,Bram Moolenaar,44,0,44,2,"{""src/testdir/test_window_cmd.vim"": {""insertions"": 42, ""deletions"": 0, ""lines"": 42}, ""src/version.c"": {""insertions"": 2, ""deletions"": 0, ""lines"": 2}}"
2020-09-04 11:53:00,fa57335e532e505ce9229ddb2354a593fb057561,Bram Moolenaar,110,21,131,7,"{""src/po/Make_cyg.mak"": {""insertions"": 33, ""deletions"": 7, ""lines"": 40}, ""src/po/Make_ming.mak"": {""insertions"": 37, ""deletions"": 7, ""lines"": 44}, ""src/po/Make_mvc.mak"": {""insertions"": 33, ""deletions"": 3, ""lines"": 36}, ""src/po/Makefile"": {""insertions"": 2, ""deletions"": 1, ""lines"": 3}, ""src/po/README.txt"": {""insertions"": 2, ""deletions"": 2, ""lines"": 4}, ""src/po/fixfilenames.vim"": {""insertions"": 1, ""deletions"": 1, ""lines"": 2}, ""src/version.c"": {""insertions"": 2, ""deletions"": 0, ""lines"": 2}}"
2020-09-03 20:33:44,eb24556df3b16a19009ee3ddee8ae94dc058a3b2,Bram Moolenaar,18,13,31,3,"{""src/testdir/test_textprop.vim"": {""insertions"": 15, ""deletions"": 10, ""lines"": 25}, ""src/textprop.c"": {""insertions"": 1, ""deletions"": 3, ""lines"": 4}, ""src/version.c"": {""insertions"": 2, ""deletions"": 0, ""lines"": 2}}"
2020-09-03 17:50:05,18eedfa40b45b1de955d61417e9918ef7d6e83f9,Bram Moolenaar,13,0,13,2,"{""src/Make_cyg_ming.mak"": {""insertions"": 11, ""deletions"": 0, ""lines"": 11}, ""src/version.c"": {""insertions"": 2, ""deletions"": 0, ""lines"": 2}}"
2020-09-03 17:25:11,7ca86fe8dc584141d6a73408acf3e90d8c88c7b9,Bram Moolenaar,16,0,16,3,"{""src/os_win32.c"": {""insertions"": 7, ""deletions"": 0, ""lines"": 7}, ""src/ui.c"": {""insertions"": 7, ""deletions"": 0, ""lines"": 7}, ""src/version.c"": {""insertions"": 2, ""deletions"": 0, ""lines"": 2}}"
2020-09-03 16:52:24,1f42f5a675fdab9ce5cdafbecea59c45e81f7ff8,Bram Moolenaar,15,1,16,3,"{""src/evalwindow.c"": {""insertions"": 1, ""deletions"": 1, ""lines"": 2}, ""src/testdir/test_popupwin.vim"": {""insertions"": 12, ""deletions"": 0, ""lines"": 12}, ""src/version.c"": {""insertions"": 2, ""deletions"": 0, ""lines"": 2}}"
2020-09-03 14:50:13,a60053b8f4cc7e135ba9496a8f4855d26aee09e7,Bram Moolenaar,74,12,86,7,"{""src/ex_getln.c"": {""insertions"": 12, ""deletions"": 12, ""lines"": 24}, ""src/testdir/dumps/Test_wildmenu_1.dump"": {""insertions"": 8, ""deletions"": 0, ""lines"": 8}, ""src/testdir/dumps/Test_wildmenu_2.dump"": {""insertions"": 8, ""deletions"": 0, ""lines"": 8}, ""src/testdir/dumps/Test_wildmenu_3.dump"": {""insertions"": 8, ""deletions"": 0, ""lines"": 8}, ""src/testdir/dumps/Test_wildmenu_4.dump"": {""insertions"": 8, ""deletions"": 0, ""lines"": 8}, ""src/testdir/test_cmdline.vim"": {""insertions"": 28, ""deletions"": 0, ""lines"": 28}, ""src/version.c"": {""insertions"": 2, ""deletions"": 0, ""lines"": 2}}"
2020-09-03 14:05:04,5b5aa11801c75fac18a587bea02dc7a8b5b90c4b,Bram Moolenaar,28,8,36,2,"{"".travis.yml"": {""insertions"": 26, ""deletions"": 8, ""lines"": 34}, ""src/version.c"": {""insertions"": 2, ""deletions"": 0, ""lines"": 2}}"
2020-09-02 20:33:24,62f93f4ec9db1deca088bab7783a35306e2ed4cb,Bram Moolenaar,13,8,21,3,"{""src/popupwin.c"": {""insertions"": 1, ""deletions"": 1, ""lines"": 2}, ""src/testdir/test_popupwin.vim"": {""insertions"": 10, ""deletions"": 7, ""lines"": 17}, ""src/version.c"": {""insertions"": 2, ""deletions"": 0, ""lines"": 2}}"
2020-09-02 20:25:35,04d594b9c14299ed50da0774fb8d3a10fbc4076f,Bram Moolenaar,44,3,47,4,"{""src/evalfunc.c"": {""insertions"": 1, ""deletions"": 1, ""lines"": 2}, ""src/map.c"": {""insertions"": 2, ""deletions"": 2, ""lines"": 4}, ""src/testdir/test_vim9_func.vim"": {""insertions"": 39, ""deletions"": 0, ""lines"": 39}, ""src/version.c"": {""insertions"": 2, ""deletions"": 0, ""lines"": 2}}"
2020-09-02 20:10:34,6c553f9c04a698ac2e19584f8ea8e2cb7cd98c80,Bram Moolenaar,7,1,8,3,"{""src/evalfunc.c"": {""insertions"": 1, ""deletions"": 1, ""lines"": 2}, ""src/testdir/test_vim9_func.vim"": {""insertions"": 4, ""deletions"": 0, ""lines"": 4}, ""src/version.c"": {""insertions"": 2, ""deletions"": 0, ""lines"": 2}}"
2020-09-02 19:57:07,f966ce5ea24748eed10f708d4f828be44887a559,Bram Moolenaar,9,3,12,3,"{""src/filepath.c"": {""insertions"": 3, ""deletions"": 3, ""lines"": 6}, ""src/testdir/test_vim9_func.vim"": {""insertions"": 4, ""deletions"": 0, ""lines"": 4}, ""src/version.c"": {""insertions"": 2, ""deletions"": 0, ""lines"": 2}}"
2020-09-02 19:53:11,5892ea151197c8a6363c7ce2322d84277b97353e,Bram Moolenaar,9,3,12,3,"{""src/filepath.c"": {""insertions"": 3, ""deletions"": 3, ""lines"": 6}, ""src/testdir/test_vim9_func.vim"": {""insertions"": 4, ""deletions"": 0, ""lines"": 4}, ""src/version.c"": {""insertions"": 2, ""deletions"": 0, ""lines"": 2}}"
2020-09-02 19:45:54,67ff97ded70a87bc77f58d0bf9a261710ae88112,Bram Moolenaar,10,2,12,3,"{""src/evalfunc.c"": {""insertions"": 2, ""deletions"": 2, ""lines"": 4}, ""src/testdir/test_vim9_func.vim"": {""insertions"": 6, ""deletions"": 0, ""lines"": 6}, ""src/version.c"": {""insertions"": 2, ""deletions"": 0, ""lines"": 2}}"
2020-09-02 19:37:56,551d25e76545df785a9f62df52f34bc1dd368bfb,Bram Moolenaar,10,2,12,3,"{""src/evalfunc.c"": {""insertions"": 2, ""deletions"": 2, ""lines"": 4}, ""src/testdir/test_vim9_func.vim"": {""insertions"": 6, ""deletions"": 0, ""lines"": 6}, ""src/version.c"": {""insertions"": 2, ""deletions"": 0, ""lines"": 2}}"
2020-09-02 19:31:22,119f5572306c4abba91eaf446c0c52637db223e8,Bram Moolenaar,8,2,10,4,"{""src/list.c"": {""insertions"": 1, ""deletions"": 1, ""lines"": 2}, ""src/testdir/test_vim9_func.vim"": {""insertions"": 5, ""deletions"": 0, ""lines"": 5}, ""src/typval.c"": {""insertions"": 0, ""deletions"": 1, ""lines"": 1}, ""src/version.c"": {""insertions"": 2, ""deletions"": 0, ""lines"": 2}}"
2020-09-02 19:21:35,9d8bfae50fdaf5f5ec6307c60ebd1fad0927c6be,Bram Moolenaar,17,7,24,5,"{""src/auto/configure"": {""insertions"": 6, ""deletions"": 4, ""lines"": 10}, ""src/configure.ac"": {""insertions"": 2, ""deletions"": 2, ""lines"": 4}, ""src/fileio.c"": {""insertions"": 5, ""deletions"": 0, ""lines"": 5}, ""src/globals.h"": {""insertions"": 2, ""deletions"": 1, ""lines"": 3}, ""src/version.c"": {""insertions"": 2, ""deletions"": 0, ""lines"": 2}}"
2020-09-02 19:02:35,a5d3841177e0b3545381c875d0b4b442f38784bd,Bram Moolenaar,36,6,42,3,"{""src/evalfunc.c"": {""insertions"": 1, ""deletions"": 6, ""lines"": 7}, ""src/testdir/test_vim9_func.vim"": {""insertions"": 33, ""deletions"": 0, ""lines"": 33}, ""src/version.c"": {""insertions"": 2, ""deletions"": 0, ""lines"": 2}}"
2020-09-02 17:59:00,4da7a259f6b28a4f855a6fa7d0ede5e038600154,Bram Moolenaar,20,2,22,3,"{""src/testdir/test_textprop.vim"": {""insertions"": 16, ""deletions"": 0, ""lines"": 16}, ""src/textprop.c"": {""insertions"": 2, ""deletions"": 2, ""lines"": 4}, ""src/version.c"": {""insertions"": 2, ""deletions"": 0, ""lines"": 2}}"
2020-09-02 17:23:06,6efa46f4efd226f65634ba8eb6ddee54de1de563,Bram Moolenaar,13,3,16,2,"{""src/Makefile"": {""insertions"": 11, ""deletions"": 3, ""lines"": 14}, ""src/version.c"": {""insertions"": 2, ""deletions"": 0, ""lines"": 2}}"
2020-09-02 15:08:59,4488f5a545691ca4c8802bad0d70a5e750fc8844,Bram Moolenaar,7,3,10,3,"{""runtime/filetype.vim"": {""insertions"": 3, ""deletions"": 3, ""lines"": 6}, ""src/testdir/test_filetype.vim"": {""insertions"": 2, ""deletions"": 0, ""lines"": 2}, ""src/version.c"": {""insertions"": 2, ""deletions"": 0, ""lines"": 2}}"
2020-09-02 10:58:48,e90d63ea904187ecbb09d0f7f21b71b302b30644,Bram Moolenaar,3,2,5,2,"{""src/spellfile.c"": {""insertions"": 1, ""deletions"": 2, ""lines"": 3}, ""src/version.c"": {""insertions"": 2, ""deletions"": 0, ""lines"": 2}}"
2020-09-02 08:25:45,4ad739fc053c1666d07ba1cf59be26cb1c3e52d7,Bram Moolenaar,15,8,23,4,"{""src/spellfile.c"": {""insertions"": 8, ""deletions"": 4, ""lines"": 12}, ""src/spellsuggest.c"": {""insertions"": 3, ""deletions"": 3, ""lines"": 6}, ""src/version.c"": {""insertions"": 2, ""deletions"": 0, ""lines"": 2}, ""src/viminfo.c"": {""insertions"": 2, ""deletions"": 1, ""lines"": 3}}"
2020-09-01 21:16:32,6f84b6db10ab86bca85e33f3fc6ee735eec8bbe5,Bram Moolenaar,7,7,14,3,"{""src/evalvars.c"": {""insertions"": 2, ""deletions"": 7, ""lines"": 9}, ""src/testdir/test_vim9_func.vim"": {""insertions"": 3, ""deletions"": 0, ""lines"": 3}, ""src/version.c"": {""insertions"": 2, ""deletions"": 0, ""lines"": 2}}"
2020-09-01 21:06:01,3767e3a3302d745349eff8cfe45411f03e13de43,Bram Moolenaar,32,29,61,5,"{""src/evalbuffer.c"": {""insertions"": 5, ""deletions"": 29, ""lines"": 34}, ""src/proto/typval.pro"": {""insertions"": 1, ""deletions"": 0, ""lines"": 1}, ""src/testdir/test_vim9_func.vim"": {""insertions"": 5, ""deletions"": 0, ""lines"": 5}, ""src/typval.c"": {""insertions"": 19, ""deletions"": 0, ""lines"": 19}, ""src/version.c"": {""insertions"": 2, ""deletions"": 0, ""lines"": 2}}"
2020-09-01 19:21:24,81fcb67fb32a12414512b72e691a1bbbff9f8511,Bram Moolenaar,3,1,4,2,"{""src/fold.c"": {""insertions"": 1, ""deletions"": 1, ""lines"": 2}, ""src/version.c"": {""insertions"": 2, ""deletions"": 0, ""lines"": 2}}"
2020-09-01 17:56:15,9c2b06637b32742cac11bfd66b1a4e84583c6c2e,Bram Moolenaar,26,14,40,6,"{""src/eval.c"": {""insertions"": 1, ""deletions"": 1, ""lines"": 2}, ""src/fold.c"": {""insertions"": 12, ""deletions"": 10, ""lines"": 22}, ""src/spellfile.c"": {""insertions"": 1, ""deletions"": 1, ""lines"": 2}, ""src/spellsuggest.c"": {""insertions"": 2, ""deletions"": 0, ""lines"": 2}, ""src/version.c"": {""insertions"": 2, ""deletions"": 0, ""lines"": 2}, ""src/vim9compile.c"": {""insertions"": 8, ""deletions"": 2, ""lines"": 10}}"
2020-09-01 15:50:51,ca563b9b948aec18463c26e9f87ae7933571b40e,Bram Moolenaar,8,7,15,2,"{"".travis.yml"": {""insertions"": 6, ""deletions"": 7, ""lines"": 13}, ""src/version.c"": {""insertions"": 2, ""deletions"": 0, ""lines"": 2}}"
2020-08-31 21:18:00,2f1228463aa9ff62814f9732561b1849e5f01f75,Bram Moolenaar,3,0,3,2,"{""src/sign.c"": {""insertions"": 1, ""deletions"": 0, ""lines"": 1}, ""src/version.c"": {""insertions"": 2, ""deletions"": 0, ""lines"": 2}}"
2020-08-31 20:16:08,997cd1a17f030d004b334d17cf1c1c57050c9906,Bram Moolenaar,18,1,19,3,"{""src/quickfix.c"": {""insertions"": 1, ""deletions"": 1, ""lines"": 2}, ""src/testdir/test_quickfix.vim"": {""insertions"": 15, ""deletions"": 0, ""lines"": 15}, ""src/version.c"": {""insertions"": 2, ""deletions"": 0, ""lines"": 2}}"
2020-08-31 20:00:05,39f7aa3c3124065b50f182b1d2f7ac92a0918656,Bram Moolenaar,49,4,53,8,"{""runtime/doc/sign.txt"": {""insertions"": 5, ""deletions"": 1, ""lines"": 6}, ""runtime/pack/dist/opt/termdebug/plugin/termdebug.vim"": {""insertions"": 2, ""deletions"": 2, ""lines"": 4}, ""src/drawline.c"": {""insertions"": 13, ""deletions"": 1, ""lines"": 14}, ""src/structs.h"": {""insertions"": 1, ""deletions"": 0, ""lines"": 1}, ""src/testdir/dumps/Test_sign_cursor_5.dump"": {""insertions"": 6, ""deletions"": 0, ""lines"": 6}, ""src/testdir/dumps/Test_sign_cursor_6.dump"": {""insertions"": 6, ""deletions"": 0, ""lines"": 6}, ""src/testdir/test_signs.vim"": {""insertions"": 14, ""deletions"": 0, ""lines"": 14}, ""src/version.c"": {""insertions"": 2, ""deletions"": 0, ""lines"": 2}}"
2020-08-31 19:30:32,7d6979608ee83b06ccfab2589da3047b143defae,Bram Moolenaar,15,8,23,5,"{"".github/workflows/ci-windows.yaml"": {""insertions"": 5, ""deletions"": 4, ""lines"": 9}, ""src/testdir/runtest.vim"": {""insertions"": 2, ""deletions"": 0, ""lines"": 2}, ""src/testdir/test_python2.vim"": {""insertions"": 3, ""deletions"": 2, ""lines"": 5}, ""src/testdir/test_python3.vim"": {""insertions"": 3, ""deletions"": 2, ""lines"": 5}, ""src/version.c"": {""insertions"": 2, ""deletions"": 0, ""lines"": 2}}"
2020-08-31 19:22:40,07e87e9eb5e7195d47d47c0ca752b6c8372a99ea,Bram Moolenaar,5,0,5,2,"{""src/fold.c"": {""insertions"": 3, ""deletions"": 0, ""lines"": 3}, ""src/version.c"": {""insertions"": 2, ""deletions"": 0, ""lines"": 2}}"
2020-08-31 19:15:02,2c93c685e3334c50d9a748ad699df727a4501b08,Bram Moolenaar,29,21,50,2,"{""src/fold.c"": {""insertions"": 27, ""deletions"": 21, ""lines"": 48}, ""src/version.c"": {""insertions"": 2, ""deletions"": 0, ""lines"": 2}}"
2020-08-31 17:58:13,64f37d309025a65210dbc33823ec9ec5d547775f,Bram Moolenaar,25,11,36,2,"{""src/fold.c"": {""insertions"": 23, ""deletions"": 11, ""lines"": 34}, ""src/version.c"": {""insertions"": 2, ""deletions"": 0, ""lines"": 2}}"
2020-08-30 21:24:20,8b565c2c1522e0c41e3d18e1bb6e1bc4b3686842,Bram Moolenaar,40,38,78,8,"{""src/eval.c"": {""insertions"": 1, ""deletions"": 1, ""lines"": 2}, ""src/proto/vim9type.pro"": {""insertions"": 2, ""deletions"": 2, ""lines"": 4}, ""src/testdir/test_vim9_func.vim"": {""insertions"": 5, ""deletions"": 5, ""lines"": 10}, ""src/version.c"": {""insertions"": 2, ""deletions"": 0, ""lines"": 2}, ""src/vim9compile.c"": {""insertions"": 4, ""deletions"": 8, ""lines"": 12}, ""src/vim9execute.c"": {""insertions"": 4, ""deletions"": 3, ""lines"": 7}, ""src/vim9script.c"": {""insertions"": 1, ""deletions"": 1, ""lines"": 2}, ""src/vim9type.c"": {""insertions"": 21, ""deletions"": 18, ""lines"": 39}}"
2020-08-30 19:26:57,02aaad91094939758e053588dd23ebda467eea29,Bram Moolenaar,18,3,21,3,"{""src/evalbuffer.c"": {""insertions"": 8, ""deletions"": 3, ""lines"": 11}, ""src/testdir/test_vim9_func.vim"": {""insertions"": 8, ""deletions"": 0, ""lines"": 8}, ""src/version.c"": {""insertions"": 2, ""deletions"": 0, ""lines"": 2}}"
2020-08-30 18:46:38,ca774f67534e6d1843fda9d1dc9a899972d27577,Bram Moolenaar,16,0,16,2,"{""src/normal.c"": {""insertions"": 14, ""deletions"": 0, ""lines"": 14}, ""src/version.c"": {""insertions"": 2, ""deletions"": 0, ""lines"": 2}}"
2020-08-30 17:42:06,0b8cf278eca45241033033f9bf389e54669a8654,Bram Moolenaar,3,0,3,2,"{""src/po/check.vim"": {""insertions"": 1, ""deletions"": 0, ""lines"": 1}, ""src/version.c"": {""insertions"": 2, ""deletions"": 0, ""lines"": 2}}"
2020-08-30 17:26:45,02c037a4be6aeb7f6376e7dcc3ab41cfc6db3ede,Bram Moolenaar,26,13,39,9,"{""src/arglist.c"": {""insertions"": 1, ""deletions"": 1, ""lines"": 2}, ""src/libvterm/README"": {""insertions"": 5, ""deletions"": 2, ""lines"": 7}, ""src/map.c"": {""insertions"": 1, ""deletions"": 1, ""lines"": 2}, ""src/mbyte.c"": {""insertions"": 2, ""deletions"": 2, ""lines"": 4}, ""src/tag.c"": {""insertions"": 1, ""deletions"": 1, ""lines"": 2}, ""src/testdir/README.txt"": {""insertions"": 9, ""deletions"": 0, ""lines"": 9}, ""src/testdir/test_put.vim"": {""insertions"": 3, ""deletions"": 5, ""lines"": 8}, ""src/undo.c"": {""insertions"": 2, ""deletions"": 1, ""lines"": 3}, ""src/version.c"": {""insertions"": 2, ""deletions"": 0, ""lines"": 2}}"
2020-08-30 16:11:54,cd80006ecbde03f668a478a272d8009970b8cefa,Bram Moolenaar,7,78,85,2,"{""src/Makefile"": {""insertions"": 5, ""deletions"": 78, ""lines"": 83}, ""src/version.c"": {""insertions"": 2, ""deletions"": 0, ""lines"": 2}}"
2020-08-30 15:24:37,76603baac5a14445d0c41d7eb14144a07288d357,Bram Moolenaar,9,2,11,3,"{""src/channel.c"": {""insertions"": 4, ""deletions"": 1, ""lines"": 5}, ""src/os_unix.c"": {""insertions"": 3, ""deletions"": 1, ""lines"": 4}, ""src/version.c"": {""insertions"": 2, ""deletions"": 0, ""lines"": 2}}"
2020-08-30 15:20:20,207f009326c8f878defde0e594d7d9ed9860106e,Bram Moolenaar,1387,1118,2505,44,"{""runtime/autoload/dist/ft.vim"": {""insertions"": 1, ""deletions"": 1, ""lines"": 2}, ""runtime/compiler/eslint.vim"": {""insertions"": 2, ""deletions"": 2, ""lines"": 4}, ""runtime/compiler/standard.vim"": {""insertions"": 3, ""deletions"": 3, ""lines"": 6}, ""runtime/doc/change.txt"": {""insertions"": 5, ""deletions"": 5, ""lines"": 10}, ""runtime/doc/develop.txt"": {""insertions"": 2, ""deletions"": 2, ""lines"": 4}, ""runtime/doc/editing.txt"": {""insertions"": 3, ""deletions"": 3, ""lines"": 6}, ""runtime/doc/eval.txt"": {""insertions"": 14, ""deletions"": 10, ""lines"": 24}, ""runtime/doc/help.txt"": {""insertions"": 2, ""deletions"": 2, ""lines"": 4}, ""runtime/doc/intro.txt"": {""insertions"": 4, ""deletions"": 4, ""lines"": 8}, ""runtime/doc/map.txt"": {""insertions"": 8, ""deletions"": 2, ""lines"": 10}, ""runtime/doc/mbyte.txt"": {""insertions"": 12, ""deletions"": 12, ""lines"": 24}, ""runtime/doc/message.txt"": {""insertions"": 6, ""deletions"": 5, ""lines"": 11}, ""runtime/doc/mlang.txt"": {""insertions"": 2, ""deletions"": 2, ""lines"": 4}, ""runtime/doc/motion.txt"": {""insertions"": 7, ""deletions"": 6, ""lines"": 13}, ""runtime/doc/netbeans.txt"": {""insertions"": 3, ""deletions"": 3, ""lines"": 6}, ""runtime/doc/options.txt"": {""insertions"": 6, ""deletions"": 5, ""lines"": 11}, ""runtime/doc/pattern.txt"": {""insertions"": 7, ""deletions"": 7, ""lines"": 14}, ""runtime/doc/pi_netrw.txt"": {""insertions"": 2, ""deletions"": 2, ""lines"": 4}, ""runtime/doc/print.txt"": {""insertions"": 7, ""deletions"": 7, ""lines"": 14}, ""runtime/doc/quickref.txt"": {""insertions"": 3, ""deletions"": 3, ""lines"": 6}, ""runtime/doc/spell.txt"": {""insertions"": 1, ""deletions"": 1, ""lines"": 2}, ""runtime/doc/syntax.txt"": {""insertions"": 2, ""deletions"": 2, ""lines"": 4}, ""runtime/doc/tags"": {""insertions"": 15, ""deletions"": 1, ""lines"": 16}, ""runtime/doc/testing.txt"": {""insertions"": 1, ""deletions"": 1, ""lines"": 2}, ""runtime/doc/todo.txt"": {""insertions"": 32, ""deletions"": 30, ""lines"": 62}, ""runtime/doc/usr_41.txt"": {""insertions"": 2, ""deletions"": 2, ""lines"": 4}, ""runtime/doc/various.txt"": {""insertions"": 7, ""deletions"": 7, ""lines"": 14}, ""runtime/doc/version5.txt"": {""insertions"": 26, ""deletions"": 26, ""lines"": 52}, ""runtime/doc/version6.txt"": {""insertions"": 113, ""deletions"": 113, ""lines"": 226}, ""runtime/doc/version7.txt"": {""insertions"": 68, ""deletions"": 68, ""lines"": 136}, ""runtime/doc/version8.txt"": {""insertions"": 113, ""deletions"": 113, ""lines"": 226}, ""runtime/doc/vi_diff.txt"": {""insertions"": 2, ""deletions"": 2, ""lines"": 4}, ""runtime/doc/vim9.txt"": {""insertions"": 41, ""deletions"": 5, ""lines"": 46}, ""runtime/ftplugin/javascript.vim"": {""insertions"": 49, ""deletions"": 12, ""lines"": 61}, ""runtime/ftplugin/javascriptreact.vim"": {""insertions"": 5, ""deletions"": 0, ""lines"": 5}, ""runtime/keymap/russian-typograph.vim"": {""insertions"": 190, ""deletions"": 0, ""lines"": 190}, ""runtime/keymap/turkish-f.vim"": {""insertions"": 1, ""deletions"": 3, ""lines"": 4}, ""runtime/keymap/turkish-q.vim"": {""insertions"": 1, ""deletions"": 1, ""lines"": 2}, ""runtime/syntax/awk.vim"": {""insertions"": 3, ""deletions"": 1, ""lines"": 4}, ""runtime/syntax/c.vim"": {""insertions"": 3, ""deletions"": 1, ""lines"": 4}, ""runtime/syntax/help_ru.vim"": {""insertions"": 65, ""deletions"": 0, ""lines"": 65}, ""runtime/tools/unicode.vim"": {""insertions"": 122, ""deletions"": 60, ""lines"": 182}, ""src/po/nl.po"": {""insertions"": 24, ""deletions"": 0, ""lines"": 24}, ""src/po/tr.po"": {""insertions"": 402, ""deletions"": 583, ""lines"": 985}}"
2020-08-30 13:52:10,0b39c3fd4c5d1c8ebd2efa85fced7df5e17efd3b,Bram Moolenaar,136,15,151,10,"{""Filelist"": {""insertions"": 2, ""deletions"": 0, ""lines"": 2}, ""runtime/doc/eval.txt"": {""insertions"": 14, ""deletions"": 0, ""lines"": 14}, ""runtime/doc/usr_41.txt"": {""insertions"": 1, ""deletions"": 0, ""lines"": 1}, ""runtime/optwin.vim"": {""insertions"": 8, ""deletions"": 8, ""lines"": 16}, ""src/evalfunc.c"": {""insertions"": 22, ""deletions"": 0, ""lines"": 22}, ""src/po/Makefile"": {""insertions"": 47, ""deletions"": 6, ""lines"": 53}, ""src/po/README.txt"": {""insertions"": 9, ""deletions"": 1, ""lines"": 10}, ""src/po/fixfilenames.vim"": {""insertions"": 13, ""deletions"": 0, ""lines"": 13}, ""src/po/tojavascript.vim"": {""insertions"": 18, ""deletions"": 0, ""lines"": 18}, ""src/version.c"": {""insertions"": 2, ""deletions"": 0, ""lines"": 2}}"
2020-08-30 10:54:53,25859dd74cd5befe964627dc03b8369dfaebe837,Bram Moolenaar,6,4,10,2,"{""src/testdir/test_vim9_script.vim"": {""insertions"": 4, ""deletions"": 4, ""lines"": 8}, ""src/version.c"": {""insertions"": 2, ""deletions"": 0, ""lines"": 2}}"
2020-08-29 20:59:17,a5639848cc85f1226abad0f3ecf46b7847ce3fef,Bram Moolenaar,5,0,5,2,"{""src/testdir/test_vim9_script.vim"": {""insertions"": 3, ""deletions"": 0, ""lines"": 3}, ""src/version.c"": {""insertions"": 2, ""deletions"": 0, ""lines"": 2}}"
2020-08-29 15:47:08,95006e3dca099d3dc73d70d9872660308106e86c,Bram Moolenaar,31,4,35,4,"{""src/testdir/test_vim9_script.vim"": {""insertions"": 7, ""deletions"": 0, ""lines"": 7}, ""src/userfunc.c"": {""insertions"": 4, ""deletions"": 3, ""lines"": 7}, ""src/version.c"": {""insertions"": 2, ""deletions"": 0, ""lines"": 2}, ""src/vim9execute.c"": {""insertions"": 18, ""deletions"": 1, ""lines"": 19}}"
2020-08-29 14:41:27,98945560c1ae6e2ddee820a7de718a36e3f4b6e5,Bram Moolenaar,3,1,4,3,"{""Filelist"": {""insertions"": 0, ""deletions"": 1, ""lines"": 1}, ""{src/testdir => runtime/tools}/emoji_list.vim"": {""insertions"": 1, ""deletions"": 0, ""lines"": 1}, ""src/version.c"": {""insertions"": 2, ""deletions"": 0, ""lines"": 2}}"
2020-08-29 11:39:17,e3d4685f1f716e0c516332101d85e0930f20fc59,Bram Moolenaar,43,21,64,7,"{""src/evalvars.c"": {""insertions"": 2, ""deletions"": 2, ""lines"": 4}, ""src/globals.h"": {""insertions"": 3, ""deletions"": 2, ""lines"": 5}, ""src/profiler.c"": {""insertions"": 5, ""deletions"": 5, ""lines"": 10}, ""src/scriptfile.c"": {""insertions"": 1, ""deletions"": 1, ""lines"": 2}, ""src/testdir/test_vim9_script.vim"": {""insertions"": 9, ""deletions"": 0, ""lines"": 9}, ""src/version.c"": {""insertions"": 2, ""deletions"": 0, ""lines"": 2}, ""src/vim9compile.c"": {""insertions"": 21, ""deletions"": 11, ""lines"": 32}}"
2020-08-29 10:57:16,423a85a11a9d3d658906aea715fed7fe6aa83cd8,Bram Moolenaar,68,6,74,3,"{""src/if_py_both.h"": {""insertions"": 14, ""deletions"": 6, ""lines"": 20}, ""src/testdir/test_python3.vim"": {""insertions"": 52, ""deletions"": 0, ""lines"": 52}, ""src/version.c"": {""insertions"": 2, ""deletions"": 0, ""lines"": 2}}"
2020-08-28 21:27:20,b06a6d59d12dbd67d55b3c46f6e5547e9103c931,Bram Moolenaar,13,10,23,4,"{""src/errors.h"": {""insertions"": 1, ""deletions"": 1, ""lines"": 2}, ""src/mbyte.c"": {""insertions"": 9, ""deletions"": 8, ""lines"": 17}, ""src/testdir/test_utf8.vim"": {""insertions"": 1, ""deletions"": 1, ""lines"": 2}, ""src/version.c"": {""insertions"": 2, ""deletions"": 0, ""lines"": 2}}"
2020-08-28 20:24:57,4e4473c927167fd24e5c8df90e0e8035080cf2da,Bram Moolenaar,91,8,99,9,"{""Filelist"": {""insertions"": 1, ""deletions"": 0, ""lines"": 1}, ""runtime/doc/eval.txt"": {""insertions"": 13, ""deletions"": 0, ""lines"": 13}, ""runtime/doc/usr_41.txt"": {""insertions"": 1, ""deletions"": 0, ""lines"": 1}, ""src/evalfunc.c"": {""insertions"": 1, ""deletions"": 0, ""lines"": 1}, ""src/mbyte.c"": {""insertions"": 43, ""deletions"": 8, ""lines"": 51}, ""src/proto/mbyte.pro"": {""insertions"": 1, ""deletions"": 0, ""lines"": 1}, ""src/testdir/emoji_list.vim"": {""insertions"": 22, ""deletions"": 0, ""lines"": 22}, ""src/testdir/test_functions.vim"": {""insertions"": 7, ""deletions"": 0, ""lines"": 7}, ""src/version.c"": {""insertions"": 2, ""deletions"": 0, ""lines"": 2}}"
2020-08-28 19:04:24,08aac3c6192f0103cb87e280270a32b50e653be1,Bram Moolenaar,265,4,269,9,"{""runtime/doc/eval.txt"": {""insertions"": 24, ""deletions"": 0, ""lines"": 24}, ""runtime/doc/options.txt"": {""insertions"": 3, ""deletions"": 1, ""lines"": 4}, ""runtime/doc/usr_41.txt"": {""insertions"": 1, ""deletions"": 0, ""lines"": 1}, ""src/errors.h"": {""insertions"": 12, ""deletions"": 0, ""lines"": 12}, ""src/evalfunc.c"": {""insertions"": 1, ""deletions"": 0, ""lines"": 1}, ""src/mbyte.c"": {""insertions"": 186, ""deletions"": 3, ""lines"": 189}, ""src/proto/mbyte.pro"": {""insertions"": 1, ""deletions"": 0, ""lines"": 1}, ""src/testdir/test_utf8.vim"": {""insertions"": 35, ""deletions"": 0, ""lines"": 35}, ""src/version.c"": {""insertions"": 2, ""deletions"": 0, ""lines"": 2}}"
2020-08-28 15:19:07,ee8580e52e767916e2a95e8ac0732fd8a5ae0651,Bram Moolenaar,19,10,29,4,"{""src/testdir/test_vim9_func.vim"": {""insertions"": 9, ""deletions"": 0, ""lines"": 9}, ""src/userfunc.c"": {""insertions"": 0, ""deletions"": 7, ""lines"": 7}, ""src/version.c"": {""insertions"": 2, ""deletions"": 0, ""lines"": 2}, ""src/vim9execute.c"": {""insertions"": 8, ""deletions"": 3, ""lines"": 11}}"
2020-08-28 14:39:33,6a950581da52b410a74531044aae8f1f8f38a7df,Bram Moolenaar,10,1,11,3,"{""src/evalfunc.c"": {""insertions"": 1, ""deletions"": 1, ""lines"": 2}, ""src/testdir/test_vim9_func.vim"": {""insertions"": 7, ""deletions"": 0, ""lines"": 7}, ""src/version.c"": {""insertions"": 2, ""deletions"": 0, ""lines"": 2}}"
2020-08-28 14:38:11,2566054a7f406a6c9a082e7fd5f1597164668ca9,Bram Moolenaar,3,1,4,2,"{""src/eval.c"": {""insertions"": 1, ""deletions"": 1, ""lines"": 2}, ""src/version.c"": {""insertions"": 2, ""deletions"": 0, ""lines"": 2}}"
2020-08-27 21:57:57,7a3330fc578033f06a94c23de61a23edcc59f95e,Bram Moolenaar,3,1,4,2,"{""src/version.c"": {""insertions"": 2, ""deletions"": 0, ""lines"": 2}, ""src/vim9compile.c"": {""insertions"": 1, ""deletions"": 1, ""lines"": 2}}"
2020-08-27 21:37:09,5163fcce792c9d730bf864f4d9bb07f30625cff9,Bram Moolenaar,13,3,16,2,"{""src/version.c"": {""insertions"": 2, ""deletions"": 0, ""lines"": 2}, ""src/vim9compile.c"": {""insertions"": 11, ""deletions"": 3, ""lines"": 14}}"
2020-08-27 21:08:47,749639ec7248740cd271f34ec5f7bb70891b459c,Bram Moolenaar,9,1,10,3,"{""src/testdir/test_vim9_expr.vim"": {""insertions"": 3, ""deletions"": 1, ""lines"": 4}, ""src/version.c"": {""insertions"": 2, ""deletions"": 0, ""lines"": 2}, ""src/vim9compile.c"": {""insertions"": 4, ""deletions"": 0, ""lines"": 4}}"
2020-08-27 20:43:03,3988f64f9d512fd809d4a600b020638bf2c7d7ec,Bram Moolenaar,30,19,49,3,"{""src/testdir/test_vim9_script.vim"": {""insertions"": 8, ""deletions"": 0, ""lines"": 8}, ""src/version.c"": {""insertions"": 2, ""deletions"": 0, ""lines"": 2}, ""src/vim9compile.c"": {""insertions"": 20, ""deletions"": 19, ""lines"": 39}}"
2020-08-27 19:33:10,601e76ac3c8fa5d65ac04647a762792ea343ebd5,Bram Moolenaar,39,7,46,4,"{""src/evalvars.c"": {""insertions"": 14, ""deletions"": 0, ""lines"": 14}, ""src/testdir/test_vim9_expr.vim"": {""insertions"": 11, ""deletions"": 0, ""lines"": 11}, ""src/testdir/test_vim9_script.vim"": {""insertions"": 12, ""deletions"": 7, ""lines"": 19}, ""src/version.c"": {""insertions"": 2, ""deletions"": 0, ""lines"": 2}}"
2020-08-27 14:06:46,228e62975e7aef9d6224a5a7c43625c1c1494fc2,Bram Moolenaar,3,1,4,2,"{""src/testdir/Makefile"": {""insertions"": 1, ""deletions"": 1, ""lines"": 2}, ""src/version.c"": {""insertions"": 2, ""deletions"": 0, ""lines"": 2}}"
2020-08-26 20:29:57,6e3aeec8461cf27396b6574b5438019a00684e00,Bram Moolenaar,6,4,10,4,"{""src/testdir/Make_dos.mak"": {""insertions"": 1, ""deletions"": 1, ""lines"": 2}, ""src/testdir/Make_ming.mak"": {""insertions"": 1, ""deletions"": 1, ""lines"": 2}, ""src/testdir/Makefile"": {""insertions"": 2, ""deletions"": 2, ""lines"": 4}, ""src/version.c"": {""insertions"": 2, ""deletions"": 0, ""lines"": 2}}"
2020-08-25 20:37:48,2e0866128b6266829a7f38733d5188bc4ec68745,Bram Moolenaar,14,5,19,3,"{""src/eval.c"": {""insertions"": 6, ""deletions"": 5, ""lines"": 11}, ""src/testdir/test_eval_stuff.vim"": {""insertions"": 6, ""deletions"": 0, ""lines"": 6}, ""src/version.c"": {""insertions"": 2, ""deletions"": 0, ""lines"": 2}}"
2020-08-25 19:19:36,b9fc192f928b484c8809fb985ef334d7a2bb5a09,Bram Moolenaar,52,32,84,2,"{""src/testdir/test_spellfile.vim"": {""insertions"": 50, ""deletions"": 32, ""lines"": 82}, ""src/version.c"": {""insertions"": 2, ""deletions"": 0, ""lines"": 2}}"
2020-08-24 18:28:56,c8ec5fe56fc30201c889ca577bf1e69823fadb2a,Bram Moolenaar,225,0,225,2,"{""src/testdir/test_spellfile.vim"": {""insertions"": 223, ""deletions"": 0, ""lines"": 223}, ""src/version.c"": {""insertions"": 2, ""deletions"": 0, ""lines"": 2}}"
2020-08-24 18:05:50,07399e7f078729b03451ba2b342d0cb434ab75cf,Bram Moolenaar,14,7,21,3,"{""src/spell.h"": {""insertions"": 1, ""deletions"": 0, ""lines"": 1}, ""src/spellfile.c"": {""insertions"": 11, ""deletions"": 7, ""lines"": 18}, ""src/version.c"": {""insertions"": 2, ""deletions"": 0, ""lines"": 2}}"
2020-08-23 19:46:32,b3ea36c5bcb88b6a05a66347eedd461e9385103f,Bram Moolenaar,25,1,26,3,"{""src/normal.c"": {""insertions"": 3, ""deletions"": 1, ""lines"": 4}, ""src/testdir/test_vim9_cmd.vim"": {""insertions"": 20, ""deletions"": 0, ""lines"": 20}, ""src/version.c"": {""insertions"": 2, ""deletions"": 0, ""lines"": 2}}"
2020-08-23 19:06:02,c2af0afff5c44969ad7611ec2d47d0f52087fa7f,Bram Moolenaar,138,98,236,3,"{""src/ex_docmd.c"": {""insertions"": 124, ""deletions"": 98, ""lines"": 222}, ""src/testdir/test_vim9_script.vim"": {""insertions"": 12, ""deletions"": 0, ""lines"": 12}, ""src/version.c"": {""insertions"": 2, ""deletions"": 0, ""lines"": 2}}"
2020-08-23 17:34:48,2e80095501238e0c6b702ac7cdfa2e2b763dba28,Bram Moolenaar,51,18,69,6,"{""src/ex_docmd.c"": {""insertions"": 22, ""deletions"": 3, ""lines"": 25}, ""src/proto/ex_docmd.pro"": {""insertions"": 1, ""deletions"": 0, ""lines"": 1}, ""src/testdir/test_vim9_script.vim"": {""insertions"": 15, ""deletions"": 10, ""lines"": 25}, ""src/testdir/vim9.vim"": {""insertions"": 5, ""deletions"": 0, ""lines"": 5}, ""src/version.c"": {""insertions"": 2, ""deletions"": 0, ""lines"": 2}, ""src/vim9compile.c"": {""insertions"": 6, ""deletions"": 5, ""lines"": 11}}"
2020-08-23 15:34:46,6c53fca02301ff871cddc1c74c388e23e53a424a,Bram Moolenaar,36,14,50,4,"{""runtime/doc/eval.txt"": {""insertions"": 17, ""deletions"": 9, ""lines"": 26}, ""src/evalfunc.c"": {""insertions"": 13, ""deletions"": 5, ""lines"": 18}, ""src/testdir/test_functions.vim"": {""insertions"": 4, ""deletions"": 0, ""lines"": 4}, ""src/version.c"": {""insertions"": 2, ""deletions"": 0, ""lines"": 2}}"
2020-08-23 14:29:11,430deb1945cbc7a17ed42c5c737fc08d2eef327a,Bram Moolenaar,8,2,10,3,"{""src/testdir/test_vim9_script.vim"": {""insertions"": 3, ""deletions"": 2, ""lines"": 5}, ""src/version.c"": {""insertions"": 2, ""deletions"": 0, ""lines"": 2}, ""src/vim9execute.c"": {""insertions"": 3, ""deletions"": 0, ""lines"": 3}}"
2020-08-23 13:21:55,8436773fad285215481c4ce2b32692e66fca599f,Bram Moolenaar,22,2,24,3,"{""src/testdir/test_vim9_script.vim"": {""insertions"": 7, ""deletions"": 0, ""lines"": 7}, ""src/version.c"": {""insertions"": 2, ""deletions"": 0, ""lines"": 2}, ""src/vim9compile.c"": {""insertions"": 13, ""deletions"": 2, ""lines"": 15}}"
2020-08-23 13:09:36,dc0cf1db3e8e0de349e4cc5b0a7ab6c8b7dc2ebb,Bram Moolenaar,4,1,5,2,"{""src/screen.c"": {""insertions"": 2, ""deletions"": 1, ""lines"": 3}, ""src/version.c"": {""insertions"": 2, ""deletions"": 0, ""lines"": 2}}"
2020-08-23 12:28:37,0981c8729e09551f2e8e6c159bc29f2c1d04019c,Bram Moolenaar,41,26,67,12,"{""src/channel.c"": {""insertions"": 1, ""deletions"": 1, ""lines"": 2}, ""src/if_cscope.c"": {""insertions"": 2, ""deletions"": 2, ""lines"": 4}, ""src/os_amiga.c"": {""insertions"": 3, ""deletions"": 3, ""lines"": 6}, ""src/os_unix.c"": {""insertions"": 22, ""deletions"": 13, ""lines"": 35}, ""src/os_win32.c"": {""insertions"": 2, ""deletions"": 2, ""lines"": 4}, ""src/proto/os_amiga.pro"": {""insertions"": 1, ""deletions"": 1, ""lines"": 2}, ""src/proto/os_unix.pro"": {""insertions"": 1, ""deletions"": 1, ""lines"": 2}, ""src/proto/os_win32.pro"": {""insertions"": 1, ""deletions"": 1, ""lines"": 2}, ""src/term.c"": {""insertions"": 1, ""deletions"": 1, ""lines"": 2}, ""src/ui.c"": {""insertions"": 1, ""deletions"": 1, ""lines"": 2}, ""src/version.c"": {""insertions"": 2, ""deletions"": 0, ""lines"": 2}, ""src/vim.h"": {""insertions"": 4, ""deletions"": 0, ""lines"": 4}}"
2020-08-22 20:37:20,69e44552c567ff25b363ba0790ad3d43fa0397a7,Bram Moolenaar,54,0,54,4,"{""src/eval.c"": {""insertions"": 7, ""deletions"": 0, ""lines"": 7}, ""src/testdir/test_vim9_expr.vim"": {""insertions"": 21, ""deletions"": 0, ""lines"": 21}, ""src/testdir/test_vimscript.vim"": {""insertions"": 24, ""deletions"": 0, ""lines"": 24}, ""src/version.c"": {""insertions"": 2, ""deletions"": 0, ""lines"": 2}}"
2020-08-22 19:08:44,cd94277f72e29b740635da84bcd872c96e11bf67,Bram Moolenaar,36,2,38,3,"{""src/register.c"": {""insertions"": 25, ""deletions"": 2, ""lines"": 27}, ""src/testdir/test_visual.vim"": {""insertions"": 9, ""deletions"": 0, ""lines"": 9}, ""src/version.c"": {""insertions"": 2, ""deletions"": 0, ""lines"": 2}}"
2020-08-22 17:02:02,5390099a9733f7952a612670693dd4ebf9e0e178,Bram Moolenaar,33,27,60,3,"{""src/testdir/test_vim9_func.vim"": {""insertions"": 16, ""deletions"": 16, ""lines"": 32}, ""src/version.c"": {""insertions"": 2, ""deletions"": 0, ""lines"": 2}, ""src/vim9compile.c"": {""insertions"": 15, ""deletions"": 11, ""lines"": 26}}"
2020-08-22 15:21:14,9943b3d97955ece99c747c959e0a7d493bb762bb,Bram Moolenaar,4,1,5,2,"{""src/screen.c"": {""insertions"": 2, ""deletions"": 1, ""lines"": 3}, ""src/version.c"": {""insertions"": 2, ""deletions"": 0, ""lines"": 2}}"
2020-08-22 14:04:52,c63b72b6dc1347530ce906b462bb568994552c8b,Bram Moolenaar,95,0,95,2,"{""src/testdir/test_debugger.vim"": {""insertions"": 93, ""deletions"": 0, ""lines"": 93}, ""src/version.c"": {""insertions"": 2, ""deletions"": 0, ""lines"": 2}}"
2020-08-22 13:19:18,51b6eb47b3c41b01a5559b099e65354c8897093e,Bram Moolenaar,8,6,14,4,"{""src/eval.c"": {""insertions"": 4, ""deletions"": 3, ""lines"": 7}, ""src/memline.c"": {""insertions"": 1, ""deletions"": 2, ""lines"": 3}, ""src/version.c"": {""insertions"": 2, ""deletions"": 0, ""lines"": 2}, ""src/vimrun.c"": {""insertions"": 1, ""deletions"": 1, ""lines"": 2}}"
2020-08-22 13:06:35,d70840ed68296c1144d743e6335003c81c558c24,Bram Moolenaar,23,5,28,4,"{""src/errors.h"": {""insertions"": 2, ""deletions"": 1, ""lines"": 3}, ""src/testdir/test_vim9_func.vim"": {""insertions"": 12, ""deletions"": 2, ""lines"": 14}, ""src/typval.c"": {""insertions"": 7, ""deletions"": 2, ""lines"": 9}, ""src/version.c"": {""insertions"": 2, ""deletions"": 0, ""lines"": 2}}"
2020-08-21 20:46:11,1b04ce2d400fda97410a961288c496bd8f445a9c,Bram Moolenaar,40,6,46,4,"{""src/testdir/test_eval_stuff.vim"": {""insertions"": 19, ""deletions"": 6, ""lines"": 25}, ""src/testdir/test_fnamemodify.vim"": {""insertions"": 6, ""deletions"": 0, ""lines"": 6}, ""src/testdir/test_functions.vim"": {""insertions"": 13, ""deletions"": 0, ""lines"": 13}, ""src/version.c"": {""insertions"": 2, ""deletions"": 0, ""lines"": 2}}"
2020-08-21 20:36:47,7cb6fc29d067ed97c0b0c1d2d5767125ef9ae1ab,Bram Moolenaar,65,39,104,11,"{""src/dict.c"": {""insertions"": 4, ""deletions"": 4, ""lines"": 8}, ""src/errors.h"": {""insertions"": 6, ""deletions"": 6, ""lines"": 12}, ""src/evalvars.c"": {""insertions"": 1, ""deletions"": 1, ""lines"": 2}, ""src/list.c"": {""insertions"": 2, ""deletions"": 2, ""lines"": 4}, ""src/testdir/test_vim9_expr.vim"": {""insertions"": 2, ""deletions"": 1, ""lines"": 3}, ""src/testdir/vim9.vim"": {""insertions"": 7, ""deletions"": 0, ""lines"": 7}, ""src/userfunc.c"": {""insertions"": 20, ""deletions"": 4, ""lines"": 24}, ""src/version.c"": {""insertions"": 2, ""deletions"": 0, ""lines"": 2}, ""src/vim9compile.c"": {""insertions"": 16, ""deletions"": 16, ""lines"": 32}, ""src/vim9script.c"": {""insertions"": 1, ""deletions"": 1, ""lines"": 2}, ""src/vim9type.c"": {""insertions"": 4, ""deletions"": 4, ""lines"": 8}}"
2020-08-21 19:55:43,81e17fbe00fd2ed93b262adc3ba41c86b02e7f46,Bram Moolenaar,23,0,23,3,"{""src/testdir/test_vim9_script.vim"": {""insertions"": 17, ""deletions"": 0, ""lines"": 17}, ""src/version.c"": {""insertions"": 2, ""deletions"": 0, ""lines"": 2}, ""src/vim9script.c"": {""insertions"": 4, ""deletions"": 0, ""lines"": 4}}"
2020-08-21 19:32:50,122616d9c1b57f1e1f29f1151f8e26d24df9092a,Bram Moolenaar,13,4,17,4,"{""src/evalvars.c"": {""insertions"": 7, ""deletions"": 1, ""lines"": 8}, ""src/testdir/test_vim9_expr.vim"": {""insertions"": 0, ""deletions"": 2, ""lines"": 2}, ""src/testdir/test_vim9_script.vim"": {""insertions"": 4, ""deletions"": 1, ""lines"": 5}, ""src/version.c"": {""insertions"": 2, ""deletions"": 0, ""lines"": 2}}"
2020-08-21 18:43:17,3fc71285d5ae7c16cf7be5d997fd1fe140f196da,Bram Moolenaar,23,3,26,3,"{""src/testdir/test_vim9_expr.vim"": {""insertions"": 12, ""deletions"": 0, ""lines"": 12}, ""src/version.c"": {""insertions"": 2, ""deletions"": 0, ""lines"": 2}, ""src/vim9compile.c"": {""insertions"": 9, ""deletions"": 3, ""lines"": 12}}"
2020-08-20 21:04:06,5d72ce69c8783fd8f1a0355c00806c5084010eec,Bram Moolenaar,25,3,28,3,"{""src/testdir/test_vim9_script.vim"": {""insertions"": 7, ""deletions"": 0, ""lines"": 7}, ""src/version.c"": {""insertions"": 2, ""deletions"": 0, ""lines"": 2}, ""src/vim9compile.c"": {""insertions"": 16, ""deletions"": 3, ""lines"": 19}}"
2020-08-20 20:29:12,ec65d77fa26cc87f7ce54a5a941a799e3a667c50,Bram Moolenaar,17,5,22,3,"{""src/eval.c"": {""insertions"": 9, ""deletions"": 5, ""lines"": 14}, ""src/testdir/test_vim9_func.vim"": {""insertions"": 6, ""deletions"": 0, ""lines"": 6}, ""src/version.c"": {""insertions"": 2, ""deletions"": 0, ""lines"": 2}}"
2020-08-20 16:59:06,733d259a83bfdd3e1670cc1665e1bd56501799df,Bram Moolenaar,39,37,76,8,"{""src/testdir/test_digraph.vim"": {""insertions"": 3, ""deletions"": 3, ""lines"": 6}, ""src/testdir/test_display.vim"": {""insertions"": 1, ""deletions"": 1, ""lines"": 2}, ""src/testdir/test_popupwin.vim"": {""insertions"": 1, ""deletions"": 1, ""lines"": 2}, ""src/testdir/test_termcodes.vim"": {""insertions"": 2, ""deletions"": 2, ""lines"": 4}, ""src/testdir/test_terminal.vim"": {""insertions"": 4, ""deletions"": 4, ""lines"": 8}, ""src/testdir/test_terminal3.vim"": {""insertions"": 19, ""deletions"": 19, ""lines"": 38}, ""src/testdir/test_writefile.vim"": {""insertions"": 7, ""deletions"": 7, ""lines"": 14}, ""src/version.c"": {""insertions"": 2, ""deletions"": 0, ""lines"": 2}}"
2020-08-20 16:29:13,17f67547f36a06220ea4667aaee7bb130108f568,Bram Moolenaar,7,6,13,2,"{""src/testdir/test_autocmd.vim"": {""insertions"": 5, ""deletions"": 6, ""lines"": 11}, ""src/version.c"": {""insertions"": 2, ""deletions"": 0, ""lines"": 2}}"
2020-08-20 16:02:47,b8a9296cedb9fae35572041ef5cfa894f3ad9fbb,Bram Moolenaar,13,0,13,4,"{""src/ex_docmd.c"": {""insertions"": 1, ""deletions"": 0, ""lines"": 1}, ""src/testdir/test_vim9_cmd.vim"": {""insertions"": 9, ""deletions"": 0, ""lines"": 9}, ""src/version.c"": {""insertions"": 2, ""deletions"": 0, ""lines"": 2}, ""src/vim9compile.c"": {""insertions"": 1, ""deletions"": 0, ""lines"": 1}}"
2020-08-20 14:16:27,df2524bbb495c880d094d9542abf7c23d739cc53,Bram Moolenaar,3,2,5,2,"{""src/Makefile"": {""insertions"": 1, ""deletions"": 2, ""lines"": 3}, ""src/version.c"": {""insertions"": 2, ""deletions"": 0, ""lines"": 2}}"
2020-08-20 13:52:21,825b54415f71beadd125b5703bed08332c053168,Bram Moolenaar,4,1,5,2,"{""src/eval.c"": {""insertions"": 2, ""deletions"": 1, ""lines"": 3}, ""src/version.c"": {""insertions"": 2, ""deletions"": 0, ""lines"": 2}}"
2020-08-20 13:41:55,fc2a47ffc425777704b329c9edbe21163bedf63c,Bram Moolenaar,278,88,366,3,"{""src/spellfile.c"": {""insertions"": 1, ""deletions"": 1, ""lines"": 2}, ""src/testdir/test_spellfile.vim"": {""insertions"": 275, ""deletions"": 87, ""lines"": 362}, ""src/version.c"": {""insertions"": 2, ""deletions"": 0, ""lines"": 2}}"
2020-08-20 13:25:00,20b23c6358131baefb57b9083387fb4524d3ff24,Bram Moolenaar,20,18,38,3,"{""src/ex_docmd.c"": {""insertions"": 11, ""deletions"": 11, ""lines"": 22}, ""src/structs.h"": {""insertions"": 7, ""deletions"": 7, ""lines"": 14}, ""src/version.c"": {""insertions"": 2, ""deletions"": 0, ""lines"": 2}}"
2020-08-20 13:02:42,66250c932e8a0e3c43e7c7c7b1dbede040b9c508,Bram Moolenaar,81,45,126,16,"{""src/autocmd.c"": {""insertions"": 5, ""deletions"": 1, ""lines"": 6}, ""src/evalfunc.c"": {""insertions"": 1, ""deletions"": 2, ""lines"": 3}, ""src/ex_cmds.h"": {""insertions"": 1, ""deletions"": 1, ""lines"": 2}, ""src/ex_docmd.c"": {""insertions"": 6, ""deletions"": 6, ""lines"": 12}, ""src/ex_getln.c"": {""insertions"": 3, ""deletions"": 3, ""lines"": 6}, ""src/proto/autocmd.pro"": {""insertions"": 1, ""deletions"": 1, ""lines"": 2}, ""src/proto/ex_docmd.pro"": {""insertions"": 4, ""deletions"": 4, ""lines"": 8}, ""src/proto/ex_getln.pro"": {""insertions"": 2, ""deletions"": 2, ""lines"": 4}, ""src/proto/scriptfile.pro"": {""insertions"": 3, ""deletions"": 3, ""lines"": 6}, ""src/proto/userfunc.pro"": {""insertions"": 1, ""deletions"": 1, ""lines"": 2}, ""src/scriptfile.c"": {""insertions"": 15, ""deletions"": 6, ""lines"": 21}, ""src/structs.h"": {""insertions"": 8, ""deletions"": 1, ""lines"": 9}, ""src/testdir/test_vim9_script.vim"": {""insertions"": 11, ""deletions"": 0, ""lines"": 11}, ""src/userfunc.c"": {""insertions"": 8, ""deletions"": 7, ""lines"": 15}, ""src/version.c"": {""insertions"": 2, ""deletions"": 0, ""lines"": 2}, ""src/vim9compile.c"": {""insertions"": 10, ""deletions"": 7, ""lines"": 17}}"
2020-08-19 20:02:41,93ad14710bdf77591f927a2b244bba6a8cbc7706,Bram Moolenaar,27,22,49,3,"{""src/testdir/test_vim9_script.vim"": {""insertions"": 12, ""deletions"": 0, ""lines"": 12}, ""src/version.c"": {""insertions"": 2, ""deletions"": 0, ""lines"": 2}, ""src/vim9compile.c"": {""insertions"": 13, ""deletions"": 22, ""lines"": 35}}"
2020-08-19 19:20:49,191929b182ba38abe6bc431fb9d8d9507f408903,Bram Moolenaar,34,21,55,3,"{""src/evalvars.c"": {""insertions"": 20, ""deletions"": 21, ""lines"": 41}, ""src/testdir/test_vim9_func.vim"": {""insertions"": 12, ""deletions"": 0, ""lines"": 12}, ""src/version.c"": {""insertions"": 2, ""deletions"": 0, ""lines"": 2}}"
2020-08-19 18:19:48,9dc1917f42b23277e143fc58bbe27482b0b76bad,Bram Moolenaar,19,1,20,4,"{""src/drawscreen.c"": {""insertions"": 1, ""deletions"": 1, ""lines"": 2}, ""src/testdir/dumps/Test_display_scroll_at_topline.dump"": {""insertions"": 4, ""deletions"": 0, ""lines"": 4}, ""src/testdir/test_display.vim"": {""insertions"": 12, ""deletions"": 0, ""lines"": 12}, ""src/version.c"": {""insertions"": 2, ""deletions"": 0, ""lines"": 2}}"
2020-08-19 17:46:12,a7c4e747639ad7642cd50ed577ff4c93db200df4,Bram Moolenaar,15,9,24,3,"{"".travis.yml"": {""insertions"": 12, ""deletions"": 8, ""lines"": 20}, ""ci/load-snd-dummy.sh"": {""insertions"": 1, ""deletions"": 1, ""lines"": 2}, ""src/version.c"": {""insertions"": 2, ""deletions"": 0, ""lines"": 2}}"
2020-08-19 14:00:06,f8abbf37d66c41d980284e28e0e38a399890e918,Bram Moolenaar,41,37,78,3,"{""src/filepath.c"": {""insertions"": 37, ""deletions"": 36, ""lines"": 73}, ""src/testdir/test_vim9_func.vim"": {""insertions"": 2, ""deletions"": 1, ""lines"": 3}, ""src/version.c"": {""insertions"": 2, ""deletions"": 0, ""lines"": 2}}"
2020-08-19 11:55:01,af8822ce085e3bd8edeb52cbb7306ddd42427d39,Bram Moolenaar,12,0,12,3,"{""src/filepath.c"": {""insertions"": 6, ""deletions"": 0, ""lines"": 6}, ""src/testdir/test_vim9_func.vim"": {""insertions"": 4, ""deletions"": 0, ""lines"": 4}, ""src/version.c"": {""insertions"": 2, ""deletions"": 0, ""lines"": 2}}"
2020-08-18 21:24:13,9b02d64cff7664b9643205d6e23b08da688fe87a,Bram Moolenaar,4,1,5,2,"{""src/testing.c"": {""insertions"": 2, ""deletions"": 1, ""lines"": 3}, ""src/version.c"": {""insertions"": 2, ""deletions"": 0, ""lines"": 2}}"
2020-08-18 20:50:38,165036ddba1318576a29f75d82fae8c326a48f18,Bram Moolenaar,3,1,4,2,"{""src/popupwin.c"": {""insertions"": 1, ""deletions"": 1, ""lines"": 2}, ""src/version.c"": {""insertions"": 2, ""deletions"": 0, ""lines"": 2}}"
2020-08-18 20:32:03,aeb2bdd0de5ce5b566509dda5ba9ad6f976063b3,Bram Moolenaar,18,3,21,4,"{""src/eval.c"": {""insertions"": 5, ""deletions"": 2, ""lines"": 7}, ""src/scriptfile.c"": {""insertions"": 2, ""deletions"": 1, ""lines"": 3}, ""src/testdir/test_vim9_expr.vim"": {""insertions"": 9, ""deletions"": 0, ""lines"": 9}, ""src/version.c"": {""insertions"": 2, ""deletions"": 0, ""lines"": 2}}"
2020-08-18 18:34:13,3affe7a6c6fc813f5d29857933ee6aca0b9c7bd6,Bram Moolenaar,306,297,603,4,"{""src/testdir/test_vim9_expr.vim"": {""insertions"": 290, ""deletions"": 289, ""lines"": 579}, ""src/testdir/vim9.vim"": {""insertions"": 12, ""deletions"": 8, ""lines"": 20}, ""src/version.c"": {""insertions"": 2, ""deletions"": 0, ""lines"": 2}, ""src/vim9execute.c"": {""insertions"": 2, ""deletions"": 0, ""lines"": 2}}"
2020-08-18 17:11:38,e15eebd202e739ec7821a0e9c2aa72a445668bb8,Bram Moolenaar,22,1,23,5,"{""src/eval.c"": {""insertions"": 1, ""deletions"": 1, ""lines"": 2}, ""src/proto/typval.pro"": {""insertions"": 1, ""deletions"": 0, ""lines"": 1}, ""src/testdir/test_vim9_func.vim"": {""insertions"": 7, ""deletions"": 0, ""lines"": 7}, ""src/typval.c"": {""insertions"": 11, ""deletions"": 0, ""lines"": 11}, ""src/version.c"": {""insertions"": 2, ""deletions"": 0, ""lines"": 2}}"
2020-08-18 11:41:50,1d634542cf5ebcd1d5d83bd124b3e1d5e7c96c58,Bram Moolenaar,56,15,71,9,"{""runtime/doc/testing.txt"": {""insertions"": 12, ""deletions"": 3, ""lines"": 15}, ""src/evalfunc.c"": {""insertions"": 1, ""deletions"": 1, ""lines"": 2}, ""src/globals.h"": {""insertions"": 1, ""deletions"": 0, ""lines"": 1}, ""src/message.c"": {""insertions"": 3, ""deletions"": 0, ""lines"": 3}, ""src/testdir/test_vim9_expr.vim"": {""insertions"": 5, ""deletions"": 3, ""lines"": 8}, ""src/testdir/vim9.vim"": {""insertions"": 6, ""deletions"": 4, ""lines"": 10}, ""src/testing.c"": {""insertions"": 25, ""deletions"": 4, ""lines"": 29}, ""src/version.c"": {""insertions"": 2, ""deletions"": 0, ""lines"": 2}, ""src/vim9execute.c"": {""insertions"": 1, ""deletions"": 0, ""lines"": 1}}"
2020-08-18 11:04:15,558813314d63dd0263a7a86c0496c1e89b5c8cba,Bram Moolenaar,33,21,54,4,"{""src/dict.c"": {""insertions"": 15, ""deletions"": 0, ""lines"": 15}, ""src/popupwin.c"": {""insertions"": 15, ""deletions"": 21, ""lines"": 36}, ""src/proto/dict.pro"": {""insertions"": 1, ""deletions"": 0, ""lines"": 1}, ""src/version.c"": {""insertions"": 2, ""deletions"": 0, ""lines"": 2}}"
2020-08-17 20:21:36,f39397e515067d5a314be99778e63fe0acf93c51,Bram Moolenaar,9,1,10,3,"{""src/evalbuffer.c"": {""insertions"": 2, ""deletions"": 1, ""lines"": 3}, ""src/testdir/test_vim9_func.vim"": {""insertions"": 5, ""deletions"": 0, ""lines"": 5}, ""src/version.c"": {""insertions"": 2, ""deletions"": 0, ""lines"": 2}}"
2020-08-17 19:57:09,aa9675a61d510c4a56c3845d05b32b1ef780d119,Bram Moolenaar,3,1,4,2,"{""runtime/autoload/dist/ft.vim"": {""insertions"": 1, ""deletions"": 1, ""lines"": 2}, ""src/version.c"": {""insertions"": 2, ""deletions"": 0, ""lines"": 2}}"
2020-08-17 19:41:02,36967b32fd02eaab4273c1a1e7a1210a5fe45d09,Bram Moolenaar,46,26,72,4,"{""src/channel.c"": {""insertions"": 7, ""deletions"": 7, ""lines"": 14}, ""src/proto/typval.pro"": {""insertions"": 1, ""deletions"": 0, ""lines"": 1}, ""src/typval.c"": {""insertions"": 36, ""deletions"": 19, ""lines"": 55}, ""src/version.c"": {""insertions"": 2, ""deletions"": 0, ""lines"": 2}}"
2020-08-17 19:17:25,624b6eaf20f3e8c669425b6a32f17fb9ec2ebbd2,Bram Moolenaar,4,1,5,3,"{""runtime/autoload/dist/ft.vim"": {""insertions"": 1, ""deletions"": 1, ""lines"": 2}, ""src/testdir/test_filetype.vim"": {""insertions"": 1, ""deletions"": 0, ""lines"": 1}, ""src/version.c"": {""insertions"": 2, ""deletions"": 0, ""lines"": 2}}"
2020-08-17 19:07:22,021bda56710d98c09a6b35610a476ab2dd8c58ad,Bram Moolenaar,60,24,84,5,"{""runtime/doc/eval.txt"": {""insertions"": 11, ""deletions"": 3, ""lines"": 14}, ""src/eval.c"": {""insertions"": 2, ""deletions"": 0, ""lines"": 2}, ""src/evalvars.c"": {""insertions"": 21, ""deletions"": 12, ""lines"": 33}, ""src/testdir/test_const.vim"": {""insertions"": 24, ""deletions"": 9, ""lines"": 33}, ""src/version.c"": {""insertions"": 2, ""deletions"": 0, ""lines"": 2}}"
2020-08-17 17:34:10,7b22117c4ecf383b6f35acef041773a83ec28220,Bram Moolenaar,24,8,32,4,"{""src/arglist.c"": {""insertions"": 13, ""deletions"": 5, ""lines"": 18}, ""src/ex_docmd.c"": {""insertions"": 1, ""deletions"": 1, ""lines"": 2}, ""src/testdir/test_arglist.vim"": {""insertions"": 8, ""deletions"": 2, ""lines"": 10}, ""src/version.c"": {""insertions"": 2, ""deletions"": 0, ""lines"": 2}}"
2020-08-16 20:50:01,241572794f7e93d2f8b762de2300e5f7e4f07628,Bram Moolenaar,11,5,16,3,"{""src/evalvars.c"": {""insertions"": 1, ""deletions"": 1, ""lines"": 2}, ""src/testdir/test_const.vim"": {""insertions"": 8, ""deletions"": 4, ""lines"": 12}, ""src/version.c"": {""insertions"": 2, ""deletions"": 0, ""lines"": 2}}"
2020-08-16 19:51:49,c0f8823ee4ca629db5446ba0a935f68d4a4fb193,Bram Moolenaar,168,1,169,2,"{""src/testdir/test_spellfile.vim"": {""insertions"": 166, ""deletions"": 1, ""lines"": 167}, ""src/version.c"": {""insertions"": 2, ""deletions"": 0, ""lines"": 2}}"
2020-08-16 19:29:05,0aae4809fd52b445531766411a9c963dc6274a04,Bram Moolenaar,56,26,82,3,"{""src/evalvars.c"": {""insertions"": 28, ""deletions"": 14, ""lines"": 42}, ""src/testdir/test_vim9_script.vim"": {""insertions"": 26, ""deletions"": 12, ""lines"": 38}, ""src/version.c"": {""insertions"": 2, ""deletions"": 0, ""lines"": 2}}"
2020-08-16 16:42:53,f923571ec17b6caeeb7f4abfd7eec3f707ab9c45,Bram Moolenaar,10,1,11,3,"{""src/eval.c"": {""insertions"": 1, ""deletions"": 1, ""lines"": 2}, ""src/testdir/test_vim9_expr.vim"": {""insertions"": 7, ""deletions"": 0, ""lines"": 7}, ""src/version.c"": {""insertions"": 2, ""deletions"": 0, ""lines"": 2}}"
2020-08-16 16:29:35,e5abf7af08ff69e7e038c067497f080d4e44332c,Bram Moolenaar,22,10,32,4,"{""src/testdir/test_vim9_script.vim"": {""insertions"": 3, ""deletions"": 0, ""lines"": 3}, ""src/version.c"": {""insertions"": 2, ""deletions"": 0, ""lines"": 2}, ""src/vim9compile.c"": {""insertions"": 3, ""deletions"": 4, ""lines"": 7}, ""src/vim9execute.c"": {""insertions"": 14, ""deletions"": 6, ""lines"": 20}}"
2020-08-16 15:33:35,cc673e746ab98566556ff964d7a76f2fb46d7f84,Bram Moolenaar,410,205,615,11,"{""src/errors.h"": {""insertions"": 9, ""deletions"": 4, ""lines"": 13}, ""src/eval.c"": {""insertions"": 212, ""deletions"": 174, ""lines"": 386}, ""src/list.c"": {""insertions"": 1, ""deletions"": 1, ""lines"": 2}, ""src/proto/eval.pro"": {""insertions"": 2, ""deletions"": 0, ""lines"": 2}, ""src/testdir/test_vim9_disassemble.vim"": {""insertions"": 44, ""deletions"": 0, ""lines"": 44}, ""src/testdir/test_vim9_expr.vim"": {""insertions"": 86, ""deletions"": 4, ""lines"": 90}, ""src/testdir/test_vim9_script.vim"": {""insertions"": 1, ""deletions"": 1, ""lines"": 2}, ""src/version.c"": {""insertions"": 2, ""deletions"": 0, ""lines"": 2}, ""src/vim9.h"": {""insertions"": 2, ""deletions"": 0, ""lines"": 2}, ""src/vim9compile.c"": {""insertions"": 23, ""deletions"": 21, ""lines"": 44}, ""src/vim9execute.c"": {""insertions"": 28, ""deletions"": 0, ""lines"": 28}}"
2020-08-16 12:48:19,56acb0943ede35cd9d2f6667cde2442819ccbf59,Bram Moolenaar,71,67,138,9,"{""src/errors.h"": {""insertions"": 2, ""deletions"": 2, ""lines"": 4}, ""src/eval.c"": {""insertions"": 3, ""deletions"": 1, ""lines"": 4}, ""src/list.c"": {""insertions"": 4, ""deletions"": 1, ""lines"": 5}, ""src/testdir/test_vim9_expr.vim"": {""insertions"": 22, ""deletions"": 13, ""lines"": 35}, ""src/testdir/test_vim9_script.vim"": {""insertions"": 5, ""deletions"": 4, ""lines"": 9}, ""src/typval.c"": {""insertions"": 13, ""deletions"": 2, ""lines"": 15}, ""src/version.c"": {""insertions"": 2, ""deletions"": 0, ""lines"": 2}, ""src/vim9compile.c"": {""insertions"": 20, ""deletions"": 6, ""lines"": 26}, ""src/vim9execute.c"": {""insertions"": 0, ""deletions"": 38, ""lines"": 38}}"
2020-08-15 20:48:48,829ac868b7615d73dbfb536f7fcd44fc7c5b7c1d,Bram Moolenaar,2,1,3,2,"{""src/version.c"": {""insertions"": 2, ""deletions"": 0, ""lines"": 2}, ""src/vim9execute.c"": {""insertions"": 0, ""deletions"": 1, ""lines"": 1}}"
2020-08-15 20:14:53,ed5918771fcf9877d8445e74c62ab1ce6b8e28c1,Bram Moolenaar,175,57,232,9,"{""src/eval.c"": {""insertions"": 7, ""deletions"": 37, ""lines"": 44}, ""src/list.c"": {""insertions"": 55, ""deletions"": 0, ""lines"": 55}, ""src/proto/list.pro"": {""insertions"": 1, ""deletions"": 0, ""lines"": 1}, ""src/testdir/test_vim9_disassemble.vim"": {""insertions"": 47, ""deletions"": 0, ""lines"": 47}, ""src/testdir/test_vim9_expr.vim"": {""insertions"": 28, ""deletions"": 0, ""lines"": 28}, ""src/version.c"": {""insertions"": 2, ""deletions"": 0, ""lines"": 2}, ""src/vim9.h"": {""insertions"": 1, ""deletions"": 0, ""lines"": 1}, ""src/vim9compile.c"": {""insertions"": 10, ""deletions"": 6, ""lines"": 16}, ""src/vim9execute.c"": {""insertions"": 24, ""deletions"": 14, ""lines"": 38}}"
2020-08-15 19:10:16,11107bab7ead9124f46a7ddf6aa3bb66b43a8246,Bram Moolenaar,183,24,207,9,"{""src/errors.h"": {""insertions"": 2, ""deletions"": 1, ""lines"": 3}, ""src/eval.c"": {""insertions"": 71, ""deletions"": 5, ""lines"": 76}, ""src/proto/eval.pro"": {""insertions"": 1, ""deletions"": 0, ""lines"": 1}, ""src/testdir/test_vim9_disassemble.vim"": {""insertions"": 1, ""deletions"": 1, ""lines"": 2}, ""src/testdir/test_vim9_expr.vim"": {""insertions"": 23, ""deletions"": 1, ""lines"": 24}, ""src/version.c"": {""insertions"": 2, ""deletions"": 0, ""lines"": 2}, ""src/vim9.h"": {""insertions"": 1, ""deletions"": 0, ""lines"": 1}, ""src/vim9compile.c"": {""insertions"": 52, ""deletions"": 7, ""lines"": 59}, ""src/vim9execute.c"": {""insertions"": 30, ""deletions"": 9, ""lines"": 39}}"
2020-08-15 16:55:18,3d1cde8a2f28dce2c82d2b2b4c5e35e6662030e0,Bram Moolenaar,9035,137,9172,39,"{""README_VIM9.md"": {""insertions"": 1, ""deletions"": 1, ""lines"": 2}, ""runtime/colors/tools/check_colors.vim"": {""insertions"": 1, ""deletions"": 1, ""lines"": 2}, ""runtime/compiler/checkstyle.vim"": {""insertions"": 15, ""deletions"": 5, ""lines"": 20}, ""runtime/compiler/gawk.vim"": {""insertions"": 34, ""deletions"": 0, ""lines"": 34}, ""runtime/compiler/gjs.vim"": {""insertions"": 25, ""deletions"": 0, ""lines"": 25}, ""runtime/compiler/jest.vim"": {""insertions"": 30, ""deletions"": 0, ""lines"": 30}, ""runtime/compiler/jjs.vim"": {""insertions"": 24, ""deletions"": 0, ""lines"": 24}, ""runtime/compiler/jshint.vim"": {""insertions"": 25, ""deletions"": 0, ""lines"": 25}, ""runtime/compiler/jsonlint.vim"": {""insertions"": 25, ""deletions"": 0, ""lines"": 25}, ""runtime/compiler/rubocop.vim"": {""insertions"": 23, ""deletions"": 0, ""lines"": 23}, ""runtime/compiler/stylelint.vim"": {""insertions"": 26, ""deletions"": 0, ""lines"": 26}, ""runtime/compiler/ts-node.vim"": {""insertions"": 29, ""deletions"": 0, ""lines"": 29}, ""runtime/compiler/tsc.vim"": {""insertions"": 26, ""deletions"": 0, ""lines"": 26}, ""runtime/compiler/typedoc.vim"": {""insertions"": 28, ""deletions"": 0, ""lines"": 28}, ""runtime/doc/cmdline.txt"": {""insertions"": 3, ""deletions"": 2, ""lines"": 5}, ""runtime/doc/eval.txt"": {""insertions"": 1, ""deletions"": 1, ""lines"": 2}, ""runtime/doc/filetype.txt"": {""insertions"": 2, ""deletions"": 2, ""lines"": 4}, ""runtime/doc/gui.txt"": {""insertions"": 3, ""deletions"": 2, ""lines"": 5}, ""runtime/doc/options.txt"": {""insertions"": 10, ""deletions"": 22, ""lines"": 32}, ""runtime/doc/quickfix.txt"": {""insertions"": 2, ""deletions"": 2, ""lines"": 4}, ""runtime/doc/recover.txt"": {""insertions"": 3, ""deletions"": 3, ""lines"": 6}, ""runtime/doc/repeat.txt"": {""insertions"": 3, ""deletions"": 3, ""lines"": 6}, ""runtime/doc/spell.txt"": {""insertions"": 2, ""deletions"": 2, ""lines"": 4}, ""runtime/doc/tabpage.txt"": {""insertions"": 1, ""deletions"": 1, ""lines"": 2}, ""runtime/doc/tags"": {""insertions"": 6, ""deletions"": 0, ""lines"": 6}, ""runtime/doc/todo.txt"": {""insertions"": 23, ""deletions"": 15, ""lines"": 38}, ""runtime/doc/usr_41.txt"": {""insertions"": 26, ""deletions"": 26, ""lines"": 52}, ""runtime/doc/version6.txt"": {""insertions"": 9, ""deletions"": 9, ""lines"": 18}, ""runtime/doc/version7.txt"": {""insertions"": 4, ""deletions"": 4, ""lines"": 8}, ""runtime/doc/version8.txt"": {""insertions"": 8506, ""deletions"": 1, ""lines"": 8507}, ""runtime/doc/vim9.txt"": {""insertions"": 26, ""deletions"": 20, ""lines"": 46}, ""runtime/doc/windows.txt"": {""insertions"": 4, ""deletions"": 2, ""lines"": 6}, ""runtime/ftplugin/cobol.vim"": {""insertions"": 3, ""deletions"": 2, ""lines"": 5}, ""runtime/ftplugin/css.vim"": {""insertions"": 4, ""deletions"": 3, ""lines"": 7}, ""runtime/ftplugin/typescript.vim"": {""insertions"": 39, ""deletions"": 0, ""lines"": 39}, ""runtime/ftplugin/typescriptreact.vim"": {""insertions"": 33, ""deletions"": 0, ""lines"": 33}, ""runtime/ftplugin/vim.vim"": {""insertions"": 3, ""deletions"": 2, ""lines"": 5}, ""runtime/scripts.vim"": {""insertions"": 2, ""deletions"": 2, ""lines"": 4}, ""runtime/syntax/c.vim"": {""insertions"": 5, ""deletions"": 4, ""lines"": 9}}"
2020-08-15 16:39:05,e3c37d8ebf9dbbf210fde4a5fb28eb1f2a492a34,Bram Moolenaar,78,24,102,6,"{""runtime/doc/eval.txt"": {""insertions"": 24, ""deletions"": 12, ""lines"": 36}, ""src/eval.c"": {""insertions"": 28, ""deletions"": 0, ""lines"": 28}, ""src/proto/eval.pro"": {""insertions"": 1, ""deletions"": 0, ""lines"": 1}, ""src/testdir/test_vim9_expr.vim"": {""insertions"": 22, ""deletions"": 6, ""lines"": 28}, ""src/version.c"": {""insertions"": 2, ""deletions"": 0, ""lines"": 2}, ""src/vim9execute.c"": {""insertions"": 1, ""deletions"": 6, ""lines"": 7}}"
2020-08-15 14:33:28,451c2e3536a3cb77d07faf3cb2b834512e174351,Bram Moolenaar,369,182,551,18,"{""src/errors.h"": {""insertions"": 200, ""deletions"": 2, ""lines"": 202}, ""src/eval.c"": {""insertions"": 1, ""deletions"": 1, ""lines"": 2}, ""src/evalvars.c"": {""insertions"": 3, ""deletions"": 3, ""lines"": 6}, ""src/ex_cmds.c"": {""insertions"": 2, ""deletions"": 2, ""lines"": 4}, ""src/ex_docmd.c"": {""insertions"": 1, ""deletions"": 1, ""lines"": 2}, ""src/globals.h"": {""insertions"": 0, ""deletions"": 2, ""lines"": 2}, ""src/match.c"": {""insertions"": 1, ""deletions"": 1, ""lines"": 2}, ""src/scriptfile.c"": {""insertions"": 1, ""deletions"": 1, ""lines"": 2}, ""src/testdir/test_vim9_disassemble.vim"": {""insertions"": 1, ""deletions"": 1, ""lines"": 2}, ""src/testdir/test_vim9_expr.vim"": {""insertions"": 21, ""deletions"": 21, ""lines"": 42}, ""src/testdir/test_vim9_func.vim"": {""insertions"": 21, ""deletions"": 21, ""lines"": 42}, ""src/testdir/test_vim9_script.vim"": {""insertions"": 12, ""deletions"": 12, ""lines"": 24}, ""src/userfunc.c"": {""insertions"": 8, ""deletions"": 8, ""lines"": 16}, ""src/version.c"": {""insertions"": 2, ""deletions"": 0, ""lines"": 2}, ""src/vim9compile.c"": {""insertions"": 59, ""deletions"": 67, ""lines"": 126}, ""src/vim9execute.c"": {""insertions"": 12, ""deletions"": 12, ""lines"": 24}, ""src/vim9script.c"": {""insertions"": 16, ""deletions"": 19, ""lines"": 35}, ""src/vim9type.c"": {""insertions"": 8, ""deletions"": 8, ""lines"": 16}}"
2020-08-15 12:31:20,53b29e4845857d76ca7df1ff2fd0e03c3eeb82e1,Bram Moolenaar,14,1,15,3,"{""src/evalvars.c"": {""insertions"": 4, ""deletions"": 1, ""lines"": 5}, ""src/testdir/test_vim9_script.vim"": {""insertions"": 8, ""deletions"": 0, ""lines"": 8}, ""src/version.c"": {""insertions"": 2, ""deletions"": 0, ""lines"": 2}}"
2020-08-15 12:07:23,9a5c553f790f74e4c36295ce5d46c1aa7d13eae6,Bram Moolenaar,6,3,9,3,"{""runtime/filetype.vim"": {""insertions"": 1, ""deletions"": 1, ""lines"": 2}, ""src/testdir/test_filetype.vim"": {""insertions"": 3, ""deletions"": 2, ""lines"": 5}, ""src/version.c"": {""insertions"": 2, ""deletions"": 0, ""lines"": 2}}"
2020-08-15 11:49:17,793dcc540d96557919ae7dff9b2b3e21386a2e88,Bram Moolenaar,7,0,7,2,"{""src/version.c"": {""insertions"": 2, ""deletions"": 0, ""lines"": 2}, ""src/vim9execute.c"": {""insertions"": 5, ""deletions"": 0, ""lines"": 5}}"
2020-08-14 21:08:22,1623619119547142d94ddee4a75adc92304e55e9,Bram Moolenaar,6,4,10,2,"{""src/testdir/Make_dos.mak"": {""insertions"": 4, ""deletions"": 4, ""lines"": 8}, ""src/version.c"": {""insertions"": 2, ""deletions"": 0, ""lines"": 2}}"
2020-08-14 20:44:25,d1103587cf339feb8c77d282f7f7e92b7cff5add,Bram Moolenaar,12,2,14,3,"{""src/testdir/test_vim9_expr.vim"": {""insertions"": 6, ""deletions"": 0, ""lines"": 6}, ""src/version.c"": {""insertions"": 2, ""deletions"": 0, ""lines"": 2}, ""src/vim9compile.c"": {""insertions"": 4, ""deletions"": 2, ""lines"": 6}}"
2020-08-14 20:16:33,79e8db9a218ef111934594024a5cd8b1f93acada,Bram Moolenaar,17,1,18,4,"{""src/testdir/test_vim9_expr.vim"": {""insertions"": 8, ""deletions"": 0, ""lines"": 8}, ""src/version.c"": {""insertions"": 2, ""deletions"": 0, ""lines"": 2}, ""src/vim9compile.c"": {""insertions"": 3, ""deletions"": 0, ""lines"": 3}, ""src/vim9execute.c"": {""insertions"": 4, ""deletions"": 1, ""lines"": 5}}"
2020-08-14 19:49:08,8de2f44ac6af2276587a2e44a0d5fe1dc6789eb3,Bram Moolenaar,3,0,3,2,"{""src/testdir/test_vim9_expr.vim"": {""insertions"": 1, ""deletions"": 0, ""lines"": 1}, ""src/version.c"": {""insertions"": 2, ""deletions"": 0, ""lines"": 2}}"
2020-08-14 19:42:54,8d56622944d563a79676e99532bd372b2bc6fa1f,Bram Moolenaar,2,11,13,2,"{""src/version.c"": {""insertions"": 2, ""deletions"": 0, ""lines"": 2}, ""src/vim9compile.c"": {""insertions"": 0, ""deletions"": 11, ""lines"": 11}}"
2020-08-14 19:27:37,41fab3eac80893fd203663fc6a7ded09b04b633f,Bram Moolenaar,55,2,57,3,"{""src/testdir/test_vim9_expr.vim"": {""insertions"": 42, ""deletions"": 0, ""lines"": 42}, ""src/version.c"": {""insertions"": 2, ""deletions"": 0, ""lines"": 2}, ""src/vim9type.c"": {""insertions"": 11, ""deletions"": 2, ""lines"": 13}}"
2020-08-14 18:52:28,7d6997015d533604f18756e59b4a2a1266a66a97,Bram Moolenaar,38,0,38,2,"{""src/testdir/test_vim9_script.vim"": {""insertions"": 36, ""deletions"": 0, ""lines"": 36}, ""src/version.c"": {""insertions"": 2, ""deletions"": 0, ""lines"": 2}}"
2020-08-14 17:20:23,32a23ac61570365eff35097691d9b218b8539383,Bram Moolenaar,3,13,16,5,"{""src/testdir/Make_amiga.mak"": {""insertions"": 1, ""deletions"": 1, ""lines"": 2}, ""src/testdir/Make_dos.mak"": {""insertions"": 0, ""deletions"": 4, ""lines"": 4}, ""src/testdir/Make_ming.mak"": {""insertions"": 0, ""deletions"": 4, ""lines"": 4}, ""src/testdir/Make_vms.mms"": {""insertions"": 0, ""deletions"": 4, ""lines"": 4}, ""src/version.c"": {""insertions"": 2, ""deletions"": 0, ""lines"": 2}}"
2020-08-14 17:11:03,4ac97f476157ee0a3600e90f79f04813c418c172,Bram Moolenaar,7,1,8,2,"{""src/testdir/test77a.in"": {""insertions"": 5, ""deletions"": 1, ""lines"": 6}, ""src/version.c"": {""insertions"": 2, ""deletions"": 0, ""lines"": 2}}"
2020-08-14 16:56:45,32f335f75c5860baa452144f63ab7a4a3dd83134,Bram Moolenaar,8,1,9,3,"{""src/evalfunc.c"": {""insertions"": 1, ""deletions"": 1, ""lines"": 2}, ""src/testdir/test_vim9_func.vim"": {""insertions"": 5, ""deletions"": 0, ""lines"": 5}, ""src/version.c"": {""insertions"": 2, ""deletions"": 0, ""lines"": 2}}"
2020-08-14 16:35:07,7517ffdbb564250de72ee3ef64fecf4a486df519,Bram Moolenaar,44,1,45,3,"{""src/testdir/test_vim9_func.vim"": {""insertions"": 20, ""deletions"": 0, ""lines"": 20}, ""src/version.c"": {""insertions"": 2, ""deletions"": 0, ""lines"": 2}, ""src/vim9execute.c"": {""insertions"": 22, ""deletions"": 1, ""lines"": 23}}"
2020-08-14 15:08:15,c4ce36d48698669f81ec90f7c9dc9ab8c362e538,Bram Moolenaar,28,1,29,3,"{""src/testdir/test_vim9_script.vim"": {""insertions"": 23, ""deletions"": 0, ""lines"": 23}, ""src/userfunc.c"": {""insertions"": 3, ""deletions"": 1, ""lines"": 4}, ""src/version.c"": {""insertions"": 2, ""deletions"": 0, ""lines"": 2}}"
