date,hexsha,author,insertions,deletions,lines,files,files_json
2021-11-27 22:47:43,59f4f9505ae7ca2499904b94100db103e5ada5a6,Bram Moolenaar,57,15,72,3,"{""src/ops.c"": {""insertions"": 30, ""deletions"": 15, ""lines"": 45}, ""src/testdir/test_blockedit.vim"": {""insertions"": 25, ""deletions"": 0, ""lines"": 25}, ""src/version.c"": {""insertions"": 2, ""deletions"": 0, ""lines"": 2}}"
2021-11-27 17:22:07,3d14c0f2b964195d08b34bb43f89ec5f99255194,Bram Moolenaar,105,7,112,7,"{""runtime/autoload/dist/ft.vim"": {""insertions"": 17, ""deletions"": 0, ""lines"": 17}, ""runtime/doc/filetype.txt"": {""insertions"": 14, ""deletions"": 5, ""lines"": 19}, ""runtime/doc/syntax.txt"": {""insertions"": 8, ""deletions"": 0, ""lines"": 8}, ""runtime/filetype.vim"": {""insertions"": 4, ""deletions"": 1, ""lines"": 5}, ""runtime/scripts.vim"": {""insertions"": 4, ""deletions"": 0, ""lines"": 4}, ""src/testdir/test_filetype.vim"": {""insertions"": 56, ""deletions"": 1, ""lines"": 57}, ""src/version.c"": {""insertions"": 2, ""deletions"": 0, ""lines"": 2}}"
2021-11-27 14:31:47,c07f11e42fc2eac5e750bf05aa3030f9b02a22ca,Bram Moolenaar,10,2,12,3,"{""runtime/filetype.vim"": {""insertions"": 7, ""deletions"": 1, ""lines"": 8}, ""src/testdir/test_filetype.vim"": {""insertions"": 1, ""deletions"": 1, ""lines"": 2}, ""src/version.c"": {""insertions"": 2, ""deletions"": 0, ""lines"": 2}}"
2021-11-27 13:28:24,e9b0b40b7978f683977922233b42dd439ef31920,Bram Moolenaar,33,0,33,3,"{""src/ops.c"": {""insertions"": 4, ""deletions"": 0, ""lines"": 4}, ""src/testdir/test_blockedit.vim"": {""insertions"": 27, ""deletions"": 0, ""lines"": 27}, ""src/version.c"": {""insertions"": 2, ""deletions"": 0, ""lines"": 2}}"
2021-11-27 11:42:50,279d733dfb838cbabe88c8b8d3549d1493a49bbe,Bram Moolenaar,27,8,35,3,"{""src/ex_cmds.h"": {""insertions"": 8, ""deletions"": 8, ""lines"": 16}, ""src/testdir/test_vim9_cmd.vim"": {""insertions"": 17, ""deletions"": 0, ""lines"": 17}, ""src/version.c"": {""insertions"": 2, ""deletions"": 0, ""lines"": 2}}"
2021-11-27 10:57:26,6304be625ce44dcfedc6735164d0b853578581c8,Bram Moolenaar,171,131,302,12,"{""runtime/colors/tools/check_colors.vim"": {""insertions"": 10, ""deletions"": 4, ""lines"": 14}, ""runtime/doc/cmdline.txt"": {""insertions"": 6, ""deletions"": 4, ""lines"": 10}, ""runtime/doc/eval.txt"": {""insertions"": 1, ""deletions"": 0, ""lines"": 1}, ""runtime/doc/options.txt"": {""insertions"": 1, ""deletions"": 1, ""lines"": 2}, ""runtime/doc/repeat.txt"": {""insertions"": 5, ""deletions"": 1, ""lines"": 6}, ""runtime/doc/sign.txt"": {""insertions"": 4, ""deletions"": 7, ""lines"": 11}, ""runtime/doc/tags"": {""insertions"": 3, ""deletions"": 0, ""lines"": 3}, ""runtime/doc/todo.txt"": {""insertions"": 4, ""deletions"": 6, ""lines"": 10}, ""runtime/doc/vim9.txt"": {""insertions"": 5, ""deletions"": 1, ""lines"": 6}, ""runtime/ftplugin/jsonc.vim"": {""insertions"": 2, ""deletions"": 8, ""lines"": 10}, ""runtime/pack/dist/opt/termdebug/plugin/termdebug.vim"": {""insertions"": 116, ""deletions"": 85, ""lines"": 201}, ""runtime/syntax/vim.vim"": {""insertions"": 14, ""deletions"": 14, ""lines"": 28}}"
2021-11-26 17:36:51,7824fc80f675b8098e6483ce082e287aad14b6da,Bram Moolenaar,40,28,68,5,"{""src/evalvars.c"": {""insertions"": 13, ""deletions"": 7, ""lines"": 20}, ""src/proto/vim9script.pro"": {""insertions"": 1, ""deletions"": 1, ""lines"": 2}, ""src/testdir/test_vim9_assign.vim"": {""insertions"": 10, ""deletions"": 0, ""lines"": 10}, ""src/version.c"": {""insertions"": 2, ""deletions"": 0, ""lines"": 2}, ""src/vim9script.c"": {""insertions"": 14, ""deletions"": 20, ""lines"": 34}}"
2021-11-26 15:57:40,bfc5786a61693aaadc3e45f80a2f147c3a6711a3,Bram Moolenaar,24,0,24,4,"{""src/mouse.c"": {""insertions"": 1, ""deletions"": 0, ""lines"": 1}, ""src/testdir/dumps/Test_popupwin_drag_04.dump"": {""insertions"": 10, ""deletions"": 0, ""lines"": 10}, ""src/testdir/test_popupwin.vim"": {""insertions"": 11, ""deletions"": 0, ""lines"": 11}, ""src/version.c"": {""insertions"": 2, ""deletions"": 0, ""lines"": 2}}"
2021-11-26 13:59:27,d1d8a595bd03bf9ff6ba1440101daa98b19249fd,DungSaga,13,14,27,2,"{""src/version.c"": {""insertions"": 2, ""deletions"": 0, ""lines"": 2}, ""src/xxd/xxd.c"": {""insertions"": 11, ""deletions"": 14, ""lines"": 25}}"
2021-11-26 13:01:41,7329cfab36356c48edab7ed68f6244eb9e20a5b1,Doug Kearns,15,1,16,3,"{""runtime/autoload/dist/ft.vim"": {""insertions"": 3, ""deletions"": 1, ""lines"": 4}, ""src/testdir/test_filetype.vim"": {""insertions"": 10, ""deletions"": 0, ""lines"": 10}, ""src/version.c"": {""insertions"": 2, ""deletions"": 0, ""lines"": 2}}"
2021-11-25 20:40:11,85be8563fe5aff686e9e30d6afff401ccd976f2a,Bram Moolenaar,6,2,8,2,"{""src/register.c"": {""insertions"": 4, ""deletions"": 2, ""lines"": 6}, ""src/version.c"": {""insertions"": 2, ""deletions"": 0, ""lines"": 2}}"
2021-11-25 19:31:15,4d07253a485819b3a9fd923d263e722ea2109c12,Bram Moolenaar,30,3,33,3,"{""src/register.c"": {""insertions"": 15, ""deletions"": 3, ""lines"": 18}, ""src/testdir/test_put.vim"": {""insertions"": 13, ""deletions"": 0, ""lines"": 13}, ""src/version.c"": {""insertions"": 2, ""deletions"": 0, ""lines"": 2}}"
2021-11-25 15:11:03,309ce251897512d42da2b0df0ff100dc303e688a,Bram Moolenaar,2,782,784,2,"{""runtime/rgb.txt"": {""insertions"": 0, ""deletions"": 782, ""lines"": 782}, ""src/version.c"": {""insertions"": 2, ""deletions"": 0, ""lines"": 2}}"
2021-11-25 14:43:18,ba8c92687d53c91bbc20c867a49e0988819ea2d5,Bram Moolenaar,12,4,16,2,"{""src/message.c"": {""insertions"": 10, ""deletions"": 4, ""lines"": 14}, ""src/version.c"": {""insertions"": 2, ""deletions"": 0, ""lines"": 2}}"
2021-11-25 13:52:37,96e7a5928e1e7a350cd6c6d0b9376305190046e7,Bram Moolenaar,5,2,7,2,"{""src/memline.c"": {""insertions"": 3, ""deletions"": 2, ""lines"": 5}, ""src/version.c"": {""insertions"": 2, ""deletions"": 0, ""lines"": 2}}"
2021-11-25 13:39:28,0bd8d0563853ab821a018fb9cdd85f674684fe57,Bram Moolenaar,5,2,7,3,"{""src/globals.h"": {""insertions"": 1, ""deletions"": 0, ""lines"": 1}, ""src/message.c"": {""insertions"": 2, ""deletions"": 2, ""lines"": 4}, ""src/version.c"": {""insertions"": 2, ""deletions"": 0, ""lines"": 2}}"
2021-11-25 13:26:19,71b36206be14c3b6334765d44a38d413eca751c7,Bram Moolenaar,4,2,6,2,"{""src/version.c"": {""insertions"": 2, ""deletions"": 0, ""lines"": 2}, ""src/xxd/xxd.c"": {""insertions"": 2, ""deletions"": 2, ""lines"": 4}}"
2021-11-25 13:04:48,34c20ff85b87be587ea5d0398812441b502ee6a5,Bram Moolenaar,30,2,32,3,"{""src/testdir/test_prompt_buffer.vim"": {""insertions"": 25, ""deletions"": 0, ""lines"": 25}, ""src/version.c"": {""insertions"": 2, ""deletions"": 0, ""lines"": 2}, ""src/window.c"": {""insertions"": 3, ""deletions"": 2, ""lines"": 5}}"
2021-11-25 11:16:50,8af87bd6b1808ffcafdd73b1d7501dd50b9d15bc,Bram Moolenaar,70,69,139,2,"{""src/version.c"": {""insertions"": 2, ""deletions"": 0, ""lines"": 2}, ""src/xxd/xxd.c"": {""insertions"": 68, ""deletions"": 69, ""lines"": 137}}"
2021-11-25 10:50:12,bd228fd097b41a798f90944b5d1245eddd484142,Bram Moolenaar,12,2,14,3,"{""src/help.c"": {""insertions"": 1, ""deletions"": 2, ""lines"": 3}, ""src/testdir/test_help.vim"": {""insertions"": 9, ""deletions"": 0, ""lines"": 9}, ""src/version.c"": {""insertions"": 2, ""deletions"": 0, ""lines"": 2}}"
2021-11-24 20:28:31,bb277fd89fd7c665d51be2a08993732d46c208ef,Yegappan Lakshmanan,89,46,135,3,"{""src/highlight.c"": {""insertions"": 72, ""deletions"": 46, ""lines"": 118}, ""src/testdir/test_highlight.vim"": {""insertions"": 15, ""deletions"": 0, ""lines"": 15}, ""src/version.c"": {""insertions"": 2, ""deletions"": 0, ""lines"": 2}}"
2021-11-24 19:55:46,510d8e6056d89d903511c4498afec23f76b4f2a4,Bram Moolenaar,10,6,16,2,"{""src/libvterm/src/state.c"": {""insertions"": 8, ""deletions"": 6, ""lines"": 14}, ""src/version.c"": {""insertions"": 2, ""deletions"": 0, ""lines"": 2}}"
2021-11-24 19:30:55,7da341560ec8db7e81cd80092b046b60a482fbbe,Bram Moolenaar,971,256,1227,18,"{""Filelist"": {""insertions"": 1, ""deletions"": 0, ""lines"": 1}, ""src/libvterm/Makefile"": {""insertions"": 2, ""deletions"": 2, ""lines"": 4}, ""src/libvterm/doc/seqs.txt"": {""insertions"": 265, ""deletions"": 218, ""lines"": 483}, ""src/libvterm/include/vterm.h"": {""insertions"": 26, ""deletions"": 1, ""lines"": 27}, ""src/libvterm/src/mouse.c"": {""insertions"": 3, ""deletions"": 0, ""lines"": 3}, ""src/libvterm/src/parser.c"": {""insertions"": 51, ""deletions"": 4, ""lines"": 55}, ""src/libvterm/src/state.c"": {""insertions"": 321, ""deletions"": 5, ""lines"": 326}, ""src/libvterm/src/vterm.c"": {""insertions"": 20, ""deletions"": 12, ""lines"": 32}, ""src/libvterm/src/vterm_internal.h"": {""insertions"": 23, ""deletions"": 1, ""lines"": 24}, ""src/libvterm/t/02parser.test"": {""insertions"": 52, ""deletions"": 4, ""lines"": 56}, ""src/libvterm/t/17state_mouse.test"": {""insertions"": 9, ""deletions"": 0, ""lines"": 9}, ""src/libvterm/t/29state_fallback.test"": {""insertions"": 12, ""deletions"": 0, ""lines"": 12}, ""src/libvterm/t/40state_selection.test"": {""insertions"": 55, ""deletions"": 0, ""lines"": 55}, ""src/libvterm/t/harness.c"": {""insertions"": 113, ""deletions"": 3, ""lines"": 116}, ""src/libvterm/t/run-test.pl"": {""insertions"": 11, ""deletions"": 3, ""lines"": 14}, ""src/libvterm/vterm.pc.in"": {""insertions"": 1, ""deletions"": 2, ""lines"": 3}, ""src/terminal.c"": {""insertions"": 4, ""deletions"": 1, ""lines"": 5}, ""src/version.c"": {""insertions"": 2, ""deletions"": 0, ""lines"": 2}}"
2021-11-24 16:32:55,19916a8c8920b6a1fd737ffa6d4e363fc7a96319,Yegappan Lakshmanan,125,6,131,9,"{""runtime/doc/options.txt"": {""insertions"": 6, ""deletions"": 4, ""lines"": 10}, ""src/buffer.c"": {""insertions"": 1, ""deletions"": 0, ""lines"": 1}, ""src/option.c"": {""insertions"": 2, ""deletions"": 0, ""lines"": 2}, ""src/optionstr.c"": {""insertions"": 9, ""deletions"": 0, ""lines"": 9}, ""src/proto/tag.pro"": {""insertions"": 3, ""deletions"": 0, ""lines"": 3}, ""src/structs.h"": {""insertions"": 2, ""deletions"": 1, ""lines"": 3}, ""src/tag.c"": {""insertions"": 50, ""deletions"": 1, ""lines"": 51}, ""src/testdir/test_tagfunc.vim"": {""insertions"": 50, ""deletions"": 0, ""lines"": 50}, ""src/version.c"": {""insertions"": 2, ""deletions"": 0, ""lines"": 2}}"
2021-11-24 16:20:13,e413ea04b716effb28eb49dbc98ad3f9f761545a,Bram Moolenaar,104,18,122,12,"{""runtime/doc/sign.txt"": {""insertions"": 15, ""deletions"": 0, ""lines"": 15}, ""runtime/doc/syntax.txt"": {""insertions"": 4, ""deletions"": 0, ""lines"": 4}, ""src/drawline.c"": {""insertions"": 27, ""deletions"": 4, ""lines"": 31}, ""src/highlight.c"": {""insertions"": 2, ""deletions"": 0, ""lines"": 2}, ""src/optiondefs.h"": {""insertions"": 1, ""deletions"": 1, ""lines"": 2}, ""src/popupwin.c"": {""insertions"": 1, ""deletions"": 1, ""lines"": 2}, ""src/proto/sign.pro"": {""insertions"": 1, ""deletions"": 1, ""lines"": 2}, ""src/sign.c"": {""insertions"": 38, ""deletions"": 3, ""lines"": 41}, ""src/structs.h"": {""insertions"": 1, ""deletions"": 0, ""lines"": 1}, ""src/testdir/test_signs.vim"": {""insertions"": 9, ""deletions"": 7, ""lines"": 16}, ""src/version.c"": {""insertions"": 2, ""deletions"": 0, ""lines"": 2}, ""src/vim.h"": {""insertions"": 3, ""deletions"": 1, ""lines"": 4}}"
2021-11-24 15:32:57,1f2453fec6f8f0f315f00ca7b562a02090cb1e37,presuku,74,17,91,3,"{""src/strings.c"": {""insertions"": 12, ""deletions"": 17, ""lines"": 29}, ""src/testdir/test_expr.vim"": {""insertions"": 60, ""deletions"": 0, ""lines"": 60}, ""src/version.c"": {""insertions"": 2, ""deletions"": 0, ""lines"": 2}}"
2021-11-24 15:13:26,cf1e0239ceec96396fa51f494e442c799ccd45fb,Bram Moolenaar,5,3,8,2,"{""src/fold.c"": {""insertions"": 3, ""deletions"": 3, ""lines"": 6}, ""src/version.c"": {""insertions"": 2, ""deletions"": 0, ""lines"": 2}}"
2021-11-24 14:59:17,8bc07e800c2af36686aadd4178cc2671f5c454d4,Bram Moolenaar,7,5,12,2,"{""src/testdir/test_put.vim"": {""insertions"": 5, ""deletions"": 5, ""lines"": 10}, ""src/version.c"": {""insertions"": 2, ""deletions"": 0, ""lines"": 2}}"
2021-11-24 13:40:29,9b0e82f35ed4e98414333e71b71ca56219683d16,Bram Moolenaar,3,1,4,2,"{""src/normal.c"": {""insertions"": 1, ""deletions"": 1, ""lines"": 2}, ""src/version.c"": {""insertions"": 2, ""deletions"": 0, ""lines"": 2}}"
2021-11-24 12:17:53,03725c5795ae5b8c14da4a39cd0ce723c6dd4304,Bram Moolenaar,64,6,70,6,"{""src/errors.h"": {""insertions"": 2, ""deletions"": 0, ""lines"": 2}, ""src/ex_docmd.c"": {""insertions"": 15, ""deletions"": 1, ""lines"": 16}, ""src/normal.c"": {""insertions"": 12, ""deletions"": 5, ""lines"": 17}, ""src/testdir/test_excmd.vim"": {""insertions"": 12, ""deletions"": 0, ""lines"": 12}, ""src/testdir/test_normal.vim"": {""insertions"": 21, ""deletions"": 0, ""lines"": 21}, ""src/version.c"": {""insertions"": 2, ""deletions"": 0, ""lines"": 2}}"
2021-11-24 11:18:07,48608b4a4bfab4b9c0c9199d57b7e876c56db74c,DungSaga,28,9,37,3,"{""src/testdir/test_xxd.vim"": {""insertions"": 14, ""deletions"": 0, ""lines"": 14}, ""src/version.c"": {""insertions"": 2, ""deletions"": 0, ""lines"": 2}, ""src/xxd/xxd.c"": {""insertions"": 12, ""deletions"": 9, ""lines"": 21}}"
2021-11-23 22:16:34,112bed0cbeac84f73dca2682c5c2d74fabe1114d,Bram Moolenaar,26,1,27,3,"{""src/testdir/test_debugger.vim"": {""insertions"": 23, ""deletions"": 0, ""lines"": 23}, ""src/version.c"": {""insertions"": 2, ""deletions"": 0, ""lines"": 2}, ""src/vim9execute.c"": {""insertions"": 1, ""deletions"": 1, ""lines"": 2}}"
2021-11-23 14:52:06,65259b5c6a8ad4edaf6eeb8dbb7b50342c64d403,Bram Moolenaar,13,1,14,3,"{""src/ex_eval.c"": {""insertions"": 4, ""deletions"": 1, ""lines"": 5}, ""src/testdir/test_vim9_cmd.vim"": {""insertions"": 7, ""deletions"": 0, ""lines"": 7}, ""src/version.c"": {""insertions"": 2, ""deletions"": 0, ""lines"": 2}}"
2021-11-23 12:35:57,cc9d725bbb515baf172c2be21de12d35a961e4ee,Mike Williams,3,1,4,2,"{""src/version.c"": {""insertions"": 2, ""deletions"": 0, ""lines"": 2}, ""src/vim9compile.c"": {""insertions"": 1, ""deletions"": 1, ""lines"": 2}}"
2021-11-23 12:27:48,ee93e327ba31e8efb1b7de6209bdc992778b809b,Chris Dalton,23,1,24,2,"{""src/gui_gtk_x11.c"": {""insertions"": 21, ""deletions"": 1, ""lines"": 22}, ""src/version.c"": {""insertions"": 2, ""deletions"": 0, ""lines"": 2}}"
2021-11-23 12:07:25,b771b6b5fe2ec36d23c21ab8229b15c80780468c,Milly,3,0,3,2,"{""src/terminal.c"": {""insertions"": 1, ""deletions"": 0, ""lines"": 1}, ""src/version.c"": {""insertions"": 2, ""deletions"": 0, ""lines"": 2}}"
2021-11-23 11:46:32,e021662f39b38ef7cf27e13850d0ce6890e48376,Yegappan Lakshmanan,425,31,456,4,"{""runtime/doc/textprop.txt"": {""insertions"": 41, ""deletions"": 5, ""lines"": 46}, ""src/testdir/test_textprop.vim"": {""insertions"": 150, ""deletions"": 1, ""lines"": 151}, ""src/textprop.c"": {""insertions"": 232, ""deletions"": 25, ""lines"": 257}, ""src/version.c"": {""insertions"": 2, ""deletions"": 0, ""lines"": 2}}"
2021-11-22 21:58:41,04b568b38f848293e1ae0e680685280151acb386,Bram Moolenaar,26,0,26,4,"{""src/errors.h"": {""insertions"": 2, ""deletions"": 0, ""lines"": 2}, ""src/evalvars.c"": {""insertions"": 5, ""deletions"": 0, ""lines"": 5}, ""src/testdir/test_vim9_cmd.vim"": {""insertions"": 17, ""deletions"": 0, ""lines"": 17}, ""src/version.c"": {""insertions"": 2, ""deletions"": 0, ""lines"": 2}}"
2021-11-22 20:10:18,3b3755fe19e9ded2a1c45f14b2c6fa065bcaf2c6,Bram Moolenaar,38,9,47,7,"{""src/dict.c"": {""insertions"": 1, ""deletions"": 1, ""lines"": 2}, ""src/eval.c"": {""insertions"": 1, ""deletions"": 1, ""lines"": 2}, ""src/evalvars.c"": {""insertions"": 4, ""deletions"": 3, ""lines"": 7}, ""src/proto/evalvars.pro"": {""insertions"": 1, ""deletions"": 1, ""lines"": 2}, ""src/testdir/test_vim9_script.vim"": {""insertions"": 25, ""deletions"": 1, ""lines"": 26}, ""src/version.c"": {""insertions"": 2, ""deletions"": 0, ""lines"": 2}, ""src/vim9compile.c"": {""insertions"": 4, ""deletions"": 2, ""lines"": 6}}"
2021-11-22 18:31:02,7a53f29c031f54ab67a803e5e3f8cb44e4edc4bc,Bram Moolenaar,21,3,24,3,"{""src/ex_eval.c"": {""insertions"": 4, ""deletions"": 3, ""lines"": 7}, ""src/testdir/test_vim9_script.vim"": {""insertions"": 15, ""deletions"": 0, ""lines"": 15}, ""src/version.c"": {""insertions"": 2, ""deletions"": 0, ""lines"": 2}}"
2021-11-22 17:21:48,4671e88d7d3ed12206d9cdd8892fe3b2cbc0d6ab,Bram Moolenaar,11,3,14,2,"{""src/gui.c"": {""insertions"": 9, ""deletions"": 3, ""lines"": 12}, ""src/version.c"": {""insertions"": 2, ""deletions"": 0, ""lines"": 2}}"
2021-11-22 17:18:44,ce59b9f29244d98e55e3ec6be341c4d521159e8f,Dusan Popovic,39,7,46,2,"{""src/gui.c"": {""insertions"": 37, ""deletions"": 7, ""lines"": 44}, ""src/version.c"": {""insertions"": 2, ""deletions"": 0, ""lines"": 2}}"
2021-11-22 15:37:15,c449271f4efa44725c40116a95b213813040312f,Bram Moolenaar,26,0,26,4,"{""src/errors.h"": {""insertions"": 2, ""deletions"": 0, ""lines"": 2}, ""src/scriptfile.c"": {""insertions"": 14, ""deletions"": 0, ""lines"": 14}, ""src/testdir/test_vim9_builtin.vim"": {""insertions"": 8, ""deletions"": 0, ""lines"": 8}, ""src/version.c"": {""insertions"": 2, ""deletions"": 0, ""lines"": 2}}"
2021-11-22 15:05:46,7d5b8becc342e49e491053ea842e59f82d072001,Bram Moolenaar,47,8,55,3,"{""src/ex_eval.c"": {""insertions"": 17, ""deletions"": 7, ""lines"": 24}, ""src/testdir/test_vim9_cmd.vim"": {""insertions"": 28, ""deletions"": 1, ""lines"": 29}, ""src/version.c"": {""insertions"": 2, ""deletions"": 0, ""lines"": 2}}"
2021-11-22 14:16:08,2228cd72cf7c6f326e4e41179e88d37595ca4abc,Bram Moolenaar,58,9,67,5,"{""src/normal.c"": {""insertions"": 23, ""deletions"": 3, ""lines"": 26}, ""src/ops.c"": {""insertions"": 10, ""deletions"": 4, ""lines"": 14}, ""src/proto/normal.pro"": {""insertions"": 1, ""deletions"": 0, ""lines"": 1}, ""src/testdir/test_normal.vim"": {""insertions"": 22, ""deletions"": 2, ""lines"": 24}, ""src/version.c"": {""insertions"": 2, ""deletions"": 0, ""lines"": 2}}"
2021-11-22 12:47:39,a3f83feb63eae5464a620ae793c002eb45f7a838,zeertzjq,9,11,20,3,"{""src/getchar.c"": {""insertions"": 3, ""deletions"": 7, ""lines"": 10}, ""src/map.c"": {""insertions"": 4, ""deletions"": 4, ""lines"": 8}, ""src/version.c"": {""insertions"": 2, ""deletions"": 0, ""lines"": 2}}"
2021-11-22 12:06:06,73448a27a8e13b9b26759abeb092fd13a0e93238,Bram Moolenaar,3,1,4,2,"{""Filelist"": {""insertions"": 1, ""deletions"": 1, ""lines"": 2}, ""src/version.c"": {""insertions"": 2, ""deletions"": 0, ""lines"": 2}}"
2021-11-22 11:57:31,581f41adb3ba1dc95bf4fc7c434427e1203be5e8,DungSaga,8,14,22,2,"{""src/version.c"": {""insertions"": 2, ""deletions"": 0, ""lines"": 2}, ""src/xxd/xxd.c"": {""insertions"": 6, ""deletions"": 14, ""lines"": 20}}"
2021-11-21 21:13:36,88a4205f1cfbdc328e987ab00521fc8a22447fc3,Bram Moolenaar,1634,949,2583,19,"{"".github/CODEOWNERS"": {""insertions"": 2, ""deletions"": 0, ""lines"": 2}, ""runtime/defaults.vim"": {""insertions"": 5, ""deletions"": 4, ""lines"": 9}, ""runtime/doc/autocmd.txt"": {""insertions"": 2, ""deletions"": 2, ""lines"": 4}, ""runtime/doc/eval.txt"": {""insertions"": 9, ""deletions"": 6, ""lines"": 15}, ""runtime/doc/helphelp.txt"": {""insertions"": 3, ""deletions"": 3, ""lines"": 6}, ""runtime/doc/map.txt"": {""insertions"": 6, ""deletions"": 1, ""lines"": 7}, ""runtime/doc/options.txt"": {""insertions"": 1, ""deletions"": 1, ""lines"": 2}, ""runtime/doc/syntax.txt"": {""insertions"": 6, ""deletions"": 6, ""lines"": 12}, ""runtime/doc/tags"": {""insertions"": 1, ""deletions"": 0, ""lines"": 1}, ""runtime/doc/usr_20.txt"": {""insertions"": 2, ""deletions"": 2, ""lines"": 4}, ""runtime/doc/visual.txt"": {""insertions"": 3, ""deletions"": 2, ""lines"": 5}, ""runtime/ftplugin/indent.vim"": {""insertions"": 4, ""deletions"": 3, ""lines"": 7}, ""runtime/ftplugin/vb.vim"": {""insertions"": 54, ""deletions"": 28, ""lines"": 82}, ""runtime/pack/dist/opt/termdebug/plugin/termdebug.vim"": {""insertions"": 98, ""deletions"": 51, ""lines"": 149}, ""runtime/syntax/indent.vim"": {""insertions"": 5, ""deletions"": 4, ""lines"": 9}, ""runtime/syntax/vim.vim"": {""insertions"": 4, ""deletions"": 4, ""lines"": 8}, ""src/po/cs.cp1250.po"": {""insertions"": 1, ""deletions"": 1, ""lines"": 2}, ""src/po/cs.po"": {""insertions"": 1, ""deletions"": 1, ""lines"": 2}, ""src/po/eo.po"": {""insertions"": 1427, ""deletions"": 830, ""lines"": 2257}}"
2021-11-21 14:51:13,eea32afdb83ae281a63152f7494f79ec7e45ff55,Bram Moolenaar,42,0,42,5,"{""src/channel.c"": {""insertions"": 4, ""deletions"": 0, ""lines"": 4}, ""src/proto/terminal.pro"": {""insertions"": 1, ""deletions"": 0, ""lines"": 1}, ""src/terminal.c"": {""insertions"": 18, ""deletions"": 0, ""lines"": 18}, ""src/testdir/test_terminal.vim"": {""insertions"": 17, ""deletions"": 0, ""lines"": 17}, ""src/version.c"": {""insertions"": 2, ""deletions"": 0, ""lines"": 2}}"
2021-11-21 12:27:13,7f0c4b418e01d6e056a74de2f22fcbad613b7591,Volodymyr Kot,3,1,4,2,"{""src/main.c"": {""insertions"": 1, ""deletions"": 1, ""lines"": 2}, ""src/version.c"": {""insertions"": 2, ""deletions"": 0, ""lines"": 2}}"
2021-11-21 12:13:56,4785fe02bba14c4e0aede0fa425ca790a1cb98d7,ii14,9,2,11,3,"{""src/cmdexpand.c"": {""insertions"": 4, ""deletions"": 2, ""lines"": 6}, ""src/testdir/test_cmdline.vim"": {""insertions"": 3, ""deletions"": 0, ""lines"": 3}, ""src/version.c"": {""insertions"": 2, ""deletions"": 0, ""lines"": 2}}"
2021-11-21 11:36:04,923dce2b07ff185c0ef661f3eca47bc17655f01b,Dominique Pelle,39,38,77,21,"{""src/testdir/runtest.vim"": {""insertions"": 1, ""deletions"": 1, ""lines"": 2}, ""src/testdir/test_debugger.vim"": {""insertions"": 5, ""deletions"": 5, ""lines"": 10}, ""src/testdir/test_diffmode.vim"": {""insertions"": 2, ""deletions"": 2, ""lines"": 4}, ""src/testdir/test_edit.vim"": {""insertions"": 3, ""deletions"": 3, ""lines"": 6}, ""src/testdir/test_excmd.vim"": {""insertions"": 1, ""deletions"": 1, ""lines"": 2}, ""src/testdir/test_flatten.vim"": {""insertions"": 1, ""deletions"": 1, ""lines"": 2}, ""src/testdir/test_ins_complete.vim"": {""insertions"": 1, ""deletions"": 1, ""lines"": 2}, ""src/testdir/test_normal.vim"": {""insertions"": 3, ""deletions"": 3, ""lines"": 6}, ""src/testdir/test_options.vim"": {""insertions"": 1, ""deletions"": 1, ""lines"": 2}, ""src/testdir/test_python2.vim"": {""insertions"": 1, ""deletions"": 1, ""lines"": 2}, ""src/testdir/test_python3.vim"": {""insertions"": 1, ""deletions"": 1, ""lines"": 2}, ""src/testdir/test_quickfix.vim"": {""insertions"": 4, ""deletions"": 4, ""lines"": 8}, ""src/testdir/test_recover.vim"": {""insertions"": 1, ""deletions"": 1, ""lines"": 2}, ""src/testdir/test_spellfile.vim"": {""insertions"": 1, ""deletions"": 1, ""lines"": 2}, ""src/testdir/test_syntax.vim"": {""insertions"": 1, ""deletions"": 2, ""lines"": 3}, ""src/testdir/test_termcodes.vim"": {""insertions"": 3, ""deletions"": 3, ""lines"": 6}, ""src/testdir/test_textobjects.vim"": {""insertions"": 1, ""deletions"": 1, ""lines"": 2}, ""src/testdir/test_trycatch.vim"": {""insertions"": 1, ""deletions"": 1, ""lines"": 2}, ""src/testdir/test_vim9_script.vim"": {""insertions"": 2, ""deletions"": 2, ""lines"": 4}, ""src/testdir/test_viminfo.vim"": {""insertions"": 3, ""deletions"": 3, ""lines"": 6}, ""src/version.c"": {""insertions"": 2, ""deletions"": 0, ""lines"": 2}}"
2021-11-21 11:15:49,2c23670300b18f2f799d0602ff5225caa55b0d67,Bram Moolenaar,3,5,8,2,"{""src/gui_gtk_x11.c"": {""insertions"": 1, ""deletions"": 5, ""lines"": 6}, ""src/version.c"": {""insertions"": 2, ""deletions"": 0, ""lines"": 2}}"
2021-11-20 22:03:30,3c19b5050040fb74e4e39048f17dce853fdafc08,Dusan Popovic,22,11,33,2,"{""src/gui_gtk_x11.c"": {""insertions"": 20, ""deletions"": 11, ""lines"": 31}, ""src/version.c"": {""insertions"": 2, ""deletions"": 0, ""lines"": 2}}"
2021-11-20 21:46:20,d604d78e7b2e63d118814d0fa0b4b702ec52aeed,Bram Moolenaar,15,1,16,3,"{""src/testdir/test_vim9_func.vim"": {""insertions"": 12, ""deletions"": 1, ""lines"": 13}, ""src/userfunc.c"": {""insertions"": 1, ""deletions"": 0, ""lines"": 1}, ""src/version.c"": {""insertions"": 2, ""deletions"": 0, ""lines"": 2}}"
2021-11-20 21:35:41,a755fdbe80bed4897e06028f0044c208e0f9d8cb,Bram Moolenaar,17,1,18,3,"{""src/testdir/test_vim9_func.vim"": {""insertions"": 14, ""deletions"": 0, ""lines"": 14}, ""src/userfunc.c"": {""insertions"": 1, ""deletions"": 1, ""lines"": 2}, ""src/version.c"": {""insertions"": 2, ""deletions"": 0, ""lines"": 2}}"
2021-11-20 20:42:29,9cd9385db7d1d2b2dc38a511d121e366a5dae511,Yamagi,4,1,5,2,"{""src/gui_gtk_x11.c"": {""insertions"": 2, ""deletions"": 1, ""lines"": 3}, ""src/version.c"": {""insertions"": 2, ""deletions"": 0, ""lines"": 2}}"
2021-11-20 19:50:59,c8a9fe541d3bee36d2760ed156997ddbb0142ee1,Bram Moolenaar,12,2,14,3,"{""src/syntax.c"": {""insertions"": 2, ""deletions"": 2, ""lines"": 4}, ""src/testdir/test_vim9_cmd.vim"": {""insertions"": 8, ""deletions"": 0, ""lines"": 8}, ""src/version.c"": {""insertions"": 2, ""deletions"": 0, ""lines"": 2}}"
2021-11-20 19:38:31,d85fccdfed58108c4e0958d0b17c64690b5f073f,presuku,16,4,20,3,"{""src/strings.c"": {""insertions"": 9, ""deletions"": 4, ""lines"": 13}, ""src/testdir/test_expr.vim"": {""insertions"": 5, ""deletions"": 0, ""lines"": 5}, ""src/version.c"": {""insertions"": 2, ""deletions"": 0, ""lines"": 2}}"
2021-11-20 19:13:39,a1198124370a366ff02811a43845a631b5c6e7f0,mityu,73,12,85,6,"{""src/evalvars.c"": {""insertions"": 2, ""deletions"": 4, ""lines"": 6}, ""src/ex_getln.c"": {""insertions"": 9, ""deletions"": 0, ""lines"": 9}, ""src/proto/ex_getln.pro"": {""insertions"": 1, ""deletions"": 0, ""lines"": 1}, ""src/testdir/test_ins_complete.vim"": {""insertions"": 49, ""deletions"": 0, ""lines"": 49}, ""src/usercmd.c"": {""insertions"": 10, ""deletions"": 8, ""lines"": 18}, ""src/version.c"": {""insertions"": 2, ""deletions"": 0, ""lines"": 2}}"
2021-11-20 13:47:45,87fd0924e2d85213cc111ee7a5122f92216a37c7,Bram Moolenaar,1041,197,1238,43,"{""src/highlight.c"": {""insertions"": 5, ""deletions"": 0, ""lines"": 5}, ""src/libvterm/include/vterm.h"": {""insertions"": 12, ""deletions"": 1, ""lines"": 13}, ""src/option.c"": {""insertions"": 4, ""deletions"": 0, ""lines"": 4}, ""src/optionstr.c"": {""insertions"": 1, ""deletions"": 4, ""lines"": 5}, ""src/popupwin.c"": {""insertions"": 5, ""deletions"": 0, ""lines"": 5}, ""src/proto/terminal.pro"": {""insertions"": 3, ""deletions"": 1, ""lines"": 4}, ""src/structs.h"": {""insertions"": 11, ""deletions"": 0, ""lines"": 11}, ""src/terminal.c"": {""insertions"": 202, ""deletions"": 181, ""lines"": 383}, ""src/testdir/dumps/Test_terminal_color_MyTermCol.dump"": {""insertions"": 15, ""deletions"": 0, ""lines"": 15}, ""src/testdir/dumps/Test_terminal_color_MyTermCol_over_Terminal.dump"": {""insertions"": 15, ""deletions"": 0, ""lines"": 15}, ""src/testdir/dumps/Test_terminal_color_MyWinCol.dump"": {""insertions"": 15, ""deletions"": 0, ""lines"": 15}, ""src/testdir/dumps/Test_terminal_color_MyWinCol_over_group.dump"": {""insertions"": 15, ""deletions"": 0, ""lines"": 15}, ""src/testdir/dumps/Test_terminal_color_Terminal.dump"": {""insertions"": 15, ""deletions"": 0, ""lines"": 15}, ""src/testdir/dumps/Test_terminal_color_gui_MyTermCol.dump"": {""insertions"": 15, ""deletions"": 0, ""lines"": 15}, ""src/testdir/dumps/Test_terminal_color_gui_MyWinCol.dump"": {""insertions"": 15, ""deletions"": 0, ""lines"": 15}, ""src/testdir/dumps/Test_terminal_color_gui_Terminal.dump"": {""insertions"": 15, ""deletions"": 0, ""lines"": 15}, ""src/testdir/dumps/Test_terminal_color_gui_transp_MyTermCol.dump"": {""insertions"": 15, ""deletions"": 0, ""lines"": 15}, ""src/testdir/dumps/Test_terminal_color_gui_transp_MyWinCol.dump"": {""insertions"": 15, ""deletions"": 0, ""lines"": 15}, ""src/testdir/dumps/Test_terminal_color_gui_transp_Terminal.dump"": {""insertions"": 15, ""deletions"": 0, ""lines"": 15}, ""src/testdir/dumps/Test_terminal_color_transp_MyTermCol.dump"": {""insertions"": 15, ""deletions"": 0, ""lines"": 15}, ""src/testdir/dumps/Test_terminal_color_transp_MyWinCol.dump"": {""insertions"": 15, ""deletions"": 0, ""lines"": 15}, ""src/testdir/dumps/Test_terminal_color_transp_Terminal.dump"": {""insertions"": 15, ""deletions"": 0, ""lines"": 15}, ""src/testdir/dumps/Test_terminal_popup_MyPopupHlCol.dump"": {""insertions"": 15, ""deletions"": 0, ""lines"": 15}, ""src/testdir/dumps/Test_terminal_popup_MyTermCol_over_Terminal.dump"": {""insertions"": 15, ""deletions"": 0, ""lines"": 15}, ""src/testdir/dumps/Test_terminal_popup_MyWinCol.dump"": {""insertions"": 15, ""deletions"": 0, ""lines"": 15}, ""src/testdir/dumps/Test_terminal_popup_MyWinCol_over_group.dump"": {""insertions"": 15, ""deletions"": 0, ""lines"": 15}, ""src/testdir/dumps/Test_terminal_popup_gui_MyPopupHlCol.dump"": {""insertions"": 15, ""deletions"": 0, ""lines"": 15}, ""src/testdir/dumps/Test_terminal_popup_gui_MyTermCol.dump"": {""insertions"": 15, ""deletions"": 0, ""lines"": 15}, ""src/testdir/dumps/Test_terminal_popup_gui_MyWinCol.dump"": {""insertions"": 15, ""deletions"": 0, ""lines"": 15}, ""src/testdir/dumps/Test_terminal_popup_gui_Terminal.dump"": {""insertions"": 15, ""deletions"": 0, ""lines"": 15}, ""src/testdir/dumps/Test_terminal_popup_gui_transp_MyPopupHlCol.dump"": {""insertions"": 15, ""deletions"": 0, ""lines"": 15}, ""src/testdir/dumps/Test_terminal_popup_gui_transp_MyTermCol.dump"": {""insertions"": 15, ""deletions"": 0, ""lines"": 15}, ""src/testdir/dumps/Test_terminal_popup_gui_transp_MyWinCol.dump"": {""insertions"": 15, ""deletions"": 0, ""lines"": 15}, ""src/testdir/dumps/Test_terminal_popup_gui_transp_Terminal.dump"": {""insertions"": 15, ""deletions"": 0, ""lines"": 15}, ""src/testdir/dumps/Test_terminal_popup_transp_MyPopupHlCol.dump"": {""insertions"": 15, ""deletions"": 0, ""lines"": 15}, ""src/testdir/dumps/Test_terminal_popup_transp_MyTermCol.dump"": {""insertions"": 15, ""deletions"": 0, ""lines"": 15}, ""src/testdir/dumps/Test_terminal_popup_transp_MyWinCol.dump"": {""insertions"": 15, ""deletions"": 0, ""lines"": 15}, ""src/testdir/dumps/Test_terminal_popup_transp_Terminal.dump"": {""insertions"": 15, ""deletions"": 0, ""lines"": 15}, ""src/testdir/dumps/Test_terminal_wincolor_split_MyWinCol.dump"": {""insertions"": 15, ""deletions"": 0, ""lines"": 15}, ""src/testdir/dumps/Test_terminal_wincolor_split_MyWinCol2.dump"": {""insertions"": 15, ""deletions"": 0, ""lines"": 15}, ""src/testdir/test_terminal3.vim"": {""insertions"": 310, ""deletions"": 10, ""lines"": 320}, ""src/version.c"": {""insertions"": 2, ""deletions"": 0, ""lines"": 2}, ""src/window.c"": {""insertions"": 6, ""deletions"": 0, ""lines"": 6}}"
2021-11-20 11:14:24,cdf5fdb2948ecdd24c6a1e27ed33dfa847c2b3e4,Bram Moolenaar,8,0,8,4,"{""runtime/doc/eval.txt"": {""insertions"": 3, ""deletions"": 0, ""lines"": 3}, ""src/evalwindow.c"": {""insertions"": 1, ""deletions"": 0, ""lines"": 1}, ""src/testdir/test_bufwintabinfo.vim"": {""insertions"": 2, ""deletions"": 0, ""lines"": 2}, ""src/version.c"": {""insertions"": 2, ""deletions"": 0, ""lines"": 2}}"
2021-11-20 10:38:25,b8e642f7ace5382b4dacb7a8effd86f22b828cc1,Bram Moolenaar,10,3,13,3,"{""src/autocmd.c"": {""insertions"": 2, ""deletions"": 0, ""lines"": 2}, ""src/testdir/test_autocmd.vim"": {""insertions"": 6, ""deletions"": 3, ""lines"": 9}, ""src/version.c"": {""insertions"": 2, ""deletions"": 0, ""lines"": 2}}"
2021-11-19 19:41:13,2de9b7c7c8791da8853a9a7ca9c467867465b655,Bram Moolenaar,19,5,24,3,"{""src/cindent.c"": {""insertions"": 5, ""deletions"": 5, ""lines"": 10}, ""src/testdir/test_cindent.vim"": {""insertions"": 12, ""deletions"": 0, ""lines"": 12}, ""src/version.c"": {""insertions"": 2, ""deletions"": 0, ""lines"": 2}}"
2021-11-19 17:01:08,3ad695328f94e0197e84454f125c7f3464091d0c,Bram Moolenaar,29,0,29,5,"{""src/buffer.c"": {""insertions"": 5, ""deletions"": 0, ""lines"": 5}, ""src/proto/terminal.pro"": {""insertions"": 1, ""deletions"": 0, ""lines"": 1}, ""src/terminal.c"": {""insertions"": 9, ""deletions"": 0, ""lines"": 9}, ""src/testdir/test_terminal.vim"": {""insertions"": 12, ""deletions"": 0, ""lines"": 12}, ""src/version.c"": {""insertions"": 2, ""deletions"": 0, ""lines"": 2}}"
2021-11-19 12:37:36,8b8d829faf04fe3706c04f7f7000054acd3254e7,Christian Brabandt,19,7,26,4,"{""runtime/doc/map.txt"": {""insertions"": 0, ""deletions"": 3, ""lines"": 3}, ""src/os_unix.c"": {""insertions"": 11, ""deletions"": 4, ""lines"": 15}, ""src/testdir/test_expand.vim"": {""insertions"": 6, ""deletions"": 0, ""lines"": 6}, ""src/version.c"": {""insertions"": 2, ""deletions"": 0, ""lines"": 2}}"
2021-11-19 11:59:08,64be6aa3a54ecfe355d4a03e1200650c301e7f29,zeertzjq,11,1,12,3,"{""src/ex_docmd.c"": {""insertions"": 1, ""deletions"": 1, ""lines"": 2}, ""src/testdir/test_autochdir.vim"": {""insertions"": 8, ""deletions"": 0, ""lines"": 8}, ""src/version.c"": {""insertions"": 2, ""deletions"": 0, ""lines"": 2}}"
2021-11-19 11:35:32,1d69ef410ab2adb0351d559ff9753d6cdd4befdf,Bram Moolenaar,3,1,4,2,"{""src/version.c"": {""insertions"": 2, ""deletions"": 0, ""lines"": 2}, ""src/vim.h"": {""insertions"": 1, ""deletions"": 1, ""lines"": 2}}"
2021-11-19 11:28:04,b3a29558eedac9979f5276ae914934b7b7cbe06b,Bram Moolenaar,338,270,608,12,"{""src/Make_cyg_ming.mak"": {""insertions"": 1, ""deletions"": 1, ""lines"": 2}, ""src/Make_mvc.mak"": {""insertions"": 1, ""deletions"": 1, ""lines"": 2}, ""src/Make_vms.mms"": {""insertions"": 122, ""deletions"": 122, ""lines"": 244}, ""src/Makefile"": {""insertions"": 146, ""deletions"": 146, ""lines"": 292}, ""src/alloc.c"": {""insertions"": 1, ""deletions"": 0, ""lines"": 1}, ""src/auto/configure"": {""insertions"": 29, ""deletions"": 0, ""lines"": 29}, ""src/config.h.in"": {""insertions"": 3, ""deletions"": 0, ""lines"": 3}, ""src/configure.ac"": {""insertions"": 10, ""deletions"": 0, ""lines"": 10}, ""src/proto/term.pro"": {""insertions"": 1, ""deletions"": 0, ""lines"": 1}, ""src/term.c"": {""insertions"": 22, ""deletions"": 0, ""lines"": 22}, ""src/{term.h => termdefs.h}"": {""insertions"": 0, ""deletions"": 0, ""lines"": 0}, ""src/version.c"": {""insertions"": 2, ""deletions"": 0, ""lines"": 2}}"
2021-11-18 22:08:57,777175b0df8c5ec3cd30d19a2e887e661ac209c8,Yegappan Lakshmanan,185,41,226,10,"{""runtime/doc/map.txt"": {""insertions"": 14, ""deletions"": 0, ""lines"": 14}, ""runtime/doc/options.txt"": {""insertions"": 17, ""deletions"": 3, ""lines"": 20}, ""src/ops.c"": {""insertions"": 26, ""deletions"": 1, ""lines"": 27}, ""src/option.c"": {""insertions"": 47, ""deletions"": 0, ""lines"": 47}, ""src/optionstr.c"": {""insertions"": 9, ""deletions"": 1, ""lines"": 10}, ""src/proto/ops.pro"": {""insertions"": 2, ""deletions"": 0, ""lines"": 2}, ""src/proto/option.pro"": {""insertions"": 2, ""deletions"": 1, ""lines"": 3}, ""src/quickfix.c"": {""insertions"": 2, ""deletions"": 35, ""lines"": 37}, ""src/testdir/test_normal.vim"": {""insertions"": 64, ""deletions"": 0, ""lines"": 64}, ""src/version.c"": {""insertions"": 2, ""deletions"": 0, ""lines"": 2}}"
2021-11-18 20:47:31,851c7a699ae00bdc14a4db874cf722b7b7393b53,Bram Moolenaar,29,6,35,4,"{""runtime/doc/eval.txt"": {""insertions"": 3, ""deletions"": 3, ""lines"": 6}, ""src/filepath.c"": {""insertions"": 5, ""deletions"": 3, ""lines"": 8}, ""src/testdir/test_cd.vim"": {""insertions"": 19, ""deletions"": 0, ""lines"": 19}, ""src/version.c"": {""insertions"": 2, ""deletions"": 0, ""lines"": 2}}"
2021-11-18 18:53:45,0526815c15170a5926e1008600ec29d42d8b64c2,Bram Moolenaar,51,4,55,9,"{""src/buffer.c"": {""insertions"": 3, ""deletions"": 0, ""lines"": 3}, ""src/ex_docmd.c"": {""insertions"": 4, ""deletions"": 1, ""lines"": 5}, ""src/globals.h"": {""insertions"": 1, ""deletions"": 0, ""lines"": 1}, ""src/main.c"": {""insertions"": 2, ""deletions"": 1, ""lines"": 3}, ""src/netbeans.c"": {""insertions"": 3, ""deletions"": 0, ""lines"": 3}, ""src/os_win32.c"": {""insertions"": 3, ""deletions"": 2, ""lines"": 5}, ""src/testdir/test_autochdir.vim"": {""insertions"": 29, ""deletions"": 0, ""lines"": 29}, ""src/version.c"": {""insertions"": 2, ""deletions"": 0, ""lines"": 2}, ""src/window.c"": {""insertions"": 4, ""deletions"": 0, ""lines"": 4}}"
2021-11-18 15:37:29,3cad47038547e694cfa26ba39c399f610d2054bd,Shougo Matsushita,11,10,21,2,"{""src/testdir/test_arglist.vim"": {""insertions"": 9, ""deletions"": 10, ""lines"": 19}, ""src/version.c"": {""insertions"": 2, ""deletions"": 0, ""lines"": 2}}"
2021-11-18 13:56:37,818ff25cd1aabf60b9cd239da2f1328a959954f7,Christian Brabandt,101,1,102,3,"{""src/testdir/test_indent.vim"": {""insertions"": 75, ""deletions"": 0, ""lines"": 75}, ""src/textformat.c"": {""insertions"": 24, ""deletions"": 1, ""lines"": 25}, ""src/version.c"": {""insertions"": 2, ""deletions"": 0, ""lines"": 2}}"
2021-11-17 20:40:16,6555500bcf280716187eea9dba22d4f69bc0a501,Bakudankun,88,5,93,8,"{""src/popupmenu.c"": {""insertions"": 2, ""deletions"": 2, ""lines"": 4}, ""src/popupwin.c"": {""insertions"": 5, ""deletions"": 1, ""lines"": 6}, ""src/proto/popupmenu.pro"": {""insertions"": 1, ""deletions"": 1, ""lines"": 2}, ""src/screen.c"": {""insertions"": 1, ""deletions"": 1, ""lines"": 2}, ""src/testdir/dumps/Test_popupwin_popupmenu_masking_1.dump"": {""insertions"": 14, ""deletions"": 0, ""lines"": 14}, ""src/testdir/dumps/Test_popupwin_popupmenu_masking_2.dump"": {""insertions"": 14, ""deletions"": 0, ""lines"": 14}, ""src/testdir/test_popupwin.vim"": {""insertions"": 49, ""deletions"": 0, ""lines"": 49}, ""src/version.c"": {""insertions"": 2, ""deletions"": 0, ""lines"": 2}}"
2021-11-17 19:01:53,e015d99abb4276f47ce97bad1ad5ff0c658b1c8a,Bram Moolenaar,5,3,8,2,"{""src/findfile.c"": {""insertions"": 3, ""deletions"": 3, ""lines"": 6}, ""src/version.c"": {""insertions"": 2, ""deletions"": 0, ""lines"": 2}}"
2021-11-17 18:22:56,64066b9acd9f8cffdf4840f797748f938a13f2d6,Bram Moolenaar,19,1,20,4,"{""src/regexp.c"": {""insertions"": 1, ""deletions"": 1, ""lines"": 2}, ""src/regexp_nfa.c"": {""insertions"": 8, ""deletions"": 0, ""lines"": 8}, ""src/testdir/test_regexp_latin.vim"": {""insertions"": 8, ""deletions"": 0, ""lines"": 8}, ""src/version.c"": {""insertions"": 2, ""deletions"": 0, ""lines"": 2}}"
2021-11-17 18:00:31,615ddd5342b50a6878a907062aa471740bd9a847,Bram Moolenaar,22,2,24,4,"{""src/findfile.c"": {""insertions"": 8, ""deletions"": 0, ""lines"": 8}, ""src/normal.c"": {""insertions"": 4, ""deletions"": 2, ""lines"": 6}, ""src/testdir/test_visual.vim"": {""insertions"": 8, ""deletions"": 0, ""lines"": 8}, ""src/version.c"": {""insertions"": 2, ""deletions"": 0, ""lines"": 2}}"
2021-11-17 16:52:40,a062006b9de0b2947ab5fb376c6e67ef92a8cd69,Bram Moolenaar,12,2,14,3,"{""src/normal.c"": {""insertions"": 1, ""deletions"": 1, ""lines"": 2}, ""src/testdir/test_edit.vim"": {""insertions"": 9, ""deletions"": 1, ""lines"": 10}, ""src/version.c"": {""insertions"": 2, ""deletions"": 0, ""lines"": 2}}"
2021-11-17 15:51:52,3075a45592fe76f2febb6321632a23e352efe949,Bram Moolenaar,65,17,82,7,"{""src/insexpand.c"": {""insertions"": 4, ""deletions"": 4, ""lines"": 8}, ""src/misc1.c"": {""insertions"": 37, ""deletions"": 4, ""lines"": 41}, ""src/proto/misc1.pro"": {""insertions"": 2, ""deletions"": 0, ""lines"": 2}, ""src/register.c"": {""insertions"": 9, ""deletions"": 9, ""lines"": 18}, ""src/structs.h"": {""insertions"": 5, ""deletions"": 0, ""lines"": 5}, ""src/testdir/test_edit.vim"": {""insertions"": 6, ""deletions"": 0, ""lines"": 6}, ""src/version.c"": {""insertions"": 2, ""deletions"": 0, ""lines"": 2}}"
2021-11-17 14:01:14,125ffd21f9601a90b845f1d50c24da0d3938bb59,Egor Zvorykin,15,0,15,4,"{""runtime/defaults.vim"": {""insertions"": 11, ""deletions"": 0, ""lines"": 11}, ""src/testdir/test_autocmd.vim"": {""insertions"": 1, ""deletions"": 0, ""lines"": 1}, ""src/testdir/test_cmdline.vim"": {""insertions"": 1, ""deletions"": 0, ""lines"": 1}, ""src/version.c"": {""insertions"": 2, ""deletions"": 0, ""lines"": 2}}"
2021-11-16 20:03:56,9459b8d461d6f8345bfa3fb9b3b4297a7950b0bc,presuku,30,145,175,3,"{""src/gui.h"": {""insertions"": 0, ""deletions"": 1, ""lines"": 1}, ""src/gui_gtk_x11.c"": {""insertions"": 28, ""deletions"": 144, ""lines"": 172}, ""src/version.c"": {""insertions"": 2, ""deletions"": 0, ""lines"": 2}}"
2021-11-16 19:20:56,d3682c5f28380695a53cbb927deb94ffa3261eca,Bram Moolenaar,3,0,3,2,"{""Filelist"": {""insertions"": 1, ""deletions"": 0, ""lines"": 1}, ""src/version.c"": {""insertions"": 2, ""deletions"": 0, ""lines"": 2}}"
2021-11-16 19:18:26,519cc559b08b800edc429688aece7ad6a00d41eb,Bram Moolenaar,365,141,506,29,"{"".github/CODEOWNERS"": {""insertions"": 3, ""deletions"": 0, ""lines"": 3}, ""runtime/autoload/zip.vim"": {""insertions"": 21, ""deletions"": 15, ""lines"": 36}, ""runtime/doc/eval.txt"": {""insertions"": 4, ""deletions"": 4, ""lines"": 8}, ""runtime/doc/helphelp.txt"": {""insertions"": 13, ""deletions"": 9, ""lines"": 22}, ""runtime/doc/if_pyth.txt"": {""insertions"": 6, ""deletions"": 1, ""lines"": 7}, ""runtime/doc/map.txt"": {""insertions"": 4, ""deletions"": 1, ""lines"": 5}, ""runtime/doc/options.txt"": {""insertions"": 1, ""deletions"": 1, ""lines"": 2}, ""runtime/doc/pi_zip.txt"": {""insertions"": 4, ""deletions"": 1, ""lines"": 5}, ""runtime/doc/syntax.txt"": {""insertions"": 1, ""deletions"": 1, ""lines"": 2}, ""runtime/doc/tags"": {""insertions"": 4, ""deletions"": 2, ""lines"": 6}, ""runtime/doc/terminal.txt"": {""insertions"": 2, ""deletions"": 2, ""lines"": 4}, ""runtime/doc/todo.txt"": {""insertions"": 4, ""deletions"": 9, ""lines"": 13}, ""runtime/doc/usr_20.txt"": {""insertions"": 5, ""deletions"": 5, ""lines"": 10}, ""runtime/filetype.vim"": {""insertions"": 1, ""deletions"": 1, ""lines"": 2}, ""runtime/ftplugin/aap.vim"": {""insertions"": 10, ""deletions"": 3, ""lines"": 13}, ""runtime/ftplugin/diff.vim"": {""insertions"": 8, ""deletions"": 3, ""lines"": 11}, ""runtime/ftplugin/lua.vim"": {""insertions"": 21, ""deletions"": 17, ""lines"": 38}, ""runtime/ftplugin/routeros.vim"": {""insertions"": 29, ""deletions"": 0, ""lines"": 29}, ""runtime/ftplugin/zimbu.vim"": {""insertions"": 57, ""deletions"": 4, ""lines"": 61}, ""runtime/pack/dist/opt/matchit/doc/matchit.txt"": {""insertions"": 2, ""deletions"": 2, ""lines"": 4}, ""runtime/pack/dist/opt/termdebug/plugin/termdebug.vim"": {""insertions"": 3, ""deletions"": 1, ""lines"": 4}, ""runtime/plugin/zipPlugin.vim"": {""insertions"": 1, ""deletions"": 1, ""lines"": 2}, ""runtime/syntax/autoit.vim"": {""insertions"": 2, ""deletions"": 1, ""lines"": 3}, ""runtime/syntax/gdb.vim"": {""insertions"": 7, ""deletions"": 6, ""lines"": 13}, ""runtime/syntax/gnuplot.vim"": {""insertions"": 23, ""deletions"": 18, ""lines"": 41}, ""runtime/syntax/lisp.vim"": {""insertions"": 14, ""deletions"": 12, ""lines"": 26}, ""runtime/syntax/routeros.vim"": {""insertions"": 91, ""deletions"": 0, ""lines"": 91}, ""runtime/syntax/tcl.vim"": {""insertions"": 10, ""deletions"": 10, ""lines"": 20}, ""runtime/syntax/vim.vim"": {""insertions"": 14, ""deletions"": 11, ""lines"": 25}}"
2021-11-16 17:50:34,728104da6cd561b8cb2c7142769f7526d725958e,Bram Moolenaar,2,0,2,1,"{""src/version.c"": {""insertions"": 2, ""deletions"": 0, ""lines"": 2}}"
2021-11-16 17:19:30,2a16dc6613368c54d526850bcbcd03c3fec1be67,Yegappan Lakshmanan,142,35,177,5,"{""runtime/doc/eval.txt"": {""insertions"": 16, ""deletions"": 1, ""lines"": 17}, ""src/highlight.c"": {""insertions"": 35, ""deletions"": 17, ""lines"": 52}, ""src/testdir/test_highlight.vim"": {""insertions"": 88, ""deletions"": 15, ""lines"": 103}, ""src/testdir/test_vim9_builtin.vim"": {""insertions"": 1, ""deletions"": 0, ""lines"": 1}, ""src/testdir/test_vim9_cmd.vim"": {""insertions"": 2, ""deletions"": 2, ""lines"": 4}}"
2021-11-16 16:38:42,c143fa0778fa0d8744867318bb7f7a2e63cf37d7,Bram Moolenaar,6,1,7,3,"{""runtime/filetype.vim"": {""insertions"": 3, ""deletions"": 0, ""lines"": 3}, ""src/testdir/test_filetype.vim"": {""insertions"": 1, ""deletions"": 1, ""lines"": 2}, ""src/version.c"": {""insertions"": 2, ""deletions"": 0, ""lines"": 2}}"
2021-11-16 15:28:10,b1b163efd7bb3ca68cce101d4e431559d2944a8e,Bram Moolenaar,11,0,11,4,"{""runtime/filetype.vim"": {""insertions"": 3, ""deletions"": 0, ""lines"": 3}, ""runtime/scripts.vim"": {""insertions"": 4, ""deletions"": 0, ""lines"": 4}, ""src/testdir/test_filetype.vim"": {""insertions"": 2, ""deletions"": 0, ""lines"": 2}, ""src/version.c"": {""insertions"": 2, ""deletions"": 0, ""lines"": 2}}"
2021-11-16 13:08:56,1be7e215830d6ec9aa6200aac4ef34ac0ae85af5,K.Takata,5,0,5,2,"{""src/testdir/test_python3.vim"": {""insertions"": 3, ""deletions"": 0, ""lines"": 3}, ""src/version.c"": {""insertions"": 2, ""deletions"": 0, ""lines"": 2}}"
2021-11-16 12:50:46,fa53722367c3793fda95dac665af74b8651065e9,ichizok,68,29,97,3,"{""src/register.c"": {""insertions"": 35, ""deletions"": 27, ""lines"": 62}, ""src/testdir/test_put.vim"": {""insertions"": 31, ""deletions"": 2, ""lines"": 33}, ""src/version.c"": {""insertions"": 2, ""deletions"": 0, ""lines"": 2}}"
2021-11-16 11:53:13,314b773abbb9b1ce0020d83482c6daf7ad6a42a2,Bram Moolenaar,10,0,10,2,"{""runtime/scripts.vim"": {""insertions"": 8, ""deletions"": 0, ""lines"": 8}, ""src/version.c"": {""insertions"": 2, ""deletions"": 0, ""lines"": 2}}"
2021-11-16 11:10:11,782b4bbc163e03ebe98d25bc62b9d82cba8f91a1,Bram Moolenaar,4,2,6,3,"{""runtime/filetype.vim"": {""insertions"": 1, ""deletions"": 1, ""lines"": 2}, ""src/testdir/test_filetype.vim"": {""insertions"": 1, ""deletions"": 1, ""lines"": 2}, ""src/version.c"": {""insertions"": 2, ""deletions"": 0, ""lines"": 2}}"
2021-11-15 21:44:11,0818ab82e7058145366ebbe759f0b3f74724bdfd,zainin,7,0,7,3,"{""runtime/filetype.vim"": {""insertions"": 3, ""deletions"": 0, ""lines"": 3}, ""src/testdir/test_filetype.vim"": {""insertions"": 2, ""deletions"": 0, ""lines"": 2}, ""src/version.c"": {""insertions"": 2, ""deletions"": 0, ""lines"": 2}}"
2021-11-15 17:13:11,36968af1558b295b5fdf56973d5dcc75fce85658,Bram Moolenaar,20,1,21,3,"{""runtime/doc/options.txt"": {""insertions"": 3, ""deletions"": 0, ""lines"": 3}, ""src/terminal.c"": {""insertions"": 15, ""deletions"": 1, ""lines"": 16}, ""src/version.c"": {""insertions"": 2, ""deletions"": 0, ""lines"": 2}}"
2021-11-15 11:22:09,733b124a9098d5e2f028fd2e12012b831c9e9024,Yegappan Lakshmanan,18,5,23,3,"{""src/popupwin.c"": {""insertions"": 5, ""deletions"": 5, ""lines"": 10}, ""src/testdir/test_vim9_cmd.vim"": {""insertions"": 11, ""deletions"": 0, ""lines"": 11}, ""src/version.c"": {""insertions"": 2, ""deletions"": 0, ""lines"": 2}}"
2021-11-14 14:05:18,0d5a12ea041c112b06b1aafde38846ae4cff8f4c,Bram Moolenaar,8,2,10,2,"{""src/getchar.c"": {""insertions"": 6, ""deletions"": 2, ""lines"": 8}, ""src/version.c"": {""insertions"": 2, ""deletions"": 0, ""lines"": 2}}"
2021-11-14 13:46:05,786e05beb5bf4a50cffacd0968f1409aa6af3c6b,Bram Moolenaar,44,29,73,2,"{""src/version.c"": {""insertions"": 2, ""deletions"": 0, ""lines"": 2}, ""src/xxd/xxd.c"": {""insertions"": 42, ""deletions"": 29, ""lines"": 71}}"
2021-11-14 11:41:31,7f13b24ab6aca808262e68680d8fe5f082670ebd,Bram Moolenaar,58,30,88,5,"{""src/evalwindow.c"": {""insertions"": 4, ""deletions"": 0, ""lines"": 4}, ""src/proto/window.pro"": {""insertions"": 1, ""deletions"": 0, ""lines"": 1}, ""src/testdir/test_execute_func.vim"": {""insertions"": 12, ""deletions"": 0, ""lines"": 12}, ""src/version.c"": {""insertions"": 2, ""deletions"": 0, ""lines"": 2}, ""src/window.c"": {""insertions"": 39, ""deletions"": 30, ""lines"": 69}}"
2021-11-13 18:44:37,6a950a6007f27d9d0ce32ef8dcaf5c9d0f1b5aab,Dominique Pelle,7,0,7,2,"{""src/testdir/test_highlight.vim"": {""insertions"": 5, ""deletions"": 0, ""lines"": 5}, ""src/version.c"": {""insertions"": 2, ""deletions"": 0, ""lines"": 2}}"
2021-11-13 12:38:49,23beefed73aadb243fb67cf944e3d60fe8c038bb,naohiro ono,84,4,88,6,"{""runtime/doc/autocmd.txt"": {""insertions"": 7, ""deletions"": 0, ""lines"": 7}, ""src/autocmd.c"": {""insertions"": 3, ""deletions"": 1, ""lines"": 4}, ""src/testdir/test_autocmd.vim"": {""insertions"": 43, ""deletions"": 3, ""lines"": 46}, ""src/version.c"": {""insertions"": 2, ""deletions"": 0, ""lines"": 2}, ""src/vim.h"": {""insertions"": 1, ""deletions"": 0, ""lines"": 1}, ""src/window.c"": {""insertions"": 28, ""deletions"": 0, ""lines"": 28}}"
2021-11-13 10:50:01,a0fca17251bf491db7b8d302ce22dee844597e82,Drew Vogel,24,35,59,5,"{""runtime/doc/eval.txt"": {""insertions"": 1, ""deletions"": 1, ""lines"": 2}, ""src/highlight.c"": {""insertions"": 0, ""deletions"": 33, ""lines"": 33}, ""src/proto/highlight.pro"": {""insertions"": 0, ""deletions"": 1, ""lines"": 1}, ""src/testdir/test_highlight.vim"": {""insertions"": 21, ""deletions"": 0, ""lines"": 21}, ""src/version.c"": {""insertions"": 2, ""deletions"": 0, ""lines"": 2}}"
2021-11-13 10:27:40,5300be620c77950caa5296019408ee02e60097e8,Bram Moolenaar,11,1,12,4,"{""runtime/doc/terminal.txt"": {""insertions"": 2, ""deletions"": 1, ""lines"": 3}, ""src/job.c"": {""insertions"": 5, ""deletions"": 0, ""lines"": 5}, ""src/testdir/test_terminal.vim"": {""insertions"": 2, ""deletions"": 0, ""lines"": 2}, ""src/version.c"": {""insertions"": 2, ""deletions"": 0, ""lines"": 2}}"
2021-11-12 19:52:47,606efc7df4c94104bbd24248106dd0e4ee6f7cfa,Bram Moolenaar,6,5,11,2,"{""src/optionstr.c"": {""insertions"": 4, ""deletions"": 5, ""lines"": 9}, ""src/version.c"": {""insertions"": 2, ""deletions"": 0, ""lines"": 2}}"
2021-11-12 16:09:54,0a15c7676bccb0c9483579106318e785c6e40a7f,Bram Moolenaar,3,1,4,2,"{""src/testdir/test_compiler.vim"": {""insertions"": 1, ""deletions"": 1, ""lines"": 2}, ""src/version.c"": {""insertions"": 2, ""deletions"": 0, ""lines"": 2}}"
2021-11-12 16:06:03,326e7da609a1b115b0ed535e89e970afebe99e35,Bram Moolenaar,4,2,6,2,"{""src/testdir/test_usercommands.vim"": {""insertions"": 2, ""deletions"": 2, ""lines"": 4}, ""src/version.c"": {""insertions"": 2, ""deletions"": 0, ""lines"": 2}}"
2021-11-12 16:01:15,88137396733896eb5e49c2b3b73d9a496d6ce49a,Bram Moolenaar,13,2,15,4,"{""src/job.c"": {""insertions"": 5, ""deletions"": 1, ""lines"": 6}, ""src/terminal.c"": {""insertions"": 2, ""deletions"": 1, ""lines"": 3}, ""src/testdir/test_terminal.vim"": {""insertions"": 4, ""deletions"": 0, ""lines"": 4}, ""src/version.c"": {""insertions"": 2, ""deletions"": 0, ""lines"": 2}}"
2021-11-12 11:25:11,58ef8a31d7087d495ab1582be5b7a22796ac2451,Bram Moolenaar,20,5,25,6,"{""runtime/doc/map.txt"": {""insertions"": 3, ""deletions"": 0, ""lines"": 3}, ""src/ex_cmds.h"": {""insertions"": 1, ""deletions"": 0, ""lines"": 1}, ""src/ex_cmds2.c"": {""insertions"": 1, ""deletions"": 1, ""lines"": 2}, ""src/testdir/test_compiler.vim"": {""insertions"": 3, ""deletions"": 0, ""lines"": 3}, ""src/usercmd.c"": {""insertions"": 10, ""deletions"": 4, ""lines"": 14}, ""src/version.c"": {""insertions"": 2, ""deletions"": 0, ""lines"": 2}}"
2021-11-12 10:30:04,0c71114aede81a209b7efc126b4bf19f11d58955,Bram Moolenaar,58,3,61,5,"{""src/normal.c"": {""insertions"": 11, ""deletions"": 3, ""lines"": 14}, ""src/testdir/dumps/Test_searchstatgd_1.dump"": {""insertions"": 10, ""deletions"": 0, ""lines"": 10}, ""src/testdir/dumps/Test_searchstatgd_2.dump"": {""insertions"": 10, ""deletions"": 0, ""lines"": 10}, ""src/testdir/test_search_stat.vim"": {""insertions"": 25, ""deletions"": 0, ""lines"": 25}, ""src/version.c"": {""insertions"": 2, ""deletions"": 0, ""lines"": 2}}"
2021-11-07 20:27:04,113cb513f76d8866cbb6dc85fa18aded753e01da,Bram Moolenaar,359,416,775,48,"{"".github/CODEOWNERS"": {""insertions"": 3, ""deletions"": 0, ""lines"": 3}, ""runtime/autoload/clojurecomplete.vim"": {""insertions"": 5, ""deletions"": 5, ""lines"": 10}, ""runtime/doc/eval.txt"": {""insertions"": 45, ""deletions"": 11, ""lines"": 56}, ""runtime/doc/gui_w32.txt"": {""insertions"": 1, ""deletions"": 1, ""lines"": 2}, ""runtime/doc/indent.txt"": {""insertions"": 24, ""deletions"": 35, ""lines"": 59}, ""runtime/doc/insert.txt"": {""insertions"": 21, ""deletions"": 25, ""lines"": 46}, ""runtime/doc/options.txt"": {""insertions"": 7, ""deletions"": 4, ""lines"": 11}, ""runtime/doc/syntax.txt"": {""insertions"": 51, ""deletions"": 33, ""lines"": 84}, ""runtime/doc/tags"": {""insertions"": 14, ""deletions"": 0, ""lines"": 14}, ""runtime/doc/tips.txt"": {""insertions"": 2, ""deletions"": 1, ""lines"": 3}, ""runtime/doc/todo.txt"": {""insertions"": 11, ""deletions"": 3, ""lines"": 14}, ""runtime/doc/usr_06.txt"": {""insertions"": 2, ""deletions"": 2, ""lines"": 4}, ""runtime/ftplugin/clojure.vim"": {""insertions"": 6, ""deletions"": 6, ""lines"": 12}, ""runtime/ftplugin/mail.vim"": {""insertions"": 9, ""deletions"": 1, ""lines"": 10}, ""runtime/ftplugin/meson.vim"": {""insertions"": 21, ""deletions"": 2, ""lines"": 23}, ""runtime/ftplugin/spec.vim"": {""insertions"": 2, ""deletions"": 2, ""lines"": 4}, ""runtime/indent/clojure.vim"": {""insertions"": 8, ""deletions"": 11, ""lines"": 19}, ""runtime/indent/meson.vim"": {""insertions"": 2, ""deletions"": 0, ""lines"": 2}, ""runtime/indent/vim.vim"": {""insertions"": 2, ""deletions"": 2, ""lines"": 4}, ""runtime/optwin.vim"": {""insertions"": 2, ""deletions"": 2, ""lines"": 4}, ""runtime/pack/dist/opt/termdebug/plugin/termdebug.vim"": {""insertions"": 22, ""deletions"": 7, ""lines"": 29}, ""runtime/syntax/arduino.vim"": {""insertions"": 1, ""deletions"": 1, ""lines"": 2}, ""runtime/syntax/clojure.vim"": {""insertions"": 34, ""deletions"": 35, ""lines"": 69}, ""runtime/syntax/help_ru.vim"": {""insertions"": 2, ""deletions"": 2, ""lines"": 4}, ""runtime/syntax/meson.vim"": {""insertions"": 11, ""deletions"": 7, ""lines"": 18}, ""runtime/syntax/sh.vim"": {""insertions"": 4, ""deletions"": 4, ""lines"": 8}, ""runtime/syntax/vim.vim"": {""insertions"": 28, ""deletions"": 29, ""lines"": 57}, ""runtime/tutor/tutor.da.utf-8"": {""insertions"": 1, ""deletions"": 1, ""lines"": 2}, ""src/po/ca.po"": {""insertions"": 0, ""deletions"": 3, ""lines"": 3}, ""src/po/da.po"": {""insertions"": 0, ""deletions"": 3, ""lines"": 3}, ""src/po/de.po"": {""insertions"": 0, ""deletions"": 3, ""lines"": 3}, ""src/po/eo.po"": {""insertions"": 0, ""deletions"": 3, ""lines"": 3}, ""src/po/fi.po"": {""insertions"": 0, ""deletions"": 3, ""lines"": 3}, ""src/po/fr.po"": {""insertions"": 0, ""deletions"": 3, ""lines"": 3}, ""src/po/ga.po"": {""insertions"": 0, ""deletions"": 3, ""lines"": 3}, ""src/po/it.po"": {""insertions"": 18, ""deletions"": 127, ""lines"": 145}, ""src/po/ja.euc-jp.po"": {""insertions"": 0, ""deletions"": 3, ""lines"": 3}, ""src/po/ja.po"": {""insertions"": 0, ""deletions"": 3, ""lines"": 3}, ""src/po/ja.sjis.po"": {""insertions"": 0, ""deletions"": 3, ""lines"": 3}, ""src/po/ko.UTF-8.po"": {""insertions"": 0, ""deletions"": 3, ""lines"": 3}, ""src/po/ko.po"": {""insertions"": 0, ""deletions"": 3, ""lines"": 3}, ""src/po/pt_BR.po"": {""insertions"": 0, ""deletions"": 3, ""lines"": 3}, ""src/po/ru.cp1251.po"": {""insertions"": 0, ""deletions"": 3, ""lines"": 3}, ""src/po/ru.po"": {""insertions"": 0, ""deletions"": 3, ""lines"": 3}, ""src/po/sr.po"": {""insertions"": 0, ""deletions"": 3, ""lines"": 3}, ""src/po/tr.po"": {""insertions"": 0, ""deletions"": 3, ""lines"": 3}, ""src/po/uk.cp1251.po"": {""insertions"": 0, ""deletions"": 3, ""lines"": 3}, ""src/po/uk.po"": {""insertions"": 0, ""deletions"": 3, ""lines"": 3}}"
2021-11-04 15:46:05,15d9890eee53afc61eb0a03b878a19cb5672f732,Bram Moolenaar,11,1,12,3,"{""src/spellsuggest.c"": {""insertions"": 1, ""deletions"": 1, ""lines"": 2}, ""src/testdir/test_spell.vim"": {""insertions"": 8, ""deletions"": 0, ""lines"": 8}, ""src/version.c"": {""insertions"": 2, ""deletions"": 0, ""lines"": 2}}"
2021-11-04 15:10:11,0b5b06cb4777d1401fdf83e7d48d287662236e7e,Bram Moolenaar,12,0,12,3,"{""src/ex_docmd.c"": {""insertions"": 1, ""deletions"": 0, ""lines"": 1}, ""src/testdir/test_put.vim"": {""insertions"": 9, ""deletions"": 0, ""lines"": 9}, ""src/version.c"": {""insertions"": 2, ""deletions"": 0, ""lines"": 2}}"
2021-11-04 13:28:29,aaec1d4fb12efb82b87ad322e95994de77b1a833,Christian Brabandt,22,1,23,3,"{""src/normal.c"": {""insertions"": 8, ""deletions"": 1, ""lines"": 9}, ""src/testdir/test_normal.vim"": {""insertions"": 12, ""deletions"": 0, ""lines"": 12}, ""src/version.c"": {""insertions"": 2, ""deletions"": 0, ""lines"": 2}}"
2021-11-03 22:31:44,4b2c8047679b737dcb0cd15c313ee51553aed617,Christian Brabandt,8,1,9,2,"{""src/testdir/runtest.vim"": {""insertions"": 6, ""deletions"": 1, ""lines"": 7}, ""src/version.c"": {""insertions"": 2, ""deletions"": 0, ""lines"": 2}}"
2021-11-03 22:25:06,b32aa8a6a10983836d5987f1e42035f88d47bf6e,Bram Moolenaar,2,0,2,1,"{""src/version.c"": {""insertions"": 2, ""deletions"": 0, ""lines"": 2}}"
2021-11-03 21:56:45,d1a8d658e1b16cf8579fc72cf7aa6a29a57ff5ef,Yegappan Lakshmanan,724,0,724,9,"{""runtime/doc/eval.txt"": {""insertions"": 89, ""deletions"": 0, ""lines"": 89}, ""runtime/doc/syntax.txt"": {""insertions"": 1, ""deletions"": 0, ""lines"": 1}, ""runtime/doc/usr_41.txt"": {""insertions"": 2, ""deletions"": 0, ""lines"": 2}, ""runtime/doc/windows.txt"": {""insertions"": 1, ""deletions"": 0, ""lines"": 1}, ""src/evalfunc.c"": {""insertions"": 4, ""deletions"": 0, ""lines"": 4}, ""src/highlight.c"": {""insertions"": 454, ""deletions"": 0, ""lines"": 454}, ""src/proto/highlight.pro"": {""insertions"": 2, ""deletions"": 0, ""lines"": 2}, ""src/testdir/test_highlight.vim"": {""insertions"": 161, ""deletions"": 0, ""lines"": 161}, ""src/testdir/test_vim9_builtin.vim"": {""insertions"": 10, ""deletions"": 0, ""lines"": 10}}"
2021-11-03 13:43:16,0f0044125c2a5dcde2c4605efc39d2e237eed024,Bram Moolenaar,6,0,6,2,"{""src/testdir/test_put.vim"": {""insertions"": 4, ""deletions"": 0, ""lines"": 4}, ""src/version.c"": {""insertions"": 2, ""deletions"": 0, ""lines"": 2}}"
2021-11-03 13:15:47,a63780b9770699bf8fda93affeab2c728bc76912,Sean Dewar,3,1,4,2,"{""src/evalfunc.c"": {""insertions"": 1, ""deletions"": 1, ""lines"": 2}, ""src/version.c"": {""insertions"": 2, ""deletions"": 0, ""lines"": 2}}"
2021-11-02 23:11:00,e551ccfb9311eea5252d1c3106ff7a53c762d994,Bram Moolenaar,11,3,14,2,"{""src/register.c"": {""insertions"": 9, ""deletions"": 3, ""lines"": 12}, ""src/version.c"": {""insertions"": 2, ""deletions"": 0, ""lines"": 2}}"
2021-11-02 22:48:49,8a1962d1355096af55e84b1ea2f0baf5f1c5a5bc,Bram Moolenaar,5,2,7,2,"{""src/register.c"": {""insertions"": 3, ""deletions"": 2, ""lines"": 5}, ""src/version.c"": {""insertions"": 2, ""deletions"": 0, ""lines"": 2}}"
2021-11-02 21:39:49,69b3072d984480935ec412b32b97fea974d2b689,Bram Moolenaar,14,9,23,5,"{""src/evalvars.c"": {""insertions"": 6, ""deletions"": 0, ""lines"": 6}, ""src/register.c"": {""insertions"": 2, ""deletions"": 1, ""lines"": 3}, ""src/testdir/test_put.vim"": {""insertions"": 0, ""deletions"": 7, ""lines"": 7}, ""src/version.c"": {""insertions"": 2, ""deletions"": 0, ""lines"": 2}, ""src/vim.h"": {""insertions"": 4, ""deletions"": 1, ""lines"": 5}}"
2021-11-02 20:56:07,7a33ebfc5b04353aa7674972087d581def8fdcc1,zeertzjq,15,5,20,3,"{""src/testdir/test_listchars.vim"": {""insertions"": 11, ""deletions"": 5, ""lines"": 16}, ""src/version.c"": {""insertions"": 2, ""deletions"": 0, ""lines"": 2}, ""src/window.c"": {""insertions"": 2, ""deletions"": 0, ""lines"": 2}}"
2021-11-02 20:24:38,e2f66064d1c643f0cf12c4791de04bb123705a0c,Bram Moolenaar,3,1,4,2,"{""src/mbyte.c"": {""insertions"": 1, ""deletions"": 1, ""lines"": 2}, ""src/version.c"": {""insertions"": 2, ""deletions"": 0, ""lines"": 2}}"
2021-11-01 22:58:43,ec6e63079dde24a1d74b4103775e74d00f9215ec,Bram Moolenaar,6,0,6,2,"{""src/testdir/test_put.vim"": {""insertions"": 4, ""deletions"": 0, ""lines"": 4}, ""src/version.c"": {""insertions"": 2, ""deletions"": 0, ""lines"": 2}}"
2021-11-01 22:44:33,fd916d654d9731b3515abf7bc1ac12bd3632b601,Christian Brabandt,9,4,13,2,"{""src/os_win32.c"": {""insertions"": 7, ""deletions"": 4, ""lines"": 11}, ""src/version.c"": {""insertions"": 2, ""deletions"": 0, ""lines"": 2}}"
2021-10-31 20:19:17,8753c1dd2c2a5c2c7ff63a9bfb14cd4b9bb9c87f,Dominique Pelle,7,1,8,2,"{""src/testdir/test_edit.vim"": {""insertions"": 5, ""deletions"": 1, ""lines"": 6}, ""src/version.c"": {""insertions"": 2, ""deletions"": 0, ""lines"": 2}}"
2021-10-28 20:06:05,9cd063e3195a4c250c8016fa340922ab21fda252,Dominique Pelle,19,0,19,2,"{""src/testdir/test_edit.vim"": {""insertions"": 17, ""deletions"": 0, ""lines"": 17}, ""src/version.c"": {""insertions"": 2, ""deletions"": 0, ""lines"": 2}}"
2021-10-28 19:49:06,44db603f691b58a8531e8ff528e0a7ce644257b2,Gary Johnson,17,0,17,2,"{""src/version.c"": {""insertions"": 2, ""deletions"": 0, ""lines"": 2}, ""src/vim.h"": {""insertions"": 15, ""deletions"": 0, ""lines"": 15}}"
2021-10-26 11:00:01,2446ec9b567ce2b72bd06d121f200f40bbdc8a84,Bram Moolenaar,217,199,416,2,"{""src/Makefile"": {""insertions"": 215, ""deletions"": 199, ""lines"": 414}, ""src/version.c"": {""insertions"": 2, ""deletions"": 0, ""lines"": 2}}"
2021-10-25 16:07:04,777e7c21b7627be80961848ac560cb0a9978ff43,Bram Moolenaar,21,4,25,3,"{""src/move.c"": {""insertions"": 0, ""deletions"": 1, ""lines"": 1}, ""src/testdir/test_normal.vim"": {""insertions"": 19, ""deletions"": 3, ""lines"": 22}, ""src/version.c"": {""insertions"": 2, ""deletions"": 0, ""lines"": 2}}"
2021-10-25 09:30:14,2a52196b78f3fcc0e9fad538984272c5fd8d85db,Bram Moolenaar,4,2,6,2,"{""src/highlight.c"": {""insertions"": 2, ""deletions"": 2, ""lines"": 4}, ""src/version.c"": {""insertions"": 2, ""deletions"": 0, ""lines"": 2}}"
2021-10-24 19:35:07,e30d10253fa634c4f60daa798d029245f4eed393,Drew Vogel,1364,398,1762,26,"{""Filelist"": {""insertions"": 1, ""deletions"": 1, ""lines"": 2}, ""READMEdir/README_extra.txt"": {""insertions"": 0, ""deletions"": 1, ""lines"": 1}, ""nsis/gvim.nsi"": {""insertions"": 2, ""deletions"": 1, ""lines"": 3}, ""runtime/colors/README.txt"": {""insertions"": 2, ""deletions"": 1, ""lines"": 3}, ""runtime/colors/lists/csscolors.vim"": {""insertions"": 166, ""deletions"": 0, ""lines"": 166}, ""runtime/colors/lists/default.vim"": {""insertions"": 801, ""deletions"": 0, ""lines"": 801}, ""runtime/doc/eval.txt"": {""insertions"": 37, ""deletions"": 0, ""lines"": 37}, ""runtime/doc/gui_w32.txt"": {""insertions"": 4, ""deletions"": 14, ""lines"": 18}, ""runtime/doc/message.txt"": {""insertions"": 5, ""deletions"": 0, ""lines"": 5}, ""runtime/doc/os_haiku.txt"": {""insertions"": 2, ""deletions"": 3, ""lines"": 5}, ""runtime/doc/syntax.txt"": {""insertions"": 28, ""deletions"": 1, ""lines"": 29}, ""runtime/doc/usr_06.txt"": {""insertions"": 24, ""deletions"": 1, ""lines"": 25}, ""src/Makefile"": {""insertions"": 1, ""deletions"": 10, ""lines"": 11}, ""src/errors.h"": {""insertions"": 6, ""deletions"": 0, ""lines"": 6}, ""src/evalvars.c"": {""insertions"": 3, ""deletions"": 0, ""lines"": 3}, ""src/globals.h"": {""insertions"": 0, ""deletions"": 3, ""lines"": 3}, ""src/gui.c"": {""insertions"": 1, ""deletions"": 1, ""lines"": 2}, ""src/gui_haiku.cc"": {""insertions"": 1, ""deletions"": 158, ""lines"": 159}, ""src/highlight.c"": {""insertions"": 232, ""deletions"": 1, ""lines"": 233}, ""src/job.c"": {""insertions"": 1, ""deletions"": 1, ""lines"": 2}, ""src/proto/highlight.pro"": {""insertions"": 6, ""deletions"": 0, ""lines"": 6}, ""src/proto/term.pro"": {""insertions"": 0, ""deletions"": 2, ""lines"": 2}, ""src/term.c"": {""insertions"": 1, ""deletions"": 198, ""lines"": 199}, ""src/testdir/test_highlight.vim"": {""insertions"": 36, ""deletions"": 0, ""lines"": 36}, ""src/version.c"": {""insertions"": 2, ""deletions"": 0, ""lines"": 2}, ""src/vim.h"": {""insertions"": 2, ""deletions"": 1, ""lines"": 3}}"
2021-10-24 13:50:07,3c5904d2a5d7861c227a4c3cd4ddcbc51014c838,James McCoy,7,39,46,2,"{""src/if_cscope.c"": {""insertions"": 5, ""deletions"": 39, ""lines"": 44}, ""src/version.c"": {""insertions"": 2, ""deletions"": 0, ""lines"": 2}}"
2021-10-23 12:32:30,844fb64a605d60131827503a001b2d1aa232b078,Bram Moolenaar,63,20,83,8,"{""src/eval.c"": {""insertions"": 16, ""deletions"": 7, ""lines"": 23}, ""src/globals.h"": {""insertions"": 2, ""deletions"": 2, ""lines"": 4}, ""src/proto/eval.pro"": {""insertions"": 1, ""deletions"": 0, ""lines"": 1}, ""src/structs.h"": {""insertions"": 5, ""deletions"": 2, ""lines"": 7}, ""src/testdir/test_vim9_func.vim"": {""insertions"": 20, ""deletions"": 0, ""lines"": 20}, ""src/userfunc.c"": {""insertions"": 8, ""deletions"": 3, ""lines"": 11}, ""src/version.c"": {""insertions"": 2, ""deletions"": 0, ""lines"": 2}, ""src/vim9compile.c"": {""insertions"": 9, ""deletions"": 6, ""lines"": 15}}"
2021-10-23 11:34:27,ee56f3f119c4378a5b62b4d504cff3373b363308,Bram Moolenaar,5,2,7,2,"{""src/ex_eval.c"": {""insertions"": 3, ""deletions"": 2, ""lines"": 5}, ""src/version.c"": {""insertions"": 2, ""deletions"": 0, ""lines"": 2}}"
2021-10-23 11:08:41,079ba76ae7a7d0ef404cb9b41dff2663ff41f51b,Bram Moolenaar,520,280,800,19,"{"".github/CODEOWNERS"": {""insertions"": 1, ""deletions"": 0, ""lines"": 1}, ""runtime/doc/eval.txt"": {""insertions"": 1, ""deletions"": 1, ""lines"": 2}, ""runtime/doc/insert.txt"": {""insertions"": 2, ""deletions"": 2, ""lines"": 4}, ""runtime/doc/map.txt"": {""insertions"": 4, ""deletions"": 1, ""lines"": 5}, ""runtime/doc/options.txt"": {""insertions"": 3, ""deletions"": 2, ""lines"": 5}, ""runtime/doc/quickref.txt"": {""insertions"": 2, ""deletions"": 1, ""lines"": 3}, ""runtime/doc/tags"": {""insertions"": 8, ""deletions"": 0, ""lines"": 8}, ""runtime/doc/todo.txt"": {""insertions"": 1, ""deletions"": 3, ""lines"": 4}, ""runtime/ftplugin/changelog.vim"": {""insertions"": 16, ""deletions"": 10, ""lines"": 26}, ""runtime/ftplugin/nsis.vim"": {""insertions"": 2, ""deletions"": 2, ""lines"": 4}, ""runtime/indent/dosbatch.vim"": {""insertions"": 3, ""deletions"": 1, ""lines"": 4}, ""runtime/indent/nsis.vim"": {""insertions"": 3, ""deletions"": 1, ""lines"": 4}, ""runtime/indent/teraterm.vim"": {""insertions"": 3, ""deletions"": 1, ""lines"": 4}, ""runtime/optwin.vim"": {""insertions"": 6, ""deletions"": 1, ""lines"": 7}, ""runtime/syntax/arduino.vim"": {""insertions"": 64, ""deletions"": 35, ""lines"": 99}, ""runtime/syntax/debchangelog.vim"": {""insertions"": 3, ""deletions"": 2, ""lines"": 5}, ""runtime/syntax/debsources.vim"": {""insertions"": 3, ""deletions"": 2, ""lines"": 5}, ""runtime/syntax/nsis.vim"": {""insertions"": 35, ""deletions"": 7, ""lines"": 42}, ""src/po/it.po"": {""insertions"": 360, ""deletions"": 208, ""lines"": 568}}"
2021-10-23 09:25:21,06ca48a40f049f20347c9630a180457d1f1aece5,Bram Moolenaar,3,1,4,2,"{""src/testdir/test_vim9_script.vim"": {""insertions"": 1, ""deletions"": 1, ""lines"": 2}, ""src/version.c"": {""insertions"": 2, ""deletions"": 0, ""lines"": 2}}"
2021-10-22 21:17:53,5fe07d2e08f05c6f3905fecdf07f4cfad4d6ed17,Bram Moolenaar,77,7,84,3,"{""src/testdir/test_vim9_script.vim"": {""insertions"": 27, ""deletions"": 0, ""lines"": 27}, ""src/userfunc.c"": {""insertions"": 48, ""deletions"": 7, ""lines"": 55}, ""src/version.c"": {""insertions"": 2, ""deletions"": 0, ""lines"": 2}}"
2021-10-22 19:56:55,841c225b9ef8c5bdf5e02968a0bd62521fff6ca8,Bram Moolenaar,41,6,47,4,"{""src/diff.c"": {""insertions"": 16, ""deletions"": 6, ""lines"": 22}, ""src/testdir/dumps/Test_diff_scroll_change_03.dump"": {""insertions"": 20, ""deletions"": 0, ""lines"": 20}, ""src/testdir/test_diffmode.vim"": {""insertions"": 3, ""deletions"": 0, ""lines"": 3}, ""src/version.c"": {""insertions"": 2, ""deletions"": 0, ""lines"": 2}}"
2021-10-22 17:56:39,25def2c8b8bd7b0c3d5f020207c717a880b05d50,=?UTF-8?q?Magnus=20Gro=C3=9F?=,82,22,104,8,"{""runtime/doc/autocmd.txt"": {""insertions"": 9, ""deletions"": 4, ""lines"": 13}, ""src/autocmd.c"": {""insertions"": 17, ""deletions"": 0, ""lines"": 17}, ""src/insexpand.c"": {""insertions"": 7, ""deletions"": 0, ""lines"": 7}, ""src/misc1.c"": {""insertions"": 8, ""deletions"": 3, ""lines"": 11}, ""src/normal.c"": {""insertions"": 6, ""deletions"": 1, ""lines"": 7}, ""src/terminal.c"": {""insertions"": 1, ""deletions"": 0, ""lines"": 1}, ""src/testdir/test_edit.vim"": {""insertions"": 32, ""deletions"": 14, ""lines"": 46}, ""src/version.c"": {""insertions"": 2, ""deletions"": 0, ""lines"": 2}}"
2021-10-22 14:55:31,a2ffb435209716dc7aeb4783333f6ea19f5d28a7,DungSaga,48,62,110,2,"{""src/version.c"": {""insertions"": 2, ""deletions"": 0, ""lines"": 2}, ""src/xxd/xxd.c"": {""insertions"": 46, ""deletions"": 62, ""lines"": 108}}"
2021-10-22 14:11:37,5a5c111e79d1ea4b24133eaf44deab42a8e78eed,Bram Moolenaar,16,7,23,2,"{""src/testdir/test_xxd.vim"": {""insertions"": 14, ""deletions"": 7, ""lines"": 21}, ""src/version.c"": {""insertions"": 2, ""deletions"": 0, ""lines"": 2}}"
2021-10-22 11:55:42,47810464aa4f9edbf222c02a860a3ec560b0b7a1,DungSaga,45,7,52,3,"{""src/testdir/test_xxd.vim"": {""insertions"": 33, ""deletions"": 0, ""lines"": 33}, ""src/version.c"": {""insertions"": 2, ""deletions"": 0, ""lines"": 2}, ""src/xxd/xxd.c"": {""insertions"": 10, ""deletions"": 7, ""lines"": 17}}"
2021-10-21 17:01:13,94e7d345c156a722bb161b73238c4ba1d27ec586,itchyny,3,1,4,2,"{""src/misc1.c"": {""insertions"": 1, ""deletions"": 1, ""lines"": 2}, ""src/version.c"": {""insertions"": 2, ""deletions"": 0, ""lines"": 2}}"
2021-10-21 10:39:53,ae38a9db7770b38889fbf06908cc69d42b463a73,Shougo Matsushita,19,1,20,3,"{""src/cmdexpand.c"": {""insertions"": 2, ""deletions"": 1, ""lines"": 3}, ""src/testdir/test_cmdline.vim"": {""insertions"": 15, ""deletions"": 0, ""lines"": 15}, ""src/version.c"": {""insertions"": 2, ""deletions"": 0, ""lines"": 2}}"
2021-10-21 09:50:44,b811de5d49a23b20df82a80533d0602cda49029e,zeertzjq,20,18,38,2,"{""src/testdir/test_autocmd.vim"": {""insertions"": 18, ""deletions"": 18, ""lines"": 36}, ""src/version.c"": {""insertions"": 2, ""deletions"": 0, ""lines"": 2}}"
2021-10-20 22:08:11,d68a0044858d00de6100def1e389a3a9c1cdbcdc,Bram Moolenaar,32,4,36,3,"{""src/gui_gtk_x11.c"": {""insertions"": 8, ""deletions"": 4, ""lines"": 12}, ""src/testdir/test_gui.vim"": {""insertions"": 22, ""deletions"": 0, ""lines"": 22}, ""src/version.c"": {""insertions"": 2, ""deletions"": 0, ""lines"": 2}}"
2021-10-20 20:58:42,1d30fde3c989a962e0e1af4cbcf90e1ea483f1f4,Bram Moolenaar,36,9,45,6,"{""src/buffer.c"": {""insertions"": 4, ""deletions"": 3, ""lines"": 7}, ""src/ex_cmds.c"": {""insertions"": 8, ""deletions"": 4, ""lines"": 12}, ""src/quickfix.c"": {""insertions"": 3, ""deletions"": 2, ""lines"": 5}, ""src/testdir/test_quickfix.vim"": {""insertions"": 17, ""deletions"": 0, ""lines"": 17}, ""src/version.c"": {""insertions"": 2, ""deletions"": 0, ""lines"": 2}, ""src/vim.h"": {""insertions"": 2, ""deletions"": 0, ""lines"": 2}}"
2021-10-20 16:21:24,09f7723d5a8694889350b13e3f6b4a9c3ed4c41f,zeertzjq,4,0,4,2,"{""src/errors.h"": {""insertions"": 2, ""deletions"": 0, ""lines"": 2}, ""src/version.c"": {""insertions"": 2, ""deletions"": 0, ""lines"": 2}}"
2021-10-20 10:01:15,94358a1e6e640ca5ebeb295efdddd4e92b700673,zeertzjq,56,3,59,6,"{""runtime/doc/eval.txt"": {""insertions"": 3, ""deletions"": 0, ""lines"": 3}, ""src/errors.h"": {""insertions"": 4, ""deletions"": 0, ""lines"": 4}, ""src/mbyte.c"": {""insertions"": 35, ""deletions"": 1, ""lines"": 36}, ""src/optionstr.c"": {""insertions"": 2, ""deletions"": 2, ""lines"": 4}, ""src/testdir/test_utf8.vim"": {""insertions"": 10, ""deletions"": 0, ""lines"": 10}, ""src/version.c"": {""insertions"": 2, ""deletions"": 0, ""lines"": 2}}"
2021-10-20 09:00:05,051a40c8d91d4595c69a27375f739367d806a475,itchyny,6,1,7,2,"{""src/os_unix.c"": {""insertions"": 4, ""deletions"": 1, ""lines"": 5}, ""src/version.c"": {""insertions"": 2, ""deletions"": 0, ""lines"": 2}}"
2021-10-19 21:12:25,8b0e62c93b6dad5ec5b2c7558d4f7b78c46216d2,Bram Moolenaar,8,2,10,3,"{""src/memline.c"": {""insertions"": 5, ""deletions"": 1, ""lines"": 6}, ""src/testdir/test_swap.vim"": {""insertions"": 1, ""deletions"": 1, ""lines"": 2}, ""src/version.c"": {""insertions"": 2, ""deletions"": 0, ""lines"": 2}}"
2021-10-19 19:48:52,c5935a859ee31d56a565878d7a231fc59b7ddc01,Bram Moolenaar,63,102,165,2,"{""src/buffer.c"": {""insertions"": 61, ""deletions"": 102, ""lines"": 163}, ""src/version.c"": {""insertions"": 2, ""deletions"": 0, ""lines"": 2}}"
2021-10-19 19:24:34,731fba1081079d5c0251fca2626043ce6e86b1f2,Bram Moolenaar,6,0,6,2,"{""src/highlight.c"": {""insertions"": 4, ""deletions"": 0, ""lines"": 4}, ""src/version.c"": {""insertions"": 2, ""deletions"": 0, ""lines"": 2}}"
2021-10-19 19:08:45,f47ebf1e1a0a6473b10fb4c92c9c6427aab4dc91,Bram Moolenaar,15,1,16,3,"{""src/register.c"": {""insertions"": 1, ""deletions"": 1, ""lines"": 2}, ""src/testdir/test_put.vim"": {""insertions"": 12, ""deletions"": 0, ""lines"": 12}, ""src/version.c"": {""insertions"": 2, ""deletions"": 0, ""lines"": 2}}"
2021-10-19 13:22:03,604e207e277767a67cbf4a6a179080efb830b9e7,Bram Moolenaar,7,0,7,2,"{""src/gui_gtk.c"": {""insertions"": 5, ""deletions"": 0, ""lines"": 5}, ""src/version.c"": {""insertions"": 2, ""deletions"": 0, ""lines"": 2}}"
2021-10-19 12:44:52,d43d8e28db9afe693002a39e003ba1ece1a8319a,Yegappan Lakshmanan,8,4,12,2,"{""src/highlight.c"": {""insertions"": 6, ""deletions"": 4, ""lines"": 10}, ""src/version.c"": {""insertions"": 2, ""deletions"": 0, ""lines"": 2}}"
2021-10-19 10:15:41,75c30e96cf280a8cc01ac01c41a9252db3e503cc,naohiro ono,23,0,23,3,"{""src/ops.c"": {""insertions"": 5, ""deletions"": 0, ""lines"": 5}, ""src/testdir/test_functions.vim"": {""insertions"": 16, ""deletions"": 0, ""lines"": 16}, ""src/version.c"": {""insertions"": 2, ""deletions"": 0, ""lines"": 2}}"
2021-10-18 21:13:57,ad6b90c33cc239794a6694ef53e8baeee2ed97bd,Yegappan Lakshmanan,932,787,1719,2,"{""src/highlight.c"": {""insertions"": 930, ""deletions"": 787, ""lines"": 1717}, ""src/version.c"": {""insertions"": 2, ""deletions"": 0, ""lines"": 2}}"
2021-10-18 19:56:39,9b0b844d252ea84b3607f39603b4afa8cb002418,Dominique Pelle,7,3,10,2,"{""src/drawscreen.c"": {""insertions"": 5, ""deletions"": 3, ""lines"": 8}, ""src/version.c"": {""insertions"": 2, ""deletions"": 0, ""lines"": 2}}"
2021-10-18 13:37:13,944eeb44fb6e9d6d28474a1348d27c07873892f9,Bram Moolenaar,4,1,5,2,"{""src/testdir/test_stat.vim"": {""insertions"": 2, ""deletions"": 1, ""lines"": 3}, ""src/version.c"": {""insertions"": 2, ""deletions"": 0, ""lines"": 2}}"
2021-10-18 12:16:03,375c35a63fdb91e8db2a9965f94d56ae87135fff,DungSaga,8,11,19,2,"{""src/version.c"": {""insertions"": 2, ""deletions"": 0, ""lines"": 2}, ""src/xxd/xxd.c"": {""insertions"": 6, ""deletions"": 11, ""lines"": 17}}"
2021-10-17 20:53:58,e08aee60abc59f517d3e263fdb9ba4a0196d507c,Bram Moolenaar,13,3,16,3,"{""src/mark.c"": {""insertions"": 1, ""deletions"": 3, ""lines"": 4}, ""src/testdir/test_marks.vim"": {""insertions"": 10, ""deletions"": 0, ""lines"": 10}, ""src/version.c"": {""insertions"": 2, ""deletions"": 0, ""lines"": 2}}"
2021-10-17 17:05:26,39c47c310487b72bc78ff197b5a068a0bcf830de,Bram Moolenaar,9,4,13,2,"{""src/testdir/test_cmdline.vim"": {""insertions"": 7, ""deletions"": 4, ""lines"": 11}, ""src/version.c"": {""insertions"": 2, ""deletions"": 0, ""lines"": 2}}"
2021-10-17 16:20:23,21c1a0c2f10575dbb72fa873d33f0c1f6e170aa7,Bram Moolenaar,38,15,53,11,"{""src/cmdexpand.c"": {""insertions"": 5, ""deletions"": 2, ""lines"": 7}, ""src/evalfunc.c"": {""insertions"": 1, ""deletions"": 1, ""lines"": 2}, ""src/ex_getln.c"": {""insertions"": 12, ""deletions"": 7, ""lines"": 19}, ""src/normal.c"": {""insertions"": 1, ""deletions"": 1, ""lines"": 2}, ""src/proto/ex_getln.pro"": {""insertions"": 1, ""deletions"": 1, ""lines"": 2}, ""src/session.c"": {""insertions"": 1, ""deletions"": 1, ""lines"": 2}, ""src/terminal.c"": {""insertions"": 1, ""deletions"": 1, ""lines"": 2}, ""src/testdir/test_cmdline.vim"": {""insertions"": 6, ""deletions"": 0, ""lines"": 6}, ""src/version.c"": {""insertions"": 2, ""deletions"": 0, ""lines"": 2}, ""src/vim.h"": {""insertions"": 6, ""deletions"": 0, ""lines"": 6}, ""src/vim9execute.c"": {""insertions"": 2, ""deletions"": 1, ""lines"": 3}}"
2021-10-17 15:09:08,34a364877f0c726cdc0779e6999fded9ba959ebe,Atsushi SUGAWARA,3,1,4,2,"{""src/version.c"": {""insertions"": 2, ""deletions"": 0, ""lines"": 2}, ""src/xxd/xxd.c"": {""insertions"": 1, ""deletions"": 1, ""lines"": 2}}"
2021-10-17 13:13:09,f4d8b76d304dabc39c06d2344cd4c7b28484811b,Bram Moolenaar,109,51,160,9,"{""runtime/doc/insert.txt"": {""insertions"": 58, ""deletions"": 16, ""lines"": 74}, ""runtime/doc/options.txt"": {""insertions"": 12, ""deletions"": 19, ""lines"": 31}, ""src/insexpand.c"": {""insertions"": 4, ""deletions"": 5, ""lines"": 9}, ""src/option.c"": {""insertions"": 15, ""deletions"": 3, ""lines"": 18}, ""src/option.h"": {""insertions"": 2, ""deletions"": 2, ""lines"": 4}, ""src/optiondefs.h"": {""insertions"": 2, ""deletions"": 2, ""lines"": 4}, ""src/structs.h"": {""insertions"": 3, ""deletions"": 1, ""lines"": 4}, ""src/testdir/test_edit.vim"": {""insertions"": 11, ""deletions"": 3, ""lines"": 14}, ""src/version.c"": {""insertions"": 2, ""deletions"": 0, ""lines"": 2}}"
2021-10-17 10:33:47,9d4b8caf9eddb2db09395587c621309f4513befa,Bram Moolenaar,4,1,5,2,"{""src/gui_gtk_x11.c"": {""insertions"": 2, ""deletions"": 1, ""lines"": 3}, ""src/version.c"": {""insertions"": 2, ""deletions"": 0, ""lines"": 2}}"
2021-10-16 20:58:27,40bd5a15405206b130d487af0ca61b5d9b5859f8,Bram Moolenaar,99,150,249,5,"{""src/testdir/check.vim"": {""insertions"": 8, ""deletions"": 0, ""lines"": 8}, ""src/testdir/setup_gui.vim"": {""insertions"": 0, ""deletions"": 1, ""lines"": 1}, ""src/testdir/test_gui.vim"": {""insertions"": 79, ""deletions"": 123, ""lines"": 202}, ""src/testdir/test_gui_init.vim"": {""insertions"": 10, ""deletions"": 26, ""lines"": 36}, ""src/version.c"": {""insertions"": 2, ""deletions"": 0, ""lines"": 2}}"
2021-10-16 20:14:11,d4c4bfa0078a959ff90ef30288fd31d9d38f23d7,Bram Moolenaar,11,9,20,6,"{""src/buffer.c"": {""insertions"": 1, ""deletions"": 1, ""lines"": 2}, ""src/insexpand.c"": {""insertions"": 4, ""deletions"": 4, ""lines"": 8}, ""src/option.c"": {""insertions"": 2, ""deletions"": 2, ""lines"": 4}, ""src/optionstr.c"": {""insertions"": 1, ""deletions"": 1, ""lines"": 2}, ""src/structs.h"": {""insertions"": 1, ""deletions"": 1, ""lines"": 2}, ""src/version.c"": {""insertions"": 2, ""deletions"": 0, ""lines"": 2}}"
2021-10-16 19:52:05,4eeedc09fed0cbbb3ba48317e0a01e20cd0b4f80,Dusan Popovic,239,14,253,12,"{""runtime/doc/options.txt"": {""insertions"": 12, ""deletions"": 0, ""lines"": 12}, ""src/errors.h"": {""insertions"": 2, ""deletions"": 0, ""lines"": 2}, ""src/gui.c"": {""insertions"": 34, ""deletions"": 0, ""lines"": 34}, ""src/gui.h"": {""insertions"": 3, ""deletions"": 0, ""lines"": 3}, ""src/gui_gtk_x11.c"": {""insertions"": 136, ""deletions"": 14, ""lines"": 150}, ""src/option.h"": {""insertions"": 3, ""deletions"": 0, ""lines"": 3}, ""src/optiondefs.h"": {""insertions"": 13, ""deletions"": 0, ""lines"": 13}, ""src/optionstr.c"": {""insertions"": 7, ""deletions"": 0, ""lines"": 7}, ""src/proto/gui.pro"": {""insertions"": 1, ""deletions"": 0, ""lines"": 1}, ""src/proto/gui_gtk_x11.pro"": {""insertions"": 1, ""deletions"": 0, ""lines"": 1}, ""src/testdir/test_gui.vim"": {""insertions"": 25, ""deletions"": 0, ""lines"": 25}, ""src/version.c"": {""insertions"": 2, ""deletions"": 0, ""lines"": 2}}"
2021-10-16 18:07:46,c89c91cafd91fbf17f431d800bbf4cafcffffe7a,DungSaga,6,8,14,2,"{""src/version.c"": {""insertions"": 2, ""deletions"": 0, ""lines"": 2}, ""src/xxd/xxd.c"": {""insertions"": 4, ""deletions"": 8, ""lines"": 12}}"
2021-10-16 16:51:40,93ff6720fe4427341bc426b6d46e6324f226c270,Bram Moolenaar,47,8,55,5,"{""runtime/doc/options.txt"": {""insertions"": 7, ""deletions"": 0, ""lines"": 7}, ""src/charset.c"": {""insertions"": 0, ""deletions"": 3, ""lines"": 3}, ""src/screen.c"": {""insertions"": 34, ""deletions"": 5, ""lines"": 39}, ""src/testdir/test_listchars.vim"": {""insertions"": 4, ""deletions"": 0, ""lines"": 4}, ""src/version.c"": {""insertions"": 2, ""deletions"": 0, ""lines"": 2}}"
2021-10-16 15:48:27,abdcfd1c837e244065d4fe04c7a78abae5af3f7e,Bram Moolenaar,3,1,4,2,"{""src/testdir/test_options.vim"": {""insertions"": 1, ""deletions"": 1, ""lines"": 2}, ""src/version.c"": {""insertions"": 2, ""deletions"": 0, ""lines"": 2}}"
2021-10-16 14:41:29,160e994d768d03a3c826b58115cde94df8fce607,Yegappan Lakshmanan,138,8,146,12,"{""runtime/doc/insert.txt"": {""insertions"": 7, ""deletions"": 1, ""lines"": 8}, ""runtime/doc/options.txt"": {""insertions"": 12, ""deletions"": 0, ""lines"": 12}, ""runtime/doc/quickref.txt"": {""insertions"": 1, ""deletions"": 0, ""lines"": 1}, ""src/buffer.c"": {""insertions"": 1, ""deletions"": 0, ""lines"": 1}, ""src/insexpand.c"": {""insertions"": 52, ""deletions"": 7, ""lines"": 59}, ""src/option.c"": {""insertions"": 3, ""deletions"": 0, ""lines"": 3}, ""src/option.h"": {""insertions"": 4, ""deletions"": 0, ""lines"": 4}, ""src/optiondefs.h"": {""insertions"": 12, ""deletions"": 0, ""lines"": 12}, ""src/optionstr.c"": {""insertions"": 1, ""deletions"": 0, ""lines"": 1}, ""src/structs.h"": {""insertions"": 1, ""deletions"": 0, ""lines"": 1}, ""src/testdir/test_edit.vim"": {""insertions"": 42, ""deletions"": 0, ""lines"": 42}, ""src/version.c"": {""insertions"": 2, ""deletions"": 0, ""lines"": 2}}"
2021-10-16 14:23:36,2286304cdbba53ceb52b3ba2ba4a521b0a2f8d0f,Bram Moolenaar,413,240,653,26,"{"".github/CODEOWNERS"": {""insertions"": 6, ""deletions"": 0, ""lines"": 6}, ""runtime/doc/autocmd.txt"": {""insertions"": 5, ""deletions"": 5, ""lines"": 10}, ""runtime/doc/change.txt"": {""insertions"": 3, ""deletions"": 3, ""lines"": 6}, ""runtime/doc/cmdline.txt"": {""insertions"": 1, ""deletions"": 1, ""lines"": 2}, ""runtime/doc/digraph.txt"": {""insertions"": 2, ""deletions"": 2, ""lines"": 4}, ""runtime/doc/editing.txt"": {""insertions"": 14, ""deletions"": 9, ""lines"": 23}, ""runtime/doc/eval.txt"": {""insertions"": 2, ""deletions"": 2, ""lines"": 4}, ""runtime/doc/help.txt"": {""insertions"": 1, ""deletions"": 0, ""lines"": 1}, ""runtime/doc/options.txt"": {""insertions"": 3, ""deletions"": 3, ""lines"": 6}, ""runtime/doc/pattern.txt"": {""insertions"": 8, ""deletions"": 9, ""lines"": 17}, ""runtime/doc/testing.txt"": {""insertions"": 4, ""deletions"": 4, ""lines"": 8}, ""runtime/doc/todo.txt"": {""insertions"": 26, ""deletions"": 22, ""lines"": 48}, ""runtime/doc/various.txt"": {""insertions"": 1, ""deletions"": 1, ""lines"": 2}, ""runtime/doc/vim9.txt"": {""insertions"": 10, ""deletions"": 10, ""lines"": 20}, ""runtime/ftplugin/context.vim"": {""insertions"": 41, ""deletions"": 26, ""lines"": 67}, ""runtime/ftplugin/csh.vim"": {""insertions"": 26, ""deletions"": 23, ""lines"": 49}, ""runtime/ftplugin/tcsh.vim"": {""insertions"": 8, ""deletions"": 13, ""lines"": 21}, ""runtime/ftplugin/tmux.vim"": {""insertions"": 3, ""deletions"": 0, ""lines"": 3}, ""runtime/ftplugin/toml.vim"": {""insertions"": 23, ""deletions"": 0, ""lines"": 23}, ""runtime/indent/hamster.vim"": {""insertions"": 18, ""deletions"": 3, ""lines"": 21}, ""runtime/indent/sqlanywhere.vim"": {""insertions"": 11, ""deletions"": 11, ""lines"": 22}, ""runtime/indent/tcsh.vim"": {""insertions"": 8, ""deletions"": 5, ""lines"": 13}, ""runtime/syntax/css.vim"": {""insertions"": 17, ""deletions"": 10, ""lines"": 27}, ""runtime/syntax/tcsh.vim"": {""insertions"": 36, ""deletions"": 30, ""lines"": 66}, ""runtime/syntax/tmux.vim"": {""insertions"": 55, ""deletions"": 48, ""lines"": 103}, ""runtime/syntax/toml.vim"": {""insertions"": 81, ""deletions"": 0, ""lines"": 81}}"
2021-10-16 12:44:04,28b6a3bef6d25d36c049bb731ced496155f7f9c0,Aman Verma,7,3,10,3,"{""runtime/filetype.vim"": {""insertions"": 3, ""deletions"": 1, ""lines"": 4}, ""src/testdir/test_filetype.vim"": {""insertions"": 2, ""deletions"": 2, ""lines"": 4}, ""src/version.c"": {""insertions"": 2, ""deletions"": 0, ""lines"": 2}}"
2021-10-16 12:00:14,f08b0eb8691ff09f98bc4beef986ece1c521655f,Bram Moolenaar,38,39,77,16,"{""src/testdir/runtest.vim"": {""insertions"": 1, ""deletions"": 38, ""lines"": 39}, ""src/testdir/test_autocmd.vim"": {""insertions"": 3, ""deletions"": 0, ""lines"": 3}, ""src/testdir/test_channel.vim"": {""insertions"": 7, ""deletions"": 0, ""lines"": 7}, ""src/testdir/test_clientserver.vim"": {""insertions"": 1, ""deletions"": 0, ""lines"": 1}, ""src/testdir/test_diffmode.vim"": {""insertions"": 1, ""deletions"": 0, ""lines"": 1}, ""src/testdir/test_functions.vim"": {""insertions"": 1, ""deletions"": 0, ""lines"": 1}, ""src/testdir/test_gui.vim"": {""insertions"": 1, ""deletions"": 0, ""lines"": 1}, ""src/testdir/test_mapping.vim"": {""insertions"": 2, ""deletions"": 1, ""lines"": 3}, ""src/testdir/test_paste.vim"": {""insertions"": 2, ""deletions"": 0, ""lines"": 2}, ""src/testdir/test_popup.vim"": {""insertions"": 1, ""deletions"": 0, ""lines"": 1}, ""src/testdir/test_quotestar.vim"": {""insertions"": 1, ""deletions"": 0, ""lines"": 1}, ""src/testdir/test_reltime.vim"": {""insertions"": 1, ""deletions"": 0, ""lines"": 1}, ""src/testdir/test_terminal.vim"": {""insertions"": 4, ""deletions"": 0, ""lines"": 4}, ""src/testdir/test_terminal2.vim"": {""insertions"": 2, ""deletions"": 0, ""lines"": 2}, ""src/testdir/test_timers.vim"": {""insertions"": 8, ""deletions"": 0, ""lines"": 8}, ""src/version.c"": {""insertions"": 2, ""deletions"": 0, ""lines"": 2}}"
2021-10-16 10:58:55,db3b44640d69ab27270691a3cab8d83cc93a0861,Christian Brabandt,52,11,63,6,"{""src/buffer.c"": {""insertions"": 1, ""deletions"": 0, ""lines"": 1}, ""src/bufwrite.c"": {""insertions"": 2, ""deletions"": 2, ""lines"": 4}, ""src/edit.c"": {""insertions"": 6, ""deletions"": 6, ""lines"": 12}, ""src/structs.h"": {""insertions"": 3, ""deletions"": 3, ""lines"": 6}, ""src/testdir/test_autocmd.vim"": {""insertions"": 38, ""deletions"": 0, ""lines"": 38}, ""src/version.c"": {""insertions"": 2, ""deletions"": 0, ""lines"": 2}}"
2021-10-15 21:25:43,7b5f45be2197403d631b5a3d633f6a20afdf806e,Milly,44,100,144,5,"{""runtime/doc/terminal.txt"": {""insertions"": 0, ""deletions"": 3, ""lines"": 3}, ""src/highlight.c"": {""insertions"": 0, ""deletions"": 12, ""lines"": 12}, ""src/proto/terminal.pro"": {""insertions"": 0, ""deletions"": 1, ""lines"": 1}, ""src/terminal.c"": {""insertions"": 42, ""deletions"": 84, ""lines"": 126}, ""src/version.c"": {""insertions"": 2, ""deletions"": 0, ""lines"": 2}}"
2021-10-15 16:23:12,def69dffb3d09a69629b071c89b7893a1783ba53,ichizok,12,9,21,2,"{""src/fileio.c"": {""insertions"": 10, ""deletions"": 9, ""lines"": 19}, ""src/version.c"": {""insertions"": 2, ""deletions"": 0, ""lines"": 2}}"
2021-10-15 16:09:50,eaa006dae3d5730e3b6dead27905444998b2cf8e,Bram Moolenaar,7,3,10,2,"{""src/testdir/test_stat.vim"": {""insertions"": 5, ""deletions"": 3, ""lines"": 8}, ""src/version.c"": {""insertions"": 2, ""deletions"": 0, ""lines"": 2}}"
2021-10-15 11:51:29,a2cff1dbc9c58758977eba3034603e6fe459031b,Bram Moolenaar,15,32,47,2,"{""src/search.c"": {""insertions"": 13, ""deletions"": 32, ""lines"": 45}, ""src/version.c"": {""insertions"": 2, ""deletions"": 0, ""lines"": 2}}"
2021-10-14 23:38:02,accf4ed352c07ffe59022377c42d36e12dd6d461,Bram Moolenaar,3,0,3,2,"{""src/testdir/test_stat.vim"": {""insertions"": 1, ""deletions"": 0, ""lines"": 1}, ""src/version.c"": {""insertions"": 2, ""deletions"": 0, ""lines"": 2}}"
2021-10-14 23:18:37,a06758dd38851f022d270dd5102efbe1049d4712,Bram Moolenaar,8,4,12,3,"{""src/evalvars.c"": {""insertions"": 3, ""deletions"": 2, ""lines"": 5}, ""src/version.c"": {""insertions"": 2, ""deletions"": 0, ""lines"": 2}, ""src/vim9script.c"": {""insertions"": 3, ""deletions"": 2, ""lines"": 5}}"
2021-10-14 20:27:55,0a7984af5601323fae7b3398f05a48087db7b767,Leah Neukirchen,151,6,157,13,"{""runtime/doc/eval.txt"": {""insertions"": 1, ""deletions"": 0, ""lines"": 1}, ""src/auto/configure"": {""insertions"": 46, ""deletions"": 0, ""lines"": 46}, ""src/bufwrite.c"": {""insertions"": 2, ""deletions"": 1, ""lines"": 3}, ""src/config.h.in"": {""insertions"": 3, ""deletions"": 0, ""lines"": 3}, ""src/configure.ac"": {""insertions"": 25, ""deletions"": 0, ""lines"": 25}, ""src/evalfunc.c"": {""insertions"": 7, ""deletions"": 0, ""lines"": 7}, ""src/fileio.c"": {""insertions"": 20, ""deletions"": 4, ""lines"": 24}, ""src/memline.c"": {""insertions"": 6, ""deletions"": 0, ""lines"": 6}, ""src/netbeans.c"": {""insertions"": 3, ""deletions"": 0, ""lines"": 3}, ""src/proto/fileio.pro"": {""insertions"": 1, ""deletions"": 1, ""lines"": 2}, ""src/structs.h"": {""insertions"": 2, ""deletions"": 0, ""lines"": 2}, ""src/testdir/test_stat.vim"": {""insertions"": 33, ""deletions"": 0, ""lines"": 33}, ""src/version.c"": {""insertions"": 2, ""deletions"": 0, ""lines"": 2}}"
2021-10-14 16:52:23,340dd0fbe462a15a9678cfba02085b4adcc45f02,Bram Moolenaar,9,2,11,3,"{""runtime/doc/options.txt"": {""insertions"": 2, ""deletions"": 2, ""lines"": 4}, ""src/undo.c"": {""insertions"": 5, ""deletions"": 0, ""lines"": 5}, ""src/version.c"": {""insertions"": 2, ""deletions"": 0, ""lines"": 2}}"
2021-10-14 15:53:42,051a8a375f8fb6a931fbc5ccca714a200d9b327f,Bram Moolenaar,10,0,10,2,"{""src/testdir/test_vim9_cmd.vim"": {""insertions"": 8, ""deletions"": 0, ""lines"": 8}, ""src/version.c"": {""insertions"": 2, ""deletions"": 0, ""lines"": 2}}"
2021-10-14 15:27:19,75aa92a16264e3511ba41aa306ffc1ffbbd2fe3a,Bram Moolenaar,10,8,18,2,"{""src/Makefile"": {""insertions"": 8, ""deletions"": 8, ""lines"": 16}, ""src/version.c"": {""insertions"": 2, ""deletions"": 0, ""lines"": 2}}"
2021-10-13 20:17:05,c0abac67d7a9cccf836bbda002ec72914e3cb3d7,Bram Moolenaar,26,0,26,2,"{""src/testdir/test_vim9_cmd.vim"": {""insertions"": 24, ""deletions"": 0, ""lines"": 24}, ""src/version.c"": {""insertions"": 2, ""deletions"": 0, ""lines"": 2}}"
2021-10-13 14:37:15,3be69bf539f3026369d20f1667e53d390d386a9f,Bram Moolenaar,6,0,6,2,"{""src/ex_cmds.c"": {""insertions"": 4, ""deletions"": 0, ""lines"": 4}, ""src/version.c"": {""insertions"": 2, ""deletions"": 0, ""lines"": 2}}"
2021-10-13 14:28:28,7f32092b9127a71d243bacd31ebb303f2c78a8f1,Bram Moolenaar,3,1,4,2,"{""src/version.c"": {""insertions"": 2, ""deletions"": 0, ""lines"": 2}, ""src/vim9compile.c"": {""insertions"": 1, ""deletions"": 1, ""lines"": 2}}"
2021-10-13 14:04:34,7b829268921e8fc1c63c34d245063c1c4e7d21af,Bram Moolenaar,111,1,112,8,"{""runtime/doc/vim9.txt"": {""insertions"": 14, ""deletions"": 1, ""lines"": 15}, ""src/errors.h"": {""insertions"": 4, ""deletions"": 0, ""lines"": 4}, ""src/ex_cmds.c"": {""insertions"": 6, ""deletions"": 0, ""lines"": 6}, ""src/ex_docmd.c"": {""insertions"": 9, ""deletions"": 0, ""lines"": 9}, ""src/proto/vim9compile.pro"": {""insertions"": 1, ""deletions"": 0, ""lines"": 1}, ""src/testdir/test_vim9_cmd.vim"": {""insertions"": 49, ""deletions"": 0, ""lines"": 49}, ""src/version.c"": {""insertions"": 2, ""deletions"": 0, ""lines"": 2}, ""src/vim9compile.c"": {""insertions"": 26, ""deletions"": 0, ""lines"": 26}}"
2021-10-13 09:05:30,fff10d9a76099aa9b944f3c33a911127ca1a0c72,Bram Moolenaar,7,0,7,2,"{""src/os_unix.c"": {""insertions"": 5, ""deletions"": 0, ""lines"": 5}, ""src/version.c"": {""insertions"": 2, ""deletions"": 0, ""lines"": 2}}"
2021-10-12 12:58:23,e519eb41c1c12836b2d12aeb703bb04c7618a724,Eric Pruitt,6,1,7,3,"{""runtime/filetype.vim"": {""insertions"": 3, ""deletions"": 0, ""lines"": 3}, ""src/testdir/test_filetype.vim"": {""insertions"": 1, ""deletions"": 1, ""lines"": 2}, ""src/version.c"": {""insertions"": 2, ""deletions"": 0, ""lines"": 2}}"
2021-10-12 11:02:49,3a724290c5dd8e4b7c9a1fa8941b81f6f80db00a,Christian Brabandt,3,1,4,2,"{"".github/workflows/ci.yml"": {""insertions"": 1, ""deletions"": 1, ""lines"": 2}, ""src/version.c"": {""insertions"": 2, ""deletions"": 0, ""lines"": 2}}"
2021-10-11 21:57:34,3d031a0ae791f901c0c2dedd5d8b9de137c23acc,Bram Moolenaar,7,5,12,2,"{""src/testdir/test_startup.vim"": {""insertions"": 5, ""deletions"": 5, ""lines"": 10}, ""src/version.c"": {""insertions"": 2, ""deletions"": 0, ""lines"": 2}}"
2021-10-11 20:04:37,37f341d7236ff8a1e886bbb0f0ba0700ad589373,James McCoy,7,3,10,2,"{""src/testdir/test_recover.vim"": {""insertions"": 5, ""deletions"": 3, ""lines"": 8}, ""src/version.c"": {""insertions"": 2, ""deletions"": 0, ""lines"": 2}}"
2021-10-11 19:26:55,a9173d06f7ca320fc84f4ffa993861d21710bc41,Dominique Pelle,4,0,4,2,"{""src/testdir/test_put.vim"": {""insertions"": 2, ""deletions"": 0, ""lines"": 2}, ""src/version.c"": {""insertions"": 2, ""deletions"": 0, ""lines"": 2}}"
2021-10-11 15:27:03,a5d4f3b09d25006f7bc988d618152bd34177a579,James McCoy,13,1,14,2,"{""src/testdir/test_crypt.vim"": {""insertions"": 11, ""deletions"": 1, ""lines"": 12}, ""src/version.c"": {""insertions"": 2, ""deletions"": 0, ""lines"": 2}}"
2021-10-11 15:08:32,b376aa2da4211fee7eaf16450bb8b37674e45bb0,Bram Moolenaar,10,1,11,2,"{""src/testdir/test_startup.vim"": {""insertions"": 8, ""deletions"": 1, ""lines"": 9}, ""src/version.c"": {""insertions"": 2, ""deletions"": 0, ""lines"": 2}}"
2021-10-11 14:40:43,b07626d4afa73dd2af0f03c0d59eed25ee159ef9,Bram Moolenaar,23,2,25,3,"{""src/normal.c"": {""insertions"": 1, ""deletions"": 2, ""lines"": 3}, ""src/testdir/test_visual.vim"": {""insertions"": 20, ""deletions"": 0, ""lines"": 20}, ""src/version.c"": {""insertions"": 2, ""deletions"": 0, ""lines"": 2}}"
2021-10-10 12:54:01,cddd5ac911707034ca27f10037c4b1b523188c47,Bram Moolenaar,6,1,7,2,"{""src/testdir/test_put.vim"": {""insertions"": 4, ""deletions"": 1, ""lines"": 5}, ""src/version.c"": {""insertions"": 2, ""deletions"": 0, ""lines"": 2}}"
2021-10-10 11:35:17,eeed1c7ae090c17f4df51cf97b2a9e4d8b4f4dc7,Bram Moolenaar,21,2,23,4,"{""src/errors.h"": {""insertions"": 2, ""deletions"": 0, ""lines"": 2}, ""src/register.c"": {""insertions"": 9, ""deletions"": 2, ""lines"": 11}, ""src/testdir/test_put.vim"": {""insertions"": 8, ""deletions"": 0, ""lines"": 8}, ""src/version.c"": {""insertions"": 2, ""deletions"": 0, ""lines"": 2}}"
2021-10-09 15:29:43,6e77b88df6371356cce9d6e08daf0f7cb1e7878a,Bram Moolenaar,16,1,17,2,"{""src/testdir/test_filetype.vim"": {""insertions"": 14, ""deletions"": 1, ""lines"": 15}, ""src/version.c"": {""insertions"": 2, ""deletions"": 0, ""lines"": 2}}"
2021-10-09 14:39:25,3826c0513bc9370583be550c864358c7eeb5605a,=?UTF-8?q?Dundar=20G=C3=B6c?=,2,8,10,6,"{""src/buffer.c"": {""insertions"": 0, ""deletions"": 2, ""lines"": 2}, ""src/getchar.c"": {""insertions"": 0, ""deletions"": 1, ""lines"": 1}, ""src/memline.c"": {""insertions"": 0, ""deletions"": 2, ""lines"": 2}, ""src/move.c"": {""insertions"": 0, ""deletions"": 1, ""lines"": 1}, ""src/option.c"": {""insertions"": 0, ""deletions"": 2, ""lines"": 2}, ""src/version.c"": {""insertions"": 2, ""deletions"": 0, ""lines"": 2}}"
2021-10-09 12:58:55,35a319b77f897744eec1155b736e9372c9c5575f,Bram Moolenaar,20,2,22,3,"{""src/ex_docmd.c"": {""insertions"": 4, ""deletions"": 2, ""lines"": 6}, ""src/testdir/test_search.vim"": {""insertions"": 14, ""deletions"": 0, ""lines"": 14}, ""src/version.c"": {""insertions"": 2, ""deletions"": 0, ""lines"": 2}}"
2021-10-09 11:50:20,26190b27011c25caedf3b9308e47005722b3f946,snxx,49,34,83,3,"{"".github/ISSUE_TEMPLATE/bug_report.md"": {""insertions"": 0, ""deletions"": 34, ""lines"": 34}, "".github/ISSUE_TEMPLATE/bug_report.yml"": {""insertions"": 47, ""deletions"": 0, ""lines"": 47}, ""src/version.c"": {""insertions"": 2, ""deletions"": 0, ""lines"": 2}}"
2021-10-08 17:39:28,826bfe4bbd7594188e3d74d2539d9707b1c6a14b,Bram Moolenaar,17,5,22,3,"{""src/drawscreen.c"": {""insertions"": 5, ""deletions"": 5, ""lines"": 10}, ""src/testdir/test_statusline.vim"": {""insertions"": 10, ""deletions"": 0, ""lines"": 10}, ""src/version.c"": {""insertions"": 2, ""deletions"": 0, ""lines"": 2}}"
2021-10-06 21:08:11,cce81e9673fe8d056e8eef310d9919620eccb2f2,Bram Moolenaar,30,2,32,3,"{""src/ex_eval.c"": {""insertions"": 8, ""deletions"": 2, ""lines"": 10}, ""src/testdir/test_trycatch.vim"": {""insertions"": 20, ""deletions"": 0, ""lines"": 20}, ""src/version.c"": {""insertions"": 2, ""deletions"": 0, ""lines"": 2}}"
2021-10-06 18:39:16,edd7a476fbcba199dc0b026461917912c574c629,Zdenek Dohnal,3,1,4,2,"{""src/testdir/test_python3.vim"": {""insertions"": 1, ""deletions"": 1, ""lines"": 2}, ""src/version.c"": {""insertions"": 2, ""deletions"": 0, ""lines"": 2}}"
2021-10-06 12:41:07,e275ba4fc994474155fbafe8b87a6d3b477456ba,Bram Moolenaar,25,1,26,4,"{""src/clipboard.c"": {""insertions"": 2, ""deletions"": 1, ""lines"": 3}, ""src/spellsuggest.c"": {""insertions"": 5, ""deletions"": 0, ""lines"": 5}, ""src/testdir/test_spell_utf8.vim"": {""insertions"": 16, ""deletions"": 0, ""lines"": 16}, ""src/version.c"": {""insertions"": 2, ""deletions"": 0, ""lines"": 2}}"
2021-10-06 10:27:21,e2982d691186c8a9b16ecc8d831d2472088c8ed8,Bram Moolenaar,9,5,14,4,"{""src/auto/configure"": {""insertions"": 3, ""deletions"": 2, ""lines"": 5}, ""src/configure.ac"": {""insertions"": 3, ""deletions"": 2, ""lines"": 5}, ""src/memline.c"": {""insertions"": 1, ""deletions"": 1, ""lines"": 2}, ""src/version.c"": {""insertions"": 2, ""deletions"": 0, ""lines"": 2}}"
2021-10-05 20:58:53,78e0fa4cf4fcd563c0bc8c87afa54d4f5dc22020,Bram Moolenaar,11,2,13,3,"{""src/cindent.c"": {""insertions"": 2, ""deletions"": 2, ""lines"": 4}, ""src/testdir/test_cindent.vim"": {""insertions"": 7, ""deletions"": 0, ""lines"": 7}, ""src/version.c"": {""insertions"": 2, ""deletions"": 0, ""lines"": 2}}"
2021-10-05 18:44:04,2e258bd79f403bcccb1336bea70803957a83808f,James McCoy,11,3,14,3,"{"".github/workflows/ci.yml"": {""insertions"": 7, ""deletions"": 1, ""lines"": 8}, ""src/structs.h"": {""insertions"": 2, ""deletions"": 2, ""lines"": 4}, ""src/version.c"": {""insertions"": 2, ""deletions"": 0, ""lines"": 2}}"
2021-10-05 18:28:01,949de97da32d4fff28c569387e2ba8b3e311e64d,Dominique Pelle,18,7,25,2,"{""src/testdir/test_trycatch.vim"": {""insertions"": 16, ""deletions"": 7, ""lines"": 23}, ""src/version.c"": {""insertions"": 2, ""deletions"": 0, ""lines"": 2}}"
2021-10-05 18:19:35,7c25a7c0a129300d0632e5b99ccefdca9bf3ffa2,Bram Moolenaar,7,0,7,3,"{""src/misc2.c"": {""insertions"": 1, ""deletions"": 0, ""lines"": 1}, ""src/testdir/test_channel.vim"": {""insertions"": 4, ""deletions"": 0, ""lines"": 4}, ""src/version.c"": {""insertions"": 2, ""deletions"": 0, ""lines"": 2}}"
2021-10-05 10:22:27,f67d3fb7363ebc9454f9bb582de3978609a4fd6b,Bram Moolenaar,11,4,15,3,"{""src/ex_eval.c"": {""insertions"": 5, ""deletions"": 1, ""lines"": 6}, ""src/structs.h"": {""insertions"": 4, ""deletions"": 3, ""lines"": 7}, ""src/version.c"": {""insertions"": 2, ""deletions"": 0, ""lines"": 2}}"
2021-10-05 00:19:53,6d197987745427801a2195836ef89e48537afbeb,Bram Moolenaar,4,0,4,2,"{""src/testdir/test_startup.vim"": {""insertions"": 2, ""deletions"": 0, ""lines"": 2}, ""src/version.c"": {""insertions"": 2, ""deletions"": 0, ""lines"": 2}}"
2021-10-04 22:13:13,d3710cf01ef6ab1b2f233866ff01dab76686f642,Bram Moolenaar,27,1,28,3,"{""src/buffer.c"": {""insertions"": 11, ""deletions"": 1, ""lines"": 12}, ""src/testdir/test_startup.vim"": {""insertions"": 14, ""deletions"": 0, ""lines"": 14}, ""src/version.c"": {""insertions"": 2, ""deletions"": 0, ""lines"": 2}}"
2021-10-04 21:17:36,08d7b1c82866a61b61a55e55b6c190dba04e54ea,kuuote,15,2,17,3,"{""src/ex_docmd.c"": {""insertions"": 5, ""deletions"": 2, ""lines"": 7}, ""src/testdir/test_excmd.vim"": {""insertions"": 8, ""deletions"": 0, ""lines"": 8}, ""src/version.c"": {""insertions"": 2, ""deletions"": 0, ""lines"": 2}}"
2021-10-04 20:51:57,965d2edbce1a8ccba96925be5ac4575981f68949,h-east,8,6,14,4,"{""runtime/doc/if_lua.txt"": {""insertions"": 4, ""deletions"": 4, ""lines"": 8}, ""src/getchar.c"": {""insertions"": 1, ""deletions"": 1, ""lines"": 2}, ""src/if_lua.c"": {""insertions"": 1, ""deletions"": 1, ""lines"": 2}, ""src/version.c"": {""insertions"": 2, ""deletions"": 0, ""lines"": 2}}"
2021-10-04 20:32:54,6e649224926bbc1df6a4fdfa7a96b4acb1f8bee0,Bram Moolenaar,2852,369,3221,50,"{"".github/CODEOWNERS"": {""insertions"": 21, ""deletions"": 0, ""lines"": 21}, ""runtime/autoload/netrw.vim"": {""insertions"": 2, ""deletions"": 1, ""lines"": 3}, ""runtime/doc/autocmd.txt"": {""insertions"": 9, ""deletions"": 2, ""lines"": 11}, ""runtime/doc/editing.txt"": {""insertions"": 4, ""deletions"": 2, ""lines"": 6}, ""runtime/doc/eval.txt"": {""insertions"": 21, ""deletions"": 21, ""lines"": 42}, ""runtime/doc/filetype.txt"": {""insertions"": 2, ""deletions"": 2, ""lines"": 4}, ""runtime/doc/intro.txt"": {""insertions"": 1, ""deletions"": 2, ""lines"": 3}, ""runtime/doc/mbyte.txt"": {""insertions"": 16, ""deletions"": 16, ""lines"": 32}, ""runtime/doc/print.txt"": {""insertions"": 2, ""deletions"": 2, ""lines"": 4}, ""runtime/doc/tags"": {""insertions"": 2, ""deletions"": 1, ""lines"": 3}, ""runtime/doc/todo.txt"": {""insertions"": 4, ""deletions"": 1, ""lines"": 5}, ""runtime/filetype.vim"": {""insertions"": 5, ""deletions"": 4, ""lines"": 9}, ""runtime/ftplugin/man.vim"": {""insertions"": 1, ""deletions"": 1, ""lines"": 2}, ""runtime/ftplugin/nginx.vim"": {""insertions"": 6, ""deletions"": 0, ""lines"": 6}, ""runtime/ftplugin/spec.vim"": {""insertions"": 2, ""deletions"": 2, ""lines"": 4}, ""runtime/indent/cdl.vim"": {""insertions"": 2, ""deletions"": 1, ""lines"": 3}, ""runtime/indent/cobol.vim"": {""insertions"": 3, ""deletions"": 0, ""lines"": 3}, ""runtime/indent/config.vim"": {""insertions"": 8, ""deletions"": 5, ""lines"": 13}, ""runtime/indent/css.vim"": {""insertions"": 7, ""deletions"": 5, ""lines"": 12}, ""runtime/indent/d.vim"": {""insertions"": 2, ""deletions"": 2, ""lines"": 4}, ""runtime/indent/dtd.vim"": {""insertions"": 6, ""deletions"": 3, ""lines"": 9}, ""runtime/indent/dylan.vim"": {""insertions"": 2, ""deletions"": 1, ""lines"": 3}, ""runtime/indent/elm.vim"": {""insertions"": 3, ""deletions"": 1, ""lines"": 4}, ""runtime/indent/eterm.vim"": {""insertions"": 6, ""deletions"": 3, ""lines"": 9}, ""runtime/indent/framescript.vim"": {""insertions"": 6, ""deletions"": 3, ""lines"": 9}, ""runtime/indent/idlang.vim"": {""insertions"": 3, ""deletions"": 2, ""lines"": 5}, ""runtime/indent/ld.vim"": {""insertions"": 6, ""deletions"": 3, ""lines"": 9}, ""runtime/indent/mail.vim"": {""insertions"": 3, ""deletions"": 1, ""lines"": 4}, ""runtime/indent/make.vim"": {""insertions"": 6, ""deletions"": 3, ""lines"": 9}, ""runtime/indent/matlab.vim"": {""insertions"": 2, ""deletions"": 0, ""lines"": 2}, ""runtime/indent/mma.vim"": {""insertions"": 6, ""deletions"": 5, ""lines"": 11}, ""runtime/indent/nginx.vim"": {""insertions"": 17, ""deletions"": 0, ""lines"": 17}, ""runtime/indent/occam.vim"": {""insertions"": 2, ""deletions"": 1, ""lines"": 3}, ""runtime/indent/pascal.vim"": {""insertions"": 7, ""deletions"": 8, ""lines"": 15}, ""runtime/indent/postscr.vim"": {""insertions"": 4, ""deletions"": 3, ""lines"": 7}, ""runtime/indent/prolog.vim"": {""insertions"": 4, ""deletions"": 3, ""lines"": 7}, ""runtime/indent/python.vim"": {""insertions"": 3, ""deletions"": 1, ""lines"": 4}, ""runtime/indent/readline.vim"": {""insertions"": 6, ""deletions"": 3, ""lines"": 9}, ""runtime/indent/sdl.vim"": {""insertions"": 3, ""deletions"": 1, ""lines"": 4}, ""runtime/indent/tcl.vim"": {""insertions"": 5, ""deletions"": 3, ""lines"": 8}, ""runtime/indent/tcsh.vim"": {""insertions"": 3, ""deletions"": 2, ""lines"": 5}, ""runtime/indent/zimbu.vim"": {""insertions"": 2, ""deletions"": 2, ""lines"": 4}, ""runtime/syntax/8th.vim"": {""insertions"": 302, ""deletions"": 233, ""lines"": 535}, ""runtime/syntax/chicken.vim"": {""insertions"": 2, ""deletions"": 2, ""lines"": 4}, ""runtime/syntax/nginx.vim"": {""insertions"": 2307, ""deletions"": 0, ""lines"": 2307}, ""runtime/syntax/sml.vim"": {""insertions"": 3, ""deletions"": 4, ""lines"": 7}, ""runtime/syntax/tcl.vim"": {""insertions"": 2, ""deletions"": 2, ""lines"": 4}, ""runtime/syntax/tcsh.vim"": {""insertions"": 3, ""deletions"": 2, ""lines"": 5}, ""runtime/syntax/typescriptcommon.vim"": {""insertions"": 3, ""deletions"": 2, ""lines"": 5}, ""runtime/syntax/xpm.vim"": {""insertions"": 5, ""deletions"": 2, ""lines"": 7}}"
2021-10-04 19:41:45,78aa5ffe314f40d33666f03b833f66b11c3d0f67,Bram Moolenaar,7,2,9,3,"{""runtime/filetype.vim"": {""insertions"": 4, ""deletions"": 1, ""lines"": 5}, ""src/testdir/test_filetype.vim"": {""insertions"": 1, ""deletions"": 1, ""lines"": 2}, ""src/version.c"": {""insertions"": 2, ""deletions"": 0, ""lines"": 2}}"
2021-10-04 19:09:19,9af9fd6ab637ea507dd9015fa5a84a408c36c1e0,Bram Moolenaar,7,2,9,2,"{""src/testdir/test_search.vim"": {""insertions"": 5, ""deletions"": 2, ""lines"": 7}, ""src/version.c"": {""insertions"": 2, ""deletions"": 0, ""lines"": 2}}"
2021-10-04 18:47:35,d8d957de86f218de9124ca1209548f8c6f61b69b,Bram Moolenaar,19,1,20,3,"{""src/ex_getln.c"": {""insertions"": 7, ""deletions"": 1, ""lines"": 8}, ""src/testdir/test_search.vim"": {""insertions"": 10, ""deletions"": 0, ""lines"": 10}, ""src/version.c"": {""insertions"": 2, ""deletions"": 0, ""lines"": 2}}"
2021-10-04 17:52:19,a684a684096ecef3fbaee39c573b47423235d6b1,Bram Moolenaar,16,1,17,3,"{""src/ex_eval.c"": {""insertions"": 2, ""deletions"": 1, ""lines"": 3}, ""src/testdir/test_trycatch.vim"": {""insertions"": 12, ""deletions"": 0, ""lines"": 12}, ""src/version.c"": {""insertions"": 2, ""deletions"": 0, ""lines"": 2}}"
2021-10-03 19:11:20,50c56893423eb6ad2154a4151e67f7097f52efb6,Bram Moolenaar,6,1,7,3,"{""runtime/filetype.vim"": {""insertions"": 3, ""deletions"": 0, ""lines"": 3}, ""src/testdir/test_filetype.vim"": {""insertions"": 1, ""deletions"": 1, ""lines"": 2}, ""src/version.c"": {""insertions"": 2, ""deletions"": 0, ""lines"": 2}}"
2021-10-03 18:29:48,c6376c798433bcb9ee38a8664299d11454546950,Bram Moolenaar,28,1,29,3,"{""src/os_unix.c"": {""insertions"": 9, ""deletions"": 1, ""lines"": 10}, ""src/testdir/test_cd.vim"": {""insertions"": 17, ""deletions"": 0, ""lines"": 17}, ""src/version.c"": {""insertions"": 2, ""deletions"": 0, ""lines"": 2}}"
2021-10-03 15:22:05,5a9357d0bff9059f547906d8d03b31bca7215af1,Bram Moolenaar,21,0,21,3,"{""src/edit.c"": {""insertions"": 3, ""deletions"": 0, ""lines"": 3}, ""src/testdir/test_autocmd.vim"": {""insertions"": 16, ""deletions"": 0, ""lines"": 16}, ""src/version.c"": {""insertions"": 2, ""deletions"": 0, ""lines"": 2}}"
2021-10-03 14:19:14,cc8cd4453332276d55b4a1109eace5785a4f319d,zeertzjq,53,5,58,4,"{""runtime/doc/eval.txt"": {""insertions"": 7, ""deletions"": 5, ""lines"": 12}, ""src/misc1.c"": {""insertions"": 6, ""deletions"": 0, ""lines"": 6}, ""src/testdir/test_functions.vim"": {""insertions"": 38, ""deletions"": 0, ""lines"": 38}, ""src/version.c"": {""insertions"": 2, ""deletions"": 0, ""lines"": 2}}"
2021-10-03 11:01:27,27fef59dd1dd75f50c366f7f616ffa4451560452,zeertzjq,11,2,13,4,"{""runtime/doc/eval.txt"": {""insertions"": 2, ""deletions"": 0, ""lines"": 2}, ""src/insexpand.c"": {""insertions"": 3, ""deletions"": 2, ""lines"": 5}, ""src/testdir/test_popup.vim"": {""insertions"": 4, ""deletions"": 0, ""lines"": 4}, ""src/version.c"": {""insertions"": 2, ""deletions"": 0, ""lines"": 2}}"
2021-10-03 10:46:09,8b8c0ed657fabd88e610401ca8a12366f987db94,Chris Aumann,6,0,6,3,"{""runtime/filetype.vim"": {""insertions"": 3, ""deletions"": 0, ""lines"": 3}, ""src/testdir/test_filetype.vim"": {""insertions"": 1, ""deletions"": 0, ""lines"": 1}, ""src/version.c"": {""insertions"": 2, ""deletions"": 0, ""lines"": 2}}"
2021-10-02 20:48:15,72d2fa69e56dd0e61eac87a9c3b79cd89d47cdd9,Bram Moolenaar,23,0,23,2,"{""src/testdir/test_edit.vim"": {""insertions"": 21, ""deletions"": 0, ""lines"": 21}, ""src/version.c"": {""insertions"": 2, ""deletions"": 0, ""lines"": 2}}"
2021-10-02 15:55:39,d85931e67316e824878000d0ead122553ccef3a4,Bram Moolenaar,12,4,16,3,"{""src/misc1.c"": {""insertions"": 5, ""deletions"": 3, ""lines"": 8}, ""src/testdir/test_edit.vim"": {""insertions"": 5, ""deletions"": 1, ""lines"": 6}, ""src/version.c"": {""insertions"": 2, ""deletions"": 0, ""lines"": 2}}"
2021-10-02 15:34:55,72406a4bd2896915b6f541e26d41521a59b1f846,Bram Moolenaar,16,1,17,4,"{""runtime/doc/eval.txt"": {""insertions"": 2, ""deletions"": 1, ""lines"": 3}, ""src/misc1.c"": {""insertions"": 4, ""deletions"": 0, ""lines"": 4}, ""src/testdir/test_functions.vim"": {""insertions"": 8, ""deletions"": 0, ""lines"": 8}, ""src/version.c"": {""insertions"": 2, ""deletions"": 0, ""lines"": 2}}"
2021-10-02 10:26:51,dfa5e464d459f84200a73d178f1ecefe75bbe511,=?UTF-8?q?Dundar=20G=C3=B6c?=,20,18,38,9,"{""src/autocmd.c"": {""insertions"": 5, ""deletions"": 5, ""lines"": 10}, ""src/buffer.c"": {""insertions"": 1, ""deletions"": 1, ""lines"": 2}, ""src/debugger.c"": {""insertions"": 1, ""deletions"": 1, ""lines"": 2}, ""src/getchar.c"": {""insertions"": 3, ""deletions"": 3, ""lines"": 6}, ""src/hardcopy.c"": {""insertions"": 2, ""deletions"": 2, ""lines"": 4}, ""src/if_cscope.c"": {""insertions"": 2, ""deletions"": 2, ""lines"": 4}, ""src/move.c"": {""insertions"": 1, ""deletions"": 1, ""lines"": 2}, ""src/tag.c"": {""insertions"": 1, ""deletions"": 1, ""lines"": 2}, ""src/version.c"": {""insertions"": 4, ""deletions"": 2, ""lines"": 6}}"
2021-09-30 18:00:00,51491adfa86fd66a857cd7ec50d0b57dbdf3da59,Yegappan Lakshmanan,65,4,69,5,"{""runtime/doc/eval.txt"": {""insertions"": 16, ""deletions"": 1, ""lines"": 17}, ""src/menu.c"": {""insertions"": 21, ""deletions"": 3, ""lines"": 24}, ""src/testdir/test_menu.vim"": {""insertions"": 3, ""deletions"": 0, ""lines"": 3}, ""src/testdir/test_vim9_builtin.vim"": {""insertions"": 23, ""deletions"": 0, ""lines"": 23}, ""src/version.c"": {""insertions"": 2, ""deletions"": 0, ""lines"": 2}}"
2021-09-26 21:11:52,be01090efad242e30728275dea05420db6f96257,Bram Moolenaar,4,2,6,3,"{""runtime/filetype.vim"": {""insertions"": 1, ""deletions"": 1, ""lines"": 2}, ""src/testdir/test_filetype.vim"": {""insertions"": 1, ""deletions"": 1, ""lines"": 2}, ""src/version.c"": {""insertions"": 2, ""deletions"": 0, ""lines"": 2}}"
2021-09-26 19:14:39,b16ff292ad5f07ed5a7e36a2236b2f82c943c982,Bram Moolenaar,6,0,6,2,"{""src/testdir/test_vim9_script.vim"": {""insertions"": 4, ""deletions"": 0, ""lines"": 4}, ""src/version.c"": {""insertions"": 2, ""deletions"": 0, ""lines"": 2}}"
2021-09-26 18:04:05,f8dbd586660c35e44276151b731eeedeace9b53e,Yegappan Lakshmanan,81,5,86,3,"{""src/evalfunc.c"": {""insertions"": 2, ""deletions"": 3, ""lines"": 5}, ""src/testdir/test_vim9_builtin.vim"": {""insertions"": 77, ""deletions"": 2, ""lines"": 79}, ""src/version.c"": {""insertions"": 2, ""deletions"": 0, ""lines"": 2}}"
2021-09-22 14:43:59,56858e4ed4e338e15821767b8303b06099e40384,Bram Moolenaar,9,2,11,3,"{""src/register.c"": {""insertions"": 3, ""deletions"": 0, ""lines"": 3}, ""src/testdir/test_put.vim"": {""insertions"": 4, ""deletions"": 2, ""lines"": 6}, ""src/version.c"": {""insertions"": 2, ""deletions"": 0, ""lines"": 2}}"
2021-09-22 14:37:07,23003e51e18371afda4420d9e171a3dcba5a31cc,Bram Moolenaar,23,3,26,3,"{""src/register.c"": {""insertions"": 11, ""deletions"": 3, ""lines"": 14}, ""src/testdir/test_put.vim"": {""insertions"": 10, ""deletions"": 0, ""lines"": 10}, ""src/version.c"": {""insertions"": 2, ""deletions"": 0, ""lines"": 2}}"
2021-09-22 12:18:13,40fa12aea352474d229f2f750e954a4318aead4e,Bram Moolenaar,16,1,17,3,"{""src/fileio.c"": {""insertions"": 1, ""deletions"": 1, ""lines"": 2}, ""src/testdir/test_autocmd.vim"": {""insertions"": 13, ""deletions"": 0, ""lines"": 13}, ""src/version.c"": {""insertions"": 2, ""deletions"": 0, ""lines"": 2}}"
2021-09-21 19:04:01,da0b497c6e4e01447669773a931b0eaa5ca757f3,Bram Moolenaar,2,1,3,1,"{""src/po/es.po"": {""insertions"": 2, ""deletions"": 1, ""lines"": 3}}"
2021-09-21 18:09:51,34cc7d8c034f2bc5b57455577051db8d72e2b87c,Bram Moolenaar,378,113,491,20,"{""runtime/autoload/csscomplete.vim"": {""insertions"": 3, ""deletions"": 3, ""lines"": 6}, ""runtime/doc/eval.txt"": {""insertions"": 8, ""deletions"": 4, ""lines"": 12}, ""runtime/doc/filetype.txt"": {""insertions"": 8, ""deletions"": 0, ""lines"": 8}, ""runtime/doc/map.txt"": {""insertions"": 1, ""deletions"": 1, ""lines"": 2}, ""runtime/doc/options.txt"": {""insertions"": 5, ""deletions"": 3, ""lines"": 8}, ""runtime/doc/tags"": {""insertions"": 8, ""deletions"": 0, ""lines"": 8}, ""runtime/doc/todo.txt"": {""insertions"": 6, ""deletions"": 9, ""lines"": 15}, ""runtime/doc/usr_41.txt"": {""insertions"": 1, ""deletions"": 1, ""lines"": 2}, ""runtime/doc/vim9.txt"": {""insertions"": 10, ""deletions"": 1, ""lines"": 11}, ""runtime/filetype.vim"": {""insertions"": 1, ""deletions"": 1, ""lines"": 2}, ""runtime/ftplugin/8th.vim"": {""insertions"": 6, ""deletions"": 4, ""lines"": 10}, ""runtime/ftplugin/c.vim"": {""insertions"": 7, ""deletions"": 3, ""lines"": 10}, ""runtime/ftplugin/gprof.vim"": {""insertions"": 13, ""deletions"": 9, ""lines"": 22}, ""runtime/syntax/go.vim"": {""insertions"": 3, ""deletions"": 3, ""lines"": 6}, ""runtime/syntax/gprof.vim"": {""insertions"": 3, ""deletions"": 2, ""lines"": 5}, ""runtime/syntax/php.vim"": {""insertions"": 251, ""deletions"": 16, ""lines"": 267}, ""runtime/syntax/vim.vim"": {""insertions"": 8, ""deletions"": 8, ""lines"": 16}, ""runtime/tutor/tutor"": {""insertions"": 10, ""deletions"": 10, ""lines"": 20}, ""runtime/tutor/tutor.utf-8"": {""insertions"": 10, ""deletions"": 10, ""lines"": 20}, ""src/po/es.po"": {""insertions"": 16, ""deletions"": 25, ""lines"": 41}}"
2021-09-21 17:37:01,690c524ce6629f9ff67728541ba211f831caf0ee,Steven Penny,6,1,7,3,"{""runtime/filetype.vim"": {""insertions"": 3, ""deletions"": 0, ""lines"": 3}, ""src/testdir/test_filetype.vim"": {""insertions"": 1, ""deletions"": 1, ""lines"": 2}, ""src/version.c"": {""insertions"": 2, ""deletions"": 0, ""lines"": 2}}"
2021-09-20 18:57:31,770ddbe1595f6dab836304203d5ca2e0b069266f,Zdenek Dohnal,4,2,6,3,"{""runtime/filetype.vim"": {""insertions"": 1, ""deletions"": 1, ""lines"": 2}, ""src/testdir/test_filetype.vim"": {""insertions"": 1, ""deletions"": 1, ""lines"": 2}, ""src/version.c"": {""insertions"": 2, ""deletions"": 0, ""lines"": 2}}"
2021-09-19 15:55:16,18fefddcb023db3c8461953892650b0c5f0cc9fe,Bram Moolenaar,26,24,50,2,"{"".github/workflows/ci.yml"": {""insertions"": 24, ""deletions"": 24, ""lines"": 48}, ""src/version.c"": {""insertions"": 2, ""deletions"": 0, ""lines"": 2}}"
2021-09-19 15:01:39,c04f62346bfd6b92151908239a3c5ab1a7d18f2a,Yasuhiro Matsumoto,9,0,9,3,"{""src/list.c"": {""insertions"": 6, ""deletions"": 0, ""lines"": 6}, ""src/testdir/test_sort.vim"": {""insertions"": 1, ""deletions"": 0, ""lines"": 1}, ""src/version.c"": {""insertions"": 2, ""deletions"": 0, ""lines"": 2}}"
2021-09-18 13:25:52,1d34189ecb99fa76363c06e1aa815c1075675a1c,Bram Moolenaar,34,4,38,3,"{""src/testdir/test_trycatch.vim"": {""insertions"": 27, ""deletions"": 1, ""lines"": 28}, ""src/userfunc.c"": {""insertions"": 5, ""deletions"": 3, ""lines"": 8}, ""src/version.c"": {""insertions"": 2, ""deletions"": 0, ""lines"": 2}}"
2021-09-18 10:15:08,d2b98ab4ecf168514ae622948e3749dea7671946,Yegappan Lakshmanan,4,2,6,2,"{""src/os_unix.h"": {""insertions"": 2, ""deletions"": 2, ""lines"": 4}, ""src/version.c"": {""insertions"": 2, ""deletions"": 0, ""lines"": 2}}"
2021-09-17 19:07:35,820d5525cae707f39571c6abc2aa6a9e66ed171e,Yegappan Lakshmanan,66,17,83,6,"{""runtime/doc/sign.txt"": {""insertions"": 1, ""deletions"": 0, ""lines"": 1}, ""runtime/doc/textprop.txt"": {""insertions"": 1, ""deletions"": 1, ""lines"": 2}, ""src/sign.c"": {""insertions"": 0, ""deletions"": 4, ""lines"": 4}, ""src/testdir/test_blob.vim"": {""insertions"": 2, ""deletions"": 1, ""lines"": 3}, ""src/testdir/test_vim9_builtin.vim"": {""insertions"": 60, ""deletions"": 11, ""lines"": 71}, ""src/version.c"": {""insertions"": 2, ""deletions"": 0, ""lines"": 2}}"
2021-09-17 18:45:30,542ffe16a1b6961e9262a3c4c6ddb86e6149a1cd,Bram Moolenaar,6,2,8,2,"{""src/globals.h"": {""insertions"": 1, ""deletions"": 1, ""lines"": 2}, ""src/version.c"": {""insertions"": 5, ""deletions"": 1, ""lines"": 6}}"
2021-09-16 20:32:15,644b49fa0fb90143e8dbe90a7c14c9498d17b266,Bram Moolenaar,36,2,38,4,"{""src/edit.c"": {""insertions"": 10, ""deletions"": 0, ""lines"": 10}, ""src/testdir/dumps/Test_conceal_two_windows_07in.dump"": {""insertions"": 20, ""deletions"": 0, ""lines"": 20}, ""src/testdir/test_conceal.vim"": {""insertions"": 4, ""deletions"": 2, ""lines"": 6}, ""src/version.c"": {""insertions"": 2, ""deletions"": 0, ""lines"": 2}}"
2021-09-16 18:14:51,3dfe2e0fb8768914a019fa04b1ed9581e33c9b26,Bram Moolenaar,4,1,5,2,"{""src/version.c"": {""insertions"": 2, ""deletions"": 0, ""lines"": 2}, ""src/vim9compile.c"": {""insertions"": 2, ""deletions"": 1, ""lines"": 3}}"
2021-09-16 14:15:07,1a7ee4dd115329052670d7af176341bd09c9dc5a,Bram Moolenaar,137,38,175,5,"{""src/testdir/test_vim9_disassemble.vim"": {""insertions"": 50, ""deletions"": 12, ""lines"": 62}, ""src/version.c"": {""insertions"": 2, ""deletions"": 0, ""lines"": 2}, ""src/vim9.h"": {""insertions"": 1, ""deletions"": 0, ""lines"": 1}, ""src/vim9compile.c"": {""insertions"": 81, ""deletions"": 26, ""lines"": 107}, ""src/vim9execute.c"": {""insertions"": 3, ""deletions"": 0, ""lines"": 3}}"
2021-09-15 10:53:40,ee2cbcd99c54d7c4a3ccfaf0cd5ddeb1369a844e,Christian Brabandt,3,1,4,2,"{""src/version.c"": {""insertions"": 2, ""deletions"": 0, ""lines"": 2}, ""vimtutor.bat"": {""insertions"": 1, ""deletions"": 1, ""lines"": 2}}"
2021-09-14 20:58:23,f2a8bafa4b815e5b4e50a25c2b3a8a24fbe8aa11,Bram Moolenaar,8,0,8,2,"{""src/testdir/test_recover.vim"": {""insertions"": 6, ""deletions"": 0, ""lines"": 6}, ""src/version.c"": {""insertions"": 2, ""deletions"": 0, ""lines"": 2}}"
2021-09-14 16:55:51,78eb9cce911dcd662182443e0920649ec1596d41,Christian Brabandt,64,0,64,5,"{""src/ops.c"": {""insertions"": 2, ""deletions"": 0, ""lines"": 2}, ""src/proto/register.pro"": {""insertions"": 1, ""deletions"": 0, ""lines"": 1}, ""src/register.c"": {""insertions"": 7, ""deletions"": 0, ""lines"": 7}, ""src/testdir/test_registers.vim"": {""insertions"": 52, ""deletions"": 0, ""lines"": 52}, ""src/version.c"": {""insertions"": 2, ""deletions"": 0, ""lines"": 2}}"
2021-09-14 15:54:30,5dfe467432638fac2e0156a2f9cd0d9eb569fb39,Yegappan Lakshmanan,185,1,186,11,"{""runtime/doc/eval.txt"": {""insertions"": 27, ""deletions"": 1, ""lines"": 28}, ""runtime/doc/usr_41.txt"": {""insertions"": 6, ""deletions"": 0, ""lines"": 6}, ""src/blob.c"": {""insertions"": 61, ""deletions"": 0, ""lines"": 61}, ""src/errors.h"": {""insertions"": 4, ""deletions"": 0, ""lines"": 4}, ""src/evalfunc.c"": {""insertions"": 14, ""deletions"": 0, ""lines"": 14}, ""src/proto/blob.pro"": {""insertions"": 2, ""deletions"": 0, ""lines"": 2}, ""src/proto/typval.pro"": {""insertions"": 1, ""deletions"": 0, ""lines"": 1}, ""src/testdir/test_blob.vim"": {""insertions"": 39, ""deletions"": 0, ""lines"": 39}, ""src/testdir/test_vim9_builtin.vim"": {""insertions"": 12, ""deletions"": 0, ""lines"": 12}, ""src/typval.c"": {""insertions"": 17, ""deletions"": 0, ""lines"": 17}, ""src/version.c"": {""insertions"": 2, ""deletions"": 0, ""lines"": 2}}"
2021-09-13 20:17:38,f5785cf0592626ec17676e814d3ba58f5123bcda,Mike Williams,8,5,13,4,"{""src/screen.c"": {""insertions"": 4, ""deletions"": 3, ""lines"": 7}, ""src/version.c"": {""insertions"": 2, ""deletions"": 0, ""lines"": 2}, ""src/xdiff/xemit.c"": {""insertions"": 1, ""deletions"": 1, ""lines"": 2}, ""src/xdiff/xutils.c"": {""insertions"": 1, ""deletions"": 1, ""lines"": 2}}"
2021-09-13 19:36:27,a29856fcdc41541c607437629c1c1f45951100a4,Bram Moolenaar,7,3,10,2,"{""src/typval.c"": {""insertions"": 5, ""deletions"": 3, ""lines"": 8}, ""src/version.c"": {""insertions"": 2, ""deletions"": 0, ""lines"": 2}}"
2021-09-13 16:25:54,b1b6f4de2b0edc3b6622912132ddb8994ec52709,Bram Moolenaar,226,26,252,6,"{""src/testdir/test_vim9_disassemble.vim"": {""insertions"": 34, ""deletions"": 1, ""lines"": 35}, ""src/testdir/test_vim9_func.vim"": {""insertions"": 31, ""deletions"": 0, ""lines"": 31}, ""src/version.c"": {""insertions"": 2, ""deletions"": 0, ""lines"": 2}, ""src/vim9.h"": {""insertions"": 3, ""deletions"": 0, ""lines"": 3}, ""src/vim9compile.c"": {""insertions"": 33, ""deletions"": 6, ""lines"": 39}, ""src/vim9execute.c"": {""insertions"": 123, ""deletions"": 19, ""lines"": 142}}"
2021-09-12 19:00:14,28e591dd5080bbcd0f468f9d9597cedb716e28c9,Bram Moolenaar,3,1,4,2,"{""src/proto/misc1.pro"": {""insertions"": 1, ""deletions"": 1, ""lines"": 2}, ""src/version.c"": {""insertions"": 2, ""deletions"": 0, ""lines"": 2}}"
2021-09-12 18:58:02,bdcba24d8597abd5af509c2fb9206e64e713c711,Bram Moolenaar,47,6,53,5,"{""runtime/doc/map.txt"": {""insertions"": 4, ""deletions"": 0, ""lines"": 4}, ""src/errors.h"": {""insertions"": 4, ""deletions"": 0, ""lines"": 4}, ""src/testdir/test_usercommands.vim"": {""insertions"": 21, ""deletions"": 0, ""lines"": 21}, ""src/usercmd.c"": {""insertions"": 16, ""deletions"": 6, ""lines"": 22}, ""src/version.c"": {""insertions"": 2, ""deletions"": 0, ""lines"": 2}}"
2021-09-12 15:03:08,ca0627df69c29508f6f797bef27a1f5fa9a447d3,Bram Moolenaar,13,14,27,3,"{""runtime/autoload/dist/ft.vim"": {""insertions"": 3, ""deletions"": 3, ""lines"": 6}, ""src/testdir/test_filetype.vim"": {""insertions"": 8, ""deletions"": 11, ""lines"": 19}, ""src/version.c"": {""insertions"": 2, ""deletions"": 0, ""lines"": 2}}"
2021-09-12 13:45:10,dfe04dbff5863f6c089da8831d7ac2a3421a44b7,naohiro ono,9,1,10,3,"{""src/cmdexpand.c"": {""insertions"": 2, ""deletions"": 1, ""lines"": 3}, ""src/testdir/test_cmdline.vim"": {""insertions"": 5, ""deletions"": 0, ""lines"": 5}, ""src/version.c"": {""insertions"": 2, ""deletions"": 0, ""lines"": 2}}"
2021-09-12 11:39:55,f1e8876fa2359b572d262772747405d3616db670,=?UTF-8?q?Magnus=20Gro=C3=9F?=,135,4,139,13,"{""runtime/doc/autocmd.txt"": {""insertions"": 18, ""deletions"": 1, ""lines"": 19}, ""src/autocmd.c"": {""insertions"": 16, ""deletions"": 2, ""lines"": 18}, ""src/edit.c"": {""insertions"": 3, ""deletions"": 0, ""lines"": 3}, ""src/ex_docmd.c"": {""insertions"": 1, ""deletions"": 0, ""lines"": 1}, ""src/ex_getln.c"": {""insertions"": 10, ""deletions"": 0, ""lines"": 10}, ""src/globals.h"": {""insertions"": 3, ""deletions"": 0, ""lines"": 3}, ""src/misc1.c"": {""insertions"": 40, ""deletions"": 1, ""lines"": 41}, ""src/normal.c"": {""insertions"": 3, ""deletions"": 0, ""lines"": 3}, ""src/proto/autocmd.pro"": {""insertions"": 1, ""deletions"": 0, ""lines"": 1}, ""src/proto/misc1.pro"": {""insertions"": 1, ""deletions"": 0, ""lines"": 1}, ""src/testdir/test_edit.vim"": {""insertions"": 34, ""deletions"": 0, ""lines"": 34}, ""src/version.c"": {""insertions"": 2, ""deletions"": 0, ""lines"": 2}, ""src/vim.h"": {""insertions"": 3, ""deletions"": 0, ""lines"": 3}}"
2021-09-11 21:07:44,464393a6961d9b9de2bfe9c05f8e2ae5bdec0293,Bram Moolenaar,19,3,22,3,"{""src/evalvars.c"": {""insertions"": 14, ""deletions"": 2, ""lines"": 16}, ""src/version.c"": {""insertions"": 2, ""deletions"": 0, ""lines"": 2}, ""src/vim9type.c"": {""insertions"": 3, ""deletions"": 1, ""lines"": 4}}"
2021-09-11 19:14:20,35a9a00afcb20897d462a766793ff45534810dc3,Bram Moolenaar,21,3,24,3,"{""src/normal.c"": {""insertions"": 7, ""deletions"": 3, ""lines"": 10}, ""src/testdir/test_edit.vim"": {""insertions"": 12, ""deletions"": 0, ""lines"": 12}, ""src/version.c"": {""insertions"": 2, ""deletions"": 0, ""lines"": 2}}"
2021-09-11 18:20:38,b3bf33a7b227df871834e816c4ce4b2706b56bea,Bram Moolenaar,19,5,24,3,"{""src/list.c"": {""insertions"": 7, ""deletions"": 1, ""lines"": 8}, ""src/testdir/test_vim9_builtin.vim"": {""insertions"": 10, ""deletions"": 4, ""lines"": 14}, ""src/version.c"": {""insertions"": 2, ""deletions"": 0, ""lines"": 2}}"
2021-09-11 13:06:44,4b4b1b84eee70b74fa3bb57624533c65bafd8428,Bram Moolenaar,52,6,58,3,"{""src/change.c"": {""insertions"": 32, ""deletions"": 6, ""lines"": 38}, ""src/testdir/test_listener.vim"": {""insertions"": 18, ""deletions"": 0, ""lines"": 18}, ""src/version.c"": {""insertions"": 2, ""deletions"": 0, ""lines"": 2}}"
2021-09-11 10:15:09,56e14698b45a9c4ef8fa65c55c9bfe86fbb3d6bf,Bram Moolenaar,4,2,6,2,"{""src/screen.c"": {""insertions"": 2, ""deletions"": 2, ""lines"": 4}, ""src/version.c"": {""insertions"": 2, ""deletions"": 0, ""lines"": 2}}"
2021-09-10 14:58:30,f14b8ba1373f569705cb80419248054100b02360,zeertzjq,264,29,293,7,"{""runtime/doc/options.txt"": {""insertions"": 14, ""deletions"": 5, ""lines"": 19}, ""src/drawline.c"": {""insertions"": 20, ""deletions"": 3, ""lines"": 23}, ""src/message.c"": {""insertions"": 30, ""deletions"": 13, ""lines"": 43}, ""src/screen.c"": {""insertions"": 58, ""deletions"": 5, ""lines"": 63}, ""src/structs.h"": {""insertions"": 1, ""deletions"": 0, ""lines"": 1}, ""src/testdir/test_listchars.vim"": {""insertions"": 139, ""deletions"": 3, ""lines"": 142}, ""src/version.c"": {""insertions"": 2, ""deletions"": 0, ""lines"": 2}}"
2021-09-09 21:01:14,07802044b90b2cbcc64b2dfe235f019d7c37589c,Bram Moolenaar,36,12,48,5,"{""src/structs.h"": {""insertions"": 3, ""deletions"": 0, ""lines"": 3}, ""src/testdir/test_vim9_assign.vim"": {""insertions"": 8, ""deletions"": 7, ""lines"": 15}, ""src/version.c"": {""insertions"": 2, ""deletions"": 0, ""lines"": 2}, ""src/vim9compile.c"": {""insertions"": 15, ""deletions"": 4, ""lines"": 19}, ""src/vim9execute.c"": {""insertions"": 8, ""deletions"": 1, ""lines"": 9}}"
2021-09-09 20:30:52,efc084e3353d6854b6dac8b240f70cb0abb838ad,Bram Moolenaar,26,0,26,3,"{""src/list.c"": {""insertions"": 1, ""deletions"": 0, ""lines"": 1}, ""src/testdir/test_vim9_func.vim"": {""insertions"": 23, ""deletions"": 0, ""lines"": 23}, ""src/version.c"": {""insertions"": 2, ""deletions"": 0, ""lines"": 2}}"
2021-09-09 19:55:11,6c391a74fe90190796ca0b0c010112948a6e75d7,Bram Moolenaar,247,167,414,80,"{"".github/CODEOWNERS"": {""insertions"": 1, ""deletions"": 0, ""lines"": 1}, ""runtime/autoload/ada.vim"": {""insertions"": 3, ""deletions"": 3, ""lines"": 6}, ""runtime/autoload/adacomplete.vim"": {""insertions"": 1, ""deletions"": 1, ""lines"": 2}, ""runtime/autoload/csscomplete.vim"": {""insertions"": 1, ""deletions"": 1, ""lines"": 2}, ""runtime/autoload/decada.vim"": {""insertions"": 1, ""deletions"": 1, ""lines"": 2}, ""runtime/autoload/getscript.vim"": {""insertions"": 2, ""deletions"": 2, ""lines"": 4}, ""runtime/autoload/haskellcomplete.vim"": {""insertions"": 3, ""deletions"": 3, ""lines"": 6}, ""runtime/autoload/htmlcomplete.vim"": {""insertions"": 1, ""deletions"": 1, ""lines"": 2}, ""runtime/autoload/netrw.vim"": {""insertions"": 4, ""deletions"": 4, ""lines"": 8}, ""runtime/autoload/phpcomplete.vim"": {""insertions"": 21, ""deletions"": 21, ""lines"": 42}, ""runtime/autoload/python3complete.vim"": {""insertions"": 1, ""deletions"": 1, ""lines"": 2}, ""runtime/autoload/pythoncomplete.vim"": {""insertions"": 1, ""deletions"": 1, ""lines"": 2}, ""runtime/autoload/sqlcomplete.vim"": {""insertions"": 7, ""deletions"": 7, ""lines"": 14}, ""runtime/autoload/tar.vim"": {""insertions"": 1, ""deletions"": 1, ""lines"": 2}, ""runtime/autoload/tohtml.vim"": {""insertions"": 1, ""deletions"": 1, ""lines"": 2}, ""runtime/autoload/xmlcomplete.vim"": {""insertions"": 1, ""deletions"": 1, ""lines"": 2}, ""runtime/autoload/zip.vim"": {""insertions"": 1, ""deletions"": 1, ""lines"": 2}, ""runtime/compiler/fpc.vim"": {""insertions"": 1, ""deletions"": 1, ""lines"": 2}, ""runtime/compiler/tex.vim"": {""insertions"": 1, ""deletions"": 1, ""lines"": 2}, ""runtime/doc/eval.txt"": {""insertions"": 6, ""deletions"": 3, ""lines"": 9}, ""runtime/doc/index.txt"": {""insertions"": 1, ""deletions"": 1, ""lines"": 2}, ""runtime/doc/insert.txt"": {""insertions"": 1, ""deletions"": 1, ""lines"": 2}, ""runtime/doc/options.txt"": {""insertions"": 3, ""deletions"": 1, ""lines"": 4}, ""runtime/doc/repeat.txt"": {""insertions"": 6, ""deletions"": 2, ""lines"": 8}, ""runtime/doc/tags"": {""insertions"": 4, ""deletions"": 0, ""lines"": 4}, ""runtime/doc/todo.txt"": {""insertions"": 10, ""deletions"": 8, ""lines"": 18}, ""runtime/doc/various.txt"": {""insertions"": 2, ""deletions"": 2, ""lines"": 4}, ""runtime/doc/vim9.txt"": {""insertions"": 3, ""deletions"": 4, ""lines"": 7}, ""runtime/doc/windows.txt"": {""insertions"": 4, ""deletions"": 3, ""lines"": 7}, ""runtime/filetype.vim"": {""insertions"": 1, ""deletions"": 1, ""lines"": 2}, ""runtime/ftplugin/dosini.vim"": {""insertions"": 1, ""deletions"": 1, ""lines"": 2}, ""runtime/ftplugin/matlab.vim"": {""insertions"": 4, ""deletions"": 3, ""lines"": 7}, ""runtime/ftplugin/ocaml.vim"": {""insertions"": 4, ""deletions"": 4, ""lines"": 8}, ""runtime/ftplugin/octave.vim"": {""insertions"": 63, ""deletions"": 0, ""lines"": 63}, ""runtime/ftplugin/systemverilog.vim"": {""insertions"": 1, ""deletions"": 1, ""lines"": 2}, ""runtime/ftplugin/tex.vim"": {""insertions"": 1, ""deletions"": 1, ""lines"": 2}, ""runtime/indent/ada.vim"": {""insertions"": 1, ""deletions"": 1, ""lines"": 2}, ""runtime/indent/cdl.vim"": {""insertions"": 6, ""deletions"": 6, ""lines"": 12}, ""runtime/indent/config.vim"": {""insertions"": 2, ""deletions"": 2, ""lines"": 4}, ""runtime/indent/dtd.vim"": {""insertions"": 3, ""deletions"": 3, ""lines"": 6}, ""runtime/indent/erlang.vim"": {""insertions"": 4, ""deletions"": 4, ""lines"": 8}, ""runtime/indent/json.vim"": {""insertions"": 1, ""deletions"": 1, ""lines"": 2}, ""runtime/indent/lifelines.vim"": {""insertions"": 1, ""deletions"": 1, ""lines"": 2}, ""runtime/indent/objc.vim"": {""insertions"": 1, ""deletions"": 1, ""lines"": 2}, ""runtime/indent/pov.vim"": {""insertions"": 1, ""deletions"": 1, ""lines"": 2}, ""runtime/indent/ruby.vim"": {""insertions"": 1, ""deletions"": 1, ""lines"": 2}, ""runtime/indent/sqlanywhere.vim"": {""insertions"": 1, ""deletions"": 1, ""lines"": 2}, ""runtime/indent/systemverilog.vim"": {""insertions"": 2, ""deletions"": 2, ""lines"": 4}, ""runtime/indent/tex.vim"": {""insertions"": 1, ""deletions"": 1, ""lines"": 2}, ""runtime/indent/treetop.vim"": {""insertions"": 1, ""deletions"": 1, ""lines"": 2}, ""runtime/indent/typescript.vim"": {""insertions"": 1, ""deletions"": 1, ""lines"": 2}, ""runtime/indent/verilog.vim"": {""insertions"": 2, ""deletions"": 2, ""lines"": 4}, ""runtime/keymap/kana.vim"": {""insertions"": 2, ""deletions"": 2, ""lines"": 4}, ""runtime/keymap/korean.vim"": {""insertions"": 1, ""deletions"": 1, ""lines"": 2}, ""runtime/keymap/russian-jcukenwintype.vim"": {""insertions"": 1, ""deletions"": 1, ""lines"": 2}, ""runtime/keymap/russian-typograph.vim"": {""insertions"": 2, ""deletions"": 2, ""lines"": 4}, ""runtime/plugin/tohtml.vim"": {""insertions"": 1, ""deletions"": 1, ""lines"": 2}, ""runtime/syntax/2html.vim"": {""insertions"": 2, ""deletions"": 2, ""lines"": 4}, ""runtime/syntax/abel.vim"": {""insertions"": 1, ""deletions"": 1, ""lines"": 2}, ""runtime/syntax/ada.vim"": {""insertions"": 1, ""deletions"": 1, ""lines"": 2}, ""runtime/syntax/ahdl.vim"": {""insertions"": 1, ""deletions"": 1, ""lines"": 2}, ""runtime/syntax/aspvbs.vim"": {""insertions"": 5, ""deletions"": 5, ""lines"": 10}, ""runtime/syntax/cfg.vim"": {""insertions"": 1, ""deletions"": 1, ""lines"": 2}, ""runtime/syntax/csc.vim"": {""insertions"": 1, ""deletions"": 1, ""lines"": 2}, ""runtime/syntax/cupl.vim"": {""insertions"": 1, ""deletions"": 1, ""lines"": 2}, ""runtime/syntax/dosbatch.vim"": {""insertions"": 1, ""deletions"": 1, ""lines"": 2}, ""runtime/syntax/doxygen.vim"": {""insertions"": 4, ""deletions"": 4, ""lines"": 8}, ""runtime/syntax/focexec.vim"": {""insertions"": 1, ""deletions"": 1, ""lines"": 2}, ""runtime/syntax/forth.vim"": {""insertions"": 1, ""deletions"": 1, ""lines"": 2}, ""runtime/syntax/hamster.vim"": {""insertions"": 1, ""deletions"": 1, ""lines"": 2}, ""runtime/syntax/idl.vim"": {""insertions"": 1, ""deletions"": 1, ""lines"": 2}, ""runtime/syntax/iss.vim"": {""insertions"": 2, ""deletions"": 2, ""lines"": 4}, ""runtime/syntax/mma.vim"": {""insertions"": 2, ""deletions"": 2, ""lines"": 4}, ""runtime/syntax/objc.vim"": {""insertions"": 1, ""deletions"": 1, ""lines"": 2}, ""runtime/syntax/postscr.vim"": {""insertions"": 6, ""deletions"": 6, ""lines"": 12}, ""runtime/syntax/sgml.vim"": {""insertions"": 3, ""deletions"": 3, ""lines"": 6}, ""runtime/syntax/spup.vim"": {""insertions"": 3, ""deletions"": 3, ""lines"": 6}, ""runtime/syntax/st.vim"": {""insertions"": 2, ""deletions"": 2, ""lines"": 4}, ""runtime/syntax/tcl.vim"": {""insertions"": 1, ""deletions"": 1, ""lines"": 2}, ""runtime/syntax/tmux.vim"": {""insertions"": 1, ""deletions"": 1, ""lines"": 2}}"
2021-09-09 18:45:34,d176ca3dde47c11aae0376c31b7e1ba0939c8c6c,Dominique Pelle,21,2,23,4,"{""src/testdir/test_functions.vim"": {""insertions"": 1, ""deletions"": 0, ""lines"": 1}, ""src/testdir/test_history.vim"": {""insertions"": 16, ""deletions"": 0, ""lines"": 16}, ""src/testdir/test_startup.vim"": {""insertions"": 2, ""deletions"": 2, ""lines"": 4}, ""src/version.c"": {""insertions"": 2, ""deletions"": 0, ""lines"": 2}}"
2021-09-09 15:14:50,6b9efdde7828b3317b64f38bd90fb5a784a654c0,Christian Brabandt,9,3,12,3,"{""src/auto/configure"": {""insertions"": 4, ""deletions"": 2, ""lines"": 6}, ""src/configure.ac"": {""insertions"": 3, ""deletions"": 1, ""lines"": 4}, ""src/version.c"": {""insertions"": 2, ""deletions"": 0, ""lines"": 2}}"
2021-09-09 10:34:19,0325d3967ce7d0fd35bc1472fd476b911b895b76,Bram Moolenaar,11,17,28,3,"{""src/debugger.c"": {""insertions"": 8, ""deletions"": 14, ""lines"": 22}, ""src/testdir/test_debugger.vim"": {""insertions"": 1, ""deletions"": 3, ""lines"": 4}, ""src/version.c"": {""insertions"": 2, ""deletions"": 0, ""lines"": 2}}"
2021-09-09 10:12:03,070ac3433b0ebefd6dc6cd49707fcfa1421b9e67,Christian Brabandt,5,0,5,2,"{""src/eval.c"": {""insertions"": 3, ""deletions"": 0, ""lines"": 3}, ""src/version.c"": {""insertions"": 2, ""deletions"": 0, ""lines"": 2}}"
2021-09-08 18:40:34,072f1c68884a1e2d468a0f39e27fc28168fb4b03,Bram Moolenaar,57,8,65,3,"{""src/debugger.c"": {""insertions"": 26, ""deletions"": 8, ""lines"": 34}, ""src/testdir/test_debugger.vim"": {""insertions"": 29, ""deletions"": 0, ""lines"": 29}, ""src/version.c"": {""insertions"": 2, ""deletions"": 0, ""lines"": 2}}"
2021-09-08 13:33:30,36f691f5f1d0676f080cc97d697d742ed5cc8251,Bram Moolenaar,27,1,28,3,"{""src/testdir/test_trycatch.vim"": {""insertions"": 24, ""deletions"": 0, ""lines"": 24}, ""src/userfunc.c"": {""insertions"": 1, ""deletions"": 1, ""lines"": 2}, ""src/version.c"": {""insertions"": 2, ""deletions"": 0, ""lines"": 2}}"
2021-09-08 12:57:42,fc3b775055c2361e507a1a44008d5a7d37eecf14,Yegappan Lakshmanan,115,13,128,7,"{""src/channel.c"": {""insertions"": 1, ""deletions"": 1, ""lines"": 2}, ""src/digraph.c"": {""insertions"": 2, ""deletions"": 2, ""lines"": 4}, ""src/evalfunc.c"": {""insertions"": 2, ""deletions"": 6, ""lines"": 8}, ""src/terminal.c"": {""insertions"": 1, ""deletions"": 1, ""lines"": 2}, ""src/testdir/test_digraph.vim"": {""insertions"": 11, ""deletions"": 1, ""lines"": 12}, ""src/testdir/test_vim9_builtin.vim"": {""insertions"": 96, ""deletions"": 2, ""lines"": 98}, ""src/version.c"": {""insertions"": 2, ""deletions"": 0, ""lines"": 2}}"
2021-09-08 12:29:46,80c88eac5a81dd9f1a96fc80cb8aab6c84fe7b86,Bram Moolenaar,41,5,46,5,"{""src/ex_docmd.c"": {""insertions"": 3, ""deletions"": 3, ""lines"": 6}, ""src/proto/usercmd.pro"": {""insertions"": 2, ""deletions"": 1, ""lines"": 3}, ""src/testdir/test_cmdline.vim"": {""insertions"": 7, ""deletions"": 0, ""lines"": 7}, ""src/usercmd.c"": {""insertions"": 27, ""deletions"": 1, ""lines"": 28}, ""src/version.c"": {""insertions"": 2, ""deletions"": 0, ""lines"": 2}}"
2021-09-08 10:31:35,a9e3d560877489acf751f99e045ab1d78e13249c,Bram Moolenaar,31,5,36,4,"{""src/errors.h"": {""insertions"": 2, ""deletions"": 2, ""lines"": 4}, ""src/testdir/test_vim9_script.vim"": {""insertions"": 17, ""deletions"": 0, ""lines"": 17}, ""src/version.c"": {""insertions"": 2, ""deletions"": 0, ""lines"": 2}, ""src/vim9script.c"": {""insertions"": 10, ""deletions"": 3, ""lines"": 13}}"
2021-09-07 20:35:34,af2d5d2ce26029a47547c05be964e749bb0310d0,Bram Moolenaar,5,2,7,2,"{""src/testdir/test_vim9_script.vim"": {""insertions"": 3, ""deletions"": 2, ""lines"": 5}, ""src/version.c"": {""insertions"": 2, ""deletions"": 0, ""lines"": 2}}"
2021-09-07 20:12:19,6853c38b78fe5333f95470e1ff3ca6741247e600,Bram Moolenaar,25,0,25,4,"{""src/errors.h"": {""insertions"": 2, ""deletions"": 0, ""lines"": 2}, ""src/evalvars.c"": {""insertions"": 6, ""deletions"": 0, ""lines"": 6}, ""src/testdir/test_vim9_script.vim"": {""insertions"": 15, ""deletions"": 0, ""lines"": 15}, ""src/version.c"": {""insertions"": 2, ""deletions"": 0, ""lines"": 2}}"
2021-09-07 18:45:31,89a54b413a8c96206ce7e038dde81a6eff6cd6b8,Bram Moolenaar,48,31,79,3,"{""src/drawline.c"": {""insertions"": 36, ""deletions"": 31, ""lines"": 67}, ""src/testdir/test_listlbr_utf8.vim"": {""insertions"": 10, ""deletions"": 0, ""lines"": 10}, ""src/version.c"": {""insertions"": 2, ""deletions"": 0, ""lines"": 2}}"
2021-09-07 17:26:53,65b605665997fad54ef39a93199e305af2fe4d7f,Bram Moolenaar,12,1,13,3,"{""src/regexp_nfa.c"": {""insertions"": 2, ""deletions"": 1, ""lines"": 3}, ""src/testdir/test_regexp_utf8.vim"": {""insertions"": 8, ""deletions"": 0, ""lines"": 8}, ""src/version.c"": {""insertions"": 2, ""deletions"": 0, ""lines"": 2}}"
2021-09-06 18:56:56,ddfc05100a29263a682dd96bb924dfde4354a654,Bram Moolenaar,14,0,14,3,"{""src/testdir/test_user_func.vim"": {""insertions"": 5, ""deletions"": 0, ""lines"": 5}, ""src/userfunc.c"": {""insertions"": 7, ""deletions"": 0, ""lines"": 7}, ""src/version.c"": {""insertions"": 2, ""deletions"": 0, ""lines"": 2}}"
2021-09-06 17:19:45,3b318513561b5862944769188ae4af6b70311838,Bram Moolenaar,3,0,3,2,"{""src/dict.c"": {""insertions"": 1, ""deletions"": 0, ""lines"": 1}, ""src/version.c"": {""insertions"": 2, ""deletions"": 0, ""lines"": 2}}"
2021-09-06 16:57:30,3ae5fc9a6a881e0be381e4cc70080ac5908d7520,Bram Moolenaar,12,0,12,3,"{""src/auto/configure"": {""insertions"": 4, ""deletions"": 0, ""lines"": 4}, ""src/configure.ac"": {""insertions"": 6, ""deletions"": 0, ""lines"": 6}, ""src/version.c"": {""insertions"": 2, ""deletions"": 0, ""lines"": 2}}"
2021-09-06 15:10:59,ec1b0968aa90d408a79b5b5dca465f65e69753a1,Bram Moolenaar,13,1,14,3,"{""src/ex_docmd.c"": {""insertions"": 9, ""deletions"": 0, ""lines"": 9}, ""src/testdir/test_usercommands.vim"": {""insertions"": 2, ""deletions"": 1, ""lines"": 3}, ""src/version.c"": {""insertions"": 2, ""deletions"": 0, ""lines"": 2}}"
2021-09-05 14:36:23,01dd6c3732a2f352d598e36336a65049614d7508,Bram Moolenaar,12,2,14,3,"{""src/testdir/test_vim9_func.vim"": {""insertions"": 4, ""deletions"": 0, ""lines"": 4}, ""src/userfunc.c"": {""insertions"": 6, ""deletions"": 2, ""lines"": 8}, ""src/version.c"": {""insertions"": 2, ""deletions"": 0, ""lines"": 2}}"
2021-09-04 19:20:41,2ddb89f8a94425cda1e5491efc80c1ccccb6e08e,Bram Moolenaar,13,2,15,2,"{""src/indent.c"": {""insertions"": 11, ""deletions"": 2, ""lines"": 13}, ""src/version.c"": {""insertions"": 2, ""deletions"": 0, ""lines"": 2}}"
2021-09-04 16:47:28,b7081e135a16091c93f6f5f7525a5c58fb7ca9f9,Bram Moolenaar,34,21,55,5,"{""src/indent.c"": {""insertions"": 21, ""deletions"": 13, ""lines"": 34}, ""src/option.c"": {""insertions"": 6, ""deletions"": 6, ""lines"": 12}, ""src/optionstr.c"": {""insertions"": 2, ""deletions"": 2, ""lines"": 4}, ""src/testdir/test_retab.vim"": {""insertions"": 3, ""deletions"": 0, ""lines"": 3}, ""src/version.c"": {""insertions"": 2, ""deletions"": 0, ""lines"": 2}}"
2021-09-04 12:49:56,10c83dde554b57ab4db71b96a0a02a5b6d1798e9,Bram Moolenaar,18,2,20,3,"{""src/evalfunc.c"": {""insertions"": 2, ""deletions"": 2, ""lines"": 4}, ""src/testdir/test_vim9_builtin.vim"": {""insertions"": 14, ""deletions"": 0, ""lines"": 14}, ""src/version.c"": {""insertions"": 2, ""deletions"": 0, ""lines"": 2}}"
2021-09-04 11:44:01,7f2dd1e90c1d4a30c791fae20014594641769a1e,Dominique Pelle,45,8,53,5,"{""runtime/doc/various.txt"": {""insertions"": 8, ""deletions"": 3, ""lines"": 11}, ""src/ex_cmds.c"": {""insertions"": 1, ""deletions"": 1, ""lines"": 2}, ""src/ex_cmds.h"": {""insertions"": 1, ""deletions"": 1, ""lines"": 2}, ""src/testdir/test_ex_z.vim"": {""insertions"": 33, ""deletions"": 3, ""lines"": 36}, ""src/version.c"": {""insertions"": 2, ""deletions"": 0, ""lines"": 2}}"
2021-09-03 17:21:36,deba5eb195d6ac70171d4973091fa884809fa3fa,Bram Moolenaar,116,5,121,5,"{""runtime/autoload/dist/ft.vim"": {""insertions"": 15, ""deletions"": 4, ""lines"": 19}, ""runtime/doc/filetype.txt"": {""insertions"": 1, ""deletions"": 0, ""lines"": 1}, ""runtime/filetype.vim"": {""insertions"": 4, ""deletions"": 1, ""lines"": 5}, ""src/testdir/test_filetype.vim"": {""insertions"": 94, ""deletions"": 0, ""lines"": 94}, ""src/version.c"": {""insertions"": 2, ""deletions"": 0, ""lines"": 2}}"
2021-09-03 14:50:16,af631f61bc42d0dddafe1bc0c06872cf3aaeb239,Dominique Pelle,116,94,210,2,"{""src/testdir/test_textobjects.vim"": {""insertions"": 114, ""deletions"": 94, ""lines"": 208}, ""src/version.c"": {""insertions"": 2, ""deletions"": 0, ""lines"": 2}}"
2021-09-02 18:05:26,03d257998b6343fc91f9dfd5ffc92eebe98d4d24,Yegappan Lakshmanan,20,0,20,2,"{""src/testdir/test_breakindent.vim"": {""insertions"": 18, ""deletions"": 0, ""lines"": 18}, ""src/version.c"": {""insertions"": 2, ""deletions"": 0, ""lines"": 2}}"
2021-09-02 17:53:07,87e1587b8add93e40340170e4261cdadc4c8940e,Bram Moolenaar,7,0,7,2,"{""src/evalfunc.c"": {""insertions"": 5, ""deletions"": 0, ""lines"": 5}, ""src/version.c"": {""insertions"": 2, ""deletions"": 0, ""lines"": 2}}"
2021-09-02 16:49:06,26a4484da20039b61f18d3565a4b4339c4d1f7e3,Bram Moolenaar,75,5,80,8,"{""src/debugger.c"": {""insertions"": 28, ""deletions"": 0, ""lines"": 28}, ""src/proto/debugger.pro"": {""insertions"": 1, ""deletions"": 0, ""lines"": 1}, ""src/proto/vim9execute.pro"": {""insertions"": 1, ""deletions"": 0, ""lines"": 1}, ""src/testdir/test_debugger.vim"": {""insertions"": 21, ""deletions"": 0, ""lines"": 21}, ""src/version.c"": {""insertions"": 2, ""deletions"": 0, ""lines"": 2}, ""src/vim.h"": {""insertions"": 9, ""deletions"": 2, ""lines"": 11}, ""src/vim9.h"": {""insertions"": 2, ""deletions"": 2, ""lines"": 4}, ""src/vim9execute.c"": {""insertions"": 11, ""deletions"": 1, ""lines"": 12}}"
2021-09-01 14:02:07,04626c243c47af91c2580eaf23e12286180e0e81,Bram Moolenaar,86,1,87,6,"{""src/diff.c"": {""insertions"": 13, ""deletions"": 0, ""lines"": 13}, ""src/move.c"": {""insertions"": 7, ""deletions"": 1, ""lines"": 8}, ""src/testdir/dumps/Test_diff_scroll_change_01.dump"": {""insertions"": 20, ""deletions"": 0, ""lines"": 20}, ""src/testdir/dumps/Test_diff_scroll_change_02.dump"": {""insertions"": 20, ""deletions"": 0, ""lines"": 20}, ""src/testdir/test_diffmode.vim"": {""insertions"": 24, ""deletions"": 0, ""lines"": 24}, ""src/version.c"": {""insertions"": 2, ""deletions"": 0, ""lines"": 2}}"
2021-09-01 12:31:51,6631597452d4644f485a09e4036d117e5f91de70,Bram Moolenaar,13,10,23,3,"{""src/strings.c"": {""insertions"": 1, ""deletions"": 0, ""lines"": 1}, ""src/testdir/test_shell.vim"": {""insertions"": 10, ""deletions"": 10, ""lines"": 20}, ""src/version.c"": {""insertions"": 2, ""deletions"": 0, ""lines"": 2}}"
2021-09-01 11:03:39,b4d82e2a8d610c00139a74970df772eece2daf1c,Bram Moolenaar,9,5,14,3,"{""src/cmdexpand.c"": {""insertions"": 2, ""deletions"": 2, ""lines"": 4}, ""src/testdir/test_cmdline.vim"": {""insertions"": 5, ""deletions"": 3, ""lines"": 8}, ""src/version.c"": {""insertions"": 2, ""deletions"": 0, ""lines"": 2}}"
2021-08-31 18:57:55,20e0c3d27bda770542c1c0e4c81fd6443c12f3a6,Bram Moolenaar,10,3,13,2,"{""src/drawline.c"": {""insertions"": 8, ""deletions"": 3, ""lines"": 11}, ""src/version.c"": {""insertions"": 2, ""deletions"": 0, ""lines"": 2}}"
2021-08-31 18:46:39,ba02e4720f863fdb456e7023520f0a354eec0dcf,Christian Brabandt,239,144,383,16,"{""src/diff.c"": {""insertions"": 1, ""deletions"": 1, ""lines"": 2}, ""src/version.c"": {""insertions"": 2, ""deletions"": 0, ""lines"": 2}, ""src/xdiff/README.txt"": {""insertions"": 1, ""deletions"": 1, ""lines"": 2}, ""src/xdiff/xdiff.h"": {""insertions"": 24, ""deletions"": 13, ""lines"": 37}, ""src/xdiff/xdiffi.c"": {""insertions"": 117, ""deletions"": 59, ""lines"": 176}, ""src/xdiff/xdiffi.h"": {""insertions"": 1, ""deletions"": 1, ""lines"": 2}, ""src/xdiff/xemit.c"": {""insertions"": 26, ""deletions"": 10, ""lines"": 36}, ""src/xdiff/xemit.h"": {""insertions"": 1, ""deletions"": 1, ""lines"": 2}, ""src/xdiff/xhistogram.c"": {""insertions"": 8, ""deletions"": 8, ""lines"": 16}, ""src/xdiff/xinclude.h"": {""insertions"": 8, ""deletions"": 2, ""lines"": 10}, ""src/xdiff/xmacros.h"": {""insertions"": 1, ""deletions"": 1, ""lines"": 2}, ""src/xdiff/xpatience.c"": {""insertions"": 23, ""deletions"": 30, ""lines"": 53}, ""src/xdiff/xprepare.h"": {""insertions"": 1, ""deletions"": 1, ""lines"": 2}, ""src/xdiff/xtypes.h"": {""insertions"": 1, ""deletions"": 1, ""lines"": 2}, ""src/xdiff/xutils.c"": {""insertions"": 23, ""deletions"": 14, ""lines"": 37}, ""src/xdiff/xutils.h"": {""insertions"": 1, ""deletions"": 1, ""lines"": 2}}"
2021-08-31 17:12:51,dca29d9cf46cd1d4d4519211c7af78b6b1c56960,zeertzjq,119,7,126,5,"{""runtime/doc/index.txt"": {""insertions"": 1, ""deletions"": 0, ""lines"": 1}, ""runtime/doc/insert.txt"": {""insertions"": 8, ""deletions"": 0, ""lines"": 8}, ""src/insexpand.c"": {""insertions"": 48, ""deletions"": 7, ""lines"": 55}, ""src/testdir/test_ins_complete.vim"": {""insertions"": 60, ""deletions"": 0, ""lines"": 60}, ""src/version.c"": {""insertions"": 2, ""deletions"": 0, ""lines"": 2}}"
2021-08-30 19:26:16,4eaef9979fc5032606897963f1af37674ee0d422,Bram Moolenaar,11,1,12,3,"{""src/os_unix.c"": {""insertions"": 7, ""deletions"": 1, ""lines"": 8}, ""src/testdir/test_fnamemodify.vim"": {""insertions"": 2, ""deletions"": 0, ""lines"": 2}, ""src/version.c"": {""insertions"": 2, ""deletions"": 0, ""lines"": 2}}"
2021-08-30 17:57:34,de05ae71589f46c5d27642c33fe5eb21b22aaf5d,Dominique Pelle,3,1,4,2,"{""src/strings.c"": {""insertions"": 1, ""deletions"": 1, ""lines"": 2}, ""src/version.c"": {""insertions"": 2, ""deletions"": 0, ""lines"": 2}}"
2021-08-29 20:12:56,a91871262670f9d3a4e5d1c5c6dbc02f85625f7d,Dominique Pelle,3,0,3,2,"{""src/indent.c"": {""insertions"": 1, ""deletions"": 0, ""lines"": 1}, ""src/version.c"": {""insertions"": 2, ""deletions"": 0, ""lines"": 2}}"
2021-08-29 19:55:35,89a9c159f23fb7b3e24e6d09068adfc24a73afcb,Bram Moolenaar,649,242,891,39,"{"".github/workflows/codeql-analysis.yml"": {""insertions"": 1, ""deletions"": 1, ""lines"": 2}, ""CONTRIBUTING.md"": {""insertions"": 1, ""deletions"": 1, ""lines"": 2}, ""README.md"": {""insertions"": 7, ""deletions"": 7, ""lines"": 14}, ""README.txt"": {""insertions"": 6, ""deletions"": 6, ""lines"": 12}, ""README_VIM9.md"": {""insertions"": 1, ""deletions"": 1, ""lines"": 2}, ""nsis/lang/turkish.nsi"": {""insertions"": 7, ""deletions"": 7, ""lines"": 14}, ""pixmaps/gen-inline-pixbufs.sh"": {""insertions"": 2, ""deletions"": 4, ""lines"": 6}, ""runtime/autoload/netrw.vim"": {""insertions"": 213, ""deletions"": 80, ""lines"": 293}, ""runtime/autoload/netrwSettings.vim"": {""insertions"": 4, ""deletions"": 4, ""lines"": 8}, ""runtime/doc/eval.txt"": {""insertions"": 16, ""deletions"": 16, ""lines"": 32}, ""runtime/doc/index.txt"": {""insertions"": 1, ""deletions"": 1, ""lines"": 2}, ""runtime/doc/insert.txt"": {""insertions"": 1, ""deletions"": 1, ""lines"": 2}, ""runtime/doc/options.txt"": {""insertions"": 11, ""deletions"": 4, ""lines"": 15}, ""runtime/doc/pi_netrw.txt"": {""insertions"": 72, ""deletions"": 12, ""lines"": 84}, ""runtime/doc/popup.txt"": {""insertions"": 18, ""deletions"": 7, ""lines"": 25}, ""runtime/doc/syntax.txt"": {""insertions"": 6, ""deletions"": 5, ""lines"": 11}, ""runtime/doc/tags"": {""insertions"": 5, ""deletions"": 0, ""lines"": 5}, ""runtime/doc/term.txt"": {""insertions"": 37, ""deletions"": 1, ""lines"": 38}, ""runtime/doc/terminal.txt"": {""insertions"": 15, ""deletions"": 13, ""lines"": 28}, ""runtime/doc/testing.txt"": {""insertions"": 16, ""deletions"": 8, ""lines"": 24}, ""runtime/doc/textprop.txt"": {""insertions"": 1, ""deletions"": 1, ""lines"": 2}, ""runtime/doc/todo.txt"": {""insertions"": 5, ""deletions"": 1, ""lines"": 6}, ""runtime/doc/version6.txt"": {""insertions"": 1, ""deletions"": 1, ""lines"": 2}, ""runtime/doc/vim9.txt"": {""insertions"": 9, ""deletions"": 6, ""lines"": 15}, ""runtime/filetype.vim"": {""insertions"": 1, ""deletions"": 1, ""lines"": 2}, ""runtime/ftplugin/scala.vim"": {""insertions"": 3, ""deletions"": 3, ""lines"": 6}, ""runtime/indent/scala.vim"": {""insertions"": 6, ""deletions"": 3, ""lines"": 9}, ""runtime/pack/dist/opt/termdebug/plugin/termdebug.vim"": {""insertions"": 5, ""deletions"": 1, ""lines"": 6}, ""runtime/plugin/netrwPlugin.vim"": {""insertions"": 21, ""deletions"": 7, ""lines"": 28}, ""runtime/syntax/cpp.vim"": {""insertions"": 19, ""deletions"": 2, ""lines"": 21}, ""runtime/syntax/gemtext.vim"": {""insertions"": 24, ""deletions"": 0, ""lines"": 24}, ""runtime/syntax/scala.vim"": {""insertions"": 12, ""deletions"": 12, ""lines"": 24}, ""runtime/syntax/structurizr.vim"": {""insertions"": 76, ""deletions"": 0, ""lines"": 76}, ""runtime/tutor/tutor"": {""insertions"": 5, ""deletions"": 5, ""lines"": 10}, ""runtime/tutor/tutor.utf-8"": {""insertions"": 5, ""deletions"": 5, ""lines"": 10}, ""src/INSTALL"": {""insertions"": 1, ""deletions"": 0, ""lines"": 1}, ""src/gvimtutor"": {""insertions"": 1, ""deletions"": 1, ""lines"": 2}, ""src/vimtutor"": {""insertions"": 13, ""deletions"": 13, ""lines"": 26}, ""vimtutor.bat"": {""insertions"": 1, ""deletions"": 1, ""lines"": 2}}"
2021-08-29 10:36:49,6e82351130ddb8d13cf3748b47f07cae77886fc7,Jason Cox,38,8,46,4,"{""runtime/doc/eval.txt"": {""insertions"": 4, ""deletions"": 0, ""lines"": 4}, ""src/strings.c"": {""insertions"": 21, ""deletions"": 0, ""lines"": 21}, ""src/testdir/test_shell.vim"": {""insertions"": 11, ""deletions"": 8, ""lines"": 19}, ""src/version.c"": {""insertions"": 2, ""deletions"": 0, ""lines"": 2}}"
2021-08-28 18:42:50,9dcd349ca85e1df1abd1cbf1c29c0f1574b70bf8,Hu Jialun,21,2,23,4,"{""runtime/doc/options.txt"": {""insertions"": 9, ""deletions"": 0, ""lines"": 9}, ""src/buffer.c"": {""insertions"": 2, ""deletions"": 2, ""lines"": 4}, ""src/testdir/test_modeline.vim"": {""insertions"": 8, ""deletions"": 0, ""lines"": 8}, ""src/version.c"": {""insertions"": 2, ""deletions"": 0, ""lines"": 2}}"
2021-08-28 13:56:06,9aecf79c45da5593e4d8c0de1b2d212edc4765ce,naohiro ono,7,2,9,3,"{""src/testdir/test_cmdline.vim"": {""insertions"": 3, ""deletions"": 1, ""lines"": 4}, ""src/userfunc.c"": {""insertions"": 2, ""deletions"": 1, ""lines"": 3}, ""src/version.c"": {""insertions"": 2, ""deletions"": 0, ""lines"": 2}}"
2021-08-28 12:58:44,c8103b4c2547ce2044469bcd49e3d55907bd33d1,Bram Moolenaar,14,2,16,3,"{""src/testdir/test_vim9_builtin.vim"": {""insertions"": 9, ""deletions"": 0, ""lines"": 9}, ""src/version.c"": {""insertions"": 2, ""deletions"": 0, ""lines"": 2}, ""src/vim9type.c"": {""insertions"": 3, ""deletions"": 2, ""lines"": 5}}"
2021-08-28 12:42:25,5c56da4de8398566ef96122db44ec93e6c2d483a,Bram Moolenaar,10,1,11,3,"{""src/globals.h"": {""insertions"": 1, ""deletions"": 1, ""lines"": 2}, ""src/testdir/test_signs.vim"": {""insertions"": 7, ""deletions"": 0, ""lines"": 7}, ""src/version.c"": {""insertions"": 2, ""deletions"": 0, ""lines"": 2}}"
2021-08-28 10:49:27,60b6e6f6cc60ac99253e1c13bd0cae4ef0e43201,Bram Moolenaar,8,0,8,3,"{""src/evalfunc.c"": {""insertions"": 5, ""deletions"": 0, ""lines"": 5}, ""src/testdir/test_expr.vim"": {""insertions"": 1, ""deletions"": 0, ""lines"": 1}, ""src/version.c"": {""insertions"": 2, ""deletions"": 0, ""lines"": 2}}"
2021-08-28 10:30:12,271906bc067a8f25422016665001d2e44cf618e2,Bram Moolenaar,10,1,11,3,"{""src/job.c"": {""insertions"": 4, ""deletions"": 1, ""lines"": 5}, ""src/testdir/test_channel.vim"": {""insertions"": 4, ""deletions"": 0, ""lines"": 4}, ""src/version.c"": {""insertions"": 2, ""deletions"": 0, ""lines"": 2}}"
2021-08-27 18:59:35,6024c0427ce1196344439997d5e41a6f8546368c,Albert Liu,9,7,16,3,"{""src/cmdexpand.c"": {""insertions"": 3, ""deletions"": 7, ""lines"": 10}, ""src/testdir/test_cmdline.vim"": {""insertions"": 4, ""deletions"": 0, ""lines"": 4}, ""src/version.c"": {""insertions"": 2, ""deletions"": 0, ""lines"": 2}}"
2021-08-26 14:39:58,47016f57724d3970c54f4ca1f392dff39d3fecae,Bram Moolenaar,13,1,14,3,"{""src/cmdexpand.c"": {""insertions"": 3, ""deletions"": 1, ""lines"": 4}, ""src/testdir/test_cmdline.vim"": {""insertions"": 8, ""deletions"": 0, ""lines"": 8}, ""src/version.c"": {""insertions"": 2, ""deletions"": 0, ""lines"": 2}}"
2021-08-25 20:37:36,4799cef85ce43e26f5022290b41a7c85bbab8cad,Bram Moolenaar,32,15,47,5,"{""src/ex_eval.c"": {""insertions"": 21, ""deletions"": 9, ""lines"": 30}, ""src/proto/ex_eval.pro"": {""insertions"": 1, ""deletions"": 0, ""lines"": 1}, ""src/testdir/test_vim9_cmd.vim"": {""insertions"": 7, ""deletions"": 1, ""lines"": 8}, ""src/version.c"": {""insertions"": 2, ""deletions"": 0, ""lines"": 2}, ""src/vim9compile.c"": {""insertions"": 1, ""deletions"": 5, ""lines"": 6}}"
2021-08-25 15:31:37,df9070e300dabf0c54de87a75973a80adb38afa3,Bram Moolenaar,4,1,5,2,"{""src/memline.c"": {""insertions"": 2, ""deletions"": 1, ""lines"": 3}, ""src/version.c"": {""insertions"": 2, ""deletions"": 0, ""lines"": 2}}"
2021-08-25 15:10:39,eb05d05f8a049b32ba1b992074534ca4763e46b3,Bram Moolenaar,6,0,6,3,"{""runtime/filetype.vim"": {""insertions"": 3, ""deletions"": 0, ""lines"": 3}, ""src/testdir/test_filetype.vim"": {""insertions"": 1, ""deletions"": 0, ""lines"": 1}, ""src/version.c"": {""insertions"": 2, ""deletions"": 0, ""lines"": 2}}"
2021-08-25 15:02:00,49b93049c68653156609ebcdf22311ccbcdf00e2,Bram Moolenaar,3,0,3,2,"{""src/testdir/test_textprop.vim"": {""insertions"": 1, ""deletions"": 0, ""lines"": 1}, ""src/version.c"": {""insertions"": 2, ""deletions"": 0, ""lines"": 2}}"
2021-08-25 14:40:03,cdd8a5e6fe089a3b1370ac940d06fc3cefc6f8f2,Bram Moolenaar,22,1,23,3,"{""src/memline.c"": {""insertions"": 11, ""deletions"": 1, ""lines"": 12}, ""src/testdir/test_textprop.vim"": {""insertions"": 9, ""deletions"": 0, ""lines"": 9}, ""src/version.c"": {""insertions"": 2, ""deletions"": 0, ""lines"": 2}}"
2021-08-24 19:56:03,5ca5cc6412d7d68fd380926f9551a8b7ba335199,Bram Moolenaar,28,4,32,4,"{""src/ex_docmd.c"": {""insertions"": 8, ""deletions"": 4, ""lines"": 12}, ""src/testdir/test_vim9_cmd.vim"": {""insertions"": 16, ""deletions"": 0, ""lines"": 16}, ""src/version.c"": {""insertions"": 2, ""deletions"": 0, ""lines"": 2}, ""src/vim9compile.c"": {""insertions"": 2, ""deletions"": 0, ""lines"": 2}}"
2021-08-23 20:22:45,60faf8656e1a100778bf7cd4d305380fb852d540,Bram Moolenaar,11,1,12,3,"{""src/eval.c"": {""insertions"": 7, ""deletions"": 1, ""lines"": 8}, ""src/testdir/test_vim9_assign.vim"": {""insertions"": 2, ""deletions"": 0, ""lines"": 2}, ""src/version.c"": {""insertions"": 2, ""deletions"": 0, ""lines"": 2}}"
2021-08-23 19:19:01,6b36d2a16d7931bac82ef8b5654c68ac456b24bf,Bram Moolenaar,12,1,13,3,"{""src/ops.c"": {""insertions"": 3, ""deletions"": 1, ""lines"": 4}, ""src/testdir/test_textformat.vim"": {""insertions"": 7, ""deletions"": 0, ""lines"": 7}, ""src/version.c"": {""insertions"": 2, ""deletions"": 0, ""lines"": 2}}"
2021-08-23 18:48:43,9cd91a1e8816d727fbdbf0b3062288e15abc5f4d,Bram Moolenaar,4,2,6,3,"{""runtime/filetype.vim"": {""insertions"": 1, ""deletions"": 1, ""lines"": 2}, ""src/testdir/test_filetype.vim"": {""insertions"": 1, ""deletions"": 1, ""lines"": 2}, ""src/version.c"": {""insertions"": 2, ""deletions"": 0, ""lines"": 2}}"
2021-08-22 20:44:11,73170917f14d1b0d919c65fbc0a9d011b87d94da,Bram Moolenaar,32,7,39,3,"{""src/ex_docmd.c"": {""insertions"": 14, ""deletions"": 7, ""lines"": 21}, ""src/testdir/test_vim9_cmd.vim"": {""insertions"": 16, ""deletions"": 0, ""lines"": 16}, ""src/version.c"": {""insertions"": 2, ""deletions"": 0, ""lines"": 2}}"
2021-08-22 11:35:31,093165c899f1620543844d1c1a7a05975697c286,Bram Moolenaar,74,2,76,3,"{""src/testdir/test_vim9_disassemble.vim"": {""insertions"": 47, ""deletions"": 0, ""lines"": 47}, ""src/version.c"": {""insertions"": 2, ""deletions"": 0, ""lines"": 2}, ""src/vim9compile.c"": {""insertions"": 25, ""deletions"": 2, ""lines"": 27}}"
2021-08-21 18:50:35,bf5f2878333da934a8bdc560bf0bcf9a88ff86a1,Bram Moolenaar,40,3,43,5,"{""src/ex_docmd.c"": {""insertions"": 20, ""deletions"": 2, ""lines"": 22}, ""src/proto/vim9compile.pro"": {""insertions"": 1, ""deletions"": 0, ""lines"": 1}, ""src/testdir/test_vim9_cmd.vim"": {""insertions"": 16, ""deletions"": 0, ""lines"": 16}, ""src/version.c"": {""insertions"": 2, ""deletions"": 0, ""lines"": 2}, ""src/vim9compile.c"": {""insertions"": 1, ""deletions"": 1, ""lines"": 2}}"
2021-08-21 15:26:50,bebf06954e1c801870b57e06ab03151c2654d079,rbtnn,202,130,332,3,"{""src/testdir/test_vim9_script.vim"": {""insertions"": 64, ""deletions"": 0, ""lines"": 64}, ""src/version.c"": {""insertions"": 2, ""deletions"": 0, ""lines"": 2}, ""src/vim9compile.c"": {""insertions"": 136, ""deletions"": 130, ""lines"": 266}}"
2021-08-21 15:13:14,b8bd2e6ebab03baf2672067067a599df69a278c0,Bram Moolenaar,12,4,16,6,"{""src/ex_cmds.c"": {""insertions"": 6, ""deletions"": 0, ""lines"": 6}, ""src/testdir/test_cmdline.vim"": {""insertions"": 1, ""deletions"": 1, ""lines"": 2}, ""src/testdir/test_undo.vim"": {""insertions"": 1, ""deletions"": 1, ""lines"": 2}, ""src/testdir/test_vim9_builtin.vim"": {""insertions"": 1, ""deletions"": 1, ""lines"": 2}, ""src/testdir/test_vim9_script.vim"": {""insertions"": 1, ""deletions"": 1, ""lines"": 2}, ""src/version.c"": {""insertions"": 2, ""deletions"": 0, ""lines"": 2}}"
2021-08-21 14:21:19,489d60996deb5e7c1a3b4633412d54632e6def42,Gregory Anders,51,16,67,3,"{""src/tag.c"": {""insertions"": 39, ""deletions"": 16, ""lines"": 55}, ""src/testdir/test_tagjump.vim"": {""insertions"": 10, ""deletions"": 0, ""lines"": 10}, ""src/version.c"": {""insertions"": 2, ""deletions"": 0, ""lines"": 2}}"
2021-08-20 18:54:25,d895b1d918f7d56dd9dd564be4820082ba6492e9,rbtnn,107,17,124,3,"{""src/testdir/test_vim9_script.vim"": {""insertions"": 83, ""deletions"": 0, ""lines"": 83}, ""src/version.c"": {""insertions"": 2, ""deletions"": 0, ""lines"": 2}, ""src/vim9compile.c"": {""insertions"": 22, ""deletions"": 17, ""lines"": 39}}"
2021-08-19 19:20:41,5aec755b678cfd434b8ea2158d06992f33e1ff80,naohiro ono,14,3,17,3,"{""src/evalfunc.c"": {""insertions"": 3, ""deletions"": 2, ""lines"": 5}, ""src/testdir/test_cmdline.vim"": {""insertions"": 9, ""deletions"": 1, ""lines"": 10}, ""src/version.c"": {""insertions"": 2, ""deletions"": 0, ""lines"": 2}}"
2021-08-19 19:08:30,c66f645b809d0852592ca37afacb9031b5950c7f,Bram Moolenaar,23,0,23,4,"{""src/errors.h"": {""insertions"": 2, ""deletions"": 0, ""lines"": 2}, ""src/testdir/test_vim9_func.vim"": {""insertions"": 9, ""deletions"": 0, ""lines"": 9}, ""src/version.c"": {""insertions"": 2, ""deletions"": 0, ""lines"": 2}, ""src/vim9type.c"": {""insertions"": 10, ""deletions"": 0, ""lines"": 10}}"
2021-08-17 21:44:54,dea561111a5761bf99397a246b8baa43e73288de,Bastian Venthur,26,3,29,3,"{""runtime/filetype.vim"": {""insertions"": 7, ""deletions"": 2, ""lines"": 9}, ""src/testdir/test_filetype.vim"": {""insertions"": 17, ""deletions"": 1, ""lines"": 18}, ""src/version.c"": {""insertions"": 2, ""deletions"": 0, ""lines"": 2}}"
2021-08-17 20:14:29,02f8694a6bd116ab3316add4a7ea6735bf2e8839,Bram Moolenaar,15,1,16,3,"{""src/misc2.c"": {""insertions"": 2, ""deletions"": 1, ""lines"": 3}, ""src/testdir/test_number.vim"": {""insertions"": 11, ""deletions"": 0, ""lines"": 11}, ""src/version.c"": {""insertions"": 2, ""deletions"": 0, ""lines"": 2}}"
2021-08-16 19:39:09,ccfb7c6758510e0fe5f390149ea14aee6ff4f55e,Yegappan Lakshmanan,253,77,330,9,"{""runtime/doc/eval.txt"": {""insertions"": 3, ""deletions"": 1, ""lines"": 4}, ""runtime/doc/textprop.txt"": {""insertions"": 32, ""deletions"": 0, ""lines"": 32}, ""runtime/doc/usr_41.txt"": {""insertions"": 1, ""deletions"": 0, ""lines"": 1}, ""src/evalfunc.c"": {""insertions"": 3, ""deletions"": 0, ""lines"": 3}, ""src/proto/textprop.pro"": {""insertions"": 1, ""deletions"": 0, ""lines"": 1}, ""src/testdir/test_textprop.vim"": {""insertions"": 35, ""deletions"": 0, ""lines"": 35}, ""src/testdir/test_vim9_builtin.vim"": {""insertions"": 5, ""deletions"": 0, ""lines"": 5}, ""src/textprop.c"": {""insertions"": 171, ""deletions"": 76, ""lines"": 247}, ""src/version.c"": {""insertions"": 2, ""deletions"": 0, ""lines"": 2}}"
2021-08-16 19:15:32,434df7a401c92d4084bb0a01ffd6d1737ae0193b,Bram Moolenaar,4,2,6,2,"{""src/memline.c"": {""insertions"": 2, ""deletions"": 2, ""lines"": 4}, ""src/version.c"": {""insertions"": 2, ""deletions"": 0, ""lines"": 2}}"
2021-08-15 20:18:04,92755bba30ec7a4c72ae0280420ba5c3847a9385,Bram Moolenaar,5,3,8,2,"{""src/memline.c"": {""insertions"": 3, ""deletions"": 3, ""lines"": 6}, ""src/version.c"": {""insertions"": 2, ""deletions"": 0, ""lines"": 2}}"
2021-08-15 18:36:28,cd6b4f300189b4920f7ee7f0204338e91210674b,Bram Moolenaar,49,31,80,5,"{""src/testdir/test_vim9_disassemble.vim"": {""insertions"": 15, ""deletions"": 13, ""lines"": 28}, ""src/testdir/test_vim9_expr.vim"": {""insertions"": 17, ""deletions"": 6, ""lines"": 23}, ""src/testdir/test_vim9_script.vim"": {""insertions"": 3, ""deletions"": 3, ""lines"": 6}, ""src/version.c"": {""insertions"": 2, ""deletions"": 0, ""lines"": 2}, ""src/vim9compile.c"": {""insertions"": 12, ""deletions"": 9, ""lines"": 21}}"
2021-08-15 17:28:05,4bba16d252da6f072d311f9b3ebb50101d6d2eaf,Bram Moolenaar,15,0,15,3,"{""src/testdir/test_vim9_func.vim"": {""insertions"": 11, ""deletions"": 0, ""lines"": 11}, ""src/userfunc.c"": {""insertions"": 2, ""deletions"": 0, ""lines"": 2}, ""src/version.c"": {""insertions"": 2, ""deletions"": 0, ""lines"": 2}}"
2021-08-15 14:08:36,b033ee2ddfa8513b57111a56d6af9e45c41f7d1e,Bram Moolenaar,23,0,23,3,"{""src/evalvars.c"": {""insertions"": 4, ""deletions"": 0, ""lines"": 4}, ""src/testdir/test_vim9_func.vim"": {""insertions"": 17, ""deletions"": 0, ""lines"": 17}, ""src/version.c"": {""insertions"": 2, ""deletions"": 0, ""lines"": 2}}"
2021-08-15 13:04:41,a401bba0805856e295c213aa504648084dae7e24,Bram Moolenaar,3,0,3,2,"{""src/testdir/test_textprop.vim"": {""insertions"": 1, ""deletions"": 0, ""lines"": 1}, ""src/version.c"": {""insertions"": 2, ""deletions"": 0, ""lines"": 2}}"
2021-08-15 12:39:13,5cebca27b831880fb6e191e5271ee614625e1f8a,Bram Moolenaar,4,2,6,2,"{""src/version.c"": {""insertions"": 2, ""deletions"": 0, ""lines"": 2}, ""src/vim9script.c"": {""insertions"": 2, ""deletions"": 2, ""lines"": 4}}"
2021-08-15 12:28:40,14c7530c4fca786d3594508e28943f10125827c3,Bram Moolenaar,29,3,32,3,"{""src/memline.c"": {""insertions"": 17, ""deletions"": 3, ""lines"": 20}, ""src/testdir/test_textprop.vim"": {""insertions"": 10, ""deletions"": 0, ""lines"": 10}, ""src/version.c"": {""insertions"": 2, ""deletions"": 0, ""lines"": 2}}"
2021-08-15 11:49:42,dd9de50f4262898384be6ea7694d05507c7cb260,Bram Moolenaar,77,9,86,9,"{""src/errors.h"": {""insertions"": 2, ""deletions"": 0, ""lines"": 2}, ""src/eval.c"": {""insertions"": 3, ""deletions"": 4, ""lines"": 7}, ""src/evalvars.c"": {""insertions"": 2, ""deletions"": 2, ""lines"": 4}, ""src/ex_docmd.c"": {""insertions"": 1, ""deletions"": 1, ""lines"": 2}, ""src/proto/vim9script.pro"": {""insertions"": 1, ""deletions"": 0, ""lines"": 1}, ""src/testdir/test_vim9_cmd.vim"": {""insertions"": 53, ""deletions"": 1, ""lines"": 54}, ""src/typval.c"": {""insertions"": 1, ""deletions"": 1, ""lines"": 2}, ""src/version.c"": {""insertions"": 2, ""deletions"": 0, ""lines"": 2}, ""src/vim9script.c"": {""insertions"": 12, ""deletions"": 0, ""lines"": 12}}"
2021-08-14 19:35:40,2596a4e763e11eb8e406f262cb72fd2b39461572,Bram Moolenaar,5,1,6,3,"{""src/eval.c"": {""insertions"": 2, ""deletions"": 1, ""lines"": 3}, ""src/testdir/test_vim9_cmd.vim"": {""insertions"": 1, ""deletions"": 0, ""lines"": 1}, ""src/version.c"": {""insertions"": 2, ""deletions"": 0, ""lines"": 2}}"
2021-08-14 19:25:52,6aa57295cfbe8f21c15f0671e45fd53cf990d404,Bram Moolenaar,1650,284,1934,35,"{""runtime/compiler/scdoc.vim"": {""insertions"": 16, ""deletions"": 0, ""lines"": 16}, ""runtime/doc/autocmd.txt"": {""insertions"": 2, ""deletions"": 2, ""lines"": 4}, ""runtime/doc/channel.txt"": {""insertions"": 4, ""deletions"": 4, ""lines"": 8}, ""runtime/doc/cmdline.txt"": {""insertions"": 7, ""deletions"": 2, ""lines"": 9}, ""runtime/doc/eval.txt"": {""insertions"": 212, ""deletions"": 184, ""lines"": 396}, ""runtime/doc/if_lua.txt"": {""insertions"": 1, ""deletions"": 1, ""lines"": 2}, ""runtime/doc/insert.txt"": {""insertions"": 2, ""deletions"": 2, ""lines"": 4}, ""runtime/doc/map.txt"": {""insertions"": 1, ""deletions"": 1, ""lines"": 2}, ""runtime/doc/message.txt"": {""insertions"": 9, ""deletions"": 1, ""lines"": 10}, ""runtime/doc/popup.txt"": {""insertions"": 3, ""deletions"": 1, ""lines"": 4}, ""runtime/doc/sign.txt"": {""insertions"": 11, ""deletions"": 11, ""lines"": 22}, ""runtime/doc/tags"": {""insertions"": 21, ""deletions"": 2, ""lines"": 23}, ""runtime/doc/terminal.txt"": {""insertions"": 32, ""deletions"": 5, ""lines"": 37}, ""runtime/doc/testing.txt"": {""insertions"": 1, ""deletions"": 1, ""lines"": 2}, ""runtime/doc/todo.txt"": {""insertions"": 5, ""deletions"": 16, ""lines"": 21}, ""runtime/doc/usr_41.txt"": {""insertions"": 1, ""deletions"": 1, ""lines"": 2}, ""runtime/doc/vim9.txt"": {""insertions"": 41, ""deletions"": 15, ""lines"": 56}, ""runtime/ftplugin/chicken.vim"": {""insertions"": 1, ""deletions"": 0, ""lines"": 1}, ""runtime/ftplugin/julia.vim"": {""insertions"": 92, ""deletions"": 0, ""lines"": 92}, ""runtime/ftplugin/scdoc.vim"": {""insertions"": 26, ""deletions"": 0, ""lines"": 26}, ""runtime/ftplugin/scheme.vim"": {""insertions"": 3, ""deletions"": 2, ""lines"": 5}, ""runtime/gvim.desktop"": {""insertions"": 0, ""deletions"": 6, ""lines"": 6}, ""runtime/indent/julia.vim"": {""insertions"": 491, ""deletions"": 0, ""lines"": 491}, ""runtime/indent/yaml.vim"": {""insertions"": 1, ""deletions"": 1, ""lines"": 2}, ""runtime/pack/dist/opt/termdebug/plugin/termdebug.vim"": {""insertions"": 22, ""deletions"": 1, ""lines"": 23}, ""runtime/plugin/manpager.vim"": {""insertions"": 5, ""deletions"": 2, ""lines"": 7}, ""runtime/syntax/chicken.vim"": {""insertions"": 19, ""deletions"": 2, ""lines"": 21}, ""runtime/syntax/debchangelog.vim"": {""insertions"": 3, ""deletions"": 3, ""lines"": 6}, ""runtime/syntax/debsources.vim"": {""insertions"": 3, ""deletions"": 3, ""lines"": 6}, ""runtime/syntax/julia.vim"": {""insertions"": 550, ""deletions"": 0, ""lines"": 550}, ""runtime/syntax/redif.vim"": {""insertions"": 2, ""deletions"": 2, ""lines"": 4}, ""runtime/syntax/scala.vim"": {""insertions"": 3, ""deletions"": 2, ""lines"": 5}, ""runtime/syntax/scdoc.vim"": {""insertions"": 52, ""deletions"": 0, ""lines"": 52}, ""runtime/syntax/scheme.vim"": {""insertions"": 8, ""deletions"": 5, ""lines"": 13}, ""runtime/vim.desktop"": {""insertions"": 0, ""deletions"": 6, ""lines"": 6}}"
2021-08-14 19:11:51,bfb2bb16bc69441fa3ec13caacb2c94637a8a0ec,Dominique Pelle,84,0,84,5,"{""src/testdir/test_arglist.vim"": {""insertions"": 6, ""deletions"": 0, ""lines"": 6}, ""src/testdir/test_cmdline.vim"": {""insertions"": 12, ""deletions"": 0, ""lines"": 12}, ""src/testdir/test_spellfile.vim"": {""insertions"": 27, ""deletions"": 0, ""lines"": 27}, ""src/testdir/test_substitute.vim"": {""insertions"": 37, ""deletions"": 0, ""lines"": 37}, ""src/version.c"": {""insertions"": 2, ""deletions"": 0, ""lines"": 2}}"
2021-08-14 13:16:00,d2e9ccee90d2b39f4c9fd6cec271ef3fafd76f09,Bram Moolenaar,8,1,9,2,"{""src/testdir/test_vimscript.vim"": {""insertions"": 6, ""deletions"": 1, ""lines"": 7}, ""src/version.c"": {""insertions"": 2, ""deletions"": 0, ""lines"": 2}}"
2021-08-14 12:59:27,4830c211a47f39edcf1827ffd787306faf65c2a5,Bram Moolenaar,3,2,5,2,"{""src/evalvars.c"": {""insertions"": 1, ""deletions"": 2, ""lines"": 3}, ""src/version.c"": {""insertions"": 2, ""deletions"": 0, ""lines"": 2}}"
2021-08-14 12:27:30,b521766c56c0e17db6e8615f35cf21012af0670c,Bram Moolenaar,5,2,7,3,"{""src/evalvars.c"": {""insertions"": 2, ""deletions"": 1, ""lines"": 3}, ""src/testdir/test_let.vim"": {""insertions"": 1, ""deletions"": 1, ""lines"": 2}, ""src/version.c"": {""insertions"": 2, ""deletions"": 0, ""lines"": 2}}"
2021-08-14 12:01:05,88c89c77229e725ab2613b022249e2f506d82b82,Bram Moolenaar,63,12,75,8,"{""src/evalvars.c"": {""insertions"": 2, ""deletions"": 1, ""lines"": 3}, ""src/globals.h"": {""insertions"": 2, ""deletions"": 2, ""lines"": 4}, ""src/message.c"": {""insertions"": 1, ""deletions"": 1, ""lines"": 2}, ""src/testdir/test_vim9_func.vim"": {""insertions"": 46, ""deletions"": 0, ""lines"": 46}, ""src/testdir/vim9.vim"": {""insertions"": 1, ""deletions"": 1, ""lines"": 2}, ""src/time.c"": {""insertions"": 2, ""deletions"": 2, ""lines"": 4}, ""src/version.c"": {""insertions"": 2, ""deletions"": 0, ""lines"": 2}, ""src/vim9execute.c"": {""insertions"": 7, ""deletions"": 5, ""lines"": 12}}"
2021-08-13 18:12:13,78a9c2e670d29349404b346e0aa90264cab19e9b,Bram Moolenaar,4,0,4,2,"{""src/eval.c"": {""insertions"": 2, ""deletions"": 0, ""lines"": 2}, ""src/version.c"": {""insertions"": 2, ""deletions"": 0, ""lines"": 2}}"
2021-08-13 17:40:51,aacc966c5d0ed91e33ed32b08f17cf4df3ca1394,Bram Moolenaar,122,32,154,8,"{""src/eval.c"": {""insertions"": 19, ""deletions"": 11, ""lines"": 30}, ""src/globals.h"": {""insertions"": 2, ""deletions"": 0, ""lines"": 2}, ""src/testdir/test_vim9_cmd.vim"": {""insertions"": 17, ""deletions"": 0, ""lines"": 17}, ""src/testdir/test_vim9_disassemble.vim"": {""insertions"": 19, ""deletions"": 0, ""lines"": 19}, ""src/version.c"": {""insertions"": 2, ""deletions"": 0, ""lines"": 2}, ""src/vim9.h"": {""insertions"": 1, ""deletions"": 0, ""lines"": 1}, ""src/vim9compile.c"": {""insertions"": 19, ""deletions"": 6, ""lines"": 25}, ""src/vim9execute.c"": {""insertions"": 43, ""deletions"": 15, ""lines"": 58}}"
2021-08-13 16:20:09,89071cb6a116a74f78f77a1853e6fada44872a15,Bram Moolenaar,17,0,17,3,"{""src/list.c"": {""insertions"": 9, ""deletions"": 0, ""lines"": 9}, ""src/testdir/test_listdict.vim"": {""insertions"": 6, ""deletions"": 0, ""lines"": 6}, ""src/version.c"": {""insertions"": 2, ""deletions"": 0, ""lines"": 2}}"
2021-08-13 15:48:25,069f90852f1444cac50491c10dfbd339a3f9e0c8,Bram Moolenaar,8,1,9,3,"{""src/evalfunc.c"": {""insertions"": 1, ""deletions"": 1, ""lines"": 2}, ""src/testdir/test_cmdline.vim"": {""insertions"": 5, ""deletions"": 0, ""lines"": 5}, ""src/version.c"": {""insertions"": 2, ""deletions"": 0, ""lines"": 2}}"
2021-08-12 19:12:56,92f05f21afdb8a43581554a252cb2fc050f9e03b,Bram Moolenaar,26,3,29,3,"{""src/list.c"": {""insertions"": 7, ""deletions"": 3, ""lines"": 10}, ""src/testdir/test_listdict.vim"": {""insertions"": 17, ""deletions"": 0, ""lines"": 17}, ""src/version.c"": {""insertions"": 2, ""deletions"": 0, ""lines"": 2}}"
2021-08-12 17:27:57,ef98257593a0abf1300d0f70358dc45a70a62580,Bram Moolenaar,248,191,439,5,"{""src/dict.c"": {""insertions"": 3, ""deletions"": 2, ""lines"": 5}, ""src/list.c"": {""insertions"": 28, ""deletions"": 23, ""lines"": 51}, ""src/testdir/test_listdict.vim"": {""insertions"": 203, ""deletions"": 164, ""lines"": 367}, ""src/testdir/vim9.vim"": {""insertions"": 12, ""deletions"": 2, ""lines"": 14}, ""src/version.c"": {""insertions"": 2, ""deletions"": 0, ""lines"": 2}}"
2021-08-12 15:06:05,bd77aa92744d79f3ba69aee713739ec17da474f6,Bram Moolenaar,136,98,234,4,"{""src/evalfunc.c"": {""insertions"": 2, ""deletions"": 1, ""lines"": 3}, ""src/testdir/test_listdict.vim"": {""insertions"": 131, ""deletions"": 96, ""lines"": 227}, ""src/version.c"": {""insertions"": 2, ""deletions"": 0, ""lines"": 2}, ""src/vim9compile.c"": {""insertions"": 1, ""deletions"": 1, ""lines"": 2}}"
2021-08-12 08:39:10,3e9c0b9608736e7d888f3141443f8754143364d7,Bram Moolenaar,41,6,47,3,"{""src/testdir/test_listdict.vim"": {""insertions"": 13, ""deletions"": 0, ""lines"": 13}, ""src/testdir/vim9.vim"": {""insertions"": 26, ""deletions"": 6, ""lines"": 32}, ""src/version.c"": {""insertions"": 2, ""deletions"": 0, ""lines"": 2}}"
2021-08-11 19:49:23,4f0884d6e24d1d45ec83fd86b372b403177d3298,Bram Moolenaar,261,106,367,9,"{""src/eval.c"": {""insertions"": 9, ""deletions"": 89, ""lines"": 98}, ""src/list.c"": {""insertions"": 152, ""deletions"": 0, ""lines"": 152}, ""src/proto/eval.pro"": {""insertions"": 1, ""deletions"": 0, ""lines"": 1}, ""src/proto/list.pro"": {""insertions"": 3, ""deletions"": 0, ""lines"": 3}, ""src/testdir/test_listdict.vim"": {""insertions"": 8, ""deletions"": 5, ""lines"": 13}, ""src/testdir/test_vim9_assign.vim"": {""insertions"": 1, ""deletions"": 1, ""lines"": 2}, ""src/version.c"": {""insertions"": 2, ""deletions"": 0, ""lines"": 2}, ""src/vim9compile.c"": {""insertions"": 32, ""deletions"": 3, ""lines"": 35}, ""src/vim9execute.c"": {""insertions"": 53, ""deletions"": 8, ""lines"": 61}}"
2021-08-11 15:13:54,ed7cb2df35244e40e5c4df06169b50e705427576,Bram Moolenaar,6,3,9,2,"{""src/version.c"": {""insertions"": 2, ""deletions"": 0, ""lines"": 2}, ""src/viminfo.c"": {""insertions"": 4, ""deletions"": 3, ""lines"": 7}}"
2021-08-11 15:01:45,7deb4115ef72c0468cd6f9cc5f036d5c405641d4,Bram Moolenaar,3,0,3,2,"{""src/tag.c"": {""insertions"": 1, ""deletions"": 0, ""lines"": 1}, ""src/version.c"": {""insertions"": 2, ""deletions"": 0, ""lines"": 2}}"
2021-08-11 14:47:26,16e63e6d353c8b7337470644ceac02dc5e569db9,Bram Moolenaar,3,0,3,2,"{""src/typval.c"": {""insertions"": 1, ""deletions"": 0, ""lines"": 1}, ""src/version.c"": {""insertions"": 2, ""deletions"": 0, ""lines"": 2}}"
2021-08-11 13:54:59,b85d3627d9a7b41d603c58a16d0ddbf6b88beeaf,Bram Moolenaar,5,1,6,2,"{""src/spellfile.c"": {""insertions"": 3, ""deletions"": 1, ""lines"": 4}, ""src/version.c"": {""insertions"": 2, ""deletions"": 0, ""lines"": 2}}"
2021-08-11 12:20:05,ba9c23e77655766f6c59de8be732b7577f795ed3,Zdenek Dohnal,29,19,48,2,"{""src/os_unix.c"": {""insertions"": 27, ""deletions"": 19, ""lines"": 46}, ""src/version.c"": {""insertions"": 2, ""deletions"": 0, ""lines"": 2}}"
2021-08-10 20:52:02,6e48b84c5f08a7e192817aca0d8278ea2ff82bc7,Bram Moolenaar,32,3,35,4,"{""src/testdir/test_vim9_disassemble.vim"": {""insertions"": 1, ""deletions"": 0, ""lines"": 1}, ""src/testdir/test_vim9_func.vim"": {""insertions"": 21, ""deletions"": 0, ""lines"": 21}, ""src/version.c"": {""insertions"": 2, ""deletions"": 0, ""lines"": 2}, ""src/vim9compile.c"": {""insertions"": 8, ""deletions"": 3, ""lines"": 11}}"
2021-08-10 19:39:20,52eb372a04dfc5d5afef238c1b3c4a8e92020837,Bram Moolenaar,6,1,7,2,"{""src/testdir/test_digraph.vim"": {""insertions"": 4, ""deletions"": 1, ""lines"": 5}, ""src/version.c"": {""insertions"": 2, ""deletions"": 0, ""lines"": 2}}"
2021-08-10 17:53:01,917c46abe559f3d779ad87500e874376111ca1ef,Bram Moolenaar,34,16,50,6,"{""src/ex_docmd.c"": {""insertions"": 6, ""deletions"": 4, ""lines"": 10}, ""src/ex_eval.c"": {""insertions"": 6, ""deletions"": 6, ""lines"": 12}, ""src/proto/ex_docmd.pro"": {""insertions"": 3, ""deletions"": 3, ""lines"": 6}, ""src/testdir/test_vim9_cmd.vim"": {""insertions"": 16, ""deletions"": 2, ""lines"": 18}, ""src/version.c"": {""insertions"": 2, ""deletions"": 0, ""lines"": 2}, ""src/vim9compile.c"": {""insertions"": 1, ""deletions"": 1, ""lines"": 2}}"
2021-08-10 08:23:27,b6f55bb5b4d7d03cdf47d552db20d06e41354d5f,Bram Moolenaar,3,1,4,2,"{""runtime/doc/eval.txt"": {""insertions"": 1, ""deletions"": 1, ""lines"": 2}, ""src/version.c"": {""insertions"": 2, ""deletions"": 0, ""lines"": 2}}"
2021-08-09 20:22:27,b56c4419d42e024e79b1772c8468c0da7c11275f,Bram Moolenaar,20,2,22,3,"{""src/testdir/test_vim9_builtin.vim"": {""insertions"": 12, ""deletions"": 0, ""lines"": 12}, ""src/version.c"": {""insertions"": 2, ""deletions"": 0, ""lines"": 2}, ""src/vim9type.c"": {""insertions"": 6, ""deletions"": 2, ""lines"": 8}}"
2021-08-09 19:04:44,bd9e7961256ea6a98bd5a7bfe14e32c4c47186e6,Dominique Pelle,46,0,46,3,"{""src/testdir/test_excmd.vim"": {""insertions"": 36, ""deletions"": 0, ""lines"": 36}, ""src/testdir/test_writefile.vim"": {""insertions"": 8, ""deletions"": 0, ""lines"": 8}, ""src/version.c"": {""insertions"": 2, ""deletions"": 0, ""lines"": 2}}"
2021-08-09 17:59:06,8ee52affe7fd4daa03e002bc06611f0a8c3bcd5b,Yegappan Lakshmanan,1303,1327,2630,31,"{""src/alloc.c"": {""insertions"": 9, ""deletions"": 15, ""lines"": 24}, ""src/channel.c"": {""insertions"": 1, ""deletions"": 1, ""lines"": 2}, ""src/dict.c"": {""insertions"": 1, ""deletions"": 1, ""lines"": 2}, ""src/digraph.c"": {""insertions"": 2, ""deletions"": 2, ""lines"": 4}, ""src/edit.c"": {""insertions"": 1, ""deletions"": 1, ""lines"": 2}, ""src/ex_docmd.c"": {""insertions"": 1, ""deletions"": 1, ""lines"": 2}, ""src/getchar.c"": {""insertions"": 1, ""deletions"": 1, ""lines"": 2}, ""src/job.c"": {""insertions"": 1, ""deletions"": 1, ""lines"": 2}, ""src/list.c"": {""insertions"": 1, ""deletions"": 1, ""lines"": 2}, ""src/message.c"": {""insertions"": 0, ""deletions"": 1110, ""lines"": 1110}, ""src/profiler.c"": {""insertions"": 18, ""deletions"": 18, ""lines"": 36}, ""src/proto/channel.pro"": {""insertions"": 0, ""deletions"": 1, ""lines"": 1}, ""src/proto/dict.pro"": {""insertions"": 0, ""deletions"": 1, ""lines"": 1}, ""src/proto/digraph.pro"": {""insertions"": 0, ""deletions"": 2, ""lines"": 2}, ""src/proto/edit.pro"": {""insertions"": 0, ""deletions"": 1, ""lines"": 1}, ""src/proto/ex_docmd.pro"": {""insertions"": 0, ""deletions"": 1, ""lines"": 1}, ""src/proto/getchar.pro"": {""insertions"": 0, ""deletions"": 1, ""lines"": 1}, ""src/proto/job.pro"": {""insertions"": 0, ""deletions"": 1, ""lines"": 1}, ""src/proto/list.pro"": {""insertions"": 0, ""deletions"": 1, ""lines"": 1}, ""src/proto/profiler.pro"": {""insertions"": 0, ""deletions"": 1, ""lines"": 1}, ""src/proto/spell.pro"": {""insertions"": 0, ""deletions"": 1, ""lines"": 1}, ""src/proto/vim9compile.pro"": {""insertions"": 0, ""deletions"": 2, ""lines"": 2}, ""src/proto/vim9script.pro"": {""insertions"": 0, ""deletions"": 2, ""lines"": 2}, ""src/proto/vim9type.pro"": {""insertions"": 0, ""deletions"": 1, ""lines"": 1}, ""src/spell.c"": {""insertions"": 1, ""deletions"": 1, ""lines"": 2}, ""src/strings.c"": {""insertions"": 1114, ""deletions"": 8, ""lines"": 1122}, ""src/version.c"": {""insertions"": 2, ""deletions"": 0, ""lines"": 2}, ""src/vim9compile.c"": {""insertions"": 2, ""deletions"": 2, ""lines"": 4}, ""src/vim9script.c"": {""insertions"": 146, ""deletions"": 146, ""lines"": 292}, ""src/vim9type.c"": {""insertions"": 1, ""deletions"": 1, ""lines"": 2}, ""src/window.c"": {""insertions"": 1, ""deletions"": 1, ""lines"": 2}}"
2021-08-09 11:20:38,eed9616120f60ad17d5e133f505bba5c559aee89,James McCoy,4,2,6,2,"{"".github/workflows/coverity.yml"": {""insertions"": 2, ""deletions"": 2, ""lines"": 4}, ""src/version.c"": {""insertions"": 2, ""deletions"": 0, ""lines"": 2}}"
2021-08-08 17:56:28,ed8b099fd23b20d7b5a436182bde6672c8686189,Bram Moolenaar,7,1,8,3,"{""src/testdir/test_float_func.vim"": {""insertions"": 4, ""deletions"": 0, ""lines"": 4}, ""src/typval.c"": {""insertions"": 1, ""deletions"": 1, ""lines"": 2}, ""src/version.c"": {""insertions"": 2, ""deletions"": 0, ""lines"": 2}}"
2021-08-08 17:07:37,33ea9fd4d849324f1e958cc669987a51cf0baded,Bram Moolenaar,31,1,32,3,"{""src/testdir/test_vim9_func.vim"": {""insertions"": 21, ""deletions"": 0, ""lines"": 21}, ""src/userfunc.c"": {""insertions"": 8, ""deletions"": 1, ""lines"": 9}, ""src/version.c"": {""insertions"": 2, ""deletions"": 0, ""lines"": 2}}"
2021-08-08 13:51:10,80a070c36125662556232ab6e83da373e22953d8,Bram Moolenaar,3,1,4,2,"{""src/evalfunc.c"": {""insertions"": 1, ""deletions"": 1, ""lines"": 2}, ""src/version.c"": {""insertions"": 2, ""deletions"": 0, ""lines"": 2}}"
2021-08-08 13:43:34,2950065e18649d234b16e60dd0e3d75adeca4513,Bram Moolenaar,72,10,82,7,"{""src/float.c"": {""insertions"": 32, ""deletions"": 2, ""lines"": 34}, ""src/json.c"": {""insertions"": 3, ""deletions"": 2, ""lines"": 5}, ""src/proto/float.pro"": {""insertions"": 1, ""deletions"": 1, ""lines"": 2}, ""src/testdir/test_float_func.vim"": {""insertions"": 16, ""deletions"": 1, ""lines"": 17}, ""src/typval.c"": {""insertions"": 17, ""deletions"": 3, ""lines"": 20}, ""src/version.c"": {""insertions"": 2, ""deletions"": 0, ""lines"": 2}, ""src/viminfo.c"": {""insertions"": 1, ""deletions"": 1, ""lines"": 2}}"
2021-08-08 12:43:22,267359902c8792fed13543ddeb56c6df0ae74957,Bram Moolenaar,78,25,103,7,"{""runtime/doc/eval.txt"": {""insertions"": 30, ""deletions"": 12, ""lines"": 42}, ""runtime/doc/usr_41.txt"": {""insertions"": 1, ""deletions"": 0, ""lines"": 1}, ""src/errors.h"": {""insertions"": 4, ""deletions"": 0, ""lines"": 4}, ""src/evalfunc.c"": {""insertions"": 9, ""deletions"": 0, ""lines"": 9}, ""src/testdir/test_vim9_builtin.vim"": {""insertions"": 24, ""deletions"": 9, ""lines"": 33}, ""src/version.c"": {""insertions"": 2, ""deletions"": 0, ""lines"": 2}, ""src/vim9compile.c"": {""insertions"": 8, ""deletions"": 4, ""lines"": 12}}"
2021-08-07 20:35:52,9e2fa4bb9eb40a78a1ae1f67a4064651b5ce0aac,gmntroll,6,23,29,2,"{""src/version.c"": {""insertions"": 2, ""deletions"": 0, ""lines"": 2}, ""src/window.c"": {""insertions"": 4, ""deletions"": 23, ""lines"": 27}}"
2021-08-07 16:12:40,e525bdda3aa29f0ffcb18d8d16903ebafc2b5881,Bram Moolenaar,12,4,16,3,"{""src/testdir/test_vim9_script.vim"": {""insertions"": 8, ""deletions"": 0, ""lines"": 8}, ""src/version.c"": {""insertions"": 2, ""deletions"": 0, ""lines"": 2}, ""src/vim9compile.c"": {""insertions"": 2, ""deletions"": 4, ""lines"": 6}}"
2021-08-07 15:20:16,dae453f3397a26a53301d7327e6ed43e8b392035,Bram Moolenaar,51,3,54,3,"{""src/testdir/runtest.vim"": {""insertions"": 15, ""deletions"": 2, ""lines"": 17}, ""src/testdir/test_vim9_expr.vim"": {""insertions"": 34, ""deletions"": 1, ""lines"": 35}, ""src/version.c"": {""insertions"": 2, ""deletions"": 0, ""lines"": 2}}"
2021-08-07 14:30:42,4270d8b7626ff8a7006f6a09c89bc446a3f89d1e,Bram Moolenaar,47,12,59,4,"{""src/testdir/test_vim9_assign.vim"": {""insertions"": 16, ""deletions"": 0, ""lines"": 16}, ""src/testdir/test_vim9_disassemble.vim"": {""insertions"": 2, ""deletions"": 2, ""lines"": 4}, ""src/version.c"": {""insertions"": 2, ""deletions"": 0, ""lines"": 2}, ""src/vim9compile.c"": {""insertions"": 27, ""deletions"": 10, ""lines"": 37}}"
2021-08-07 13:50:23,fbeefb1b87b0d52a095c08fee47b62d290bf4c33,Bram Moolenaar,34,5,39,3,"{""src/testdir/test_vim9_expr.vim"": {""insertions"": 13, ""deletions"": 1, ""lines"": 14}, ""src/version.c"": {""insertions"": 2, ""deletions"": 0, ""lines"": 2}, ""src/vim9execute.c"": {""insertions"": 19, ""deletions"": 4, ""lines"": 23}}"
2021-08-07 13:35:36,6ce46b99635877fb0a17c06a6f5625fbc1ffa6f4,Bram Moolenaar,16,2,18,3,"{""src/testdir/test_vim9_func.vim"": {""insertions"": 12, ""deletions"": 0, ""lines"": 12}, ""src/version.c"": {""insertions"": 2, ""deletions"": 0, ""lines"": 2}, ""src/vim9execute.c"": {""insertions"": 2, ""deletions"": 2, ""lines"": 4}}"
2021-08-07 13:05:47,7de62623735d228c8f81f6ac8309fe4922822cb2,Bram Moolenaar,40,10,50,6,"{""src/testdir/test_vim9_disassemble.vim"": {""insertions"": 4, ""deletions"": 0, ""lines"": 4}, ""src/testdir/test_vim9_script.vim"": {""insertions"": 9, ""deletions"": 2, ""lines"": 11}, ""src/version.c"": {""insertions"": 2, ""deletions"": 0, ""lines"": 2}, ""src/vim9.h"": {""insertions"": 5, ""deletions"": 4, ""lines"": 9}, ""src/vim9compile.c"": {""insertions"": 5, ""deletions"": 1, ""lines"": 6}, ""src/vim9execute.c"": {""insertions"": 15, ""deletions"": 3, ""lines"": 18}}"
2021-08-07 11:59:43,1b154ea121d8374a129c3e30d50fa9742cd5faa1,Bram Moolenaar,10,3,13,2,"{""src/autocmd.c"": {""insertions"": 8, ""deletions"": 3, ""lines"": 11}, ""src/version.c"": {""insertions"": 2, ""deletions"": 0, ""lines"": 2}}"
2021-08-07 11:26:53,84934998806408db3f3ecff7ac4c3980e0c2a96e,rbtnn,57,37,94,4,"{""src/ex_eval.c"": {""insertions"": 2, ""deletions"": 1, ""lines"": 3}, ""src/testdir/test_vim9_script.vim"": {""insertions"": 14, ""deletions"": 0, ""lines"": 14}, ""src/version.c"": {""insertions"": 2, ""deletions"": 0, ""lines"": 2}, ""src/vim9compile.c"": {""insertions"": 39, ""deletions"": 36, ""lines"": 75}}"
2021-08-07 11:08:45,c611941c606328740b6e9acc1191a5d97ace13e2,rbtnn,5,3,8,4,"{""src/popupwin.c"": {""insertions"": 1, ""deletions"": 1, ""lines"": 2}, ""src/testdir/dumps/Test_popupwin_multibytetitle.dump"": {""insertions"": 1, ""deletions"": 1, ""lines"": 2}, ""src/testdir/test_popupwin.vim"": {""insertions"": 1, ""deletions"": 1, ""lines"": 2}, ""src/version.c"": {""insertions"": 2, ""deletions"": 0, ""lines"": 2}}"
2021-08-07 10:44:41,3276f5846f7ad61f55175959ac21c1b4cf595352,Dominique Pelle,14,12,26,4,"{""src/structs.h"": {""insertions"": 8, ""deletions"": 8, ""lines"": 16}, ""src/version.c"": {""insertions"": 2, ""deletions"": 0, ""lines"": 2}, ""src/vim9.h"": {""insertions"": 3, ""deletions"": 3, ""lines"": 6}, ""src/vim9execute.c"": {""insertions"": 1, ""deletions"": 1, ""lines"": 2}}"
2021-08-07 10:32:20,d57a6bd98c9a57b766eadcc3f10e9c4169c788aa,Bram Moolenaar,83,0,83,3,"{"".github/workflows/coverity.yml"": {""insertions"": 80, ""deletions"": 0, ""lines"": 80}, ""Filelist"": {""insertions"": 1, ""deletions"": 0, ""lines"": 1}, ""src/version.c"": {""insertions"": 2, ""deletions"": 0, ""lines"": 2}}"
2021-08-06 19:51:55,cbae5802832b29f3a1af4cb6b0fc8cf69f17cbf4,Yegappan Lakshmanan,938,884,1822,13,"{""Filelist"": {""insertions"": 2, ""deletions"": 0, ""lines"": 2}, ""src/Make_ami.mak"": {""insertions"": 1, ""deletions"": 0, ""lines"": 1}, ""src/Make_cyg_ming.mak"": {""insertions"": 1, ""deletions"": 0, ""lines"": 1}, ""src/Make_mvc.mak"": {""insertions"": 4, ""deletions"": 0, ""lines"": 4}, ""src/Make_vms.mms"": {""insertions"": 5, ""deletions"": 0, ""lines"": 5}, ""src/Makefile"": {""insertions"": 10, ""deletions"": 0, ""lines"": 10}, ""src/README.md"": {""insertions"": 1, ""deletions"": 0, ""lines"": 1}, ""src/alloc.c"": {""insertions"": 872, ""deletions"": 0, ""lines"": 872}, ""src/misc2.c"": {""insertions"": 9, ""deletions"": 857, ""lines"": 866}, ""src/proto.h"": {""insertions"": 1, ""deletions"": 0, ""lines"": 1}, ""src/proto/alloc.pro"": {""insertions"": 29, ""deletions"": 0, ""lines"": 29}, ""src/proto/misc2.pro"": {""insertions"": 1, ""deletions"": 27, ""lines"": 28}, ""src/version.c"": {""insertions"": 2, ""deletions"": 0, ""lines"": 2}}"
2021-08-06 19:34:38,11328bc7df0ecc47f4025a10bb86882a659e9994,Yegappan Lakshmanan,124,5,129,7,"{""runtime/doc/if_lua.txt"": {""insertions"": 14, ""deletions"": 1, ""lines"": 15}, ""src/evalfunc.c"": {""insertions"": 42, ""deletions"": 0, ""lines"": 42}, ""src/if_lua.c"": {""insertions"": 31, ""deletions"": 3, ""lines"": 34}, ""src/proto/evalfunc.pro"": {""insertions"": 1, ""deletions"": 0, ""lines"": 1}, ""src/testdir/test_lua.vim"": {""insertions"": 32, ""deletions"": 0, ""lines"": 32}, ""src/testdir/test_shell.vim"": {""insertions"": 2, ""deletions"": 1, ""lines"": 3}, ""src/version.c"": {""insertions"": 2, ""deletions"": 0, ""lines"": 2}}"
2021-08-05 20:48:11,5671f3f076573fa9133bc210d6580067698d9a1b,Bram Moolenaar,34,3,37,4,"{""src/evalfunc.c"": {""insertions"": 7, ""deletions"": 0, ""lines"": 7}, ""src/testdir/test_vim9_builtin.vim"": {""insertions"": 23, ""deletions"": 1, ""lines"": 24}, ""src/version.c"": {""insertions"": 2, ""deletions"": 0, ""lines"": 2}, ""src/vim9compile.c"": {""insertions"": 2, ""deletions"": 2, ""lines"": 4}}"
2021-08-05 19:17:32,6f6d58c3809010b1386634c1aeec61f1a66e72c2,Bram Moolenaar,6,1,7,2,"{""src/ex_docmd.c"": {""insertions"": 4, ""deletions"": 1, ""lines"": 5}, ""src/version.c"": {""insertions"": 2, ""deletions"": 0, ""lines"": 2}}"
2021-08-05 18:40:03,63b9173693015b135aad8e3657bef5e7f776787e,Bram Moolenaar,90,36,126,16,"{""runtime/doc/map.txt"": {""insertions"": 5, ""deletions"": 2, ""lines"": 7}, ""src/errors.h"": {""insertions"": 3, ""deletions"": 1, ""lines"": 4}, ""src/eval.c"": {""insertions"": 3, ""deletions"": 3, ""lines"": 6}, ""src/evalvars.c"": {""insertions"": 2, ""deletions"": 2, ""lines"": 4}, ""src/ex_cmds.c"": {""insertions"": 2, ""deletions"": 2, ""lines"": 4}, ""src/ex_docmd.c"": {""insertions"": 28, ""deletions"": 11, ""lines"": 39}, ""src/ex_eval.c"": {""insertions"": 12, ""deletions"": 0, ""lines"": 12}, ""src/proto/ex_docmd.pro"": {""insertions"": 1, ""deletions"": 0, ""lines"": 1}, ""src/proto/ex_eval.pro"": {""insertions"": 1, ""deletions"": 0, ""lines"": 1}, ""src/syntax.c"": {""insertions"": 7, ""deletions"": 7, ""lines"": 14}, ""src/testdir/test_autocmd.vim"": {""insertions"": 8, ""deletions"": 0, ""lines"": 8}, ""src/testdir/test_usercommands.vim"": {""insertions"": 8, ""deletions"": 0, ""lines"": 8}, ""src/userfunc.c"": {""insertions"": 6, ""deletions"": 6, ""lines"": 12}, ""src/version.c"": {""insertions"": 2, ""deletions"": 0, ""lines"": 2}, ""src/vim9compile.c"": {""insertions"": 1, ""deletions"": 1, ""lines"": 2}, ""src/vim9script.c"": {""insertions"": 1, ""deletions"": 1, ""lines"": 2}}"
2021-08-05 17:01:17,af647e76cacc60d3cfc5df3ff5b3d9d4b69b519d,Bram Moolenaar,23,2,25,3,"{""src/testdir/test_vim9_assign.vim"": {""insertions"": 17, ""deletions"": 0, ""lines"": 17}, ""src/version.c"": {""insertions"": 2, ""deletions"": 0, ""lines"": 2}, ""src/vim9compile.c"": {""insertions"": 4, ""deletions"": 2, ""lines"": 6}}"
2021-08-05 15:57:02,4f33bc20d7d5444e44d13f954e8219ad1abd26ef,zeertzjq,268,19,287,14,"{""src/drawline.c"": {""insertions"": 13, ""deletions"": 19, ""lines"": 32}, ""src/testdir/dumps/Test_Xcursorline_19.dump"": {""insertions"": 20, ""deletions"": 0, ""lines"": 20}, ""src/testdir/dumps/Test_Xcursorline_20.dump"": {""insertions"": 20, ""deletions"": 0, ""lines"": 20}, ""src/testdir/dumps/Test_Xcursorline_21.dump"": {""insertions"": 20, ""deletions"": 0, ""lines"": 20}, ""src/testdir/dumps/Test_Xcursorline_22.dump"": {""insertions"": 20, ""deletions"": 0, ""lines"": 20}, ""src/testdir/dumps/Test_Xcursorline_23.dump"": {""insertions"": 20, ""deletions"": 0, ""lines"": 20}, ""src/testdir/dumps/Test_Xcursorline_24.dump"": {""insertions"": 20, ""deletions"": 0, ""lines"": 20}, ""src/testdir/dumps/Test_diff_with_cul_bri_01.dump"": {""insertions"": 20, ""deletions"": 0, ""lines"": 20}, ""src/testdir/dumps/Test_diff_with_cul_bri_02.dump"": {""insertions"": 20, ""deletions"": 0, ""lines"": 20}, ""src/testdir/dumps/Test_diff_with_cul_bri_03.dump"": {""insertions"": 20, ""deletions"": 0, ""lines"": 20}, ""src/testdir/dumps/Test_diff_with_cul_bri_04.dump"": {""insertions"": 20, ""deletions"": 0, ""lines"": 20}, ""src/testdir/test_cursorline.vim"": {""insertions"": 22, ""deletions"": 0, ""lines"": 22}, ""src/testdir/test_diffmode.vim"": {""insertions"": 31, ""deletions"": 0, ""lines"": 31}, ""src/version.c"": {""insertions"": 2, ""deletions"": 0, ""lines"": 2}}"
2021-08-05 14:47:08,1b6acf02b7e685ecb87ccba52c91835a7519073e,Bram Moolenaar,11,1,12,2,"{""src/if_lua.c"": {""insertions"": 9, ""deletions"": 1, ""lines"": 10}, ""src/version.c"": {""insertions"": 2, ""deletions"": 0, ""lines"": 2}}"
2021-08-05 14:23:27,6a230c6b32695393785ae64b440ce5f023a22382,Andy Gozas,82,1,83,4,"{""src/insexpand.c"": {""insertions"": 27, ""deletions"": 1, ""lines"": 28}, ""src/testdir/Make_all.mak"": {""insertions"": 2, ""deletions"": 0, ""lines"": 2}, ""src/testdir/test_ins_complete_no_halt.vim"": {""insertions"": 51, ""deletions"": 0, ""lines"": 51}, ""src/version.c"": {""insertions"": 2, ""deletions"": 0, ""lines"": 2}}"
2021-08-05 13:24:59,bc67e5a0a494f5fc48e872d747371e31a782d171,Christian Brabandt,16,1,17,3,"{""src/search.c"": {""insertions"": 3, ""deletions"": 1, ""lines"": 4}, ""src/testdir/test_search.vim"": {""insertions"": 11, ""deletions"": 0, ""lines"": 11}, ""src/version.c"": {""insertions"": 2, ""deletions"": 0, ""lines"": 2}}"
2021-08-05 13:11:08,4a01159da23a279005b7c5042a15af47eb9617fe,Bram Moolenaar,8,1,9,3,"{""src/if_lua.c"": {""insertions"": 2, ""deletions"": 1, ""lines"": 3}, ""src/testdir/test_lua.vim"": {""insertions"": 4, ""deletions"": 0, ""lines"": 4}, ""src/version.c"": {""insertions"": 2, ""deletions"": 0, ""lines"": 2}}"
2021-08-04 20:30:52,9fe17d473a6041e2ea85229f4fa09831d910def4,Zdenek Dohnal,23,13,36,2,"{""src/version.c"": {""insertions"": 2, ""deletions"": 0, ""lines"": 2}, ""src/vim9compile.c"": {""insertions"": 21, ""deletions"": 13, ""lines"": 34}}"
2021-08-04 19:16:50,f18e8a969a3414ed5e6b7159c40fe43963021ff3,Bram Moolenaar,10,1,11,2,"{""src/version.c"": {""insertions"": 2, ""deletions"": 0, ""lines"": 2}, ""src/window.c"": {""insertions"": 8, ""deletions"": 1, ""lines"": 9}}"
2021-08-04 19:12:52,9dc4bef897a37a610a28d69cee6d30749db61296,Yegappan Lakshmanan,414,0,414,4,"{""runtime/doc/if_lua.txt"": {""insertions"": 32, ""deletions"": 0, ""lines"": 32}, ""src/if_lua.c"": {""insertions"": 138, ""deletions"": 0, ""lines"": 138}, ""src/testdir/test_lua.vim"": {""insertions"": 242, ""deletions"": 0, ""lines"": 242}, ""src/version.c"": {""insertions"": 2, ""deletions"": 0, ""lines"": 2}}"
2021-08-04 18:54:55,57942237c1d54d8a236b43c56dc2b002339eb394,Bram Moolenaar,65,14,79,3,"{""src/testdir/test_channel.vim"": {""insertions"": 29, ""deletions"": 0, ""lines"": 29}, ""src/version.c"": {""insertions"": 2, ""deletions"": 0, ""lines"": 2}, ""src/window.c"": {""insertions"": 34, ""deletions"": 14, ""lines"": 48}}"
2021-08-04 18:26:19,d61f2f772a59617850e9aa2f5fa069c1aad8e074,Bram Moolenaar,28,20,48,2,"{""src/version.c"": {""insertions"": 2, ""deletions"": 0, ""lines"": 2}, ""src/window.c"": {""insertions"": 26, ""deletions"": 20, ""lines"": 46}}"
2021-08-04 18:00:27,dd097bdc1376e4ca2cfd4a4d64021b6ba0df4bed,Gregory Anders,6,0,6,3,"{""runtime/filetype.vim"": {""insertions"": 3, ""deletions"": 0, ""lines"": 3}, ""src/testdir/test_filetype.vim"": {""insertions"": 1, ""deletions"": 0, ""lines"": 1}, ""src/version.c"": {""insertions"": 2, ""deletions"": 0, ""lines"": 2}}"
2021-08-04 17:25:54,80d7395dcfe96158428da6bb3d28a6eee1244e28,Sean Dewar,79,36,115,8,"{""src/blob.c"": {""insertions"": 5, ""deletions"": 2, ""lines"": 7}, ""src/errors.h"": {""insertions"": 2, ""deletions"": 1, ""lines"": 3}, ""src/eval.c"": {""insertions"": 1, ""deletions"": 1, ""lines"": 2}, ""src/list.c"": {""insertions"": 32, ""deletions"": 28, ""lines"": 60}, ""src/proto/blob.pro"": {""insertions"": 1, ""deletions"": 1, ""lines"": 2}, ""src/testdir/test_blob.vim"": {""insertions"": 33, ""deletions"": 0, ""lines"": 33}, ""src/testdir/test_eval_stuff.vim"": {""insertions"": 3, ""deletions"": 3, ""lines"": 6}, ""src/version.c"": {""insertions"": 2, ""deletions"": 0, ""lines"": 2}}"
2021-08-04 15:03:59,0eec8519424eaea7baebfda979c33dd609a4e3fa,Christian Clason,7,0,7,3,"{""runtime/filetype.vim"": {""insertions"": 3, ""deletions"": 0, ""lines"": 3}, ""src/testdir/test_filetype.vim"": {""insertions"": 2, ""deletions"": 0, ""lines"": 2}, ""src/version.c"": {""insertions"": 2, ""deletions"": 0, ""lines"": 2}}"
2021-08-04 14:09:24,41a3485dd638a09e4c463b1a1da231f4290454f2,Bram Moolenaar,7,4,11,3,"{""src/errors.h"": {""insertions"": 2, ""deletions"": 2, ""lines"": 4}, ""src/usercmd.c"": {""insertions"": 3, ""deletions"": 2, ""lines"": 5}, ""src/version.c"": {""insertions"": 2, ""deletions"": 0, ""lines"": 2}}"
2021-08-03 19:16:18,23e2e115154ef0bf05d809024eed328a46ed0f82,Bram Moolenaar,8,21,29,4,"{""src/testdir/test_vim9_assign.vim"": {""insertions"": 2, ""deletions"": 14, ""lines"": 16}, ""src/testdir/test_vim9_func.vim"": {""insertions"": 2, ""deletions"": 3, ""lines"": 5}, ""src/testdir/test_vim9_script.vim"": {""insertions"": 2, ""deletions"": 4, ""lines"": 6}, ""src/version.c"": {""insertions"": 2, ""deletions"": 0, ""lines"": 2}}"
2021-08-03 16:33:08,51ad850f5fbafa7aa3f60affa74ec9c9f992c6cc,Gary Johnson,56,37,93,10,"{""runtime/doc/options.txt"": {""insertions"": 1, ""deletions"": 1, ""lines"": 2}, ""src/buffer.c"": {""insertions"": 0, ""deletions"": 1, ""lines"": 1}, ""src/drawscreen.c"": {""insertions"": 3, ""deletions"": 3, ""lines"": 6}, ""src/ops.c"": {""insertions"": 5, ""deletions"": 5, ""lines"": 10}, ""src/option.c"": {""insertions"": 11, ""deletions"": 9, ""lines"": 20}, ""src/option.h"": {""insertions"": 2, ""deletions"": 2, ""lines"": 4}, ""src/optionstr.c"": {""insertions"": 2, ""deletions"": 3, ""lines"": 5}, ""src/structs.h"": {""insertions"": 4, ""deletions"": 2, ""lines"": 6}, ""src/testdir/test_virtualedit.vim"": {""insertions"": 26, ""deletions"": 11, ""lines"": 37}, ""src/version.c"": {""insertions"": 2, ""deletions"": 0, ""lines"": 2}}"
2021-08-02 20:26:56,2c70711e3fb2ef24a7f55322fdadbf7f9e657c2f,Bram Moolenaar,17,2,19,3,"{""src/ex_cmds.h"": {""insertions"": 1, ""deletions"": 1, ""lines"": 2}, ""src/testdir/test_vim9_cmd.vim"": {""insertions"": 14, ""deletions"": 1, ""lines"": 15}, ""src/version.c"": {""insertions"": 2, ""deletions"": 0, ""lines"": 2}}"
2021-08-02 19:55:15,7bf9a07bd7d6264f623109c2896b2a4002c86080,Bram Moolenaar,10,1,11,3,"{""src/testdir/test_vim9_assign.vim"": {""insertions"": 6, ""deletions"": 0, ""lines"": 6}, ""src/version.c"": {""insertions"": 2, ""deletions"": 0, ""lines"": 2}, ""src/vim9compile.c"": {""insertions"": 2, ""deletions"": 1, ""lines"": 3}}"
2021-08-02 19:12:05,c3160727b940b762e18fd9431416dc1a4a081c3a,Bram Moolenaar,7,4,11,2,"{""src/version.c"": {""insertions"": 2, ""deletions"": 0, ""lines"": 2}, ""src/vim9compile.c"": {""insertions"": 5, ""deletions"": 4, ""lines"": 9}}"
2021-08-02 18:06:50,bb7ee7abe1ea1e60b8a5dadd2bed8cdbe4f3e8fb,Bram Moolenaar,34,6,40,5,"{""src/evalfunc.c"": {""insertions"": 1, ""deletions"": 2, ""lines"": 3}, ""src/proto/evalfunc.pro"": {""insertions"": 1, ""deletions"": 0, ""lines"": 1}, ""src/testdir/test_vim9_builtin.vim"": {""insertions"": 19, ""deletions"": 0, ""lines"": 19}, ""src/version.c"": {""insertions"": 2, ""deletions"": 0, ""lines"": 2}, ""src/vim9compile.c"": {""insertions"": 11, ""deletions"": 4, ""lines"": 15}}"
2021-08-02 17:10:38,35578168becd1e11973bec413f2078a4bf81ba6b,Bram Moolenaar,64,61,125,5,"{""src/arglist.c"": {""insertions"": 3, ""deletions"": 3, ""lines"": 6}, ""src/macros.h"": {""insertions"": 4, ""deletions"": 2, ""lines"": 6}, ""src/version.c"": {""insertions"": 2, ""deletions"": 0, ""lines"": 2}, ""src/vim9compile.c"": {""insertions"": 21, ""deletions"": 21, ""lines"": 42}, ""src/vim9execute.c"": {""insertions"": 34, ""deletions"": 35, ""lines"": 69}}"
2021-08-02 16:07:18,952d9d827e5bfc66a6b1d39956e4e5596b09e2bd,Bram Moolenaar,38,67,105,11,"{""src/channel.c"": {""insertions"": 1, ""deletions"": 5, ""lines"": 6}, ""src/gui_xim.c"": {""insertions"": 3, ""deletions"": 1, ""lines"": 4}, ""src/if_mzsch.c"": {""insertions"": 1, ""deletions"": 1, ""lines"": 2}, ""src/nbdebug.c"": {""insertions"": 1, ""deletions"": 1, ""lines"": 2}, ""src/nbdebug.h"": {""insertions"": 1, ""deletions"": 5, ""lines"": 6}, ""src/netbeans.c"": {""insertions"": 1, ""deletions"": 1, ""lines"": 2}, ""src/proto.h"": {""insertions"": 12, ""deletions"": 42, ""lines"": 54}, ""src/term.c"": {""insertions"": 1, ""deletions"": 1, ""lines"": 2}, ""src/version.c"": {""insertions"": 2, ""deletions"": 0, ""lines"": 2}, ""src/vim.h"": {""insertions"": 15, ""deletions"": 2, ""lines"": 17}, ""src/vim9execute.c"": {""insertions"": 0, ""deletions"": 8, ""lines"": 8}}"
2021-08-01 20:01:30,1321257317b7d28228a6a9a0d612f81f70290b4c,Bram Moolenaar,3,1,4,2,"{""src/userfunc.c"": {""insertions"": 1, ""deletions"": 1, ""lines"": 2}, ""src/version.c"": {""insertions"": 2, ""deletions"": 0, ""lines"": 2}}"
2021-08-01 19:30:12,e041dde7bb9157644fa5135a252c84924b9ea433,Bram Moolenaar,12,4,16,3,"{""src/testdir/test_textprop.vim"": {""insertions"": 9, ""deletions"": 3, ""lines"": 12}, ""src/textprop.c"": {""insertions"": 1, ""deletions"": 1, ""lines"": 2}, ""src/version.c"": {""insertions"": 2, ""deletions"": 0, ""lines"": 2}}"
2021-08-01 19:19:43,e4db17fb6e2d029aa2dddfca703ace9bcf0d85fd,Bram Moolenaar,98,20,118,7,"{""src/ex_docmd.c"": {""insertions"": 1, ""deletions"": 1, ""lines"": 2}, ""src/proto/ex_docmd.pro"": {""insertions"": 1, ""deletions"": 0, ""lines"": 1}, ""src/testdir/test_vim9_script.vim"": {""insertions"": 28, ""deletions"": 0, ""lines"": 28}, ""src/usercmd.c"": {""insertions"": 19, ""deletions"": 16, ""lines"": 35}, ""src/userfunc.c"": {""insertions"": 15, ""deletions"": 2, ""lines"": 17}, ""src/version.c"": {""insertions"": 2, ""deletions"": 0, ""lines"": 2}, ""src/vim9compile.c"": {""insertions"": 32, ""deletions"": 1, ""lines"": 33}}"
2021-08-01 17:28:15,0d4d9ee9bb18f89d76c67f037baebe2c2db545f0,Bram Moolenaar,9,6,15,2,"{""src/textprop.c"": {""insertions"": 7, ""deletions"": 6, ""lines"": 13}, ""src/version.c"": {""insertions"": 2, ""deletions"": 0, ""lines"": 2}}"
2021-08-01 13:40:31,f78da4f9d6daf1907e4ce4be74146375dbd9a546,Bram Moolenaar,44,24,68,4,"{""src/evalfunc.c"": {""insertions"": 16, ""deletions"": 10, ""lines"": 26}, ""src/testdir/test_vim9_func.vim"": {""insertions"": 21, ""deletions"": 14, ""lines"": 35}, ""src/version.c"": {""insertions"": 2, ""deletions"": 0, ""lines"": 2}, ""src/vim9type.c"": {""insertions"": 5, ""deletions"": 0, ""lines"": 5}}"
2021-08-01 12:52:32,73b8b0ae3acac220e823076f8ca1c14524ed96dd,Bram Moolenaar,100,50,150,10,"{""runtime/doc/autocmd.txt"": {""insertions"": 6, ""deletions"": 0, ""lines"": 6}, ""runtime/doc/map.txt"": {""insertions"": 4, ""deletions"": 4, ""lines"": 8}, ""src/autocmd.c"": {""insertions"": 20, ""deletions"": 9, ""lines"": 29}, ""src/ex_docmd.c"": {""insertions"": 1, ""deletions"": 1, ""lines"": 2}, ""src/proto/autocmd.pro"": {""insertions"": 1, ""deletions"": 1, ""lines"": 2}, ""src/proto/usercmd.pro"": {""insertions"": 1, ""deletions"": 0, ""lines"": 1}, ""src/testdir/test_autocmd.vim"": {""insertions"": 16, ""deletions"": 0, ""lines"": 16}, ""src/usercmd.c"": {""insertions"": 44, ""deletions"": 35, ""lines"": 79}, ""src/version.c"": {""insertions"": 2, ""deletions"": 0, ""lines"": 2}, ""src/vim.h"": {""insertions"": 5, ""deletions"": 0, ""lines"": 5}}"
2021-08-01 12:08:54,6db660bed9ed5063f8c6e0fadeef32d44bbd017d,Bram Moolenaar,94,30,124,3,"{""src/testdir/test_vim9_disassemble.vim"": {""insertions"": 48, ""deletions"": 0, ""lines"": 48}, ""src/version.c"": {""insertions"": 2, ""deletions"": 0, ""lines"": 2}, ""src/vim9execute.c"": {""insertions"": 44, ""deletions"": 30, ""lines"": 74}}"
2021-08-01 11:17:17,e97976baa7a74fbbe0cfecd1943fe1c5f9dfba4f,Bram Moolenaar,19,5,24,3,"{""src/testdir/test_vim9_assign.vim"": {""insertions"": 6, ""deletions"": 0, ""lines"": 6}, ""src/version.c"": {""insertions"": 2, ""deletions"": 0, ""lines"": 2}, ""src/vim9compile.c"": {""insertions"": 11, ""deletions"": 5, ""lines"": 16}}"
2021-08-01 10:44:37,78ba933d18439ff1a02f6be4c571e73ddceb3cd4,Christian Brabandt,66,1,67,3,"{""src/search.c"": {""insertions"": 10, ""deletions"": 1, ""lines"": 11}, ""src/testdir/test_search.vim"": {""insertions"": 54, ""deletions"": 0, ""lines"": 54}, ""src/version.c"": {""insertions"": 2, ""deletions"": 0, ""lines"": 2}}"
2021-08-01 10:01:49,f24f51d03035379cf3e5b2dccf489a40bc4ca92a,Bram Moolenaar,6,2,8,2,"{""src/eval.c"": {""insertions"": 4, ""deletions"": 2, ""lines"": 6}, ""src/version.c"": {""insertions"": 2, ""deletions"": 0, ""lines"": 2}}"
2021-07-31 20:51:10,f5d52c90e0f2f51622a911b646024b2ad1225ed4,Bram Moolenaar,40,7,47,4,"{""src/testdir/test_vim9_assign.vim"": {""insertions"": 26, ""deletions"": 0, ""lines"": 26}, ""src/testdir/test_vim9_disassemble.vim"": {""insertions"": 1, ""deletions"": 1, ""lines"": 2}, ""src/version.c"": {""insertions"": 2, ""deletions"": 0, ""lines"": 2}, ""src/vim9compile.c"": {""insertions"": 11, ""deletions"": 6, ""lines"": 17}}"
2021-07-31 20:17:28,9e0ee590197d74f94b7127bf0e033e4f83cf3762,Bram Moolenaar,3,2,5,2,"{""src/ex_docmd.c"": {""insertions"": 1, ""deletions"": 2, ""lines"": 3}, ""src/version.c"": {""insertions"": 2, ""deletions"": 0, ""lines"": 2}}"
2021-07-31 20:03:59,1780f08ba42837b6d4a5f0451117a79b2d49974a,Bram Moolenaar,19,4,23,3,"{""src/evalfunc.c"": {""insertions"": 8, ""deletions"": 1, ""lines"": 9}, ""src/testdir/test_vim9_builtin.vim"": {""insertions"": 9, ""deletions"": 3, ""lines"": 12}, ""src/version.c"": {""insertions"": 2, ""deletions"": 0, ""lines"": 2}}"
2021-07-31 19:44:35,335c8c7b206df776b59fb63a1c7f91c8b1425398,Bram Moolenaar,3,1,4,2,"{""src/ex_docmd.c"": {""insertions"": 1, ""deletions"": 1, ""lines"": 2}, ""src/version.c"": {""insertions"": 2, ""deletions"": 0, ""lines"": 2}}"
2021-07-31 19:32:31,620c959c6c00e469c4d3b1ab2e08e4767ee142a4,Bram Moolenaar,78,61,139,4,"{""src/ex_docmd.c"": {""insertions"": 68, ""deletions"": 61, ""lines"": 129}, ""src/indent.c"": {""insertions"": 7, ""deletions"": 0, ""lines"": 7}, ""src/proto/ex_docmd.pro"": {""insertions"": 1, ""deletions"": 0, ""lines"": 1}, ""src/version.c"": {""insertions"": 2, ""deletions"": 0, ""lines"": 2}}"
2021-07-31 17:12:58,78db17c6f335f518752ca221ec6bde79db584e15,Bram Moolenaar,39,37,76,4,"{""src/errors.h"": {""insertions"": 8, ""deletions"": 8, ""lines"": 16}, ""src/testdir/test_vim9_builtin.vim"": {""insertions"": 26, ""deletions"": 26, ""lines"": 52}, ""src/typval.c"": {""insertions"": 3, ""deletions"": 3, ""lines"": 6}, ""src/version.c"": {""insertions"": 2, ""deletions"": 0, ""lines"": 2}}"
2021-07-31 16:33:57,8e3fc135e884a30620fb1c6e84986fae1467acd3,Bram Moolenaar,9,0,9,3,"{""src/testdir/test_textprop.vim"": {""insertions"": 3, ""deletions"": 0, ""lines"": 3}, ""src/textprop.c"": {""insertions"": 4, ""deletions"": 0, ""lines"": 4}, ""src/version.c"": {""insertions"": 2, ""deletions"": 0, ""lines"": 2}}"
2021-07-31 15:20:04,bf634a0a8b64fda2e53d3e2254fe0ffdc3d67196,Bram Moolenaar,5,0,5,2,"{""src/testdir/test_functions.vim"": {""insertions"": 3, ""deletions"": 0, ""lines"": 3}, ""src/version.c"": {""insertions"": 2, ""deletions"": 0, ""lines"": 2}}"
2021-07-31 11:31:42,b9115da4bec5e6cfff69da85cc47c42dd67e42e4,Connor Lane Smith,54,5,59,4,"{""src/search.c"": {""insertions"": 2, ""deletions"": 0, ""lines"": 2}, ""src/testdir/test_textobjects.vim"": {""insertions"": 32, ""deletions"": 0, ""lines"": 32}, ""src/textobject.c"": {""insertions"": 18, ""deletions"": 5, ""lines"": 23}, ""src/version.c"": {""insertions"": 2, ""deletions"": 0, ""lines"": 2}}"
2021-07-31 10:43:23,28d8421bfb3327d7a5e81369977e8fc108b0229e,Yegappan Lakshmanan,32,5,37,5,"{""runtime/doc/eval.txt"": {""insertions"": 4, ""deletions"": 2, ""lines"": 6}, ""src/evalwindow.c"": {""insertions"": 6, ""deletions"": 0, ""lines"": 6}, ""src/misc2.c"": {""insertions"": 3, ""deletions"": 3, ""lines"": 6}, ""src/testdir/test_quickfix.vim"": {""insertions"": 17, ""deletions"": 0, ""lines"": 17}, ""src/version.c"": {""insertions"": 2, ""deletions"": 0, ""lines"": 2}}"
2021-07-30 19:56:10,890ee4e2be1dca0c07a91f836e26baead952ae7c,Bram Moolenaar,7,5,12,3,"{""src/testdir/test_channel.py"": {""insertions"": 5, ""deletions"": 0, ""lines"": 5}, ""src/testdir/test_channel.vim"": {""insertions"": 0, ""deletions"": 5, ""lines"": 5}, ""src/version.c"": {""insertions"": 2, ""deletions"": 0, ""lines"": 2}}"
2021-07-30 19:32:45,4a15504e911bc90a29d862862f0b7a46d8acd12a,Yegappan Lakshmanan,53,59,112,5,"{""src/evalbuffer.c"": {""insertions"": 14, ""deletions"": 21, ""lines"": 35}, ""src/evalfunc.c"": {""insertions"": 0, ""deletions"": 36, ""lines"": 36}, ""src/map.c"": {""insertions"": 35, ""deletions"": 1, ""lines"": 36}, ""src/proto/map.pro"": {""insertions"": 2, ""deletions"": 1, ""lines"": 3}, ""src/version.c"": {""insertions"": 2, ""deletions"": 0, ""lines"": 2}}"
2021-07-30 19:18:03,0f5575d0a7316a9c9a4b02df3372a07514cd8f26,Bram Moolenaar,16,1,17,3,"{""src/term.c"": {""insertions"": 2, ""deletions"": 1, ""lines"": 3}, ""src/testdir/test_termcodes.vim"": {""insertions"": 12, ""deletions"": 0, ""lines"": 12}, ""src/version.c"": {""insertions"": 2, ""deletions"": 0, ""lines"": 2}}"
2021-07-30 18:51:59,1790be6cb6f2edfd8a833dd848b8df02cef599cf,Christian Brabandt,3,1,4,2,"{""src/Make_mvc.mak"": {""insertions"": 1, ""deletions"": 1, ""lines"": 2}, ""src/version.c"": {""insertions"": 2, ""deletions"": 0, ""lines"": 2}}"
2021-07-29 20:48:54,60dc8274e9f8c6a20d54efebc7a8752fe062eead,Bram Moolenaar,26,10,36,8,"{""src/eval.c"": {""insertions"": 1, ""deletions"": 1, ""lines"": 2}, ""src/proto/vim9type.pro"": {""insertions"": 1, ""deletions"": 1, ""lines"": 2}, ""src/testdir/test_vim9_script.vim"": {""insertions"": 6, ""deletions"": 0, ""lines"": 6}, ""src/version.c"": {""insertions"": 2, ""deletions"": 0, ""lines"": 2}, ""src/vim.h"": {""insertions"": 3, ""deletions"": 0, ""lines"": 3}, ""src/vim9execute.c"": {""insertions"": 1, ""deletions"": 1, ""lines"": 2}, ""src/vim9script.c"": {""insertions"": 3, ""deletions"": 2, ""lines"": 5}, ""src/vim9type.c"": {""insertions"": 9, ""deletions"": 5, ""lines"": 14}}"
2021-07-29 20:25:05,921ba529266c8dfc0809d41e1f084e26d25fffb1,Bram Moolenaar,16,0,16,3,"{""src/testdir/test_vim9_script.vim"": {""insertions"": 10, ""deletions"": 0, ""lines"": 10}, ""src/version.c"": {""insertions"": 2, ""deletions"": 0, ""lines"": 2}, ""src/vim9script.c"": {""insertions"": 4, ""deletions"": 0, ""lines"": 4}}"
2021-07-29 19:23:50,77ab4e28a26a92628bc85cd580c1bfa2b6230be6,Bram Moolenaar,8,5,13,2,"{""src/fileio.c"": {""insertions"": 6, ""deletions"": 5, ""lines"": 11}, ""src/version.c"": {""insertions"": 2, ""deletions"": 0, ""lines"": 2}}"
2021-07-29 19:11:30,77111e2bfc7316eb6b1e653386cef6441af806f8,Bram Moolenaar,3,1,4,2,"{""src/option.c"": {""insertions"": 1, ""deletions"": 1, ""lines"": 2}, ""src/version.c"": {""insertions"": 2, ""deletions"": 0, ""lines"": 2}}"
2021-07-29 18:37:49,131530a54d0f72b820b027606231744e3a09b9ef,Bram Moolenaar,25,13,38,7,"{""src/buffer.c"": {""insertions"": 4, ""deletions"": 0, ""lines"": 4}, ""src/crypt.c"": {""insertions"": 13, ""deletions"": 4, ""lines"": 17}, ""src/errors.h"": {""insertions"": 2, ""deletions"": 0, ""lines"": 2}, ""src/fileio.c"": {""insertions"": 0, ""deletions"": 4, ""lines"": 4}, ""src/memline.c"": {""insertions"": 0, ""deletions"": 5, ""lines"": 5}, ""src/version.c"": {""insertions"": 2, ""deletions"": 0, ""lines"": 2}, ""src/vim.h"": {""insertions"": 4, ""deletions"": 0, ""lines"": 4}}"
2021-07-29 18:22:14,41114a2a27047bf1884e092b98c6298c128eb2f0,Yegappan Lakshmanan,34,8,42,4,"{""src/if_lua.c"": {""insertions"": 15, ""deletions"": 8, ""lines"": 23}, ""src/misc2.c"": {""insertions"": 16, ""deletions"": 0, ""lines"": 16}, ""src/proto/misc2.pro"": {""insertions"": 1, ""deletions"": 0, ""lines"": 1}, ""src/version.c"": {""insertions"": 2, ""deletions"": 0, ""lines"": 2}}"
2021-07-29 17:18:33,83cd0156e01b5befadf12ee66bc26436ee8d023f,msoyka-of-wharton,34,96,130,3,"{""src/GvimExt/gvimext.cpp"": {""insertions"": 31, ""deletions"": 89, ""lines"": 120}, ""src/GvimExt/gvimext.h"": {""insertions"": 1, ""deletions"": 7, ""lines"": 8}, ""src/version.c"": {""insertions"": 2, ""deletions"": 0, ""lines"": 2}}"
2021-07-28 20:44:08,0732932553e54e9bfca07e55b47201b8f30b2c4f,Bram Moolenaar,4,2,6,2,"{""src/testdir/test_vim9_builtin.vim"": {""insertions"": 2, ""deletions"": 2, ""lines"": 4}, ""src/version.c"": {""insertions"": 2, ""deletions"": 0, ""lines"": 2}}"
2021-07-28 20:21:23,6e850a6900793e215c08b39d6490173488cb05ce,Bram Moolenaar,5,0,5,2,"{""src/userfunc.c"": {""insertions"": 3, ""deletions"": 0, ""lines"": 3}, ""src/version.c"": {""insertions"": 2, ""deletions"": 0, ""lines"": 2}}"
2021-07-28 19:48:59,2a4bd00cef1a291059903e26a126b84718e47804,Bram Moolenaar,5,2,7,3,"{""src/if_lua.c"": {""insertions"": 1, ""deletions"": 0, ""lines"": 1}, ""src/testdir/test_lua.vim"": {""insertions"": 2, ""deletions"": 2, ""lines"": 4}, ""src/version.c"": {""insertions"": 2, ""deletions"": 0, ""lines"": 2}}"
2021-07-28 19:25:49,81530e36033dec2c2cd94af6dd48ceb0389e95a2,Bram Moolenaar,22,1,23,4,"{""src/evalvars.c"": {""insertions"": 3, ""deletions"": 0, ""lines"": 3}, ""src/testdir/test_vim9_assign.vim"": {""insertions"": 8, ""deletions"": 0, ""lines"": 8}, ""src/version.c"": {""insertions"": 2, ""deletions"": 0, ""lines"": 2}, ""src/vim9compile.c"": {""insertions"": 9, ""deletions"": 1, ""lines"": 10}}"
2021-07-28 18:52:13,d47c39775b8d381005751b7b20da56412dafb5e4,Bram Moolenaar,10,2,12,4,"{""src/errors.h"": {""insertions"": 2, ""deletions"": 0, ""lines"": 2}, ""src/testdir/test_vim9_expr.vim"": {""insertions"": 1, ""deletions"": 1, ""lines"": 2}, ""src/version.c"": {""insertions"": 2, ""deletions"": 0, ""lines"": 2}, ""src/vim9compile.c"": {""insertions"": 5, ""deletions"": 1, ""lines"": 6}}"
2021-07-28 18:10:16,53f7fccc9413c9f770694b56f40f242d383b2d5f,Bram Moolenaar,804,353,1157,33,"{"".github/CODEOWNERS"": {""insertions"": 2, ""deletions"": 0, ""lines"": 2}, "".github/workflows/ci.yml"": {""insertions"": 1, ""deletions"": 1, ""lines"": 2}, ""README_VIM9.md"": {""insertions"": 13, ""deletions"": 7, ""lines"": 20}, ""runtime/compiler/spectral.vim"": {""insertions"": 17, ""deletions"": 0, ""lines"": 17}, ""runtime/compiler/yamllint.vim"": {""insertions"": 16, ""deletions"": 0, ""lines"": 16}, ""runtime/doc/autocmd.txt"": {""insertions"": 3, ""deletions"": 2, ""lines"": 5}, ""runtime/doc/digraph.txt"": {""insertions"": 1, ""deletions"": 1, ""lines"": 2}, ""runtime/doc/editing.txt"": {""insertions"": 6, ""deletions"": 3, ""lines"": 9}, ""runtime/doc/eval.txt"": {""insertions"": 66, ""deletions"": 31, ""lines"": 97}, ""runtime/doc/fold.txt"": {""insertions"": 3, ""deletions"": 1, ""lines"": 4}, ""runtime/doc/map.txt"": {""insertions"": 3, ""deletions"": 2, ""lines"": 5}, ""runtime/doc/options.txt"": {""insertions"": 2, ""deletions"": 1, ""lines"": 3}, ""runtime/doc/pattern.txt"": {""insertions"": 6, ""deletions"": 5, ""lines"": 11}, ""runtime/doc/syntax.txt"": {""insertions"": 1, ""deletions"": 1, ""lines"": 2}, ""runtime/doc/tags"": {""insertions"": 8, ""deletions"": 0, ""lines"": 8}, ""runtime/doc/todo.txt"": {""insertions"": 23, ""deletions"": 10, ""lines"": 33}, ""runtime/doc/usr_41.txt"": {""insertions"": 1, ""deletions"": 1, ""lines"": 2}, ""runtime/doc/version6.txt"": {""insertions"": 1, ""deletions"": 1, ""lines"": 2}, ""runtime/doc/version7.txt"": {""insertions"": 2, ""deletions"": 2, ""lines"": 4}, ""runtime/doc/version8.txt"": {""insertions"": 8, ""deletions"": 4, ""lines"": 12}, ""runtime/doc/vim9.txt"": {""insertions"": 54, ""deletions"": 12, ""lines"": 66}, ""runtime/indent/bzl.vim"": {""insertions"": 26, ""deletions"": 15, ""lines"": 41}, ""runtime/indent/testdir/xml.in"": {""insertions"": 1, ""deletions"": 1, ""lines"": 2}, ""runtime/indent/testdir/xml.ok"": {""insertions"": 1, ""deletions"": 1, ""lines"": 2}, ""runtime/macros/hanoi/hanoi.vim"": {""insertions"": 1, ""deletions"": 1, ""lines"": 2}, ""runtime/pack/dist/opt/matchit/doc/matchit.txt"": {""insertions"": 2, ""deletions"": 2, ""lines"": 4}, ""runtime/spell/tet/main.aap"": {""insertions"": 1, ""deletions"": 1, ""lines"": 2}, ""runtime/syntax/aptconf.vim"": {""insertions"": 8, ""deletions"": 5, ""lines"": 13}, ""runtime/syntax/pascal.vim"": {""insertions"": 1, ""deletions"": 1, ""lines"": 2}, ""runtime/syntax/redif.vim"": {""insertions"": 2, ""deletions"": 2, ""lines"": 4}, ""runtime/tools/shtags.1"": {""insertions"": 1, ""deletions"": 1, ""lines"": 2}, ""runtime/tools/xcmdsrv_client.c"": {""insertions"": 1, ""deletions"": 1, ""lines"": 2}, ""src/po/tr.po"": {""insertions"": 522, ""deletions"": 237, ""lines"": 759}}"
2021-07-28 17:34:14,327d3ee4557027b51aad86e68743a85ed3a6f52b,Bram Moolenaar,23,1,24,3,"{""src/testdir/test_vim9_assign.vim"": {""insertions"": 15, ""deletions"": 0, ""lines"": 15}, ""src/userfunc.c"": {""insertions"": 6, ""deletions"": 1, ""lines"": 7}, ""src/version.c"": {""insertions"": 2, ""deletions"": 0, ""lines"": 2}}"
2021-07-28 14:51:53,eaf3f36168f85c8e0ab7083cd996b9fbe937045d,zeertzjq,22,1,23,6,"{""runtime/doc/eval.txt"": {""insertions"": 4, ""deletions"": 0, ""lines"": 4}, ""src/globals.h"": {""insertions"": 2, ""deletions"": 0, ""lines"": 2}, ""src/misc1.c"": {""insertions"": 4, ""deletions"": 0, ""lines"": 4}, ""src/normal.c"": {""insertions"": 0, ""deletions"": 1, ""lines"": 1}, ""src/testdir/test_functions.vim"": {""insertions"": 10, ""deletions"": 0, ""lines"": 10}, ""src/version.c"": {""insertions"": 2, ""deletions"": 0, ""lines"": 2}}"
2021-07-28 13:54:54,6868634abd6a49b2dfd3a994a6da7d5911457a37,Bram Moolenaar,10,1,11,3,"{""src/testdir/test_usercommands.vim"": {""insertions"": 7, ""deletions"": 0, ""lines"": 7}, ""src/userfunc.c"": {""insertions"": 1, ""deletions"": 1, ""lines"": 2}, ""src/version.c"": {""insertions"": 2, ""deletions"": 0, ""lines"": 2}}"
2021-07-28 13:07:01,78e006b9b02fac94c910445d842f6dc5331fa57a,Bram Moolenaar,22,2,24,3,"{""src/if_lua.c"": {""insertions"": 2, ""deletions"": 2, ""lines"": 4}, ""src/testdir/test_lua.vim"": {""insertions"": 18, ""deletions"": 0, ""lines"": 18}, ""src/version.c"": {""insertions"": 2, ""deletions"": 0, ""lines"": 2}}"
2021-07-28 11:30:16,e2390c7f32879ab7942adf0d38b1db34933695fa,Martin Tournoij,149,61,210,4,"{""runtime/doc/textprop.txt"": {""insertions"": 2, ""deletions"": 0, ""lines"": 2}, ""src/testdir/test_textprop.vim"": {""insertions"": 129, ""deletions"": 58, ""lines"": 187}, ""src/textprop.c"": {""insertions"": 16, ""deletions"": 3, ""lines"": 19}, ""src/version.c"": {""insertions"": 2, ""deletions"": 0, ""lines"": 2}}"
2021-07-28 09:51:48,7e6a2a64f09df577f29e024c1d1e6733d6bc1b7c,Yegappan Lakshmanan,21,1,22,5,"{""src/misc1.c"": {""insertions"": 1, ""deletions"": 1, ""lines"": 2}, ""src/proto/typval.pro"": {""insertions"": 1, ""deletions"": 0, ""lines"": 1}, ""src/testdir/test_vim9_builtin.vim"": {""insertions"": 6, ""deletions"": 0, ""lines"": 6}, ""src/typval.c"": {""insertions"": 11, ""deletions"": 0, ""lines"": 11}, ""src/version.c"": {""insertions"": 2, ""deletions"": 0, ""lines"": 2}}"
2021-07-27 20:35:42,9088784972c0ed72997de8752964d6b587218778,Bram Moolenaar,4,0,4,2,"{""src/errors.h"": {""insertions"": 2, ""deletions"": 0, ""lines"": 2}, ""src/version.c"": {""insertions"": 2, ""deletions"": 0, ""lines"": 2}}"
2021-07-27 20:21:44,f723701de0636ad8b4aad6179b322f72b04354b9,Bram Moolenaar,15,0,15,3,"{""src/testdir/test_vim9_builtin.vim"": {""insertions"": 10, ""deletions"": 0, ""lines"": 10}, ""src/version.c"": {""insertions"": 2, ""deletions"": 0, ""lines"": 2}, ""src/vim9compile.c"": {""insertions"": 3, ""deletions"": 0, ""lines"": 3}}"
2021-07-27 20:00:44,4490ec4e839e45a2e6923c265c7e9e64c240b805,Yegappan Lakshmanan,1710,630,2340,55,"{""src/arglist.c"": {""insertions"": 15, ""deletions"": 0, ""lines"": 15}, ""src/change.c"": {""insertions"": 8, ""deletions"": 1, ""lines"": 9}, ""src/channel.c"": {""insertions"": 41, ""deletions"": 6, ""lines"": 47}, ""src/cindent.c"": {""insertions"": 3, ""deletions"": 0, ""lines"": 3}, ""src/clientserver.c"": {""insertions"": 28, ""deletions"": 11, ""lines"": 39}, ""src/cmdhist.c"": {""insertions"": 10, ""deletions"": 1, ""lines"": 11}, ""src/dict.c"": {""insertions"": 8, ""deletions"": 0, ""lines"": 8}, ""src/diff.c"": {""insertions"": 3, ""deletions"": 0, ""lines"": 3}, ""src/digraph.c"": {""insertions"": 12, ""deletions"": 0, ""lines"": 12}, ""src/errors.h"": {""insertions"": 20, ""deletions"": 0, ""lines"": 20}, ""src/eval.c"": {""insertions"": 2, ""deletions"": 2, ""lines"": 4}, ""src/evalbuffer.c"": {""insertions"": 48, ""deletions"": 6, ""lines"": 54}, ""src/evalfunc.c"": {""insertions"": 278, ""deletions"": 33, ""lines"": 311}, ""src/evalwindow.c"": {""insertions"": 68, ""deletions"": 3, ""lines"": 71}, ""src/ex_docmd.c"": {""insertions"": 6, ""deletions"": 1, ""lines"": 7}, ""src/ex_getln.c"": {""insertions"": 15, ""deletions"": 2, ""lines"": 17}, ""src/filepath.c"": {""insertions"": 57, ""deletions"": 5, ""lines"": 62}, ""src/findfile.c"": {""insertions"": 3, ""deletions"": 0, ""lines"": 3}, ""src/float.c"": {""insertions"": 86, ""deletions"": 2, ""lines"": 88}, ""src/fold.c"": {""insertions"": 10, ""deletions"": 0, ""lines"": 10}, ""src/getchar.c"": {""insertions"": 3, ""deletions"": 0, ""lines"": 3}, ""src/indent.c"": {""insertions"": 6, ""deletions"": 0, ""lines"": 6}, ""src/insexpand.c"": {""insertions"": 4, ""deletions"": 4, ""lines"": 8}, ""src/job.c"": {""insertions"": 16, ""deletions"": 2, ""lines"": 18}, ""src/json.c"": {""insertions"": 6, ""deletions"": 0, ""lines"": 6}, ""src/list.c"": {""insertions"": 1, ""deletions"": 4, ""lines"": 5}, ""src/mark.c"": {""insertions"": 3, ""deletions"": 0, ""lines"": 3}, ""src/match.c"": {""insertions"": 22, ""deletions"": 4, ""lines"": 26}, ""src/mbyte.c"": {""insertions"": 9, ""deletions"": 0, ""lines"": 9}, ""src/menu.c"": {""insertions"": 5, ""deletions"": 0, ""lines"": 5}, ""src/misc1.c"": {""insertions"": 7, ""deletions"": 1, ""lines"": 8}, ""src/move.c"": {""insertions"": 6, ""deletions"": 0, ""lines"": 6}, ""src/popupwin.c"": {""insertions"": 45, ""deletions"": 10, ""lines"": 55}, ""src/proto/typval.pro"": {""insertions"": 6, ""deletions"": 1, ""lines"": 7}, ""src/quickfix.c"": {""insertions"": 8, ""deletions"": 0, ""lines"": 8}, ""src/search.c"": {""insertions"": 3, ""deletions"": 0, ""lines"": 3}, ""src/sign.c"": {""insertions"": 18, ""deletions"": 0, ""lines"": 18}, ""src/sound.c"": {""insertions"": 8, ""deletions"": 1, ""lines"": 9}, ""src/strings.c"": {""insertions"": 63, ""deletions"": 2, ""lines"": 65}, ""src/terminal.c"": {""insertions"": 51, ""deletions"": 16, ""lines"": 67}, ""src/testdir/test_assert.vim"": {""insertions"": 1, ""deletions"": 1, ""lines"": 2}, ""src/testdir/test_blob.vim"": {""insertions"": 1, ""deletions"": 1, ""lines"": 2}, ""src/testdir/test_execute_func.vim"": {""insertions"": 1, ""deletions"": 1, ""lines"": 2}, ""src/testdir/test_float_func.vim"": {""insertions"": 1, ""deletions"": 2, ""lines"": 3}, ""src/testdir/test_functions.vim"": {""insertions"": 3, ""deletions"": 6, ""lines"": 9}, ""src/testdir/test_glob2regpat.vim"": {""insertions"": 1, ""deletions"": 2, ""lines"": 3}, ""src/testdir/test_listdict.vim"": {""insertions"": 1, ""deletions"": 1, ""lines"": 2}, ""src/testdir/test_vim9_builtin.vim"": {""insertions"": 482, ""deletions"": 482, ""lines"": 964}, ""src/testdir/test_vim9_script.vim"": {""insertions"": 1, ""deletions"": 1, ""lines"": 2}, ""src/testing.c"": {""insertions"": 57, ""deletions"": 4, ""lines"": 61}, ""src/textprop.c"": {""insertions"": 25, ""deletions"": 1, ""lines"": 26}, ""src/time.c"": {""insertions"": 24, ""deletions"": 0, ""lines"": 24}, ""src/typval.c"": {""insertions"": 96, ""deletions"": 10, ""lines"": 106}, ""src/undo.c"": {""insertions"": 3, ""deletions"": 0, ""lines"": 3}, ""src/version.c"": {""insertions"": 2, ""deletions"": 0, ""lines"": 2}}"
2021-07-27 19:17:32,5d7c2df536c17db4a9c61e0760bdcf78d0db7330,Bram Moolenaar,84,14,98,6,"{""runtime/doc/map.txt"": {""insertions"": 10, ""deletions"": 0, ""lines"": 10}, ""src/misc2.c"": {""insertions"": 10, ""deletions"": 11, ""lines"": 21}, ""src/proto/misc2.pro"": {""insertions"": 1, ""deletions"": 1, ""lines"": 2}, ""src/testdir/test_usercommands.vim"": {""insertions"": 18, ""deletions"": 0, ""lines"": 18}, ""src/usercmd.c"": {""insertions"": 43, ""deletions"": 2, ""lines"": 45}, ""src/version.c"": {""insertions"": 2, ""deletions"": 0, ""lines"": 2}}"
2021-07-26 20:19:10,53ba05b09075f14227f9be831a22ed16f7cc26b2,Gary Johnson,220,41,261,17,"{""runtime/doc/options.txt"": {""insertions"": 5, ""deletions"": 1, ""lines"": 6}, ""src/buffer.c"": {""insertions"": 1, ""deletions"": 0, ""lines"": 1}, ""src/change.c"": {""insertions"": 1, ""deletions"": 1, ""lines"": 2}, ""src/drawscreen.c"": {""insertions"": 4, ""deletions"": 4, ""lines"": 8}, ""src/edit.c"": {""insertions"": 3, ""deletions"": 3, ""lines"": 6}, ""src/misc2.c"": {""insertions"": 12, ""deletions"": 9, ""lines"": 21}, ""src/normal.c"": {""insertions"": 3, ""deletions"": 3, ""lines"": 6}, ""src/ops.c"": {""insertions"": 11, ""deletions"": 5, ""lines"": 16}, ""src/option.c"": {""insertions"": 20, ""deletions"": 1, ""lines"": 21}, ""src/option.h"": {""insertions"": 3, ""deletions"": 0, ""lines"": 3}, ""src/optiondefs.h"": {""insertions"": 2, ""deletions"": 1, ""lines"": 3}, ""src/optionstr.c"": {""insertions"": 25, ""deletions"": 9, ""lines"": 34}, ""src/proto/option.pro"": {""insertions"": 1, ""deletions"": 0, ""lines"": 1}, ""src/register.c"": {""insertions"": 5, ""deletions"": 4, ""lines"": 9}, ""src/structs.h"": {""insertions"": 2, ""deletions"": 0, ""lines"": 2}, ""src/testdir/test_virtualedit.vim"": {""insertions"": 120, ""deletions"": 0, ""lines"": 120}, ""src/version.c"": {""insertions"": 2, ""deletions"": 0, ""lines"": 2}}"
2021-07-26 19:54:04,29b857150c111a455f1a38a8f748243524f692e1,h-east,190,189,379,10,"{""runtime/doc/digraph.txt"": {""insertions"": 1, ""deletions"": 1, ""lines"": 2}, ""runtime/doc/eval.txt"": {""insertions"": 105, ""deletions"": 106, ""lines"": 211}, ""runtime/doc/usr_41.txt"": {""insertions"": 4, ""deletions"": 4, ""lines"": 8}, ""src/digraph.c"": {""insertions"": 24, ""deletions"": 24, ""lines"": 48}, ""src/edit.c"": {""insertions"": 1, ""deletions"": 1, ""lines"": 2}, ""src/errors.h"": {""insertions"": 2, ""deletions"": 2, ""lines"": 4}, ""src/evalfunc.c"": {""insertions"": 8, ""deletions"": 8, ""lines"": 16}, ""src/proto/digraph.pro"": {""insertions"": 6, ""deletions"": 6, ""lines"": 12}, ""src/testdir/test_digraph.vim"": {""insertions"": 37, ""deletions"": 37, ""lines"": 74}, ""src/version.c"": {""insertions"": 2, ""deletions"": 0, ""lines"": 2}}"
2021-07-26 19:11:32,ccb148ac63941feba879ea4678aa4713d81494f2,Bram Moolenaar,3,1,4,2,"{""src/ex_getln.c"": {""insertions"": 1, ""deletions"": 1, ""lines"": 2}, ""src/version.c"": {""insertions"": 2, ""deletions"": 0, ""lines"": 2}}"
2021-07-26 19:10:11,678b207fb111840fec1f0dc43910613ba106b90d,Bram Moolenaar,23,2,25,4,"{""src/eval.c"": {""insertions"": 2, ""deletions"": 1, ""lines"": 3}, ""src/testdir/test_vim9_cmd.vim"": {""insertions"": 14, ""deletions"": 0, ""lines"": 14}, ""src/version.c"": {""insertions"": 2, ""deletions"": 0, ""lines"": 2}, ""src/vim9compile.c"": {""insertions"": 5, ""deletions"": 1, ""lines"": 6}}"
2021-07-25 18:27:06,ff34bee3a2d22f2ff7abd4519270b5518082c33d,Bram Moolenaar,34,1,35,3,"{""src/ex_cmds.h"": {""insertions"": 1, ""deletions"": 1, ""lines"": 2}, ""src/testdir/test_ins_complete.vim"": {""insertions"": 31, ""deletions"": 0, ""lines"": 31}, ""src/version.c"": {""insertions"": 2, ""deletions"": 0, ""lines"": 2}}"
2021-07-25 16:07:00,3c77b6a1ce1d4a06c60bb9fae7eec2775f547d55,Bram Moolenaar,27,3,30,3,"{""src/testdir/test_vim9_func.vim"": {""insertions"": 10, ""deletions"": 1, ""lines"": 11}, ""src/version.c"": {""insertions"": 2, ""deletions"": 0, ""lines"": 2}, ""src/vim9compile.c"": {""insertions"": 15, ""deletions"": 2, ""lines"": 17}}"
2021-07-25 13:57:32,a764e73d4ffc5d046807c757eaacb9b0a5408152,Yegappan Lakshmanan,189,17,206,9,"{""src/evalfunc.c"": {""insertions"": 70, ""deletions"": 10, ""lines"": 80}, ""src/popupwin.c"": {""insertions"": 5, ""deletions"": 1, ""lines"": 6}, ""src/proto/typval.pro"": {""insertions"": 2, ""deletions"": 0, ""lines"": 2}, ""src/testdir/test_assert.vim"": {""insertions"": 3, ""deletions"": 3, ""lines"": 6}, ""src/testdir/test_vim9_builtin.vim"": {""insertions"": 60, ""deletions"": 0, ""lines"": 60}, ""src/testdir/test_vim9_script.vim"": {""insertions"": 2, ""deletions"": 2, ""lines"": 4}, ""src/testing.c"": {""insertions"": 18, ""deletions"": 1, ""lines"": 19}, ""src/typval.c"": {""insertions"": 27, ""deletions"": 0, ""lines"": 27}, ""src/version.c"": {""insertions"": 2, ""deletions"": 0, ""lines"": 2}}"
2021-07-25 13:41:44,2ec28aec9d4f1b9c1c008e36adde9fc82affae0f,Dominique Pelle,9,2,11,2,"{""src/testdir/test_vim9_builtin.vim"": {""insertions"": 7, ""deletions"": 2, ""lines"": 9}, ""src/version.c"": {""insertions"": 2, ""deletions"": 0, ""lines"": 2}}"
2021-07-25 13:08:05,7a4ca32175bef0f9a177052796bd9addd10dc218,Christian Brabandt,39,0,39,4,"{""runtime/doc/editing.txt"": {""insertions"": 6, ""deletions"": 0, ""lines"": 6}, ""src/findfile.c"": {""insertions"": 9, ""deletions"": 0, ""lines"": 9}, ""src/testdir/test_findfile.vim"": {""insertions"": 22, ""deletions"": 0, ""lines"": 22}, ""src/version.c"": {""insertions"": 2, ""deletions"": 0, ""lines"": 2}}"
2021-07-25 12:36:05,8a4c812ede5b01a8e71082c1ff4ebfcbf1bd515f,Christian Brabandt,43,11,54,6,"{""src/bufwrite.c"": {""insertions"": 13, ""deletions"": 4, ""lines"": 17}, ""src/crypt.c"": {""insertions"": 1, ""deletions"": 4, ""lines"": 5}, ""src/proto/undo.pro"": {""insertions"": 1, ""deletions"": 0, ""lines"": 1}, ""src/testdir/test_crypt.vim"": {""insertions"": 4, ""deletions"": 3, ""lines"": 7}, ""src/undo.c"": {""insertions"": 22, ""deletions"": 0, ""lines"": 22}, ""src/version.c"": {""insertions"": 2, ""deletions"": 0, ""lines"": 2}}"
2021-07-25 12:21:11,3ed0d9379683246a77aa8c1a59da7a0ac6395339,Bram Moolenaar,3,1,4,2,"{""src/globals.h"": {""insertions"": 1, ""deletions"": 1, ""lines"": 2}, ""src/version.c"": {""insertions"": 2, ""deletions"": 0, ""lines"": 2}}"
2021-07-25 12:13:53,2eb6fc3b52148f961e804ec2be361d531ff770d8,Bram Moolenaar,135,76,211,8,"{""src/eval.c"": {""insertions"": 7, ""deletions"": 3, ""lines"": 10}, ""src/evalvars.c"": {""insertions"": 1, ""deletions"": 7, ""lines"": 8}, ""src/ex_eval.c"": {""insertions"": 4, ""deletions"": 14, ""lines"": 18}, ""src/structs.h"": {""insertions"": 3, ""deletions"": 0, ""lines"": 3}, ""src/testdir/test_vim9_script.vim"": {""insertions"": 28, ""deletions"": 0, ""lines"": 28}, ""src/userfunc.c"": {""insertions"": 36, ""deletions"": 22, ""lines"": 58}, ""src/version.c"": {""insertions"": 2, ""deletions"": 0, ""lines"": 2}, ""src/vim9script.c"": {""insertions"": 54, ""deletions"": 30, ""lines"": 84}}"
2021-07-24 19:33:26,5bca906b307728fa74a112914dc55b424d512d39,Yegappan Lakshmanan,223,102,325,8,"{""src/change.c"": {""insertions"": 3, ""deletions"": 0, ""lines"": 3}, ""src/evalfunc.c"": {""insertions"": 112, ""deletions"": 77, ""lines"": 189}, ""src/filepath.c"": {""insertions"": 14, ""deletions"": 0, ""lines"": 14}, ""src/sound.c"": {""insertions"": 9, ""deletions"": 0, ""lines"": 9}, ""src/testdir/test_gui.vim"": {""insertions"": 4, ""deletions"": 4, ""lines"": 8}, ""src/testdir/test_vim9_builtin.vim"": {""insertions"": 70, ""deletions"": 14, ""lines"": 84}, ""src/testing.c"": {""insertions"": 9, ""deletions"": 7, ""lines"": 16}, ""src/version.c"": {""insertions"": 2, ""deletions"": 0, ""lines"": 2}}"
2021-07-24 19:19:42,7d60384a00755e5c0112cebeb5e232fc133c9eca,Christian Brabandt,38,16,54,3,"{""nsis/gvim.nsi"": {""insertions"": 11, ""deletions"": 14, ""lines"": 25}, ""runtime/doc/os_win32.txt"": {""insertions"": 25, ""deletions"": 2, ""lines"": 27}, ""src/version.c"": {""insertions"": 2, ""deletions"": 0, ""lines"": 2}}"
2021-07-24 18:51:13,9c9472ff49b09c3d8f747b330eeb1cdb92bab449,Dominique Pelle,48,0,48,2,"{""src/testdir/test_spellfile.vim"": {""insertions"": 46, ""deletions"": 0, ""lines"": 46}, ""src/version.c"": {""insertions"": 2, ""deletions"": 0, ""lines"": 2}}"
2021-07-24 17:32:12,5a9e5845e1539592e94963fcdf5b3ad4fdc59db4,Dominique Pelle,54,44,98,2,"{""src/version.c"": {""insertions"": 2, ""deletions"": 0, ""lines"": 2}, ""src/vim9execute.c"": {""insertions"": 52, ""deletions"": 44, ""lines"": 96}}"
2021-07-24 14:16:15,7973de35ba6840b7e106e2e8a8912522e9a2a960,Yegappan Lakshmanan,165,22,187,10,"{""src/channel.c"": {""insertions"": 7, ""deletions"": 1, ""lines"": 8}, ""src/evalfunc.c"": {""insertions"": 48, ""deletions"": 17, ""lines"": 65}, ""src/evalvars.c"": {""insertions"": 11, ""deletions"": 0, ""lines"": 11}, ""src/if_cscope.c"": {""insertions"": 8, ""deletions"": 0, ""lines"": 8}, ""src/job.c"": {""insertions"": 8, ""deletions"": 0, ""lines"": 8}, ""src/proto/typval.pro"": {""insertions"": 1, ""deletions"": 0, ""lines"": 1}, ""src/testdir/test_vim9_builtin.vim"": {""insertions"": 61, ""deletions"": 3, ""lines"": 64}, ""src/time.c"": {""insertions"": 8, ""deletions"": 1, ""lines"": 9}, ""src/typval.c"": {""insertions"": 11, ""deletions"": 0, ""lines"": 11}, ""src/version.c"": {""insertions"": 2, ""deletions"": 0, ""lines"": 2}}"
2021-07-24 13:44:30,dd0b287c1ec8314034a2dbb14c4267994c47520c,Bram Moolenaar,13,3,16,3,"{""src/testdir/test_vim9_builtin.vim"": {""insertions"": 10, ""deletions"": 2, ""lines"": 12}, ""src/version.c"": {""insertions"": 2, ""deletions"": 0, ""lines"": 2}, ""src/vim9compile.c"": {""insertions"": 1, ""deletions"": 1, ""lines"": 2}}"
2021-07-24 12:14:52,88421d6dc812a2f3b0eab34740f174c9558cb734,Bram Moolenaar,42,1,43,3,"{""src/testdir/test_vim9_func.vim"": {""insertions"": 36, ""deletions"": 0, ""lines"": 36}, ""src/version.c"": {""insertions"": 2, ""deletions"": 0, ""lines"": 2}, ""src/vim9compile.c"": {""insertions"": 4, ""deletions"": 1, ""lines"": 5}}"
2021-07-24 11:57:29,1a3e5747b7df7ddda312bbfd18e04fc2122001fb,Martin Tournoij,45,30,75,14,"{""src/globals.h"": {""insertions"": 1, ""deletions"": 1, ""lines"": 2}, ""src/if_cscope.c"": {""insertions"": 0, ""deletions"": 18, ""lines"": 18}, ""src/if_lua.c"": {""insertions"": 3, ""deletions"": 1, ""lines"": 4}, ""src/if_mzsch.c"": {""insertions"": 2, ""deletions"": 2, ""lines"": 4}, ""src/if_perl.xs"": {""insertions"": 2, ""deletions"": 0, ""lines"": 2}, ""src/if_python.c"": {""insertions"": 3, ""deletions"": 1, ""lines"": 4}, ""src/if_python3.c"": {""insertions"": 3, ""deletions"": 1, ""lines"": 4}, ""src/if_ruby.c"": {""insertions"": 3, ""deletions"": 1, ""lines"": 4}, ""src/if_tcl.c"": {""insertions"": 3, ""deletions"": 1, ""lines"": 4}, ""src/mbyte.c"": {""insertions"": 2, ""deletions"": 1, ""lines"": 3}, ""src/os_win32.c"": {""insertions"": 17, ""deletions"": 1, ""lines"": 18}, ""src/proto/os_win32.pro"": {""insertions"": 1, ""deletions"": 0, ""lines"": 1}, ""src/terminal.c"": {""insertions"": 3, ""deletions"": 2, ""lines"": 5}, ""src/version.c"": {""insertions"": 2, ""deletions"": 0, ""lines"": 2}}"
2021-07-24 11:18:48,5a234eb18e6e43408755bb24e813330306c11629,Bram Moolenaar,9,1,10,3,"{""src/testdir/test_vim9_builtin.vim"": {""insertions"": 6, ""deletions"": 1, ""lines"": 7}, ""src/version.c"": {""insertions"": 2, ""deletions"": 0, ""lines"": 2}, ""src/vim9compile.c"": {""insertions"": 1, ""deletions"": 0, ""lines"": 1}}"
2021-07-23 18:37:56,0ad871dc4dfe1026e14931a55c225616b63f4c5b,Yegappan Lakshmanan,456,152,608,19,"{""src/blob.c"": {""insertions"": 0, ""deletions"": 6, ""lines"": 6}, ""src/cmdhist.c"": {""insertions"": 5, ""deletions"": 0, ""lines"": 5}, ""src/dict.c"": {""insertions"": 0, ""deletions"": 5, ""lines"": 5}, ""src/errors.h"": {""insertions"": 2, ""deletions"": 4, ""lines"": 6}, ""src/evalfunc.c"": {""insertions"": 138, ""deletions"": 82, ""lines"": 220}, ""src/filepath.c"": {""insertions"": 6, ""deletions"": 0, ""lines"": 6}, ""src/globals.h"": {""insertions"": 0, ""deletions"": 1, ""lines"": 1}, ""src/job.c"": {""insertions"": 6, ""deletions"": 0, ""lines"": 6}, ""src/list.c"": {""insertions"": 38, ""deletions"": 6, ""lines"": 44}, ""src/match.c"": {""insertions"": 24, ""deletions"": 2, ""lines"": 26}, ""src/misc1.c"": {""insertions"": 5, ""deletions"": 0, ""lines"": 5}, ""src/popupwin.c"": {""insertions"": 9, ""deletions"": 2, ""lines"": 11}, ""src/proto/typval.pro"": {""insertions"": 2, ""deletions"": 1, ""lines"": 3}, ""src/sign.c"": {""insertions"": 19, ""deletions"": 0, ""lines"": 19}, ""src/terminal.c"": {""insertions"": 15, ""deletions"": 1, ""lines"": 16}, ""src/testdir/test_blob.vim"": {""insertions"": 4, ""deletions"": 4, ""lines"": 8}, ""src/testdir/test_vim9_builtin.vim"": {""insertions"": 140, ""deletions"": 15, ""lines"": 155}, ""src/typval.c"": {""insertions"": 41, ""deletions"": 23, ""lines"": 64}, ""src/version.c"": {""insertions"": 2, ""deletions"": 0, ""lines"": 2}}"
2021-07-23 17:30:19,1b862c466ba4242857eec581f67982d265005ef4,Bram Moolenaar,5,3,8,2,"{""src/version.c"": {""insertions"": 2, ""deletions"": 0, ""lines"": 2}, ""src/vim9compile.c"": {""insertions"": 3, ""deletions"": 3, ""lines"": 6}}"
2021-07-22 19:33:03,c9e7e344ed390d2a22afb88001b6aa80832d2541,Bram Moolenaar,94,1,95,5,"{""src/drawscreen.c"": {""insertions"": 3, ""deletions"": 1, ""lines"": 4}, ""src/testdir/dumps/Test_cursorline_redraw_1.dump"": {""insertions"": 20, ""deletions"": 0, ""lines"": 20}, ""src/testdir/dumps/Test_cursorline_redraw_2.dump"": {""insertions"": 20, ""deletions"": 0, ""lines"": 20}, ""src/testdir/test_cursorline.vim"": {""insertions"": 49, ""deletions"": 0, ""lines"": 49}, ""src/version.c"": {""insertions"": 2, ""deletions"": 0, ""lines"": 2}}"
2021-07-22 17:11:08,cd268017cf79a546a494883b4b026a3cbbd9a8a0,Bram Moolenaar,10,3,13,3,"{""src/evalfunc.c"": {""insertions"": 3, ""deletions"": 1, ""lines"": 4}, ""src/version.c"": {""insertions"": 2, ""deletions"": 0, ""lines"": 2}, ""src/vim9compile.c"": {""insertions"": 5, ""deletions"": 2, ""lines"": 7}}"
2021-07-22 16:48:53,5dd839ce20466eea52e59ecf86456f1ab370d2bd,Bram Moolenaar,127,39,166,4,"{""src/ex_docmd.c"": {""insertions"": 2, ""deletions"": 1, ""lines"": 3}, ""src/testdir/test_listdict.vim"": {""insertions"": 116, ""deletions"": 38, ""lines"": 154}, ""src/version.c"": {""insertions"": 2, ""deletions"": 0, ""lines"": 2}, ""src/vim9execute.c"": {""insertions"": 7, ""deletions"": 0, ""lines"": 7}}"
2021-07-22 13:14:25,2b59df00d80ea8d2c0fcf4f4ae9a018c1790206f,Bram Moolenaar,5,5,10,3,"{""src/eval.c"": {""insertions"": 1, ""deletions"": 2, ""lines"": 3}, ""src/evalvars.c"": {""insertions"": 2, ""deletions"": 3, ""lines"": 5}, ""src/version.c"": {""insertions"": 2, ""deletions"": 0, ""lines"": 2}}"
2021-07-22 12:58:47,7a3fe3e180bdbce8f193abdf399559c5154bdaae,Bram Moolenaar,78,49,127,13,"{""src/dict.c"": {""insertions"": 3, ""deletions"": 3, ""lines"": 6}, ""src/errors.h"": {""insertions"": 6, ""deletions"": 0, ""lines"": 6}, ""src/eval.c"": {""insertions"": 4, ""deletions"": 3, ""lines"": 7}, ""src/if_py_both.h"": {""insertions"": 1, ""deletions"": 1, ""lines"": 2}, ""src/list.c"": {""insertions"": 18, ""deletions"": 13, ""lines"": 31}, ""src/proto/dict.pro"": {""insertions"": 1, ""deletions"": 1, ""lines"": 2}, ""src/proto/vim9type.pro"": {""insertions"": 1, ""deletions"": 1, ""lines"": 2}, ""src/structs.h"": {""insertions"": 3, ""deletions"": 0, ""lines"": 3}, ""src/testdir/test_vim9_builtin.vim"": {""insertions"": 5, ""deletions"": 3, ""lines"": 8}, ""src/version.c"": {""insertions"": 2, ""deletions"": 0, ""lines"": 2}, ""src/vim9compile.c"": {""insertions"": 5, ""deletions"": 11, ""lines"": 16}, ""src/vim9execute.c"": {""insertions"": 7, ""deletions"": 3, ""lines"": 10}, ""src/vim9type.c"": {""insertions"": 22, ""deletions"": 10, ""lines"": 32}}"
2021-07-22 10:26:14,a74901929e999a0052c1ce388ab09359c10cbb0d,Bram Moolenaar,4,2,6,2,"{""src/version.c"": {""insertions"": 2, ""deletions"": 0, ""lines"": 2}, ""src/vim9execute.c"": {""insertions"": 2, ""deletions"": 2, ""lines"": 4}}"
2021-07-22 09:46:59,f674b358fc18cf1641a066cc5de73da69e651024,Maxim Kim,71,8,79,4,"{""runtime/doc/options.txt"": {""insertions"": 3, ""deletions"": 1, ""lines"": 4}, ""src/indent.c"": {""insertions"": 12, ""deletions"": 6, ""lines"": 18}, ""src/testdir/test_breakindent.vim"": {""insertions"": 54, ""deletions"": 1, ""lines"": 55}, ""src/version.c"": {""insertions"": 2, ""deletions"": 0, ""lines"": 2}}"
2021-07-21 20:20:33,d8e44476d84b5f0cc8c4de080a47a3a9af547028,Bram Moolenaar,61,35,96,15,"{""src/edit.c"": {""insertions"": 1, ""deletions"": 1, ""lines"": 2}, ""src/errors.h"": {""insertions"": 33, ""deletions"": 0, ""lines"": 33}, ""src/evalvars.c"": {""insertions"": 3, ""deletions"": 2, ""lines"": 5}, ""src/ex_cmds.c"": {""insertions"": 1, ""deletions"": 1, ""lines"": 2}, ""src/ex_docmd.c"": {""insertions"": 1, ""deletions"": 1, ""lines"": 2}, ""src/globals.h"": {""insertions"": 0, ""deletions"": 8, ""lines"": 8}, ""src/option.c"": {""insertions"": 4, ""deletions"": 4, ""lines"": 8}, ""src/quickfix.c"": {""insertions"": 1, ""deletions"": 1, ""lines"": 2}, ""src/regexp.c"": {""insertions"": 0, ""deletions"": 3, ""lines"": 3}, ""src/regexp_bt.c"": {""insertions"": 8, ""deletions"": 8, ""lines"": 16}, ""src/regexp_nfa.c"": {""insertions"": 4, ""deletions"": 3, ""lines"": 7}, ""src/undo.c"": {""insertions"": 1, ""deletions"": 1, ""lines"": 2}, ""src/version.c"": {""insertions"": 2, ""deletions"": 0, ""lines"": 2}, ""src/vim9compile.c"": {""insertions"": 1, ""deletions"": 1, ""lines"": 2}, ""src/vim9script.c"": {""insertions"": 1, ""deletions"": 1, ""lines"": 2}}"
2021-07-21 19:37:28,05bd9785fd0fd0102ab64554307bff0ec0ae34c1,Bram Moolenaar,57,22,79,3,"{""src/testdir/test_vim9_expr.vim"": {""insertions"": 18, ""deletions"": 11, ""lines"": 29}, ""src/version.c"": {""insertions"": 2, ""deletions"": 0, ""lines"": 2}, ""src/vim9compile.c"": {""insertions"": 37, ""deletions"": 11, ""lines"": 48}}"
2021-07-21 18:38:46,c4c5642513ac41b22b7772cc880c776c69e964c9,Bram Moolenaar,9,2,11,3,"{""src/testdir/test_vim9_func.vim"": {""insertions"": 6, ""deletions"": 0, ""lines"": 6}, ""src/version.c"": {""insertions"": 2, ""deletions"": 0, ""lines"": 2}, ""src/vim9compile.c"": {""insertions"": 1, ""deletions"": 2, ""lines"": 3}}"
2021-07-21 17:09:09,cd9172077bc8c0aafddf2e5367cc0ae2c00c8ff7,Yegappan Lakshmanan,253,139,392,10,"{""src/diff.c"": {""insertions"": 1, ""deletions"": 1, ""lines"": 2}, ""src/evalbuffer.c"": {""insertions"": 11, ""deletions"": 1, ""lines"": 12}, ""src/evalfunc.c"": {""insertions"": 115, ""deletions"": 92, ""lines"": 207}, ""src/job.c"": {""insertions"": 1, ""deletions"": 1, ""lines"": 2}, ""src/proto/typval.pro"": {""insertions"": 3, ""deletions"": 0, ""lines"": 3}, ""src/sign.c"": {""insertions"": 1, ""deletions"": 1, ""lines"": 2}, ""src/terminal.c"": {""insertions"": 36, ""deletions"": 10, ""lines"": 46}, ""src/testdir/test_vim9_builtin.vim"": {""insertions"": 28, ""deletions"": 0, ""lines"": 28}, ""src/typval.c"": {""insertions"": 55, ""deletions"": 33, ""lines"": 88}, ""src/version.c"": {""insertions"": 2, ""deletions"": 0, ""lines"": 2}}"
2021-07-21 16:04:56,189663bdac1156237c49925f77bd197c1bdea12c,Bram Moolenaar,22,4,26,3,"{""src/move.c"": {""insertions"": 4, ""deletions"": 4, ""lines"": 8}, ""src/testdir/test_cursor_func.vim"": {""insertions"": 16, ""deletions"": 0, ""lines"": 16}, ""src/version.c"": {""insertions"": 2, ""deletions"": 0, ""lines"": 2}}"
2021-07-20 20:29:19,11d7e62f1d29fdd7a88b86131b7bbb853f29fe8b,Bram Moolenaar,2,2,4,2,"{""src/errors.h"": {""insertions"": 0, ""deletions"": 2, ""lines"": 2}, ""src/version.c"": {""insertions"": 2, ""deletions"": 0, ""lines"": 2}}"
2021-07-20 20:21:59,63cb6567f0153c35dc75cbc09039ff5d0a7b60e3,Bram Moolenaar,148,90,238,4,"{""src/testdir/test_listdict.vim"": {""insertions"": 121, ""deletions"": 84, ""lines"": 205}, ""src/version.c"": {""insertions"": 2, ""deletions"": 0, ""lines"": 2}, ""src/vim9compile.c"": {""insertions"": 1, ""deletions"": 1, ""lines"": 2}, ""src/vim9execute.c"": {""insertions"": 24, ""deletions"": 5, ""lines"": 29}}"
2021-07-20 19:07:36,e29a27f6f8eef8f00d3c2d4cd9811d81cf3026b3,Bram Moolenaar,127,98,225,29,"{""src/buffer.c"": {""insertions"": 2, ""deletions"": 2, ""lines"": 4}, ""src/debugger.c"": {""insertions"": 1, ""deletions"": 1, ""lines"": 2}, ""src/digraph.c"": {""insertions"": 2, ""deletions"": 2, ""lines"": 4}, ""src/edit.c"": {""insertions"": 1, ""deletions"": 1, ""lines"": 2}, ""src/errors.h"": {""insertions"": 56, ""deletions"": 0, ""lines"": 56}, ""src/ex_cmds.c"": {""insertions"": 5, ""deletions"": 5, ""lines"": 10}, ""src/ex_cmds2.c"": {""insertions"": 1, ""deletions"": 1, ""lines"": 2}, ""src/ex_docmd.c"": {""insertions"": 2, ""deletions"": 2, ""lines"": 4}, ""src/ex_eval.c"": {""insertions"": 4, ""deletions"": 4, ""lines"": 8}, ""src/globals.h"": {""insertions"": 0, ""deletions"": 30, ""lines"": 30}, ""src/gui.c"": {""insertions"": 1, ""deletions"": 1, ""lines"": 2}, ""src/list.c"": {""insertions"": 1, ""deletions"": 1, ""lines"": 2}, ""src/main.c"": {""insertions"": 3, ""deletions"": 3, ""lines"": 6}, ""src/map.c"": {""insertions"": 2, ""deletions"": 1, ""lines"": 3}, ""src/match.c"": {""insertions"": 1, ""deletions"": 1, ""lines"": 2}, ""src/quickfix.c"": {""insertions"": 7, ""deletions"": 7, ""lines"": 14}, ""src/regexp.c"": {""insertions"": 3, ""deletions"": 3, ""lines"": 6}, ""src/regexp_bt.c"": {""insertions"": 6, ""deletions"": 6, ""lines"": 12}, ""src/regexp_nfa.c"": {""insertions"": 2, ""deletions"": 2, ""lines"": 4}, ""src/register.c"": {""insertions"": 5, ""deletions"": 5, ""lines"": 10}, ""src/search.c"": {""insertions"": 3, ""deletions"": 3, ""lines"": 6}, ""src/session.c"": {""insertions"": 1, ""deletions"": 1, ""lines"": 2}, ""src/spell.c"": {""insertions"": 1, ""deletions"": 1, ""lines"": 2}, ""src/syntax.c"": {""insertions"": 2, ""deletions"": 2, ""lines"": 4}, ""src/time.c"": {""insertions"": 3, ""deletions"": 3, ""lines"": 6}, ""src/userfunc.c"": {""insertions"": 1, ""deletions"": 1, ""lines"": 2}, ""src/version.c"": {""insertions"": 2, ""deletions"": 0, ""lines"": 2}, ""src/vim9execute.c"": {""insertions"": 2, ""deletions"": 2, ""lines"": 4}, ""src/window.c"": {""insertions"": 7, ""deletions"": 7, ""lines"": 14}}"
2021-07-20 17:18:44,9fa5dabedc4ed5af85773413e91c2fdbe4cb9f0a,Bram Moolenaar,6,1,7,3,"{""src/ex_docmd.c"": {""insertions"": 1, ""deletions"": 1, ""lines"": 2}, ""src/testdir/test_vim9_script.vim"": {""insertions"": 3, ""deletions"": 0, ""lines"": 3}, ""src/version.c"": {""insertions"": 2, ""deletions"": 0, ""lines"": 2}}"
2021-07-20 15:51:51,83494b4ac61898f687d6ef9dce4bad5802fb8e51,Yegappan Lakshmanan,1417,299,1716,34,"{""src/blob.c"": {""insertions"": 8, ""deletions"": 1, ""lines"": 9}, ""src/channel.c"": {""insertions"": 20, ""deletions"": 1, ""lines"": 21}, ""src/clientserver.c"": {""insertions"": 17, ""deletions"": 2, ""lines"": 19}, ""src/cmdexpand.c"": {""insertions"": 6, ""deletions"": 0, ""lines"": 6}, ""src/cmdhist.c"": {""insertions"": 1, ""deletions"": 2, ""lines"": 3}, ""src/dict.c"": {""insertions"": 5, ""deletions"": 0, ""lines"": 5}, ""src/diff.c"": {""insertions"": 1, ""deletions"": 3, ""lines"": 4}, ""src/errors.h"": {""insertions"": 6, ""deletions"": 0, ""lines"": 6}, ""src/eval.c"": {""insertions"": 9, ""deletions"": 0, ""lines"": 9}, ""src/evalbuffer.c"": {""insertions"": 18, ""deletions"": 0, ""lines"": 18}, ""src/evalfunc.c"": {""insertions"": 385, ""deletions"": 103, ""lines"": 488}, ""src/evalvars.c"": {""insertions"": 32, ""deletions"": 0, ""lines"": 32}, ""src/evalwindow.c"": {""insertions"": 7, ""deletions"": 2, ""lines"": 9}, ""src/filepath.c"": {""insertions"": 26, ""deletions"": 4, ""lines"": 30}, ""src/globals.h"": {""insertions"": 4, ""deletions"": 1, ""lines"": 5}, ""src/insexpand.c"": {""insertions"": 11, ""deletions"": 0, ""lines"": 11}, ""src/job.c"": {""insertions"": 15, ""deletions"": 5, ""lines"": 20}, ""src/list.c"": {""insertions"": 32, ""deletions"": 0, ""lines"": 32}, ""src/map.c"": {""insertions"": 6, ""deletions"": 0, ""lines"": 6}, ""src/match.c"": {""insertions"": 8, ""deletions"": 1, ""lines"": 9}, ""src/proto/typval.pro"": {""insertions"": 14, ""deletions"": 0, ""lines"": 14}, ""src/quickfix.c"": {""insertions"": 15, ""deletions"": 0, ""lines"": 15}, ""src/search.c"": {""insertions"": 18, ""deletions"": 8, ""lines"": 26}, ""src/sign.c"": {""insertions"": 6, ""deletions"": 0, ""lines"": 6}, ""src/strings.c"": {""insertions"": 19, ""deletions"": 6, ""lines"": 25}, ""src/terminal.c"": {""insertions"": 21, ""deletions"": 19, ""lines"": 40}, ""src/testdir/test_blob.vim"": {""insertions"": 0, ""deletions"": 28, ""lines"": 28}, ""src/testdir/test_gui.vim"": {""insertions"": 5, ""deletions"": 5, ""lines"": 10}, ""src/testdir/test_vim9_builtin.vim"": {""insertions"": 459, ""deletions"": 93, ""lines"": 552}, ""src/testing.c"": {""insertions"": 5, ""deletions"": 8, ""lines"": 13}, ""src/textprop.c"": {""insertions"": 26, ""deletions"": 4, ""lines"": 30}, ""src/time.c"": {""insertions"": 7, ""deletions"": 3, ""lines"": 10}, ""src/typval.c"": {""insertions"": 203, ""deletions"": 0, ""lines"": 203}, ""src/version.c"": {""insertions"": 2, ""deletions"": 0, ""lines"": 2}}"
2021-07-19 20:19:29,9bb0dad0d8283c86fddf5b950f4fbb6fb8f12741,Bram Moolenaar,46,2,48,4,"{""src/popupwin.c"": {""insertions"": 2, ""deletions"": 2, ""lines"": 4}, ""src/proto/vim9compile.pro"": {""insertions"": 1, ""deletions"": 0, ""lines"": 1}, ""src/version.c"": {""insertions"": 2, ""deletions"": 0, ""lines"": 2}, ""src/vim9compile.c"": {""insertions"": 41, ""deletions"": 0, ""lines"": 41}}"
2021-07-19 19:45:07,605793500b351ee92483d04b1e03fb8af30dd101,Bram Moolenaar,38,5,43,4,"{""src/errors.h"": {""insertions"": 1, ""deletions"": 1, ""lines"": 2}, ""src/evalvars.c"": {""insertions"": 11, ""deletions"": 4, ""lines"": 15}, ""src/testdir/test_vim9_script.vim"": {""insertions"": 24, ""deletions"": 0, ""lines"": 24}, ""src/version.c"": {""insertions"": 2, ""deletions"": 0, ""lines"": 2}}"
2021-07-19 19:04:23,ac2cd2b08f0fd15e9c3759da043e9b28da80dca8,Bram Moolenaar,24,15,39,3,"{""src/testdir/test_vim9_expr.vim"": {""insertions"": 4, ""deletions"": 0, ""lines"": 4}, ""src/userfunc.c"": {""insertions"": 18, ""deletions"": 15, ""lines"": 33}, ""src/version.c"": {""insertions"": 2, ""deletions"": 0, ""lines"": 2}}"
2021-07-19 18:07:21,6106504e9edc8500131f7a36e59bc146f90180fa,mityu,583,37,620,11,"{""runtime/doc/digraph.txt"": {""insertions"": 3, ""deletions"": 0, ""lines"": 3}, ""runtime/doc/eval.txt"": {""insertions"": 107, ""deletions"": 0, ""lines"": 107}, ""runtime/doc/usr_41.txt"": {""insertions"": 4, ""deletions"": 0, ""lines"": 4}, ""src/digraph.c"": {""insertions"": 353, ""deletions"": 35, ""lines"": 388}, ""src/errors.h"": {""insertions"": 12, ""deletions"": 0, ""lines"": 12}, ""src/evalfunc.c"": {""insertions"": 15, ""deletions"": 0, ""lines"": 15}, ""src/ex_docmd.c"": {""insertions"": 1, ""deletions"": 1, ""lines"": 2}, ""src/globals.h"": {""insertions"": 2, ""deletions"": 0, ""lines"": 2}, ""src/proto/digraph.pro"": {""insertions"": 6, ""deletions"": 0, ""lines"": 6}, ""src/testdir/test_digraph.vim"": {""insertions"": 78, ""deletions"": 1, ""lines"": 79}, ""src/version.c"": {""insertions"": 2, ""deletions"": 0, ""lines"": 2}}"
2021-07-19 08:38:49,98c2eaed27579602e05e7b96aa3a60428a8b9cb2,Bram Moolenaar,7,5,12,3,"{""src/errors.h"": {""insertions"": 2, ""deletions"": 2, ""lines"": 4}, ""src/testdir/test_vim9_builtin.vim"": {""insertions"": 3, ""deletions"": 3, ""lines"": 6}, ""src/version.c"": {""insertions"": 2, ""deletions"": 0, ""lines"": 2}}"
2021-07-18 20:25:29,885971e2f5eabc4108e083086c1d6d0a31a2782f,Bram Moolenaar,34,6,40,3,"{""src/list.c"": {""insertions"": 26, ""deletions"": 6, ""lines"": 32}, ""src/testdir/test_vim9_builtin.vim"": {""insertions"": 6, ""deletions"": 0, ""lines"": 6}, ""src/version.c"": {""insertions"": 2, ""deletions"": 0, ""lines"": 2}}"
2021-07-18 19:44:37,9ff9c7b9741b216d3dc75603e50654088dc5f55b,Dominique Pelle,37,15,52,2,"{""src/testdir/test_vim9_builtin.vim"": {""insertions"": 35, ""deletions"": 15, ""lines"": 50}, ""src/version.c"": {""insertions"": 2, ""deletions"": 0, ""lines"": 2}}"
2021-07-18 19:24:50,f6488547e3c7e41ff2c12dd0b93c9ef04e4c8c6f,Bram Moolenaar,21,14,35,2,"{""src/evalvars.c"": {""insertions"": 19, ""deletions"": 14, ""lines"": 33}, ""src/version.c"": {""insertions"": 2, ""deletions"": 0, ""lines"": 2}}"
2021-07-18 18:40:33,24e9316560bd5c9ea2e5a963335aedff025e7f66,Bram Moolenaar,223,157,380,5,"{""src/errors.h"": {""insertions"": 2, ""deletions"": 0, ""lines"": 2}, ""src/eval.c"": {""insertions"": 2, ""deletions"": 1, ""lines"": 3}, ""src/evalvars.c"": {""insertions"": 162, ""deletions"": 132, ""lines"": 294}, ""src/testdir/test_vim9_script.vim"": {""insertions"": 55, ""deletions"": 24, ""lines"": 79}, ""src/version.c"": {""insertions"": 2, ""deletions"": 0, ""lines"": 2}}"
2021-07-18 16:21:38,4db572eeb2b42819268e934e76c67163316d873f,Bram Moolenaar,25,65,90,5,"{""runtime/doc/vim9.txt"": {""insertions"": 4, ""deletions"": 0, ""lines"": 4}, ""src/testdir/test_vim9_script.vim"": {""insertions"": 8, ""deletions"": 41, ""lines"": 49}, ""src/version.c"": {""insertions"": 2, ""deletions"": 0, ""lines"": 2}, ""src/vim9compile.c"": {""insertions"": 2, ""deletions"": 11, ""lines"": 13}, ""src/vim9script.c"": {""insertions"": 9, ""deletions"": 13, ""lines"": 22}}"
2021-07-18 15:08:50,ad2d4969e1616d3a0354c181e3a09271d5433b3d,Bram Moolenaar,20,2,22,3,"{""src/eval.c"": {""insertions"": 12, ""deletions"": 2, ""lines"": 14}, ""src/testdir/test_vim9_script.vim"": {""insertions"": 6, ""deletions"": 0, ""lines"": 6}, ""src/version.c"": {""insertions"": 2, ""deletions"": 0, ""lines"": 2}}"
2021-07-18 12:43:43,0c35752d04f70408a3c560d5b3edbafcaddff302,Bram Moolenaar,41,4,45,4,"{""src/errors.h"": {""insertions"": 2, ""deletions"": 2, ""lines"": 4}, ""src/testdir/test_vim9_expr.vim"": {""insertions"": 23, ""deletions"": 0, ""lines"": 23}, ""src/typval.c"": {""insertions"": 14, ""deletions"": 2, ""lines"": 16}, ""src/version.c"": {""insertions"": 2, ""deletions"": 0, ""lines"": 2}}"
2021-07-18 11:42:29,c6ba2f9dde6d01c8ab356c239c2259f7d83652a4,Bram Moolenaar,23,0,23,3,"{""src/eval.c"": {""insertions"": 5, ""deletions"": 0, ""lines"": 5}, ""src/testdir/test_vim9_func.vim"": {""insertions"": 16, ""deletions"": 0, ""lines"": 16}, ""src/version.c"": {""insertions"": 2, ""deletions"": 0, ""lines"": 2}}"
2021-07-17 19:24:56,47bc9c333766ee3d45cb18c583a630e4ad53405a,Bram Moolenaar,11,1,12,3,"{""src/testdir/test_vim9_assign.vim"": {""insertions"": 7, ""deletions"": 0, ""lines"": 7}, ""src/version.c"": {""insertions"": 2, ""deletions"": 0, ""lines"": 2}, ""src/vim9compile.c"": {""insertions"": 2, ""deletions"": 1, ""lines"": 3}}"
2021-07-17 17:11:07,a9a7c0c602b231dc37c4b0f62ade0421c84fca03,Yegappan Lakshmanan,329,31,360,11,"{""src/diff.c"": {""insertions"": 9, ""deletions"": 1, ""lines"": 10}, ""src/errors.h"": {""insertions"": 4, ""deletions"": 0, ""lines"": 4}, ""src/evalfunc.c"": {""insertions"": 55, ""deletions"": 22, ""lines"": 77}, ""src/globals.h"": {""insertions"": 1, ""deletions"": 0, ""lines"": 1}, ""src/job.c"": {""insertions"": 7, ""deletions"": 0, ""lines"": 7}, ""src/proto/typval.pro"": {""insertions"": 2, ""deletions"": 0, ""lines"": 2}, ""src/strings.c"": {""insertions"": 12, ""deletions"": 0, ""lines"": 12}, ""src/terminal.c"": {""insertions"": 46, ""deletions"": 5, ""lines"": 51}, ""src/testdir/test_vim9_builtin.vim"": {""insertions"": 151, ""deletions"": 0, ""lines"": 151}, ""src/typval.c"": {""insertions"": 40, ""deletions"": 3, ""lines"": 43}, ""src/version.c"": {""insertions"": 2, ""deletions"": 0, ""lines"": 2}}"
2021-07-16 08:39:28,20c370d9f2ee89cb854054edf71f5004f6efff77,Bram Moolenaar,3,1,4,2,"{""src/testdir/test_vim9_builtin.vim"": {""insertions"": 1, ""deletions"": 1, ""lines"": 2}, ""src/version.c"": {""insertions"": 2, ""deletions"": 0, ""lines"": 2}}"
2021-07-15 21:44:54,f5f1b59d3b98f1a00180cbaf0a12115fb58b573a,Bram Moolenaar,3,1,4,2,"{""src/userfunc.c"": {""insertions"": 1, ""deletions"": 1, ""lines"": 2}, ""src/version.c"": {""insertions"": 2, ""deletions"": 0, ""lines"": 2}}"
2021-07-15 21:15:59,d8cee76b498507c48706f651aeb78b93b5376d00,Bram Moolenaar,3,1,4,2,"{""src/userfunc.c"": {""insertions"": 1, ""deletions"": 1, ""lines"": 2}, ""src/version.c"": {""insertions"": 2, ""deletions"": 0, ""lines"": 2}}"
2021-07-15 20:03:50,5245beb37cb52991a745644c20d7ca1b0138ef2c,Bram Moolenaar,47,6,53,4,"{""src/testdir/test_vim9_expr.vim"": {""insertions"": 2, ""deletions"": 1, ""lines"": 3}, ""src/testdir/test_vim9_func.vim"": {""insertions"": 10, ""deletions"": 0, ""lines"": 10}, ""src/userfunc.c"": {""insertions"": 33, ""deletions"": 5, ""lines"": 38}, ""src/version.c"": {""insertions"": 2, ""deletions"": 0, ""lines"": 2}}"
2021-07-15 17:23:18,378697ac58b8f9705286e36d1805a052e96fb86e,Bram Moolenaar,14,1,15,3,"{""src/testdir/test_vim9_assign.vim"": {""insertions"": 10, ""deletions"": 0, ""lines"": 10}, ""src/version.c"": {""insertions"": 2, ""deletions"": 0, ""lines"": 2}, ""src/vim9compile.c"": {""insertions"": 2, ""deletions"": 1, ""lines"": 3}}"
2021-07-15 16:14:56,547f94f33098b060da9d62c29d9fcbe9bf1e2b11,Bram Moolenaar,18,16,34,2,"{""src/tag.c"": {""insertions"": 16, ""deletions"": 16, ""lines"": 32}, ""src/version.c"": {""insertions"": 2, ""deletions"": 0, ""lines"": 2}}"
2021-07-15 16:09:53,b5841b99e678da187b68c21f46d56a608a0dc10c,Bram Moolenaar,44,1,45,3,"{""src/testdir/test_vim9_script.vim"": {""insertions"": 40, ""deletions"": 0, ""lines"": 40}, ""src/version.c"": {""insertions"": 2, ""deletions"": 0, ""lines"": 2}, ""src/vim9execute.c"": {""insertions"": 2, ""deletions"": 1, ""lines"": 3}}"
2021-07-15 13:40:58,9e60e899ee546a8a35c4cbe0319971719c1839e9,Bram Moolenaar,12,0,12,3,"{""src/testdir/test_vim9_expr.vim"": {""insertions"": 7, ""deletions"": 0, ""lines"": 7}, ""src/version.c"": {""insertions"": 2, ""deletions"": 0, ""lines"": 2}, ""src/vim9compile.c"": {""insertions"": 3, ""deletions"": 0, ""lines"": 3}}"
2021-07-15 12:14:30,0894e0d8087aad4d467fd7b3d87b1930fe661916,Bram Moolenaar,6,1,7,2,"{""src/dosinst.c"": {""insertions"": 4, ""deletions"": 1, ""lines"": 5}, ""src/version.c"": {""insertions"": 2, ""deletions"": 0, ""lines"": 2}}"
2021-07-15 11:13:39,1557b16dad2b1a3466a93d015575cd7fdb4661c9,Wei-Chung Wen,36,0,36,3,"{""src/quickfix.c"": {""insertions"": 1, ""deletions"": 0, ""lines"": 1}, ""src/testdir/test_quickfix.vim"": {""insertions"": 33, ""deletions"": 0, ""lines"": 33}, ""src/version.c"": {""insertions"": 2, ""deletions"": 0, ""lines"": 2}}"
2021-07-15 10:49:58,1a71d31bf34b0b2b08517903826004ec6fd440e5,Yegappan Lakshmanan,780,269,1049,22,"{""runtime/doc/channel.txt"": {""insertions"": 1, ""deletions"": 1, ""lines"": 2}, ""src/clientserver.c"": {""insertions"": 8, ""deletions"": 1, ""lines"": 9}, ""src/cmdhist.c"": {""insertions"": 6, ""deletions"": 0, ""lines"": 6}, ""src/errors.h"": {""insertions"": 2, ""deletions"": 0, ""lines"": 2}, ""src/evalfunc.c"": {""insertions"": 144, ""deletions"": 105, ""lines"": 249}, ""src/evalwindow.c"": {""insertions"": 6, ""deletions"": 0, ""lines"": 6}, ""src/filepath.c"": {""insertions"": 6, ""deletions"": 0, ""lines"": 6}, ""src/globals.h"": {""insertions"": 1, ""deletions"": 0, ""lines"": 1}, ""src/popupwin.c"": {""insertions"": 40, ""deletions"": 10, ""lines"": 50}, ""src/proto/typval.pro"": {""insertions"": 1, ""deletions"": 0, ""lines"": 1}, ""src/sign.c"": {""insertions"": 4, ""deletions"": 0, ""lines"": 4}, ""src/strings.c"": {""insertions"": 23, ""deletions"": 2, ""lines"": 25}, ""src/terminal.c"": {""insertions"": 5, ""deletions"": 0, ""lines"": 5}, ""src/testdir/test_normal.vim"": {""insertions"": 1, ""deletions"": 1, ""lines"": 2}, ""src/testdir/test_reltime.vim"": {""insertions"": 2, ""deletions"": 2, ""lines"": 4}, ""src/testdir/test_vim9_builtin.vim"": {""insertions"": 474, ""deletions"": 131, ""lines"": 605}, ""src/testdir/test_vim9_expr.vim"": {""insertions"": 1, ""deletions"": 1, ""lines"": 2}, ""src/testing.c"": {""insertions"": 12, ""deletions"": 3, ""lines"": 15}, ""src/textprop.c"": {""insertions"": 8, ""deletions"": 1, ""lines"": 9}, ""src/time.c"": {""insertions"": 16, ""deletions"": 11, ""lines"": 27}, ""src/typval.c"": {""insertions"": 17, ""deletions"": 0, ""lines"": 17}, ""src/version.c"": {""insertions"": 2, ""deletions"": 0, ""lines"": 2}}"
2021-07-14 19:00:41,c816a2c22667108fcd61f445de2c926f78ff9fa7,Bram Moolenaar,27,0,27,3,"{""src/testdir/test_vim9_builtin.vim"": {""insertions"": 13, ""deletions"": 0, ""lines"": 13}, ""src/time.c"": {""insertions"": 12, ""deletions"": 0, ""lines"": 12}, ""src/version.c"": {""insertions"": 2, ""deletions"": 0, ""lines"": 2}}"
2021-07-14 18:00:27,4a0b85ad0193ac162e2d8458e4b1c5ad2e2b0193,Christian Brabandt,100,1,101,5,"{""runtime/doc/options.txt"": {""insertions"": 4, ""deletions"": 1, ""lines"": 5}, ""src/indent.c"": {""insertions"": 23, ""deletions"": 0, ""lines"": 23}, ""src/structs.h"": {""insertions"": 1, ""deletions"": 0, ""lines"": 1}, ""src/testdir/test_breakindent.vim"": {""insertions"": 70, ""deletions"": 0, ""lines"": 70}, ""src/version.c"": {""insertions"": 2, ""deletions"": 0, ""lines"": 2}}"
2021-07-13 20:21:44,5bea41dea34bcc73c4efb1b554ad0a2018966ecc,Bram Moolenaar,8,3,11,2,"{""src/change.c"": {""insertions"": 6, ""deletions"": 3, ""lines"": 9}, ""src/version.c"": {""insertions"": 2, ""deletions"": 0, ""lines"": 2}}"
2021-07-13 18:32:29,1840a7b4e3577e617f724c9d07ccc78195cc010a,Bram Moolenaar,11,1,12,3,"{""src/evalfunc.c"": {""insertions"": 4, ""deletions"": 1, ""lines"": 5}, ""src/testdir/test_functions.vim"": {""insertions"": 5, ""deletions"": 0, ""lines"": 5}, ""src/version.c"": {""insertions"": 2, ""deletions"": 0, ""lines"": 2}}"
2021-07-13 17:09:12,16e26a31161d65baca7885c46c43ab4a48399c92,Christian Brabandt,4,2,6,2,"{""src/testdir/test_crypt.vim"": {""insertions"": 2, ""deletions"": 2, ""lines"": 4}, ""src/version.c"": {""insertions"": 2, ""deletions"": 0, ""lines"": 2}}"
2021-07-12 20:15:24,ee41052ccb65f8109f285fc43eed3e232de68375,Dominique Pelle,3,0,3,2,"{""src/testdir/test_vim9_builtin.vim"": {""insertions"": 1, ""deletions"": 0, ""lines"": 1}, ""src/version.c"": {""insertions"": 2, ""deletions"": 0, ""lines"": 2}}"
2021-07-12 19:43:19,042414fa0053388f9a35cad61886405507554068,Dominique Pelle,65,0,65,3,"{""src/testdir/test_options.vim"": {""insertions"": 44, ""deletions"": 0, ""lines"": 44}, ""src/testdir/test_set.vim"": {""insertions"": 19, ""deletions"": 0, ""lines"": 19}, ""src/version.c"": {""insertions"": 2, ""deletions"": 0, ""lines"": 2}}"
2021-07-11 20:04:25,841e498c5d1765eab17bce5242543b47dfc25b41,Yegappan Lakshmanan,21,3,24,3,"{""src/evalfunc.c"": {""insertions"": 4, ""deletions"": 3, ""lines"": 7}, ""src/testdir/test_vim9_builtin.vim"": {""insertions"": 15, ""deletions"": 0, ""lines"": 15}, ""src/version.c"": {""insertions"": 2, ""deletions"": 0, ""lines"": 2}}"
2021-07-11 19:51:17,7b7a118e74d25ff35cd277c2bb5191ae44bb20b2,Tsuyoshi CHO,49,3,52,3,"{""src/misc1.c"": {""insertions"": 18, ""deletions"": 3, ""lines"": 21}, ""src/testdir/test_buffer.vim"": {""insertions"": 29, ""deletions"": 0, ""lines"": 29}, ""src/version.c"": {""insertions"": 2, ""deletions"": 0, ""lines"": 2}}"
2021-07-11 18:59:00,11005b078d2485a306c74f77c9dd158fdd7f3cbe,Bram Moolenaar,11,1,12,3,"{""src/evalvars.c"": {""insertions"": 2, ""deletions"": 1, ""lines"": 3}, ""src/testdir/test_vim9_expr.vim"": {""insertions"": 7, ""deletions"": 0, ""lines"": 7}, ""src/version.c"": {""insertions"": 2, ""deletions"": 0, ""lines"": 2}}"
2021-07-11 18:22:30,ffcfddc759e583471a1ed55e0938d042bf68c507,Bram Moolenaar,30,5,35,3,"{""src/testdir/test_vim9_script.vim"": {""insertions"": 17, ""deletions"": 0, ""lines"": 17}, ""src/version.c"": {""insertions"": 2, ""deletions"": 0, ""lines"": 2}, ""src/vim9compile.c"": {""insertions"": 11, ""deletions"": 5, ""lines"": 16}}"
2021-07-11 17:44:18,c72bdd28ac5fe079825155930af8e792580139bb,Yegappan Lakshmanan,118,21,139,4,"{""src/evalfunc.c"": {""insertions"": 51, ""deletions"": 19, ""lines"": 70}, ""src/testdir/test_vim9_builtin.vim"": {""insertions"": 62, ""deletions"": 2, ""lines"": 64}, ""src/testing.c"": {""insertions"": 3, ""deletions"": 0, ""lines"": 3}, ""src/version.c"": {""insertions"": 2, ""deletions"": 0, ""lines"": 2}}"
2021-07-11 17:12:04,cc7eb2aa7a7f2e6ae41f1e7cf60965c083d8a9e9,Bram Moolenaar,52,4,56,5,"{""src/message.c"": {""insertions"": 20, ""deletions"": 1, ""lines"": 21}, ""src/proto/message.pro"": {""insertions"": 1, ""deletions"": 0, ""lines"": 1}, ""src/testdir/test_usercommands.vim"": {""insertions"": 20, ""deletions"": 2, ""lines"": 22}, ""src/usercmd.c"": {""insertions"": 9, ""deletions"": 1, ""lines"": 10}, ""src/version.c"": {""insertions"": 2, ""deletions"": 0, ""lines"": 2}}"
2021-07-11 16:23:19,5231224e11bf468f5366a7400414368908c40795,Bram Moolenaar,17,1,18,4,"{""src/evalfunc.c"": {""insertions"": 2, ""deletions"": 1, ""lines"": 3}, ""src/testdir/test_vim9_builtin.vim"": {""insertions"": 2, ""deletions"": 0, ""lines"": 2}, ""src/version.c"": {""insertions"": 2, ""deletions"": 0, ""lines"": 2}, ""src/vim9compile.c"": {""insertions"": 11, ""deletions"": 0, ""lines"": 11}}"
2021-07-11 15:55:01,648594eaf703fe9a862cb12a35702a10aff6e5a9,Bram Moolenaar,34,15,49,4,"{""src/testdir/test_vim9_script.vim"": {""insertions"": 13, ""deletions"": 3, ""lines"": 16}, ""src/version.c"": {""insertions"": 2, ""deletions"": 0, ""lines"": 2}, ""src/vim9compile.c"": {""insertions"": 10, ""deletions"": 0, ""lines"": 10}, ""src/vim9execute.c"": {""insertions"": 9, ""deletions"": 12, ""lines"": 21}}"
2021-07-11 14:52:45,c03fe66ade4c79a4eb5fc05d1d549c8f931a04b6,Bram Moolenaar,16,0,16,3,"{""src/eval.c"": {""insertions"": 4, ""deletions"": 0, ""lines"": 4}, ""src/testdir/test_vim9_script.vim"": {""insertions"": 10, ""deletions"": 0, ""lines"": 10}, ""src/version.c"": {""insertions"": 2, ""deletions"": 0, ""lines"": 2}}"
2021-07-11 14:31:51,4ece152ad60c4fbd5b98b849a39b8ad9a987d319,Bram Moolenaar,4,0,4,2,"{""src/testdir/test_vim9_script.vim"": {""insertions"": 2, ""deletions"": 0, ""lines"": 2}, ""src/version.c"": {""insertions"": 2, ""deletions"": 0, ""lines"": 2}}"
2021-07-11 14:01:58,0f1227f7d5a3e368f61d396c1640088c079fef91,Bram Moolenaar,27,2,29,4,"{""src/errors.h"": {""insertions"": 2, ""deletions"": 0, ""lines"": 2}, ""src/eval.c"": {""insertions"": 2, ""deletions"": 0, ""lines"": 2}, ""src/testdir/test_vim9_builtin.vim"": {""insertions"": 21, ""deletions"": 2, ""lines"": 23}, ""src/version.c"": {""insertions"": 2, ""deletions"": 0, ""lines"": 2}}"
2021-07-11 13:26:13,d9162550aa47ca3865a5cadf78ff2212a1d8eca7,Bram Moolenaar,20,0,20,3,"{""src/testdir/test_vim9_script.vim"": {""insertions"": 13, ""deletions"": 0, ""lines"": 13}, ""src/version.c"": {""insertions"": 2, ""deletions"": 0, ""lines"": 2}, ""src/vim9compile.c"": {""insertions"": 5, ""deletions"": 0, ""lines"": 5}}"
2021-07-11 12:55:49,1aeddeb8bd29a69fa118734c7f27d7df1b37801f,Bram Moolenaar,10,1,11,3,"{""src/evalfunc.c"": {""insertions"": 2, ""deletions"": 1, ""lines"": 3}, ""src/testdir/test_vim9_builtin.vim"": {""insertions"": 6, ""deletions"": 0, ""lines"": 6}, ""src/version.c"": {""insertions"": 2, ""deletions"": 0, ""lines"": 2}}"
2021-07-11 12:28:25,de69a7353e9bec552e15dbe3706a9f4e88080fce,Martin Tournoij,23,27,50,4,"{""src/errors.h"": {""insertions"": 2, ""deletions"": 0, ""lines"": 2}, ""src/testdir/test_usercommands.vim"": {""insertions"": 17, ""deletions"": 19, ""lines"": 36}, ""src/usercmd.c"": {""insertions"": 2, ""deletions"": 8, ""lines"": 10}, ""src/version.c"": {""insertions"": 2, ""deletions"": 0, ""lines"": 2}}"
2021-07-10 20:21:40,482d2f37a5ce43157ab1e22c26f389770d0c20cf,Bram Moolenaar,5,3,8,2,"{""src/testdir/test_channel.vim"": {""insertions"": 3, ""deletions"": 3, ""lines"": 6}, ""src/version.c"": {""insertions"": 2, ""deletions"": 0, ""lines"": 2}}"
2021-07-10 19:29:18,a2438132a675be4dde3acbdf03ba1fdb2f09427c,Yegappan Lakshmanan,1673,1627,3300,21,"{""Filelist"": {""insertions"": 2, ""deletions"": 0, ""lines"": 2}, ""src/Make_ami.mak"": {""insertions"": 1, ""deletions"": 0, ""lines"": 1}, ""src/Make_cyg_ming.mak"": {""insertions"": 1, ""deletions"": 0, ""lines"": 1}, ""src/Make_mvc.mak"": {""insertions"": 4, ""deletions"": 0, ""lines"": 4}, ""src/Make_vms.mms"": {""insertions"": 6, ""deletions"": 0, ""lines"": 6}, ""src/Makefile"": {""insertions"": 10, ""deletions"": 0, ""lines"": 10}, ""src/README.md"": {""insertions"": 1, ""deletions"": 0, ""lines"": 1}, ""src/eval.c"": {""insertions"": 3, ""deletions"": 46, ""lines"": 49}, ""src/evalfunc.c"": {""insertions"": 0, ""deletions"": 825, ""lines"": 825}, ""src/mbyte.c"": {""insertions"": 31, ""deletions"": 0, ""lines"": 31}, ""src/misc1.c"": {""insertions"": 2, ""deletions"": 24, ""lines"": 26}, ""src/misc2.c"": {""insertions"": 0, ""deletions"": 706, ""lines"": 706}, ""src/proto.h"": {""insertions"": 1, ""deletions"": 0, ""lines"": 1}, ""src/proto/eval.pro"": {""insertions"": 0, ""deletions"": 3, ""lines"": 3}, ""src/proto/evalfunc.pro"": {""insertions"": 0, ""deletions"": 1, ""lines"": 1}, ""src/proto/mbyte.pro"": {""insertions"": 1, ""deletions"": 0, ""lines"": 1}, ""src/proto/misc1.pro"": {""insertions"": 0, ""deletions"": 1, ""lines"": 1}, ""src/proto/misc2.pro"": {""insertions"": 0, ""deletions"": 21, ""lines"": 21}, ""src/proto/strings.pro"": {""insertions"": 45, ""deletions"": 0, ""lines"": 45}, ""src/strings.c"": {""insertions"": 1563, ""deletions"": 0, ""lines"": 1563}, ""src/version.c"": {""insertions"": 2, ""deletions"": 0, ""lines"": 2}}"
2021-07-10 18:43:59,31e21766d6fb0a386e15ccc8c2192f6a3a210f53,Bram Moolenaar,9,7,16,2,"{""src/testdir/test_debugger.vim"": {""insertions"": 7, ""deletions"": 7, ""lines"": 14}, ""src/version.c"": {""insertions"": 2, ""deletions"": 0, ""lines"": 2}}"
2021-07-10 17:42:03,c323527d67081cfaff22503d1d282495976c7042,Bram Moolenaar,76,15,91,7,"{""src/errors.h"": {""insertions"": 2, ""deletions"": 0, ""lines"": 2}, ""src/ex_eval.c"": {""insertions"": 19, ""deletions"": 2, ""lines"": 21}, ""src/testdir/test_vim9_expr.vim"": {""insertions"": 1, ""deletions"": 1, ""lines"": 2}, ""src/testdir/test_vim9_func.vim"": {""insertions"": 3, ""deletions"": 3, ""lines"": 6}, ""src/testdir/test_vim9_script.vim"": {""insertions"": 17, ""deletions"": 2, ""lines"": 19}, ""src/version.c"": {""insertions"": 2, ""deletions"": 0, ""lines"": 2}, ""src/vim9compile.c"": {""insertions"": 32, ""deletions"": 7, ""lines"": 39}}"
2021-07-10 15:59:48,fe3418abe0dac65e42e85b5a91c5d0c975bc65bb,Dominique Pelle,22,0,22,3,"{""src/testdir/test_cd.vim"": {""insertions"": 16, ""deletions"": 0, ""lines"": 16}, ""src/testdir/test_swap.vim"": {""insertions"": 4, ""deletions"": 0, ""lines"": 4}, ""src/version.c"": {""insertions"": 2, ""deletions"": 0, ""lines"": 2}}"
2021-07-10 11:15:41,5b73992d8f82be7ac4b6f46c17f53ffb9640e5fa,Yegappan Lakshmanan,563,186,749,12,"{""src/channel.c"": {""insertions"": 5, ""deletions"": 0, ""lines"": 5}, ""src/errors.h"": {""insertions"": 2, ""deletions"": 0, ""lines"": 2}, ""src/evalfunc.c"": {""insertions"": 94, ""deletions"": 70, ""lines"": 164}, ""src/proto/typval.pro"": {""insertions"": 1, ""deletions"": 0, ""lines"": 1}, ""src/terminal.c"": {""insertions"": 5, ""deletions"": 0, ""lines"": 5}, ""src/testdir/test_search.vim"": {""insertions"": 6, ""deletions"": 6, ""lines"": 12}, ""src/testdir/test_textprop.vim"": {""insertions"": 1, ""deletions"": 1, ""lines"": 2}, ""src/testdir/test_vim9_builtin.vim"": {""insertions"": 421, ""deletions"": 103, ""lines"": 524}, ""src/testing.c"": {""insertions"": 4, ""deletions"": 1, ""lines"": 5}, ""src/textprop.c"": {""insertions"": 1, ""deletions"": 1, ""lines"": 2}, ""src/typval.c"": {""insertions"": 21, ""deletions"": 4, ""lines"": 25}, ""src/version.c"": {""insertions"": 2, ""deletions"": 0, ""lines"": 2}}"
2021-07-09 17:53:57,9da32e4d578f4e93ef5397f9dd13e2c28b2a2595,Bram Moolenaar,9,1,10,3,"{""src/testdir/test_vim9_builtin.vim"": {""insertions"": 6, ""deletions"": 0, ""lines"": 6}, ""src/version.c"": {""insertions"": 2, ""deletions"": 0, ""lines"": 2}, ""src/vim9type.c"": {""insertions"": 1, ""deletions"": 1, ""lines"": 2}}"
2021-07-09 17:17:55,90fba5627b361dbc970b3afc2eebf7411c49a0cc,Bram Moolenaar,4,1,5,2,"{""src/list.c"": {""insertions"": 2, ""deletions"": 1, ""lines"": 3}, ""src/version.c"": {""insertions"": 2, ""deletions"": 0, ""lines"": 2}}"
2021-07-09 13:54:00,6bcb18253a392cf75d3784953ef9c71de7af9019,Bram Moolenaar,3,1,4,2,"{""src/drawscreen.c"": {""insertions"": 1, ""deletions"": 1, ""lines"": 2}, ""src/version.c"": {""insertions"": 2, ""deletions"": 0, ""lines"": 2}}"
2021-07-08 20:20:50,981217c11f92b37f2baa51492cbe12e85d0ea493,Bram Moolenaar,8,0,8,2,"{""src/testdir/test_channel.vim"": {""insertions"": 6, ""deletions"": 0, ""lines"": 6}, ""src/version.c"": {""insertions"": 2, ""deletions"": 0, ""lines"": 2}}"
2021-07-08 20:02:11,b885a7c72c8fed5f14454633fb3ba9d77fff1c24,Bram Moolenaar,5,3,8,2,"{""src/testdir/test_vim9_script.vim"": {""insertions"": 3, ""deletions"": 3, ""lines"": 6}, ""src/version.c"": {""insertions"": 2, ""deletions"": 0, ""lines"": 2}}"
2021-07-08 19:38:50,c967d57aa9a6bede0f50c6986dcddc1dc035a354,Bram Moolenaar,29,20,49,7,"{""src/eval.c"": {""insertions"": 1, ""deletions"": 1, ""lines"": 2}, ""src/evalvars.c"": {""insertions"": 7, ""deletions"": 6, ""lines"": 13}, ""src/proto/vim9script.pro"": {""insertions"": 1, ""deletions"": 1, ""lines"": 2}, ""src/testdir/test_vim9_script.vim"": {""insertions"": 11, ""deletions"": 3, ""lines"": 14}, ""src/userfunc.c"": {""insertions"": 1, ""deletions"": 1, ""lines"": 2}, ""src/version.c"": {""insertions"": 2, ""deletions"": 0, ""lines"": 2}, ""src/vim9script.c"": {""insertions"": 6, ""deletions"": 8, ""lines"": 14}}"
2021-07-08 18:57:24,f055d4502365f24de6c0f210a06e2c146a75dc4d,Bram Moolenaar,38,9,47,7,"{""src/eval.c"": {""insertions"": 1, ""deletions"": 1, ""lines"": 2}, ""src/evalvars.c"": {""insertions"": 19, ""deletions"": 1, ""lines"": 20}, ""src/proto/vim9script.pro"": {""insertions"": 1, ""deletions"": 1, ""lines"": 2}, ""src/testdir/test_vim9_builtin.vim"": {""insertions"": 7, ""deletions"": 0, ""lines"": 7}, ""src/userfunc.c"": {""insertions"": 1, ""deletions"": 1, ""lines"": 2}, ""src/version.c"": {""insertions"": 2, ""deletions"": 0, ""lines"": 2}, ""src/vim9script.c"": {""insertions"": 7, ""deletions"": 5, ""lines"": 12}}"
2021-07-08 18:53:40,f32f099761e5ae0603149b305a0086e4f4627d81,Bram Moolenaar,13,1,14,3,"{""src/list.c"": {""insertions"": 4, ""deletions"": 1, ""lines"": 5}, ""src/testdir/test_vim9_builtin.vim"": {""insertions"": 7, ""deletions"": 0, ""lines"": 7}, ""src/version.c"": {""insertions"": 2, ""deletions"": 0, ""lines"": 2}}"
2021-07-08 17:22:12,d4ab807d62c1a8262e78deb674c6750183bc030a,Bram Moolenaar,8,0,8,3,"{""src/ex_eval.c"": {""insertions"": 5, ""deletions"": 0, ""lines"": 5}, ""src/testdir/test_vim9_script.vim"": {""insertions"": 1, ""deletions"": 0, ""lines"": 1}, ""src/version.c"": {""insertions"": 2, ""deletions"": 0, ""lines"": 2}}"
2021-07-08 16:05:00,09f688c33aad9692276dfb68842cf0621a0e2002,=?UTF-8?q?Dundar=20G=C3=B6c?=,7,5,12,2,"{""src/regexp_nfa.c"": {""insertions"": 5, ""deletions"": 5, ""lines"": 10}, ""src/version.c"": {""insertions"": 2, ""deletions"": 0, ""lines"": 2}}"
2021-07-08 15:35:36,deb108ba0a8599c1307ddc1507c73e7b60f17d36,Bram Moolenaar,57,1,58,3,"{""src/option.c"": {""insertions"": 16, ""deletions"": 1, ""lines"": 17}, ""src/testdir/test_vim9_script.vim"": {""insertions"": 39, ""deletions"": 0, ""lines"": 39}, ""src/version.c"": {""insertions"": 2, ""deletions"": 0, ""lines"": 2}}"
2021-07-08 14:40:13,1594f313452cf6ca88375d9c8f68605a9c3c8ab5,Bram Moolenaar,25,7,32,4,"{""src/errors.h"": {""insertions"": 2, ""deletions"": 0, ""lines"": 2}, ""src/option.c"": {""insertions"": 7, ""deletions"": 2, ""lines"": 9}, ""src/testdir/test_vim9_script.vim"": {""insertions"": 14, ""deletions"": 5, ""lines"": 19}, ""src/version.c"": {""insertions"": 2, ""deletions"": 0, ""lines"": 2}}"
2021-07-08 11:19:31,30441bb3d5fa73f888b09684db3f54ff5ab48dbc,Bram Moolenaar,33,1,34,5,"{""src/move.c"": {""insertions"": 5, ""deletions"": 1, ""lines"": 6}, ""src/testdir/dumps/Test_listchars_06.dump"": {""insertions"": 10, ""deletions"": 0, ""lines"": 10}, ""src/testdir/dumps/Test_listchars_07.dump"": {""insertions"": 10, ""deletions"": 0, ""lines"": 10}, ""src/testdir/test_listchars.vim"": {""insertions"": 6, ""deletions"": 0, ""lines"": 6}, ""src/version.c"": {""insertions"": 2, ""deletions"": 0, ""lines"": 2}}"
2021-07-08 10:40:05,41fb723ee97baa2f095cde601a5a144b168b7a6b,Bram Moolenaar,87,1,88,8,"{""src/drawline.c"": {""insertions"": 3, ""deletions"": 1, ""lines"": 4}, ""src/testdir/dumps/Test_listchars_01.dump"": {""insertions"": 10, ""deletions"": 0, ""lines"": 10}, ""src/testdir/dumps/Test_listchars_02.dump"": {""insertions"": 10, ""deletions"": 0, ""lines"": 10}, ""src/testdir/dumps/Test_listchars_03.dump"": {""insertions"": 10, ""deletions"": 0, ""lines"": 10}, ""src/testdir/dumps/Test_listchars_04.dump"": {""insertions"": 10, ""deletions"": 0, ""lines"": 10}, ""src/testdir/dumps/Test_listchars_05.dump"": {""insertions"": 10, ""deletions"": 0, ""lines"": 10}, ""src/testdir/test_listchars.vim"": {""insertions"": 32, ""deletions"": 0, ""lines"": 32}, ""src/version.c"": {""insertions"": 2, ""deletions"": 0, ""lines"": 2}}"
2021-07-08 09:37:50,db8647277082a8a69a189ded8bd1408af993b54e,Bram Moolenaar,7,2,9,2,"{""src/testdir/test_crypt.vim"": {""insertions"": 5, ""deletions"": 2, ""lines"": 7}, ""src/version.c"": {""insertions"": 2, ""deletions"": 0, ""lines"": 2}}"
2021-07-07 20:13:08,6a9e5c69cf36676e65ae191264872a3e41bde37f,Bram Moolenaar,3,1,4,2,"{""src/evalfunc.c"": {""insertions"": 1, ""deletions"": 1, ""lines"": 2}, ""src/version.c"": {""insertions"": 2, ""deletions"": 0, ""lines"": 2}}"
2021-07-07 19:55:25,5ede5b231eb2269b0ef335f3cd24e4c4b1d4395b,Bram Moolenaar,9,1,10,3,"{""src/testdir/test_vim9_script.vim"": {""insertions"": 6, ""deletions"": 0, ""lines"": 6}, ""src/version.c"": {""insertions"": 2, ""deletions"": 0, ""lines"": 2}, ""src/vim9compile.c"": {""insertions"": 1, ""deletions"": 1, ""lines"": 2}}"
2021-07-07 19:21:30,efc5db5215b4efc424b2de34613525d729a05c93,Bram Moolenaar,23,3,26,5,"{""src/evalfunc.c"": {""insertions"": 7, ""deletions"": 1, ""lines"": 8}, ""src/globals.h"": {""insertions"": 1, ""deletions"": 0, ""lines"": 1}, ""src/testdir/test_vim9_script.vim"": {""insertions"": 8, ""deletions"": 0, ""lines"": 8}, ""src/version.c"": {""insertions"": 2, ""deletions"": 0, ""lines"": 2}, ""src/vim9compile.c"": {""insertions"": 5, ""deletions"": 2, ""lines"": 7}}"
2021-07-07 18:26:08,90df4b9d423485f7db16e3a65cab4f14edc815ae,Bram Moolenaar,846,194,1040,22,"{"".github/CODEOWNERS"": {""insertions"": 1, ""deletions"": 0, ""lines"": 1}, ""runtime/doc/autocmd.txt"": {""insertions"": 5, ""deletions"": 3, ""lines"": 8}, ""runtime/doc/eval.txt"": {""insertions"": 20, ""deletions"": 4, ""lines"": 24}, ""runtime/doc/gui.txt"": {""insertions"": 3, ""deletions"": 2, ""lines"": 5}, ""runtime/doc/insert.txt"": {""insertions"": 3, ""deletions"": 2, ""lines"": 5}, ""runtime/doc/repeat.txt"": {""insertions"": 2, ""deletions"": 2, ""lines"": 4}, ""runtime/doc/sponsor.txt"": {""insertions"": 3, ""deletions"": 17, ""lines"": 20}, ""runtime/doc/syntax.txt"": {""insertions"": 25, ""deletions"": 3, ""lines"": 28}, ""runtime/doc/tags"": {""insertions"": 5, ""deletions"": 0, ""lines"": 5}, ""runtime/doc/testing.txt"": {""insertions"": 3, ""deletions"": 2, ""lines"": 5}, ""runtime/doc/todo.txt"": {""insertions"": 6, ""deletions"": 7, ""lines"": 13}, ""runtime/doc/version6.txt"": {""insertions"": 2, ""deletions"": 2, ""lines"": 4}, ""runtime/doc/version8.txt"": {""insertions"": 2, ""deletions"": 2, ""lines"": 4}, ""runtime/doc/vim9.txt"": {""insertions"": 47, ""deletions"": 15, ""lines"": 62}, ""runtime/filetype.vim"": {""insertions"": 1, ""deletions"": 1, ""lines"": 2}, ""runtime/ftplugin/jsonc.vim"": {""insertions"": 27, ""deletions"": 0, ""lines"": 27}, ""runtime/indent/jsonc.vim"": {""insertions"": 189, ""deletions"": 0, ""lines"": 189}, ""runtime/indent/pascal.vim"": {""insertions"": 3, ""deletions"": 1, ""lines"": 4}, ""runtime/syntax/go.vim"": {""insertions"": 361, ""deletions"": 83, ""lines"": 444}, ""runtime/syntax/jsonc.vim"": {""insertions"": 44, ""deletions"": 0, ""lines"": 44}, ""runtime/syntax/vim.vim"": {""insertions"": 1, ""deletions"": 1, ""lines"": 2}, ""src/po/it.po"": {""insertions"": 93, ""deletions"": 47, ""lines"": 140}}"
2021-07-07 18:10:43,303215d60cece0462f040035502b5bc95373bd6e,Bram Moolenaar,19,2,21,3,"{""src/testdir/test_debugger.vim"": {""insertions"": 13, ""deletions"": 0, ""lines"": 13}, ""src/version.c"": {""insertions"": 2, ""deletions"": 0, ""lines"": 2}, ""src/vim9execute.c"": {""insertions"": 4, ""deletions"": 2, ""lines"": 6}}"
2021-07-07 17:26:19,b5098060f4acae4dac3203130278c948d670a3d5,Bram Moolenaar,4,1,5,2,"{""src/version.c"": {""insertions"": 2, ""deletions"": 0, ""lines"": 2}, ""src/window.c"": {""insertions"": 2, ""deletions"": 1, ""lines"": 3}}"
2021-07-06 18:15:46,599a6e5b3629d943a795cd69e4d3d19886f86405,=?UTF-8?q?Ola=20S=C3=B6der?=,8,4,12,2,"{""src/memline.c"": {""insertions"": 6, ""deletions"": 4, ""lines"": 10}, ""src/version.c"": {""insertions"": 2, ""deletions"": 0, ""lines"": 2}}"
2021-07-05 20:23:00,442b29c968eff1c8fec1a96418aa47be9cba62ea,Bram Moolenaar,14,7,21,3,"{""src/eval.c"": {""insertions"": 6, ""deletions"": 1, ""lines"": 7}, ""src/testdir/test_vim9_script.vim"": {""insertions"": 6, ""deletions"": 6, ""lines"": 12}, ""src/version.c"": {""insertions"": 2, ""deletions"": 0, ""lines"": 2}}"
2021-07-05 20:03:04,5cb09620c1e0a0178c0dc986230997a8aac0e61a,Bram Moolenaar,6,1,7,2,"{""src/drawscreen.c"": {""insertions"": 4, ""deletions"": 1, ""lines"": 5}, ""src/version.c"": {""insertions"": 2, ""deletions"": 0, ""lines"": 2}}"
2021-07-05 19:41:48,404557e6a60389d09bbf91dd0cf3bae11bd623b9,Bram Moolenaar,22,5,27,4,"{""src/eval.c"": {""insertions"": 9, ""deletions"": 4, ""lines"": 13}, ""src/testdir/test_vim9_script.vim"": {""insertions"": 7, ""deletions"": 0, ""lines"": 7}, ""src/version.c"": {""insertions"": 2, ""deletions"": 0, ""lines"": 2}, ""src/vim9compile.c"": {""insertions"": 4, ""deletions"": 1, ""lines"": 5}}"
2021-07-05 18:15:23,04db26b36000a4677b95403ec94bd11f6cc73975,Bram Moolenaar,183,6,189,6,"{""runtime/doc/pattern.txt"": {""insertions"": 27, ""deletions"": 4, ""lines"": 31}, ""src/errors.h"": {""insertions"": 2, ""deletions"": 0, ""lines"": 2}, ""src/regexp_bt.c"": {""insertions"": 33, ""deletions"": 1, ""lines"": 34}, ""src/regexp_nfa.c"": {""insertions"": 29, ""deletions"": 1, ""lines"": 30}, ""src/testdir/test_regexp_latin.vim"": {""insertions"": 90, ""deletions"": 0, ""lines"": 90}, ""src/version.c"": {""insertions"": 2, ""deletions"": 0, ""lines"": 2}}"
2021-07-05 15:49:02,f6d877975ba93fc9b4bee2c5d2aff88dbf9bea59,Bram Moolenaar,3,1,4,2,"{""src/testdir/check.vim"": {""insertions"": 1, ""deletions"": 1, ""lines"": 2}, ""src/version.c"": {""insertions"": 2, ""deletions"": 0, ""lines"": 2}}"
2021-07-05 12:10:04,d6fa7bd5b900dd363d3a824e0ebe3619a1634df6,Bram Moolenaar,13,3,16,4,"{""src/testdir/check.vim"": {""insertions"": 8, ""deletions"": 0, ""lines"": 8}, ""src/testdir/test_clientserver.vim"": {""insertions"": 1, ""deletions"": 3, ""lines"": 4}, ""src/testdir/test_vim9_builtin.vim"": {""insertions"": 2, ""deletions"": 0, ""lines"": 2}, ""src/version.c"": {""insertions"": 2, ""deletions"": 0, ""lines"": 2}}"
2021-07-04 21:29:30,22f85d04594e1a09936227ef62955a7939d584b4,Bram Moolenaar,14,1,15,3,"{""src/testdir/test_vim9_assign.vim"": {""insertions"": 10, ""deletions"": 0, ""lines"": 10}, ""src/userfunc.c"": {""insertions"": 2, ""deletions"": 1, ""lines"": 3}, ""src/version.c"": {""insertions"": 2, ""deletions"": 0, ""lines"": 2}}"
2021-07-04 20:48:12,6977dba04b68b91410585ada65079651788ca7dc,Bram Moolenaar,25,1,26,3,"{""src/testdir/test_vim9_assign.vim"": {""insertions"": 10, ""deletions"": 0, ""lines"": 10}, ""src/version.c"": {""insertions"": 2, ""deletions"": 0, ""lines"": 2}, ""src/vim9compile.c"": {""insertions"": 13, ""deletions"": 1, ""lines"": 14}}"
2021-07-04 18:20:52,97f227d9c9351f12138d923ffdf9232dc5520bef,Bram Moolenaar,32,3,35,4,"{""src/testdir/test_vim9_assign.vim"": {""insertions"": 6, ""deletions"": 3, ""lines"": 9}, ""src/userfunc.c"": {""insertions"": 11, ""deletions"": 0, ""lines"": 11}, ""src/version.c"": {""insertions"": 2, ""deletions"": 0, ""lines"": 2}, ""src/vim9type.c"": {""insertions"": 13, ""deletions"": 0, ""lines"": 13}}"
2021-07-04 16:28:15,b7480cd8931fa1696265f75c7d4d9fdf0be69e12,Bram Moolenaar,13,1,14,4,"{""src/globals.h"": {""insertions"": 1, ""deletions"": 1, ""lines"": 2}, ""src/testdir/test_vim9_assign.vim"": {""insertions"": 9, ""deletions"": 0, ""lines"": 9}, ""src/version.c"": {""insertions"": 2, ""deletions"": 0, ""lines"": 2}, ""src/vim9type.c"": {""insertions"": 1, ""deletions"": 0, ""lines"": 1}}"
2021-07-04 15:36:54,f33cae605064c8bdb908a8069d936f752572cd76,Bram Moolenaar,15,13,28,2,"{""src/testdir/test_swap.vim"": {""insertions"": 13, ""deletions"": 13, ""lines"": 26}, ""src/version.c"": {""insertions"": 2, ""deletions"": 0, ""lines"": 2}}"
2021-07-04 15:23:25,3777d6e32b22f0a70b774760c24160079e303bad,Bram Moolenaar,14,8,22,2,"{""src/testdir/test_swap.vim"": {""insertions"": 12, ""deletions"": 8, ""lines"": 20}, ""src/version.c"": {""insertions"": 2, ""deletions"": 0, ""lines"": 2}}"
2021-07-04 15:21:04,26e88ec8e23fa04e559044199ccb369aed29e570,Bram Moolenaar,2,0,2,1,"{""src/version.c"": {""insertions"": 2, ""deletions"": 0, ""lines"": 2}}"
2021-07-04 14:50:55,67b17a6fc62156383d24dcbd6e6df34e180d7235,Bram Moolenaar,2,1,3,1,"{""src/proto/float.pro"": {""insertions"": 2, ""deletions"": 1, ""lines"": 3}}"
2021-07-04 13:54:08,7a40ff00edd35cc4313d74a43e7a7b67cd24372d,Bram Moolenaar,35,8,43,7,"{""src/evalfunc.c"": {""insertions"": 12, ""deletions"": 0, ""lines"": 12}, ""src/proto/evalfunc.pro"": {""insertions"": 1, ""deletions"": 1, ""lines"": 2}, ""src/testdir/test_vim9_assign.vim"": {""insertions"": 9, ""deletions"": 0, ""lines"": 9}, ""src/testdir/test_vim9_expr.vim"": {""insertions"": 1, ""deletions"": 1, ""lines"": 2}, ""src/testdir/test_vim9_func.vim"": {""insertions"": 1, ""deletions"": 1, ""lines"": 2}, ""src/version.c"": {""insertions"": 2, ""deletions"": 0, ""lines"": 2}, ""src/vim9type.c"": {""insertions"": 9, ""deletions"": 5, ""lines"": 14}}"
2021-07-04 12:47:30,4197828dc666f2d258594f7f9461534d23cc50e4,Bram Moolenaar,28,6,34,4,"{""src/ex_eval.c"": {""insertions"": 12, ""deletions"": 2, ""lines"": 14}, ""src/structs.h"": {""insertions"": 5, ""deletions"": 4, ""lines"": 9}, ""src/testdir/test_vim9_script.vim"": {""insertions"": 9, ""deletions"": 0, ""lines"": 9}, ""src/version.c"": {""insertions"": 2, ""deletions"": 0, ""lines"": 2}}"
2021-07-04 12:00:55,999db2346b61e6f6e6fde2d0b56f4646a46b727d,Bram Moolenaar,12,2,14,2,"{""src/testdir/test_popupwin.vim"": {""insertions"": 10, ""deletions"": 2, ""lines"": 12}, ""src/version.c"": {""insertions"": 2, ""deletions"": 0, ""lines"": 2}}"
2021-07-04 11:27:11,1d97efce0ce31ddf0dd4c1ae2228ef4caee6880c,Bram Moolenaar,19,0,19,3,"{""src/buffer.c"": {""insertions"": 5, ""deletions"": 0, ""lines"": 5}, ""src/testdir/test_swap.vim"": {""insertions"": 12, ""deletions"": 0, ""lines"": 12}, ""src/version.c"": {""insertions"": 2, ""deletions"": 0, ""lines"": 2}}"
2021-07-04 10:30:06,6c72fd51a899e6f0c272b08b9784d3c7a3cede20,Dominique Pelle,5,3,8,4,"{""src/testdir/test_debugger.vim"": {""insertions"": 1, ""deletions"": 2, ""lines"": 3}, ""src/testdir/test_lambda.vim"": {""insertions"": 1, ""deletions"": 0, ""lines"": 1}, ""src/testdir/test_visual.vim"": {""insertions"": 1, ""deletions"": 1, ""lines"": 2}, ""src/version.c"": {""insertions"": 2, ""deletions"": 0, ""lines"": 2}}"
2021-07-03 20:15:17,b17ab86e7b8712206aa9ea7198c28db969e25936,Bram Moolenaar,43,3,46,4,"{""src/drawscreen.c"": {""insertions"": 30, ""deletions"": 3, ""lines"": 33}, ""src/testdir/dumps/Test_visual_block_with_virtualedit2.dump"": {""insertions"": 8, ""deletions"": 0, ""lines"": 8}, ""src/testdir/test_visual.vim"": {""insertions"": 3, ""deletions"": 0, ""lines"": 3}, ""src/version.c"": {""insertions"": 2, ""deletions"": 0, ""lines"": 2}}"
2021-07-03 19:41:38,c60e959cba03fae9cff9b2674fab646cc70819fc,Dominique Pelle,3,0,3,2,"{""src/testdir/test_popupwin.vim"": {""insertions"": 1, ""deletions"": 0, ""lines"": 1}, ""src/version.c"": {""insertions"": 2, ""deletions"": 0, ""lines"": 2}}"
2021-07-03 19:37:59,fb773a3e0aa9466bb953c29bad0bf4ba34461a40,Bram Moolenaar,15,0,15,3,"{""src/testdir/check.vim"": {""insertions"": 11, ""deletions"": 0, ""lines"": 11}, ""src/testdir/test_gui.vim"": {""insertions"": 2, ""deletions"": 0, ""lines"": 2}, ""src/version.c"": {""insertions"": 2, ""deletions"": 0, ""lines"": 2}}"
2021-07-03 17:27:37,74509239df107b04abe4f30ada12109629c85939,Dominique Pelle,13,2,15,3,"{""runtime/doc/eval.txt"": {""insertions"": 7, ""deletions"": 0, ""lines"": 7}, ""src/testdir/test_vim9_builtin.vim"": {""insertions"": 4, ""deletions"": 2, ""lines"": 6}, ""src/version.c"": {""insertions"": 2, ""deletions"": 0, ""lines"": 2}}"
2021-07-03 16:56:53,e28d9b3bd4de2c7288add83ec35dc001ba280617,Bram Moolenaar,13,4,17,4,"{""src/structs.h"": {""insertions"": 2, ""deletions"": 0, ""lines"": 2}, ""src/testdir/test_vim9_func.vim"": {""insertions"": 6, ""deletions"": 0, ""lines"": 6}, ""src/version.c"": {""insertions"": 2, ""deletions"": 0, ""lines"": 2}, ""src/vim9compile.c"": {""insertions"": 3, ""deletions"": 4, ""lines"": 7}}"
2021-07-03 16:04:11,00aaa512d5e775e0db21e251f43d7afb8fca910f,Bram Moolenaar,8,0,8,2,"{""src/drawscreen.c"": {""insertions"": 6, ""deletions"": 0, ""lines"": 6}, ""src/version.c"": {""insertions"": 2, ""deletions"": 0, ""lines"": 2}}"
2021-07-03 14:33:16,20cc52832067d22a3cd47dfb0805251228c32e7d,Bram Moolenaar,30,31,61,2,"{""src/userfunc.c"": {""insertions"": 28, ""deletions"": 31, ""lines"": 59}, ""src/version.c"": {""insertions"": 2, ""deletions"": 0, ""lines"": 2}}"
2021-07-03 13:08:37,9cee4a1c9c69542ccd73bcd2db05920150856361,Bram Moolenaar,34,1,35,4,"{""src/drawscreen.c"": {""insertions"": 3, ""deletions"": 1, ""lines"": 4}, ""src/testdir/dumps/Test_visual_block_with_virtualedit.dump"": {""insertions"": 8, ""deletions"": 0, ""lines"": 8}, ""src/testdir/test_visual.vim"": {""insertions"": 21, ""deletions"": 0, ""lines"": 21}, ""src/version.c"": {""insertions"": 2, ""deletions"": 0, ""lines"": 2}}"
2021-07-03 11:51:44,fcde67c99fbb6d7294e01b9e87d8d2ae7af31255,Bram Moolenaar,6,0,6,3,"{""runtime/filetype.vim"": {""insertions"": 3, ""deletions"": 0, ""lines"": 3}, ""src/testdir/test_filetype.vim"": {""insertions"": 1, ""deletions"": 0, ""lines"": 1}, ""src/version.c"": {""insertions"": 2, ""deletions"": 0, ""lines"": 2}}"
2021-07-03 11:36:31,6fc016168249360f0524b68f72cf33efd0574d40,Bram Moolenaar,30,0,30,3,"{""src/testdir/test_debugger.vim"": {""insertions"": 16, ""deletions"": 0, ""lines"": 16}, ""src/version.c"": {""insertions"": 2, ""deletions"": 0, ""lines"": 2}, ""src/vim9compile.c"": {""insertions"": 12, ""deletions"": 0, ""lines"": 12}}"
2021-07-03 11:09:37,acbb4b5720fc27b8b07357b763ed4e5a944ae1da,Izhak Jakov,6,0,6,3,"{""runtime/filetype.vim"": {""insertions"": 3, ""deletions"": 0, ""lines"": 3}, ""src/testdir/test_filetype.vim"": {""insertions"": 1, ""deletions"": 0, ""lines"": 1}, ""src/version.c"": {""insertions"": 2, ""deletions"": 0, ""lines"": 2}}"
2021-07-03 09:58:12,a26f56f67502c72d44c61afdede2206cdde47c17,Yegappan Lakshmanan,645,146,791,6,"{""src/evalfunc.c"": {""insertions"": 150, ""deletions"": 103, ""lines"": 253}, ""src/testdir/test_functions.vim"": {""insertions"": 5, ""deletions"": 3, ""lines"": 8}, ""src/testdir/test_glob2regpat.vim"": {""insertions"": 2, ""deletions"": 1, ""lines"": 3}, ""src/testdir/test_vim9_builtin.vim"": {""insertions"": 486, ""deletions"": 32, ""lines"": 518}, ""src/testdir/test_vim9_expr.vim"": {""insertions"": 0, ""deletions"": 7, ""lines"": 7}, ""src/version.c"": {""insertions"": 2, ""deletions"": 0, ""lines"": 2}}"
2021-07-02 18:19:31,72463f883cdfd08e29ab0018ef3889284848d5f1,Christian Brabandt,6,1,7,3,"{""src/mbyte.c"": {""insertions"": 2, ""deletions"": 1, ""lines"": 3}, ""src/testdir/test_functions.vim"": {""insertions"": 2, ""deletions"": 0, ""lines"": 2}, ""src/version.c"": {""insertions"": 2, ""deletions"": 0, ""lines"": 2}}"
2021-07-01 20:11:28,b836f631dba2534efd314a8f77439cebc75acd4e,Bram Moolenaar,27,3,30,4,"{""src/channel.c"": {""insertions"": 8, ""deletions"": 3, ""lines"": 11}, ""src/testdir/test_channel.py"": {""insertions"": 5, ""deletions"": 0, ""lines"": 5}, ""src/testdir/test_channel.vim"": {""insertions"": 12, ""deletions"": 0, ""lines"": 12}, ""src/version.c"": {""insertions"": 2, ""deletions"": 0, ""lines"": 2}}"
2021-06-30 20:01:02,11a632d60bde616feb298d180108819ebb1d04a0,Alisue,5,2,7,2,"{""src/channel.c"": {""insertions"": 3, ""deletions"": 2, ""lines"": 5}, ""src/version.c"": {""insertions"": 2, ""deletions"": 0, ""lines"": 2}}"
2021-06-30 19:30:10,576cb75ceb38ed077938d4a1c1265095050f6105,Yegappan Lakshmanan,25,5,30,2,"{""src/testdir/test_recover.vim"": {""insertions"": 23, ""deletions"": 5, ""lines"": 28}, ""src/version.c"": {""insertions"": 2, ""deletions"": 0, ""lines"": 2}}"
2021-06-30 18:56:00,a3d1b29bd36487167c98b3cefa30f06c529e412d,Mike Williams,118,52,170,10,"{""runtime/doc/eval.txt"": {""insertions"": 9, ""deletions"": 7, ""lines"": 16}, ""runtime/doc/options.txt"": {""insertions"": 13, ""deletions"": 15, ""lines"": 28}, ""runtime/doc/os_dos.txt"": {""insertions"": 52, ""deletions"": 12, ""lines"": 64}, ""runtime/doc/os_win32.txt"": {""insertions"": 1, ""deletions"": 0, ""lines"": 1}, ""src/fileio.c"": {""insertions"": 5, ""deletions"": 2, ""lines"": 7}, ""src/misc2.c"": {""insertions"": 7, ""deletions"": 7, ""lines"": 14}, ""src/option.c"": {""insertions"": 9, ""deletions"": 3, ""lines"": 12}, ""src/os_win32.c"": {""insertions"": 5, ""deletions"": 2, ""lines"": 7}, ""src/testdir/test_shell.vim"": {""insertions"": 15, ""deletions"": 4, ""lines"": 19}, ""src/version.c"": {""insertions"": 2, ""deletions"": 0, ""lines"": 2}}"
2021-06-30 18:39:15,834193afd7195bc96026d2aed696d64f8075cd35,Bram Moolenaar,39,4,43,4,"{""src/testdir/test_vim9_script.vim"": {""insertions"": 19, ""deletions"": 0, ""lines"": 19}, ""src/version.c"": {""insertions"": 2, ""deletions"": 0, ""lines"": 2}, ""src/vim9compile.c"": {""insertions"": 8, ""deletions"": 1, ""lines"": 9}, ""src/vim9execute.c"": {""insertions"": 10, ""deletions"": 3, ""lines"": 13}}"
2021-06-30 17:54:43,d3d8feeb897a6b956fc82c81448b938a53312d71,Bram Moolenaar,57,9,66,3,"{""src/testdir/test_vim9_script.vim"": {""insertions"": 35, ""deletions"": 0, ""lines"": 35}, ""src/version.c"": {""insertions"": 2, ""deletions"": 0, ""lines"": 2}, ""src/vim9execute.c"": {""insertions"": 20, ""deletions"": 9, ""lines"": 29}}"
2021-06-30 10:02:24,3f987b59173926420998ca92eb71688ee3e4a3e3,Bram Moolenaar,32,1,33,3,"{""src/testdir/test_vim9_script.vim"": {""insertions"": 26, ""deletions"": 0, ""lines"": 26}, ""src/version.c"": {""insertions"": 2, ""deletions"": 0, ""lines"": 2}, ""src/vim9execute.c"": {""insertions"": 4, ""deletions"": 1, ""lines"": 5}}"
2021-06-29 18:36:25,80b2ba3e9602e09ab523e78946fbb26da311b68b,=?UTF-8?q?J=C3=BCrgen=20Weigert?=,6,8,14,3,"{""src/testdir/test_xxd.vim"": {""insertions"": 1, ""deletions"": 1, ""lines"": 2}, ""src/version.c"": {""insertions"": 2, ""deletions"": 0, ""lines"": 2}, ""src/xxd/xxd.c"": {""insertions"": 3, ""deletions"": 7, ""lines"": 10}}"
2021-06-29 18:22:32,ea042677ab5cab736540f3164909cac2c685de74,Bram Moolenaar,43,15,58,8,"{""src/edit.c"": {""insertions"": 12, ""deletions"": 3, ""lines"": 15}, ""src/normal.c"": {""insertions"": 4, ""deletions"": 4, ""lines"": 8}, ""src/proto/screen.pro"": {""insertions"": 1, ""deletions"": 1, ""lines"": 2}, ""src/screen.c"": {""insertions"": 12, ""deletions"": 2, ""lines"": 14}, ""src/testdir/dumps/Test_popupwin_atcursor_pos.dump"": {""insertions"": 4, ""deletions"": 4, ""lines"": 8}, ""src/testdir/test_popupwin.vim"": {""insertions"": 7, ""deletions"": 0, ""lines"": 7}, ""src/ui.c"": {""insertions"": 1, ""deletions"": 1, ""lines"": 2}, ""src/version.c"": {""insertions"": 2, ""deletions"": 0, ""lines"": 2}}"
2021-06-29 16:54:35,4067bd3604215b48e4b4201e28f9e401b08418e4,Bram Moolenaar,100,25,125,4,"{""src/ops.c"": {""insertions"": 49, ""deletions"": 20, ""lines"": 69}, ""src/testdir/test_blockedit.vim"": {""insertions"": 48, ""deletions"": 0, ""lines"": 48}, ""src/testdir/test_visual.vim"": {""insertions"": 1, ""deletions"": 5, ""lines"": 6}, ""src/version.c"": {""insertions"": 2, ""deletions"": 0, ""lines"": 2}}"
2021-06-28 19:54:27,7d7bcc6ba01454c1cbb1dcbf5f11c3a4051535d6,Bram Moolenaar,25,1,26,3,"{""src/register.c"": {""insertions"": 3, ""deletions"": 1, ""lines"": 4}, ""src/testdir/test_visual.vim"": {""insertions"": 20, ""deletions"": 0, ""lines"": 20}, ""src/version.c"": {""insertions"": 2, ""deletions"": 0, ""lines"": 2}}"
2021-06-28 18:53:58,127950241e84c822d3c50f46a00d42a70d2d5cb6,Mike Williams,206,49,255,9,"{""runtime/doc/eval.txt"": {""insertions"": 7, ""deletions"": 4, ""lines"": 11}, ""runtime/doc/options.txt"": {""insertions"": 33, ""deletions"": 23, ""lines"": 56}, ""runtime/doc/os_dos.txt"": {""insertions"": 42, ""deletions"": 3, ""lines"": 45}, ""src/fileio.c"": {""insertions"": 3, ""deletions"": 2, ""lines"": 5}, ""src/misc2.c"": {""insertions"": 39, ""deletions"": 10, ""lines"": 49}, ""src/option.c"": {""insertions"": 49, ""deletions"": 4, ""lines"": 53}, ""src/os_win32.c"": {""insertions"": 2, ""deletions"": 1, ""lines"": 3}, ""src/testdir/test_shell.vim"": {""insertions"": 29, ""deletions"": 2, ""lines"": 31}, ""src/version.c"": {""insertions"": 2, ""deletions"": 0, ""lines"": 2}}"
2021-06-27 20:09:59,ffec6dd16a766180429addaa78928c773a3c9832,Yegappan Lakshmanan,43,25,68,3,"{""src/testdir/test_shell.vim"": {""insertions"": 41, ""deletions"": 4, ""lines"": 45}, ""src/testdir/test_startup.vim"": {""insertions"": 0, ""deletions"": 21, ""lines"": 21}, ""src/version.c"": {""insertions"": 2, ""deletions"": 0, ""lines"": 2}}"
2021-06-27 20:03:33,108010aa4720ef023a8ac59004fc0f2bc11125af,Bram Moolenaar,130,109,239,32,"{""src/arglist.c"": {""insertions"": 2, ""deletions"": 2, ""lines"": 4}, ""src/buffer.c"": {""insertions"": 2, ""deletions"": 2, ""lines"": 4}, ""src/channel.c"": {""insertions"": 2, ""deletions"": 2, ""lines"": 4}, ""src/errors.h"": {""insertions"": 38, ""deletions"": 0, ""lines"": 38}, ""src/eval.c"": {""insertions"": 8, ""deletions"": 8, ""lines"": 16}, ""src/evalfunc.c"": {""insertions"": 1, ""deletions"": 1, ""lines"": 2}, ""src/evalvars.c"": {""insertions"": 4, ""deletions"": 4, ""lines"": 8}, ""src/evalwindow.c"": {""insertions"": 3, ""deletions"": 3, ""lines"": 6}, ""src/ex_cmds.c"": {""insertions"": 6, ""deletions"": 6, ""lines"": 12}, ""src/ex_docmd.c"": {""insertions"": 29, ""deletions"": 28, ""lines"": 57}, ""src/ex_getln.c"": {""insertions"": 1, ""deletions"": 1, ""lines"": 2}, ""src/filepath.c"": {""insertions"": 2, ""deletions"": 2, ""lines"": 4}, ""src/fold.c"": {""insertions"": 1, ""deletions"": 1, ""lines"": 2}, ""src/getchar.c"": {""insertions"": 1, ""deletions"": 1, ""lines"": 2}, ""src/globals.h"": {""insertions"": 0, ""deletions"": 20, ""lines"": 20}, ""src/indent.c"": {""insertions"": 1, ""deletions"": 1, ""lines"": 2}, ""src/list.c"": {""insertions"": 1, ""deletions"": 1, ""lines"": 2}, ""src/map.c"": {""insertions"": 1, ""deletions"": 1, ""lines"": 2}, ""src/mark.c"": {""insertions"": 2, ""deletions"": 2, ""lines"": 4}, ""src/normal.c"": {""insertions"": 3, ""deletions"": 3, ""lines"": 6}, ""src/ops.c"": {""insertions"": 1, ""deletions"": 1, ""lines"": 2}, ""src/optionstr.c"": {""insertions"": 2, ""deletions"": 2, ""lines"": 4}, ""src/popupwin.c"": {""insertions"": 1, ""deletions"": 1, ""lines"": 2}, ""src/quickfix.c"": {""insertions"": 3, ""deletions"": 3, ""lines"": 6}, ""src/spellfile.c"": {""insertions"": 2, ""deletions"": 2, ""lines"": 4}, ""src/textprop.c"": {""insertions"": 4, ""deletions"": 4, ""lines"": 8}, ""src/typval.c"": {""insertions"": 1, ""deletions"": 1, ""lines"": 2}, ""src/undo.c"": {""insertions"": 1, ""deletions"": 1, ""lines"": 2}, ""src/userfunc.c"": {""insertions"": 1, ""deletions"": 1, ""lines"": 2}, ""src/version.c"": {""insertions"": 2, ""deletions"": 0, ""lines"": 2}, ""src/vim9compile.c"": {""insertions"": 2, ""deletions"": 2, ""lines"": 4}, ""src/window.c"": {""insertions"": 2, ""deletions"": 2, ""lines"": 4}}"
2021-06-27 19:30:14,d887297ad0164516dd52cdab0308c3626337d124,Christian Brabandt,78,35,113,3,"{""runtime/tools/unicode.vim"": {""insertions"": 21, ""deletions"": 5, ""lines"": 26}, ""src/mbyte.c"": {""insertions"": 55, ""deletions"": 30, ""lines"": 85}, ""src/version.c"": {""insertions"": 2, ""deletions"": 0, ""lines"": 2}}"
2021-06-27 17:02:52,1d1ce613cdc74721499660b1d8911de164e2862d,Bram Moolenaar,14,1,15,4,"{""src/evalfunc.c"": {""insertions"": 7, ""deletions"": 0, ""lines"": 7}, ""src/testdir/test_gui.vim"": {""insertions"": 4, ""deletions"": 0, ""lines"": 4}, ""src/testing.c"": {""insertions"": 1, ""deletions"": 1, ""lines"": 2}, ""src/version.c"": {""insertions"": 2, ""deletions"": 0, ""lines"": 2}}"
2021-06-27 14:29:53,17d868b8b268c9b9670421039d1a772341937add,Bram Moolenaar,31,2,33,3,"{""src/testdir/test_debugger.vim"": {""insertions"": 28, ""deletions"": 1, ""lines"": 29}, ""src/version.c"": {""insertions"": 2, ""deletions"": 0, ""lines"": 2}, ""src/vim9compile.c"": {""insertions"": 1, ""deletions"": 1, ""lines"": 2}}"
2021-06-27 13:35:40,577dc93da9ec78684576bff71328d40f24bd6dd8,Bram Moolenaar,26,2,28,3,"{""src/testdir/test_vim9_script.vim"": {""insertions"": 21, ""deletions"": 0, ""lines"": 21}, ""src/version.c"": {""insertions"": 2, ""deletions"": 0, ""lines"": 2}, ""src/vim9compile.c"": {""insertions"": 3, ""deletions"": 2, ""lines"": 5}}"
2021-06-27 13:18:56,4d8f476176eadfc745bcb8e143460029048f858d,Bram Moolenaar,5057,2577,7634,30,"{""nsis/README.txt"": {""insertions"": 1, ""deletions"": 1, ""lines"": 2}, ""runtime/autoload/rubycomplete.vim"": {""insertions"": 3, ""deletions"": 8, ""lines"": 11}, ""runtime/doc/arabic.txt"": {""insertions"": 8, ""deletions"": 1, ""lines"": 9}, ""runtime/doc/change.txt"": {""insertions"": 8, ""deletions"": 5, ""lines"": 13}, ""runtime/doc/eval.txt"": {""insertions"": 24, ""deletions"": 14, ""lines"": 38}, ""runtime/doc/ft_ps1.txt"": {""insertions"": 1, ""deletions"": 1, ""lines"": 2}, ""runtime/doc/ft_raku.txt"": {""insertions"": 1, ""deletions"": 1, ""lines"": 2}, ""runtime/doc/index.txt"": {""insertions"": 2, ""deletions"": 1, ""lines"": 3}, ""runtime/doc/motion.txt"": {""insertions"": 2, ""deletions"": 2, ""lines"": 4}, ""runtime/doc/options.txt"": {""insertions"": 5, ""deletions"": 3, ""lines"": 8}, ""runtime/doc/repeat.txt"": {""insertions"": 11, ""deletions"": 1, ""lines"": 12}, ""runtime/doc/rileft.txt"": {""insertions"": 2, ""deletions"": 2, ""lines"": 4}, ""runtime/doc/syntax.txt"": {""insertions"": 4, ""deletions"": 4, ""lines"": 8}, ""runtime/doc/tags"": {""insertions"": 17, ""deletions"": 2, ""lines"": 19}, ""runtime/doc/testing.txt"": {""insertions"": 1, ""deletions"": 1, ""lines"": 2}, ""runtime/doc/todo.txt"": {""insertions"": 16, ""deletions"": 6, ""lines"": 22}, ""runtime/doc/vim9.txt"": {""insertions"": 12, ""deletions"": 2, ""lines"": 14}, ""runtime/ftplugin/eruby.vim"": {""insertions"": 2, ""deletions"": 2, ""lines"": 4}, ""runtime/ftplugin/ruby.vim"": {""insertions"": 2, ""deletions"": 2, ""lines"": 4}, ""runtime/gvim.desktop"": {""insertions"": 5, ""deletions"": 1, ""lines"": 6}, ""runtime/indent/ruby.vim"": {""insertions"": 1, ""deletions"": 0, ""lines"": 1}, ""runtime/syntax/8th.vim"": {""insertions"": 1, ""deletions"": 1, ""lines"": 2}, ""runtime/syntax/help.vim"": {""insertions"": 2, ""deletions"": 1, ""lines"": 3}, ""runtime/syntax/redif.vim"": {""insertions"": 2, ""deletions"": 2, ""lines"": 4}, ""runtime/syntax/ruby.vim"": {""insertions"": 10, ""deletions"": 10, ""lines"": 20}, ""runtime/syntax/vim.vim"": {""insertions"": 22, ""deletions"": 17, ""lines"": 39}, ""runtime/vim.desktop"": {""insertions"": 5, ""deletions"": 1, ""lines"": 6}, ""src/po/gvim.desktop.in"": {""insertions"": 0, ""deletions"": 1, ""lines"": 1}, ""src/po/it.po"": {""insertions"": 4887, ""deletions"": 2483, ""lines"": 7370}, ""src/po/vim.desktop.in"": {""insertions"": 0, ""deletions"": 1, ""lines"": 1}}"
2021-06-27 13:04:05,e65081d1b591f16dc6e380a830d87565c5eb7b03,Bram Moolenaar,51,23,74,3,"{""src/eval.c"": {""insertions"": 25, ""deletions"": 8, ""lines"": 33}, ""src/testdir/test_vim9_assign.vim"": {""insertions"": 24, ""deletions"": 15, ""lines"": 39}, ""src/version.c"": {""insertions"": 2, ""deletions"": 0, ""lines"": 2}}"
2021-06-27 12:08:24,65aee0b714e809b9f19862f3decd35055ed4de10,Bram Moolenaar,22,2,24,3,"{""src/bufwrite.c"": {""insertions"": 12, ""deletions"": 2, ""lines"": 14}, ""src/fileio.c"": {""insertions"": 8, ""deletions"": 0, ""lines"": 8}, ""src/version.c"": {""insertions"": 2, ""deletions"": 0, ""lines"": 2}}"
2021-06-27 11:04:00,4cd5c52d64a66ad1984d33462a40e0c6721ca232,Bram Moolenaar,31,4,35,4,"{""src/memline.c"": {""insertions"": 6, ""deletions"": 4, ""lines"": 10}, ""src/structs.h"": {""insertions"": 1, ""deletions"": 0, ""lines"": 1}, ""src/testdir/test_textprop.vim"": {""insertions"": 22, ""deletions"": 0, ""lines"": 22}, ""src/version.c"": {""insertions"": 2, ""deletions"": 0, ""lines"": 2}}"
2021-06-27 10:07:49,054794c20f6322bbd9482c4124041dc0a140c78e,Yegappan Lakshmanan,163,89,252,6,"{""src/testdir/Make_all.mak"": {""insertions"": 2, ""deletions"": 0, ""lines"": 2}, ""src/testdir/test_functions.vim"": {""insertions"": 0, ""deletions"": 25, ""lines"": 25}, ""src/testdir/test_options.vim"": {""insertions"": 0, ""deletions"": 28, ""lines"": 28}, ""src/testdir/test_shell.vim"": {""insertions"": 159, ""deletions"": 0, ""lines"": 159}, ""src/testdir/test_system.vim"": {""insertions"": 0, ""deletions"": 36, ""lines"": 36}, ""src/version.c"": {""insertions"": 2, ""deletions"": 0, ""lines"": 2}}"
2021-06-26 20:22:38,98f9a5f4cbe6061e09bccf6074afe0a88a504219,Bram Moolenaar,8,2,10,3,"{""src/testdir/test_vim9_func.vim"": {""insertions"": 3, ""deletions"": 0, ""lines"": 3}, ""src/userfunc.c"": {""insertions"": 3, ""deletions"": 2, ""lines"": 5}, ""src/version.c"": {""insertions"": 2, ""deletions"": 0, ""lines"": 2}}"
2021-06-26 20:17:35,e3ffaa6b7c2d53ab53da933ec91382d003cf9a12,Bram Moolenaar,22,17,39,2,"{""src/userfunc.c"": {""insertions"": 20, ""deletions"": 17, ""lines"": 37}, ""src/version.c"": {""insertions"": 2, ""deletions"": 0, ""lines"": 2}}"
2021-06-26 19:52:02,015cf103115f9a0380ae3e3e85a77792cfe87d49,Bram Moolenaar,15,1,16,3,"{""src/testdir/test_vim9_func.vim"": {""insertions"": 7, ""deletions"": 0, ""lines"": 7}, ""src/userfunc.c"": {""insertions"": 6, ""deletions"": 1, ""lines"": 7}, ""src/version.c"": {""insertions"": 2, ""deletions"": 0, ""lines"": 2}}"
2021-06-26 19:21:03,307dec4567e0f64a7a4cfc2d5302d2aba26db775,Bram Moolenaar,3,1,4,2,"{""src/version.c"": {""insertions"": 2, ""deletions"": 0, ""lines"": 2}, ""src/vim9.h"": {""insertions"": 1, ""deletions"": 1, ""lines"": 2}}"
2021-06-26 17:25:49,14ded11fcad77ebf41032ec80a95d516ca9acb1c,Bram Moolenaar,9,1,10,3,"{""src/testdir/test_vim9_func.vim"": {""insertions"": 6, ""deletions"": 0, ""lines"": 6}, ""src/userfunc.c"": {""insertions"": 1, ""deletions"": 1, ""lines"": 2}, ""src/version.c"": {""insertions"": 2, ""deletions"": 0, ""lines"": 2}}"
2021-06-26 13:00:59,3a3b10e87a10dd0bc355618dbfc4a0a6c828aad7,Bram Moolenaar,21,2,23,6,"{""src/errors.h"": {""insertions"": 2, ""deletions"": 0, ""lines"": 2}, ""src/eval.c"": {""insertions"": 7, ""deletions"": 1, ""lines"": 8}, ""src/testdir/test_let.vim"": {""insertions"": 1, ""deletions"": 1, ""lines"": 2}, ""src/testdir/test_listdict.vim"": {""insertions"": 3, ""deletions"": 0, ""lines"": 3}, ""src/testdir/test_vim9_assign.vim"": {""insertions"": 6, ""deletions"": 0, ""lines"": 6}, ""src/version.c"": {""insertions"": 2, ""deletions"": 0, ""lines"": 2}}"
2021-06-26 11:59:29,4d5dfe20839e9d13c95eaf4254467f952653b042,Bram Moolenaar,18,3,21,4,"{""src/errors.h"": {""insertions"": 1, ""deletions"": 1, ""lines"": 2}, ""src/testdir/test_vim9_assign.vim"": {""insertions"": 10, ""deletions"": 0, ""lines"": 10}, ""src/version.c"": {""insertions"": 2, ""deletions"": 0, ""lines"": 2}, ""src/vim9compile.c"": {""insertions"": 5, ""deletions"": 2, ""lines"": 7}}"
2021-06-26 11:28:35,13e45d14ba7f590fb243c041bc45e6d4d47c8432,Bram Moolenaar,19,11,30,3,"{""src/testdir/test_vim9_assign.vim"": {""insertions"": 15, ""deletions"": 10, ""lines"": 25}, ""src/version.c"": {""insertions"": 2, ""deletions"": 0, ""lines"": 2}, ""src/vim9compile.c"": {""insertions"": 2, ""deletions"": 1, ""lines"": 3}}"
2021-06-26 11:00:49,ce024c3e20839465dc8c8f79dcccc5414dd8c506,Bram Moolenaar,42,19,61,3,"{""src/testdir/test_vim9_func.vim"": {""insertions"": 17, ""deletions"": 0, ""lines"": 17}, ""src/version.c"": {""insertions"": 2, ""deletions"": 0, ""lines"": 2}, ""src/vim9compile.c"": {""insertions"": 23, ""deletions"": 19, ""lines"": 42}}"
2021-06-26 10:40:56,444d878324525787e55185ce3c3e29a3de9b700a,Bram Moolenaar,16,4,20,3,"{""src/testdir/test_vim9_script.vim"": {""insertions"": 7, ""deletions"": 0, ""lines"": 7}, ""src/version.c"": {""insertions"": 2, ""deletions"": 0, ""lines"": 2}, ""src/vim9compile.c"": {""insertions"": 7, ""deletions"": 4, ""lines"": 11}}"
2021-06-26 10:02:55,f3caeb63d62c08b579e9b5f40b35e8bf64dde87a,Austin Gatlin,60,2,62,4,"{""runtime/autoload/dist/ft.vim"": {""insertions"": 11, ""deletions"": 0, ""lines"": 11}, ""runtime/filetype.vim"": {""insertions"": 9, ""deletions"": 2, ""lines"": 11}, ""src/testdir/test_filetype.vim"": {""insertions"": 38, ""deletions"": 0, ""lines"": 38}, ""src/version.c"": {""insertions"": 2, ""deletions"": 0, ""lines"": 2}}"
2021-06-25 19:54:25,6582e230a0f6592287b1123c5fc3807d6fed997e,Kevin Locke,6,1,7,3,"{""runtime/filetype.vim"": {""insertions"": 3, ""deletions"": 0, ""lines"": 3}, ""src/testdir/test_filetype.vim"": {""insertions"": 1, ""deletions"": 1, ""lines"": 2}, ""src/version.c"": {""insertions"": 2, ""deletions"": 0, ""lines"": 2}}"
2021-06-25 19:31:09,22480d147fe83cb31316d2dabc5c5f249477af15,Bram Moolenaar,23,0,23,5,"{""src/errors.h"": {""insertions"": 2, ""deletions"": 0, ""lines"": 2}, ""src/testdir/test_vim9_assign.vim"": {""insertions"": 6, ""deletions"": 0, ""lines"": 6}, ""src/version.c"": {""insertions"": 2, ""deletions"": 0, ""lines"": 2}, ""src/vim9compile.c"": {""insertions"": 6, ""deletions"": 0, ""lines"": 6}, ""src/vim9script.c"": {""insertions"": 7, ""deletions"": 0, ""lines"": 7}}"
2021-06-25 17:29:30,f3d30842dcc8ef4134da462bd4197ae2e2c6c0c1,Bram Moolenaar,14,4,18,4,"{""src/ex_cmds.h"": {""insertions"": 2, ""deletions"": 2, ""lines"": 4}, ""src/testdir/test_vim9_assign.vim"": {""insertions"": 4, ""deletions"": 0, ""lines"": 4}, ""src/version.c"": {""insertions"": 2, ""deletions"": 0, ""lines"": 2}, ""src/vim9script.c"": {""insertions"": 6, ""deletions"": 2, ""lines"": 8}}"
2021-06-24 19:43:31,b420ac9d20d484ba0ebf3e328069251a63f96996,ola.soder@axis.com,3,1,4,2,"{""src/os_amiga.c"": {""insertions"": 1, ""deletions"": 1, ""lines"": 2}, ""src/version.c"": {""insertions"": 2, ""deletions"": 0, ""lines"": 2}}"
2021-06-24 17:55:27,98703d7f6c9a0ef9e54cb291a92342b9f96db732,Christian Brabandt,5,3,8,4,"{""src/VisVim/README_VisVim.txt"": {""insertions"": 1, ""deletions"": 1, ""lines"": 2}, ""src/evalfunc.c"": {""insertions"": 1, ""deletions"": 1, ""lines"": 2}, ""src/testdir/vim9.vim"": {""insertions"": 1, ""deletions"": 1, ""lines"": 2}, ""src/version.c"": {""insertions"": 2, ""deletions"": 0, ""lines"": 2}}"
2021-06-24 16:50:30,3a62b14077c51c739cdc755356882b40c299f1c0,ola.soder@axis.com,4,2,6,2,"{""src/os_amiga.c"": {""insertions"": 2, ""deletions"": 2, ""lines"": 4}, ""src/version.c"": {""insertions"": 2, ""deletions"": 0, ""lines"": 2}}"
2021-06-23 20:05:27,d415d269130b233c0f198c75cc159bee721aa55c,ola.soder@axis.com,55,6,61,2,"{""src/os_amiga.c"": {""insertions"": 53, ""deletions"": 6, ""lines"": 59}, ""src/version.c"": {""insertions"": 2, ""deletions"": 0, ""lines"": 2}}"
2021-06-23 19:44:06,6738fd2000f0bea4d40f4a8651e0e1f4b0503bb3,Bram Moolenaar,4,2,6,2,"{""src/testdir/test_swap.vim"": {""insertions"": 2, ""deletions"": 2, ""lines"": 4}, ""src/version.c"": {""insertions"": 2, ""deletions"": 0, ""lines"": 2}}"
2021-06-23 19:13:20,44dea9da4b2a21dd1e03f2bd94b4f2679d4613e5,Bram Moolenaar,13,2,15,2,"{""src/os_unix.c"": {""insertions"": 11, ""deletions"": 2, ""lines"": 13}, ""src/version.c"": {""insertions"": 2, ""deletions"": 0, ""lines"": 2}}"
2021-06-23 18:46:52,18d46587b985923ef4b90b19a0cf37a094607fec,Yegappan Lakshmanan,174,5,179,9,"{""runtime/doc/eval.txt"": {""insertions"": 2, ""deletions"": 0, ""lines"": 2}, ""runtime/doc/testing.txt"": {""insertions"": 18, ""deletions"": 3, ""lines"": 21}, ""runtime/doc/usr_41.txt"": {""insertions"": 1, ""deletions"": 0, ""lines"": 1}, ""src/evalfunc.c"": {""insertions"": 2, ""deletions"": 0, ""lines"": 2}, ""src/gui.c"": {""insertions"": 1, ""deletions"": 0, ""lines"": 1}, ""src/proto/testing.pro"": {""insertions"": 1, ""deletions"": 0, ""lines"": 1}, ""src/testdir/test_gui.vim"": {""insertions"": 89, ""deletions"": 0, ""lines"": 89}, ""src/testing.c"": {""insertions"": 58, ""deletions"": 2, ""lines"": 60}, ""src/version.c"": {""insertions"": 2, ""deletions"": 0, ""lines"": 2}}"
2021-06-23 18:20:53,8cec9273d2518f2a9abcbd326722a2eba38d2a13,Bram Moolenaar,48,14,62,6,"{""src/testdir/test_debugger.vim"": {""insertions"": 14, ""deletions"": 1, ""lines"": 15}, ""src/testdir/test_vim9_disassemble.vim"": {""insertions"": 12, ""deletions"": 6, ""lines"": 18}, ""src/version.c"": {""insertions"": 2, ""deletions"": 0, ""lines"": 2}, ""src/vim9.h"": {""insertions"": 8, ""deletions"": 2, ""lines"": 10}, ""src/vim9compile.c"": {""insertions"": 6, ""deletions"": 1, ""lines"": 7}, ""src/vim9execute.c"": {""insertions"": 6, ""deletions"": 4, ""lines"": 10}}"
2021-06-23 13:52:46,cc6504098605f894b557109b618e88913a89914b,ola.soder@axis.com,5,0,5,2,"{""src/os_amiga.c"": {""insertions"": 3, ""deletions"": 0, ""lines"": 3}, ""src/version.c"": {""insertions"": 2, ""deletions"": 0, ""lines"": 2}}"
2021-06-23 13:41:52,8ce3ca8961c5968a02de0a0b98f906695331f254,ichizok,5,3,8,3,"{""src/auto/configure"": {""insertions"": 2, ""deletions"": 2, ""lines"": 4}, ""src/configure.ac"": {""insertions"": 1, ""deletions"": 1, ""lines"": 2}, ""src/version.c"": {""insertions"": 2, ""deletions"": 0, ""lines"": 2}}"
2021-06-22 17:52:27,7237cab8f1d1a4391372cafdb57f2d97f3b32d05,Yegappan Lakshmanan,400,72,472,7,"{""src/evalfunc.c"": {""insertions"": 68, ""deletions"": 64, ""lines"": 132}, ""src/testdir/test_assert.vim"": {""insertions"": 2, ""deletions"": 0, ""lines"": 2}, ""src/testdir/test_gui.vim"": {""insertions"": 62, ""deletions"": 1, ""lines"": 63}, ""src/testdir/test_popupwin.vim"": {""insertions"": 2, ""deletions"": 2, ""lines"": 4}, ""src/testdir/test_vim9_builtin.vim"": {""insertions"": 237, ""deletions"": 0, ""lines"": 237}, ""src/testing.c"": {""insertions"": 27, ""deletions"": 5, ""lines"": 32}, ""src/version.c"": {""insertions"": 2, ""deletions"": 0, ""lines"": 2}}"
2021-06-22 17:32:17,831bdf8622fdfce7f02d48f847005e3909a055a8,Bram Moolenaar,18,2,20,3,"{""src/testdir/test_vim9_func.vim"": {""insertions"": 14, ""deletions"": 0, ""lines"": 14}, ""src/version.c"": {""insertions"": 2, ""deletions"": 0, ""lines"": 2}, ""src/vim9type.c"": {""insertions"": 2, ""deletions"": 2, ""lines"": 4}}"
2021-06-22 16:21:19,ef7be8348fd830e409504a442f3f3ad0931cfbc3,Christian Brabandt,3,1,4,2,"{"".github/workflows/ci.yml"": {""insertions"": 1, ""deletions"": 1, ""lines"": 2}, ""src/version.c"": {""insertions"": 2, ""deletions"": 0, ""lines"": 2}}"
2021-06-21 19:55:18,419a40ac9657e39646b2e0f3f71d7736b0c459d1,Bram Moolenaar,23,4,27,3,"{""src/ex_cmds.c"": {""insertions"": 17, ""deletions"": 4, ""lines"": 21}, ""src/testdir/test_global.vim"": {""insertions"": 4, ""deletions"": 0, ""lines"": 4}, ""src/version.c"": {""insertions"": 2, ""deletions"": 0, ""lines"": 2}}"
2021-06-21 19:08:08,226b28b96150e59375d2bff44e0aadd382b0c3f1,Christian Brabandt,68,21,89,7,"{""src/Make_mvc.mak"": {""insertions"": 9, ""deletions"": 5, ""lines"": 14}, ""src/crypt.c"": {""insertions"": 50, ""deletions"": 11, ""lines"": 61}, ""src/errors.h"": {""insertions"": 1, ""deletions"": 1, ""lines"": 2}, ""src/fileio.c"": {""insertions"": 3, ""deletions"": 1, ""lines"": 4}, ""src/memline.c"": {""insertions"": 2, ""deletions"": 1, ""lines"": 3}, ""src/proto/crypt.pro"": {""insertions"": 1, ""deletions"": 2, ""lines"": 3}, ""src/version.c"": {""insertions"": 2, ""deletions"": 0, ""lines"": 2}}"
2021-06-21 18:48:58,22f17a29cd0b0cc3107dc6cd1d96c62eee52a7d9,Bram Moolenaar,22,1,23,3,"{""src/testdir/test_vim9_func.vim"": {""insertions"": 18, ""deletions"": 0, ""lines"": 18}, ""src/userfunc.c"": {""insertions"": 2, ""deletions"": 1, ""lines"": 3}, ""src/version.c"": {""insertions"": 2, ""deletions"": 0, ""lines"": 2}}"
2021-06-21 18:15:37,cb54bc65625abad9a0af501acac5c70fba17e2cc,Dominique Pelle,9,7,16,3,"{""src/crypt.c"": {""insertions"": 5, ""deletions"": 5, ""lines"": 10}, ""src/errors.h"": {""insertions"": 2, ""deletions"": 2, ""lines"": 4}, ""src/version.c"": {""insertions"": 2, ""deletions"": 0, ""lines"": 2}}"
2021-06-21 17:44:11,035bd1c99f2a8eda5ee886adde4f97ea71fb167f,Bram Moolenaar,96,20,116,7,"{""src/ex_docmd.c"": {""insertions"": 11, ""deletions"": 2, ""lines"": 13}, ""src/testdir/test_vim9_assign.vim"": {""insertions"": 23, ""deletions"": 0, ""lines"": 23}, ""src/testdir/test_vim9_disassemble.vim"": {""insertions"": 31, ""deletions"": 0, ""lines"": 31}, ""src/version.c"": {""insertions"": 2, ""deletions"": 0, ""lines"": 2}, ""src/vim9.h"": {""insertions"": 7, ""deletions"": 0, ""lines"": 7}, ""src/vim9compile.c"": {""insertions"": 14, ""deletions"": 12, ""lines"": 26}, ""src/vim9execute.c"": {""insertions"": 8, ""deletions"": 6, ""lines"": 14}}"
2021-06-21 16:44:26,f1e7449d567c630601aa0cec6c663b791785a668,Yegappan Lakshmanan,337,5,342,9,"{""runtime/doc/eval.txt"": {""insertions"": 2, ""deletions"": 0, ""lines"": 2}, ""runtime/doc/testing.txt"": {""insertions"": 25, ""deletions"": 1, ""lines"": 26}, ""runtime/doc/usr_41.txt"": {""insertions"": 1, ""deletions"": 0, ""lines"": 1}, ""src/evalfunc.c"": {""insertions"": 2, ""deletions"": 0, ""lines"": 2}, ""src/proto/testing.pro"": {""insertions"": 1, ""deletions"": 0, ""lines"": 1}, ""src/testdir/test_gui.vim"": {""insertions"": 223, ""deletions"": 1, ""lines"": 224}, ""src/testdir/test_viminfo.vim"": {""insertions"": 67, ""deletions"": 3, ""lines"": 70}, ""src/testing.c"": {""insertions"": 14, ""deletions"": 0, ""lines"": 14}, ""src/version.c"": {""insertions"": 2, ""deletions"": 0, ""lines"": 2}}"
2021-06-20 18:09:42,2ac4b2536a40e5cd75b4ff7a3d44a282d2f4f008,Bram Moolenaar,27,0,27,3,"{""src/testdir/test_debugger.vim"": {""insertions"": 22, ""deletions"": 0, ""lines"": 22}, ""src/version.c"": {""insertions"": 2, ""deletions"": 0, ""lines"": 2}, ""src/vim9execute.c"": {""insertions"": 3, ""deletions"": 0, ""lines"": 3}}"
2021-06-20 17:28:14,4f8f54280fa728b7d5a63b67d02b60a3b3dce543,Bram Moolenaar,71,6,77,7,"{""src/debugger.c"": {""insertions"": 1, ""deletions"": 1, ""lines"": 2}, ""src/structs.h"": {""insertions"": 5, ""deletions"": 0, ""lines"": 5}, ""src/testdir/test_debugger.vim"": {""insertions"": 25, ""deletions"": 0, ""lines"": 25}, ""src/version.c"": {""insertions"": 2, ""deletions"": 0, ""lines"": 2}, ""src/vim.h"": {""insertions"": 2, ""deletions"": 2, ""lines"": 4}, ""src/vim9.h"": {""insertions"": 1, ""deletions"": 1, ""lines"": 2}, ""src/vim9execute.c"": {""insertions"": 35, ""deletions"": 2, ""lines"": 37}}"
2021-06-20 14:31:00,0d5e1ec37fbe75e18acba6f650c59bf91063108c,shane.xb.qian,38,1,39,2,"{""src/testdir/test_quickfix.vim"": {""insertions"": 36, ""deletions"": 1, ""lines"": 37}, ""src/version.c"": {""insertions"": 2, ""deletions"": 0, ""lines"": 2}}"
2021-06-20 13:03:15,2fb1b89d721682585228f9a6ee7da4b6d3c6634d,Bram Moolenaar,3,1,4,2,"{""src/testdir/test_execute_func.vim"": {""insertions"": 1, ""deletions"": 1, ""lines"": 2}, ""src/version.c"": {""insertions"": 2, ""deletions"": 0, ""lines"": 2}}"
2021-06-20 12:41:01,ca81f0e834640cf3465b3b742e60c12e8a0956f2,Bram Moolenaar,37,1,38,3,"{""src/evalfunc.c"": {""insertions"": 23, ""deletions"": 1, ""lines"": 24}, ""src/testdir/test_vim9_builtin.vim"": {""insertions"": 12, ""deletions"": 0, ""lines"": 12}, ""src/version.c"": {""insertions"": 2, ""deletions"": 0, ""lines"": 2}}"
2021-06-20 12:02:16,f573c6e1ed58d46d694c802eaf5ae3662a952744,Christian Brabandt,820,64,884,29,"{"".github/workflows/ci.yml"": {""insertions"": 2, ""deletions"": 1, ""lines"": 3}, ""runtime/doc/eval.txt"": {""insertions"": 1, ""deletions"": 0, ""lines"": 1}, ""runtime/doc/options.txt"": {""insertions"": 17, ""deletions"": 0, ""lines"": 17}, ""runtime/doc/various.txt"": {""insertions"": 1, ""deletions"": 0, ""lines"": 1}, ""src/INSTALLpc.txt"": {""insertions"": 3, ""deletions"": 0, ""lines"": 3}, ""src/Make_cyg_ming.mak"": {""insertions"": 13, ""deletions"": 2, ""lines"": 15}, ""src/Make_mvc.mak"": {""insertions"": 26, ""deletions"": 3, ""lines"": 29}, ""src/auto/configure"": {""insertions"": 66, ""deletions"": 0, ""lines"": 66}, ""src/blowfish.c"": {""insertions"": 4, ""deletions"": 3, ""lines"": 7}, ""src/bufwrite.c"": {""insertions"": 17, ""deletions"": 2, ""lines"": 19}, ""src/config.h.in"": {""insertions"": 1, ""deletions"": 0, ""lines"": 1}, ""src/configure.ac"": {""insertions"": 37, ""deletions"": 0, ""lines"": 37}, ""src/crypt.c"": {""insertions"": 359, ""deletions"": 26, ""lines"": 385}, ""src/crypt_zip.c"": {""insertions"": 4, ""deletions"": 2, ""lines"": 6}, ""src/errors.h"": {""insertions"": 19, ""deletions"": 0, ""lines"": 19}, ""src/evalfunc.c"": {""insertions"": 7, ""deletions"": 0, ""lines"": 7}, ""src/feature.h"": {""insertions"": 7, ""deletions"": 0, ""lines"": 7}, ""src/fileio.c"": {""insertions"": 38, ""deletions"": 2, ""lines"": 40}, ""src/memline.c"": {""insertions"": 30, ""deletions"": 8, ""lines"": 38}, ""src/option.c"": {""insertions"": 4, ""deletions"": 0, ""lines"": 4}, ""src/optionstr.c"": {""insertions"": 5, ""deletions"": 1, ""lines"": 6}, ""src/proto/blowfish.pro"": {""insertions"": 2, ""deletions"": 2, ""lines"": 4}, ""src/proto/crypt.pro"": {""insertions"": 11, ""deletions"": 3, ""lines"": 14}, ""src/proto/crypt_zip.pro"": {""insertions"": 2, ""deletions"": 2, ""lines"": 4}, ""src/structs.h"": {""insertions"": 3, ""deletions"": 2, ""lines"": 5}, ""src/testdir/samples/crypt_sodium_invalid.txt"": {""insertions"": 0, ""deletions"": 0, ""lines"": 0}, ""src/testdir/test_crypt.vim"": {""insertions"": 126, ""deletions"": 1, ""lines"": 127}, ""src/undo.c"": {""insertions"": 8, ""deletions"": 4, ""lines"": 12}, ""src/version.c"": {""insertions"": 7, ""deletions"": 0, ""lines"": 7}}"
2021-06-20 10:40:08,208f0b48b2c616b29f377a1408290111ed2663f7,Bram Moolenaar,26,3,29,3,"{""src/option.c"": {""insertions"": 4, ""deletions"": 3, ""lines"": 7}, ""src/testdir/test_vim9_script.vim"": {""insertions"": 20, ""deletions"": 0, ""lines"": 20}, ""src/version.c"": {""insertions"": 2, ""deletions"": 0, ""lines"": 2}}"
2021-06-19 19:38:25,2fb749568662c86992aea3b596458b9e470f223d,=?UTF-8?q?Dundar=20G=C3=B6c?=,2,3,5,2,"{""src/ex_docmd.c"": {""insertions"": 0, ""deletions"": 3, ""lines"": 3}, ""src/version.c"": {""insertions"": 2, ""deletions"": 0, ""lines"": 2}}"
2021-06-19 18:45:20,6864efa59636ccede2af24e3f5f92d78d210d77b,thinca,122,38,160,8,"{""runtime/doc/eval.txt"": {""insertions"": 3, ""deletions"": 0, ""lines"": 3}, ""src/quickfix.c"": {""insertions"": 70, ""deletions"": 21, ""lines"": 91}, ""src/testdir/dumps/Test_quickfix_cwindow_1.dump"": {""insertions"": 3, ""deletions"": 3, ""lines"": 6}, ""src/testdir/dumps/Test_quickfix_cwindow_2.dump"": {""insertions"": 3, ""deletions"": 3, ""lines"": 6}, ""src/testdir/test_quickfix.vim"": {""insertions"": 32, ""deletions"": 5, ""lines"": 37}, ""src/testdir/test_tagjump.vim"": {""insertions"": 7, ""deletions"": 6, ""lines"": 13}, ""src/testdir/test_vim9_expr.vim"": {""insertions"": 2, ""deletions"": 0, ""lines"": 2}, ""src/version.c"": {""insertions"": 2, ""deletions"": 0, ""lines"": 2}}"
2021-06-19 16:22:53,ad52f96a2d3169cb1b915c1d4a6ba26ba6e5bd0a,Yegappan Lakshmanan,71,1,72,3,"{""src/quickfix.c"": {""insertions"": 11, ""deletions"": 1, ""lines"": 12}, ""src/testdir/test_quickfix.vim"": {""insertions"": 58, ""deletions"": 0, ""lines"": 58}, ""src/version.c"": {""insertions"": 2, ""deletions"": 0, ""lines"": 2}}"
2021-06-17 20:27:48,59b50c3bee908694ae4ac10b26bfebf99d09d466,Bram Moolenaar,17,2,19,3,"{""src/testdir/test_debugger.vim"": {""insertions"": 5, ""deletions"": 0, ""lines"": 5}, ""src/version.c"": {""insertions"": 2, ""deletions"": 0, ""lines"": 2}, ""src/vim9execute.c"": {""insertions"": 10, ""deletions"": 2, ""lines"": 12}}"
2021-06-17 20:08:30,fae55a9cb0838e4c2e634e55a3468af4a75fbdf2,Bram Moolenaar,24,13,37,8,"{""src/eval.c"": {""insertions"": 10, ""deletions"": 2, ""lines"": 12}, ""src/testdir/test_eval_stuff.vim"": {""insertions"": 1, ""deletions"": 1, ""lines"": 2}, ""src/testdir/test_let.vim"": {""insertions"": 1, ""deletions"": 0, ""lines"": 1}, ""src/testdir/test_vim9_expr.vim"": {""insertions"": 5, ""deletions"": 5, ""lines"": 10}, ""src/testdir/test_vim9_script.vim"": {""insertions"": 3, ""deletions"": 3, ""lines"": 6}, ""src/testdir/test_viminfo.vim"": {""insertions"": 1, ""deletions"": 1, ""lines"": 2}, ""src/testdir/test_vimscript.vim"": {""insertions"": 1, ""deletions"": 1, ""lines"": 2}, ""src/version.c"": {""insertions"": 2, ""deletions"": 0, ""lines"": 2}}"
2021-06-17 19:03:07,74f4a965bc6e2a9c41cce2f644e861168702922f,Bram Moolenaar,33,5,38,5,"{""src/globals.h"": {""insertions"": 3, ""deletions"": 0, ""lines"": 3}, ""src/testdir/test_vim9_assign.vim"": {""insertions"": 13, ""deletions"": 0, ""lines"": 13}, ""src/version.c"": {""insertions"": 2, ""deletions"": 0, ""lines"": 2}, ""src/vim9compile.c"": {""insertions"": 14, ""deletions"": 3, ""lines"": 17}, ""src/vim9execute.c"": {""insertions"": 1, ""deletions"": 2, ""lines"": 3}}"
2021-06-17 11:53:41,6e9695525e212466398a269a54bc4d53625673f0,Dominique Pelle,3,3,6,2,"{""src/version.c"": {""insertions"": 2, ""deletions"": 0, ""lines"": 2}, ""src/vim9execute.c"": {""insertions"": 1, ""deletions"": 3, ""lines"": 4}}"
2021-06-16 20:24:40,4cea536bdf48df459e7ad651dfee006844bbf2c0,Bram Moolenaar,78,31,109,3,"{""src/testdir/test_debugger.vim"": {""insertions"": 29, ""deletions"": 16, ""lines"": 45}, ""src/version.c"": {""insertions"": 2, ""deletions"": 0, ""lines"": 2}, ""src/vim9execute.c"": {""insertions"": 47, ""deletions"": 15, ""lines"": 62}}"
2021-06-16 17:28:34,29f0dc3689eafcf7888e06d57d1cf79e62c5c148,Christian Brabandt,27,2,29,3,"{""src/drawline.c"": {""insertions"": 3, ""deletions"": 2, ""lines"": 5}, ""src/testdir/test_number.vim"": {""insertions"": 22, ""deletions"": 0, ""lines"": 22}, ""src/version.c"": {""insertions"": 2, ""deletions"": 0, ""lines"": 2}}"
2021-06-16 17:19:55,6bc30b05e6081bcaece6d1a7fcfca238ea5a194f,Bram Moolenaar,71,13,84,4,"{""src/testdir/test_debugger.vim"": {""insertions"": 37, ""deletions"": 6, ""lines"": 43}, ""src/version.c"": {""insertions"": 2, ""deletions"": 0, ""lines"": 2}, ""src/vim9compile.c"": {""insertions"": 16, ""deletions"": 2, ""lines"": 18}, ""src/vim9execute.c"": {""insertions"": 16, ""deletions"": 5, ""lines"": 21}}"
2021-06-16 13:53:17,41a7f82dea525b3398bf372cbb9c268455845800,Yegappan Lakshmanan,360,2,362,5,"{""src/register.c"": {""insertions"": 3, ""deletions"": 0, ""lines"": 3}, ""src/testdir/test_fileformat.vim"": {""insertions"": 16, ""deletions"": 0, ""lines"": 16}, ""src/testdir/test_smartindent.vim"": {""insertions"": 23, ""deletions"": 0, ""lines"": 23}, ""src/testdir/test_viminfo.vim"": {""insertions"": 316, ""deletions"": 2, ""lines"": 318}, ""src/version.c"": {""insertions"": 2, ""deletions"": 0, ""lines"": 2}}"
2021-06-16 08:59:36,b90ac5e96e40706ffb039db64b92fcd16fa78c04,Bram Moolenaar,4,1,5,2,"{""src/testdir/test_startup.vim"": {""insertions"": 2, ""deletions"": 1, ""lines"": 3}, ""src/version.c"": {""insertions"": 2, ""deletions"": 0, ""lines"": 2}}"
2021-06-15 21:05:59,55b6b60b691eca7058535006113a1adffda4cabf,Bram Moolenaar,4,1,5,2,"{""src/testdir/test_startup.vim"": {""insertions"": 2, ""deletions"": 1, ""lines"": 3}, ""src/version.c"": {""insertions"": 2, ""deletions"": 0, ""lines"": 2}}"
2021-06-15 20:54:28,61a417b7c1fe858d778c7c47f33f7b4dac19360d,Bram Moolenaar,8,4,12,3,"{""src/testdir/test_functions.vim"": {""insertions"": 3, ""deletions"": 3, ""lines"": 6}, ""src/typval.c"": {""insertions"": 3, ""deletions"": 1, ""lines"": 4}, ""src/version.c"": {""insertions"": 2, ""deletions"": 0, ""lines"": 2}}"
2021-06-15 20:39:11,a97c36310f90ed15dbf5a2ba5bf91fc906e2e724,Bram Moolenaar,27,9,36,3,"{""src/message.c"": {""insertions"": 11, ""deletions"": 9, ""lines"": 20}, ""src/testdir/test_startup.vim"": {""insertions"": 14, ""deletions"": 0, ""lines"": 14}, ""src/version.c"": {""insertions"": 2, ""deletions"": 0, ""lines"": 2}}"
2021-06-15 20:13:27,f57b43c230c23117650c956c1f62546a34500fb6,Bram Moolenaar,71,48,119,7,"{""src/testdir/test_vim9_disassemble.vim"": {""insertions"": 34, ""deletions"": 34, ""lines"": 68}, ""src/testdir/test_vim9_expr.vim"": {""insertions"": 14, ""deletions"": 0, ""lines"": 14}, ""src/typval.c"": {""insertions"": 11, ""deletions"": 5, ""lines"": 16}, ""src/version.c"": {""insertions"": 2, ""deletions"": 0, ""lines"": 2}, ""src/vim9.h"": {""insertions"": 1, ""deletions"": 1, ""lines"": 2}, ""src/vim9compile.c"": {""insertions"": 3, ""deletions"": 3, ""lines"": 6}, ""src/vim9execute.c"": {""insertions"": 6, ""deletions"": 5, ""lines"": 11}}"
2021-06-15 18:06:34,8ac681a280ffae14c30784a54587ad6cb640afbb,Bram Moolenaar,16,1,17,3,"{""src/ex_docmd.c"": {""insertions"": 1, ""deletions"": 1, ""lines"": 2}, ""src/testdir/test_vim9_script.vim"": {""insertions"": 13, ""deletions"": 0, ""lines"": 13}, ""src/version.c"": {""insertions"": 2, ""deletions"": 0, ""lines"": 2}}"
2021-06-15 17:32:40,968a5b62ffd3e08005d907d93eaaf807be466a88,Bram Moolenaar,30,5,35,3,"{""src/testdir/test_debugger.vim"": {""insertions"": 27, ""deletions"": 0, ""lines"": 27}, ""src/version.c"": {""insertions"": 2, ""deletions"": 0, ""lines"": 2}, ""src/vim9execute.c"": {""insertions"": 1, ""deletions"": 5, ""lines"": 6}}"
2021-06-15 17:09:43,affd0bc626560631f1df2e0f68db2f15dbda47e1,Dominique Pelle,3,1,4,2,"{""src/if_tcl.c"": {""insertions"": 1, ""deletions"": 1, ""lines"": 2}, ""src/version.c"": {""insertions"": 2, ""deletions"": 0, ""lines"": 2}}"
2021-06-15 09:27:21,caf1a2f296499bdcf030aca545a04da65ac210a1,Bram Moolenaar,4,0,4,2,"{""src/version.c"": {""insertions"": 2, ""deletions"": 0, ""lines"": 2}, ""src/vim9compile.c"": {""insertions"": 2, ""deletions"": 0, ""lines"": 2}}"
2021-06-15 08:22:17,3b814af7e1e7ca18fe1c8c671b18e5e8c1f9e94c,Bram Moolenaar,3,1,4,2,"{""src/version.c"": {""insertions"": 2, ""deletions"": 0, ""lines"": 2}, ""src/vim9compile.c"": {""insertions"": 1, ""deletions"": 1, ""lines"": 2}}"
2021-06-14 20:08:46,47f6db90895c01259e90108caae9517e894e1f95,Bram Moolenaar,11,0,11,2,"{""src/gui_beval.c"": {""insertions"": 9, ""deletions"": 0, ""lines"": 9}, ""src/version.c"": {""insertions"": 2, ""deletions"": 0, ""lines"": 2}}"
2021-06-14 19:32:21,1b0a9dd413c03054f461a01531e010ad739617a7,Bram Moolenaar,12,6,18,2,"{""src/evalvars.c"": {""insertions"": 10, ""deletions"": 6, ""lines"": 16}, ""src/version.c"": {""insertions"": 2, ""deletions"": 0, ""lines"": 2}}"
2021-06-14 19:08:56,26d711645c12abb29bcaf410b4f02d700f62e799,Bram Moolenaar,17,5,22,2,"{""src/testdir/test_vim9_disassemble.vim"": {""insertions"": 15, ""deletions"": 5, ""lines"": 20}, ""src/version.c"": {""insertions"": 2, ""deletions"": 0, ""lines"": 2}}"
2021-06-14 18:40:37,b69c6fb7b423ddc4578b093cb19257cad459dfae,Bram Moolenaar,113,17,130,7,"{""src/debugger.c"": {""insertions"": 1, ""deletions"": 1, ""lines"": 2}, ""src/proto/vim9execute.pro"": {""insertions"": 1, ""deletions"": 0, ""lines"": 1}, ""src/testdir/test_debugger.vim"": {""insertions"": 9, ""deletions"": 6, ""lines"": 15}, ""src/version.c"": {""insertions"": 2, ""deletions"": 0, ""lines"": 2}, ""src/vim9.h"": {""insertions"": 3, ""deletions"": 1, ""lines"": 4}, ""src/vim9compile.c"": {""insertions"": 47, ""deletions"": 7, ""lines"": 54}, ""src/vim9execute.c"": {""insertions"": 50, ""deletions"": 2, ""lines"": 52}}"
2021-06-14 13:08:30,90478f35a8c78e2e10a4b4a8f135998dc04c91fa,Zdenek Dohnal,20,0,20,2,"{""src/if_python3.c"": {""insertions"": 18, ""deletions"": 0, ""lines"": 18}, ""src/version.c"": {""insertions"": 2, ""deletions"": 0, ""lines"": 2}}"
2021-06-13 19:52:48,2d6d718dde7163c971d37b8f4f1ed8f2d25de130,Yegappan Lakshmanan,127,2,129,7,"{""src/testdir/test_excmd.vim"": {""insertions"": 1, ""deletions"": 1, ""lines"": 2}, ""src/testdir/test_mapping.vim"": {""insertions"": 20, ""deletions"": 0, ""lines"": 20}, ""src/testdir/test_modeline.vim"": {""insertions"": 26, ""deletions"": 0, ""lines"": 26}, ""src/testdir/test_options.vim"": {""insertions"": 17, ""deletions"": 0, ""lines"": 17}, ""src/testdir/test_paste.vim"": {""insertions"": 60, ""deletions"": 0, ""lines"": 60}, ""src/version.c"": {""insertions"": 2, ""deletions"": 0, ""lines"": 2}, ""src/vim9compile.c"": {""insertions"": 1, ""deletions"": 1, ""lines"": 2}}"
2021-06-13 18:27:36,5ffefbb35aba2448099314a9e09714d2f3b2b1bd,Bram Moolenaar,31,3,34,5,"{""src/mbyte.c"": {""insertions"": 1, ""deletions"": 2, ""lines"": 3}, ""src/option.c"": {""insertions"": 19, ""deletions"": 1, ""lines"": 20}, ""src/proto/option.pro"": {""insertions"": 1, ""deletions"": 0, ""lines"": 1}, ""src/testdir/test_options.vim"": {""insertions"": 8, ""deletions"": 0, ""lines"": 8}, ""src/version.c"": {""insertions"": 2, ""deletions"": 0, ""lines"": 2}}"
2021-06-13 17:02:49,2346a6378483c9871016f9fc821ec5cbea638f13,Bram Moolenaar,399,185,584,30,"{""runtime/doc/autocmd.txt"": {""insertions"": 1, ""deletions"": 1, ""lines"": 2}, ""runtime/doc/change.txt"": {""insertions"": 1, ""deletions"": 1, ""lines"": 2}, ""runtime/doc/eval.txt"": {""insertions"": 16, ""deletions"": 16, ""lines"": 32}, ""runtime/doc/filetype.txt"": {""insertions"": 1, ""deletions"": 1, ""lines"": 2}, ""runtime/doc/ft_raku.txt"": {""insertions"": 1, ""deletions"": 1, ""lines"": 2}, ""runtime/doc/help.txt"": {""insertions"": 4, ""deletions"": 1, ""lines"": 5}, ""runtime/doc/motion.txt"": {""insertions"": 7, ""deletions"": 2, ""lines"": 9}, ""runtime/doc/options.txt"": {""insertions"": 1, ""deletions"": 1, ""lines"": 2}, ""runtime/doc/os_vms.txt"": {""insertions"": 3, ""deletions"": 3, ""lines"": 6}, ""runtime/doc/pattern.txt"": {""insertions"": 1, ""deletions"": 1, ""lines"": 2}, ""runtime/doc/pi_netrw.txt"": {""insertions"": 1, ""deletions"": 1, ""lines"": 2}, ""runtime/doc/repeat.txt"": {""insertions"": 5, ""deletions"": 3, ""lines"": 8}, ""runtime/doc/syntax.txt"": {""insertions"": 5, ""deletions"": 5, ""lines"": 10}, ""runtime/doc/tags"": {""insertions"": 8, ""deletions"": 0, ""lines"": 8}, ""runtime/doc/term.txt"": {""insertions"": 2, ""deletions"": 2, ""lines"": 4}, ""runtime/doc/todo.txt"": {""insertions"": 22, ""deletions"": 43, ""lines"": 65}, ""runtime/doc/usr_41.txt"": {""insertions"": 1, ""deletions"": 1, ""lines"": 2}, ""runtime/doc/various.txt"": {""insertions"": 1, ""deletions"": 1, ""lines"": 2}, ""runtime/doc/vim.1"": {""insertions"": 1, ""deletions"": 1, ""lines"": 2}, ""runtime/doc/vim.man"": {""insertions"": 3, ""deletions"": 3, ""lines"": 6}, ""runtime/doc/vim9.txt"": {""insertions"": 8, ""deletions"": 2, ""lines"": 10}, ""runtime/doc/vimdiff.1"": {""insertions"": 3, ""deletions"": 3, ""lines"": 6}, ""runtime/doc/vimdiff.man"": {""insertions"": 10, ""deletions"": 9, ""lines"": 19}, ""runtime/filetype.vim"": {""insertions"": 1, ""deletions"": 1, ""lines"": 2}, ""runtime/gvim.desktop"": {""insertions"": 1, ""deletions"": 0, ""lines"": 1}, ""runtime/indent/html.vim"": {""insertions"": 34, ""deletions"": 29, ""lines"": 63}, ""runtime/syntax/gvpr.vim"": {""insertions"": 85, ""deletions"": 0, ""lines"": 85}, ""runtime/vim.desktop"": {""insertions"": 1, ""deletions"": 0, ""lines"": 1}, ""src/INSTALLpc.txt"": {""insertions"": 2, ""deletions"": 1, ""lines"": 3}, ""src/po/sr.po"": {""insertions"": 169, ""deletions"": 52, ""lines"": 221}}"
2021-06-13 16:38:48,4ee9d8e04daa97a3d0a19d7d2eed76b7721301e6,Bram Moolenaar,53,1,54,6,"{""src/cmdexpand.c"": {""insertions"": 4, ""deletions"": 1, ""lines"": 5}, ""src/proto/vim9execute.pro"": {""insertions"": 2, ""deletions"": 0, ""lines"": 2}, ""src/testdir/test_cmdline.vim"": {""insertions"": 10, ""deletions"": 0, ""lines"": 10}, ""src/version.c"": {""insertions"": 2, ""deletions"": 0, ""lines"": 2}, ""src/vim.h"": {""insertions"": 1, ""deletions"": 0, ""lines"": 1}, ""src/vim9execute.c"": {""insertions"": 34, ""deletions"": 0, ""lines"": 34}}"
2021-06-13 15:20:08,e70e12b32f193addae88ae8df933b04fc234550f,Bram Moolenaar,10,0,10,3,"{""src/cmdexpand.c"": {""insertions"": 2, ""deletions"": 0, ""lines"": 2}, ""src/testdir/test_cmdline.vim"": {""insertions"": 6, ""deletions"": 0, ""lines"": 6}, ""src/version.c"": {""insertions"": 2, ""deletions"": 0, ""lines"": 2}}"
2021-06-13 15:03:06,2e66b0d1373891f40e2561ccd2d3369de1614bcd,kompowiec2,6,1,7,3,"{""runtime/filetype.vim"": {""insertions"": 3, ""deletions"": 0, ""lines"": 3}, ""src/testdir/test_filetype.vim"": {""insertions"": 1, ""deletions"": 1, ""lines"": 2}, ""src/version.c"": {""insertions"": 2, ""deletions"": 0, ""lines"": 2}}"
2021-06-13 13:39:00,c2dec4cac4087af90dd4f64f4912a8e14a5fdd56,Bram Moolenaar,9,0,9,2,"{""src/version.c"": {""insertions"": 2, ""deletions"": 0, ""lines"": 2}, ""src/vim9compile.c"": {""insertions"": 7, ""deletions"": 0, ""lines"": 7}}"
2021-06-13 13:16:01,c3a27bbd53a4653c2d8122a047a4cf2cfc52ed21,Bram Moolenaar,13,3,16,3,"{""src/version.c"": {""insertions"": 2, ""deletions"": 0, ""lines"": 2}, ""src/vim.h"": {""insertions"": 1, ""deletions"": 0, ""lines"": 1}, ""src/vim9.h"": {""insertions"": 10, ""deletions"": 3, ""lines"": 13}}"
2021-06-13 12:33:20,6d1792d4085c9905c9da6ff27065b57cb7cddc57,Bram Moolenaar,6,5,11,2,"{""src/version.c"": {""insertions"": 2, ""deletions"": 0, ""lines"": 2}, ""src/vim9execute.c"": {""insertions"": 4, ""deletions"": 5, ""lines"": 9}}"
2021-06-13 12:15:29,d9f31c13d217b4b97f724774a67a6d1f8640e8ae,Bram Moolenaar,6,2,8,2,"{""src/version.c"": {""insertions"": 2, ""deletions"": 0, ""lines"": 2}, ""src/vim9compile.c"": {""insertions"": 4, ""deletions"": 2, ""lines"": 6}}"
2021-06-13 12:01:26,e99d422bbd3e47620915bf89671673f0711671b4,Bram Moolenaar,196,77,273,11,"{""src/eval.c"": {""insertions"": 1, ""deletions"": 1, ""lines"": 2}, ""src/proto/vim9compile.pro"": {""insertions"": 2, ""deletions"": 2, ""lines"": 4}, ""src/testdir/test_debugger.vim"": {""insertions"": 11, ""deletions"": 10, ""lines"": 21}, ""src/testdir/test_vim9_disassemble.vim"": {""insertions"": 15, ""deletions"": 1, ""lines"": 16}, ""src/userfunc.c"": {""insertions"": 1, ""deletions"": 1, ""lines"": 2}, ""src/version.c"": {""insertions"": 2, ""deletions"": 0, ""lines"": 2}, ""src/vim.h"": {""insertions"": 9, ""deletions"": 2, ""lines"": 11}, ""src/vim9.h"": {""insertions"": 4, ""deletions"": 0, ""lines"": 4}, ""src/vim9compile.c"": {""insertions"": 83, ""deletions"": 42, ""lines"": 125}, ""src/vim9execute.c"": {""insertions"": 67, ""deletions"": 17, ""lines"": 84}, ""src/vim9type.c"": {""insertions"": 1, ""deletions"": 1, ""lines"": 2}}"
2021-06-12 16:30:56,e6174fd58d459722847c76f8c5aa1b08a49c3e0d,Bram Moolenaar,5,1,6,2,"{""src/version.c"": {""insertions"": 2, ""deletions"": 0, ""lines"": 2}, ""src/vim9compile.c"": {""insertions"": 3, ""deletions"": 1, ""lines"": 4}}"
2021-06-12 14:12:16,4a27aefe3b5652ee58b2eb85e9d09b542b087aaa,Bram Moolenaar,6,0,6,1,"{""README.md"": {""insertions"": 6, ""deletions"": 0, ""lines"": 6}}"
2021-06-12 13:58:16,a9931535387e5eb4e6ce62f2a661484de4a1757d,Bram Moolenaar,41,6,47,5,"{""src/eval.c"": {""insertions"": 6, ""deletions"": 2, ""lines"": 8}, ""src/testdir/test_vim9_func.vim"": {""insertions"": 20, ""deletions"": 0, ""lines"": 20}, ""src/userfunc.c"": {""insertions"": 1, ""deletions"": 1, ""lines"": 2}, ""src/version.c"": {""insertions"": 2, ""deletions"": 0, ""lines"": 2}, ""src/vim9compile.c"": {""insertions"": 12, ""deletions"": 3, ""lines"": 15}}"
2021-06-12 12:53:05,742357718000927d652b1a98d313a3950571c8ec,Bram Moolenaar,111,42,153,6,"{""runtime/doc/vim9.txt"": {""insertions"": 64, ""deletions"": 12, ""lines"": 76}, ""src/ex_cmdidxs.h"": {""insertions"": 30, ""deletions"": 30, ""lines"": 60}, ""src/ex_cmds.h"": {""insertions"": 12, ""deletions"": 0, ""lines"": 12}, ""src/testdir/test_vim9_assign.vim"": {""insertions"": 2, ""deletions"": 0, ""lines"": 2}, ""src/version.c"": {""insertions"": 2, ""deletions"": 0, ""lines"": 2}, ""src/vim9script.c"": {""insertions"": 1, ""deletions"": 0, ""lines"": 1}}"
2021-06-12 12:05:41,6654ca702ca64c99965efcad3243ea5f95473252,James McCoy,98,97,195,2,"{""src/testdir/test_recover.vim"": {""insertions"": 96, ""deletions"": 97, ""lines"": 193}, ""src/version.c"": {""insertions"": 2, ""deletions"": 0, ""lines"": 2}}"
2021-06-12 11:59:03,0b71955552c4b18f1853c1769ca64d696f8b60c1,Bram Moolenaar,3,0,3,2,"{""src/testdir/test_popupwin.vim"": {""insertions"": 1, ""deletions"": 0, ""lines"": 1}, ""src/version.c"": {""insertions"": 2, ""deletions"": 0, ""lines"": 2}}"
2021-06-12 11:46:41,5958549760652c173b703613b9cbf09b25a4eddb,Yegappan Lakshmanan,108,1,109,8,"{""src/testdir/test_edit.vim"": {""insertions"": 24, ""deletions"": 0, ""lines"": 24}, ""src/testdir/test_excmd.vim"": {""insertions"": 6, ""deletions"": 0, ""lines"": 6}, ""src/testdir/test_help.vim"": {""insertions"": 10, ""deletions"": 0, ""lines"": 10}, ""src/testdir/test_mksession.vim"": {""insertions"": 13, ""deletions"": 0, ""lines"": 13}, ""src/testdir/test_options.vim"": {""insertions"": 31, ""deletions"": 0, ""lines"": 31}, ""src/testdir/test_vartabs.vim"": {""insertions"": 13, ""deletions"": 0, ""lines"": 13}, ""src/testdir/test_window_cmd.vim"": {""insertions"": 9, ""deletions"": 1, ""lines"": 10}, ""src/version.c"": {""insertions"": 2, ""deletions"": 0, ""lines"": 2}}"
2021-06-12 10:33:48,744aecf8777e86fac6d30f072e90e2de353b8ea1,Bram Moolenaar,3,0,3,2,"{""src/eval.c"": {""insertions"": 1, ""deletions"": 0, ""lines"": 1}, ""src/version.c"": {""insertions"": 2, ""deletions"": 0, ""lines"": 2}}"
2021-06-12 10:16:55,22db0d549f64aa3d8a6e366b70eb8d7e66933b82,Bram Moolenaar,15,1,16,4,"{""src/errors.h"": {""insertions"": 2, ""deletions"": 0, ""lines"": 2}, ""src/eval.c"": {""insertions"": 8, ""deletions"": 0, ""lines"": 8}, ""src/testdir/test_functions.vim"": {""insertions"": 3, ""deletions"": 1, ""lines"": 4}, ""src/version.c"": {""insertions"": 2, ""deletions"": 0, ""lines"": 2}}"
2021-06-11 20:21:24,8de901e1f1b051e02a61ae76ad7c925e4c0642e5,Bram Moolenaar,6,2,8,2,"{""src/scriptfile.c"": {""insertions"": 4, ""deletions"": 2, ""lines"": 6}, ""src/version.c"": {""insertions"": 2, ""deletions"": 0, ""lines"": 2}}"
2021-06-11 20:05:47,f0a4069e3df904ac6bd57718ec06e56c5d7363e4,Bram Moolenaar,43,3,46,5,"{""src/evalvars.c"": {""insertions"": 3, ""deletions"": 2, ""lines"": 5}, ""src/scriptfile.c"": {""insertions"": 3, ""deletions"": 0, ""lines"": 3}, ""src/testdir/test_vim9_func.vim"": {""insertions"": 28, ""deletions"": 0, ""lines"": 28}, ""src/version.c"": {""insertions"": 2, ""deletions"": 0, ""lines"": 2}, ""src/vim9compile.c"": {""insertions"": 7, ""deletions"": 1, ""lines"": 8}}"
2021-06-11 17:07:40,4f135275984722c1b1e9ace72eeeb7ce7e4ec983,Bram Moolenaar,32,12,44,5,"{""src/proto/spell.pro"": {""insertions"": 1, ""deletions"": 1, ""lines"": 2}, ""src/spell.c"": {""insertions"": 22, ""deletions"": 5, ""lines"": 27}, ""src/spellfile.c"": {""insertions"": 3, ""deletions"": 3, ""lines"": 6}, ""src/spellsuggest.c"": {""insertions"": 4, ""deletions"": 3, ""lines"": 7}, ""src/version.c"": {""insertions"": 2, ""deletions"": 0, ""lines"": 2}}"
2021-06-10 19:52:15,3044324e8dccd470bd854cf7d9457232cc9c220e,Yegappan Lakshmanan,166,1,167,4,"{""src/testdir/test_diffmode.vim"": {""insertions"": 118, ""deletions"": 1, ""lines"": 119}, ""src/testdir/test_prompt_buffer.vim"": {""insertions"": 2, ""deletions"": 0, ""lines"": 2}, ""src/testdir/test_recover.vim"": {""insertions"": 44, ""deletions"": 0, ""lines"": 44}, ""src/version.c"": {""insertions"": 2, ""deletions"": 0, ""lines"": 2}}"
2021-06-10 19:07:48,7b4f76c0300f0bd9bf54ca1968fe9ae5e4dbdef4,Bram Moolenaar,155,123,278,4,"{""src/buffer.c"": {""insertions"": 143, ""deletions"": 123, ""lines"": 266}, ""src/testdir/test_popupwin.vim"": {""insertions"": 6, ""deletions"": 0, ""lines"": 6}, ""src/version.c"": {""insertions"": 2, ""deletions"": 0, ""lines"": 2}, ""src/vim.h"": {""insertions"": 4, ""deletions"": 0, ""lines"": 4}}"
2021-06-10 17:39:11,544a38e44db0f25ec4fa7a2a4666cf28a2336f33,Christian Brabandt,99,8,107,8,"{""runtime/doc/change.txt"": {""insertions"": 12, ""deletions"": 1, ""lines"": 13}, ""runtime/doc/index.txt"": {""insertions"": 1, ""deletions"": 0, ""lines"": 1}, ""src/normal.c"": {""insertions"": 3, ""deletions"": 0, ""lines"": 3}, ""src/ops.c"": {""insertions"": 3, ""deletions"": 0, ""lines"": 3}, ""src/register.c"": {""insertions"": 20, ""deletions"": 6, ""lines"": 26}, ""src/structs.h"": {""insertions"": 3, ""deletions"": 1, ""lines"": 4}, ""src/testdir/test_visual.vim"": {""insertions"": 55, ""deletions"": 0, ""lines"": 55}, ""src/version.c"": {""insertions"": 2, ""deletions"": 0, ""lines"": 2}}"
2021-06-10 16:50:55,31e299c08f250b126b2c2c0ecce12ee563b70fdc,Zdenek Dohnal,10,2,12,3,"{""src/auto/configure"": {""insertions"": 4, ""deletions"": 1, ""lines"": 5}, ""src/configure.ac"": {""insertions"": 4, ""deletions"": 1, ""lines"": 5}, ""src/version.c"": {""insertions"": 2, ""deletions"": 0, ""lines"": 2}}"
2021-06-10 16:43:25,a42e6e0082a6d564dbfa55317d4a698ac12ae898,Bram Moolenaar,12,0,12,3,"{""src/evalvars.c"": {""insertions"": 1, ""deletions"": 0, ""lines"": 1}, ""src/testdir/test_vimscript.vim"": {""insertions"": 9, ""deletions"": 0, ""lines"": 9}, ""src/version.c"": {""insertions"": 2, ""deletions"": 0, ""lines"": 2}}"
2021-06-09 18:50:46,54656015d384a96ef814dfcf2a18e47f5ba3df14,Bram Moolenaar,5,0,5,2,"{""src/eval.c"": {""insertions"": 3, ""deletions"": 0, ""lines"": 3}, ""src/version.c"": {""insertions"": 2, ""deletions"": 0, ""lines"": 2}}"
2021-06-09 17:30:03,c04f2a4cd40f32120b7a94fdea7bfa62e8640041,Bram Moolenaar,99,46,145,4,"{""src/structs.h"": {""insertions"": 1, ""deletions"": 1, ""lines"": 2}, ""src/testdir/test_vim9_func.vim"": {""insertions"": 13, ""deletions"": 0, ""lines"": 13}, ""src/version.c"": {""insertions"": 2, ""deletions"": 0, ""lines"": 2}, ""src/vim9execute.c"": {""insertions"": 83, ""deletions"": 45, ""lines"": 128}}"
2021-06-09 10:33:40,e3f50ad640fb30f27027f85a616280288bbc14ca,Bram Moolenaar,3,0,3,2,"{""src/memline.c"": {""insertions"": 1, ""deletions"": 0, ""lines"": 1}, ""src/version.c"": {""insertions"": 2, ""deletions"": 0, ""lines"": 2}}"
2021-06-08 20:01:53,b55d618f193d9f413612d8d4e62758056e842e46,Bram Moolenaar,26,0,26,4,"{""src/errors.h"": {""insertions"": 2, ""deletions"": 0, ""lines"": 2}, ""src/testdir/test_vim9_func.vim"": {""insertions"": 16, ""deletions"": 0, ""lines"": 16}, ""src/version.c"": {""insertions"": 2, ""deletions"": 0, ""lines"": 2}, ""src/vim9compile.c"": {""insertions"": 6, ""deletions"": 0, ""lines"": 6}}"
2021-06-08 18:46:45,a733042b124357225e4081e10ef28591236c6077,Bram Moolenaar,11,3,14,4,"{""src/eval.c"": {""insertions"": 3, ""deletions"": 2, ""lines"": 5}, ""src/testdir/test_vim9_expr.vim"": {""insertions"": 4, ""deletions"": 0, ""lines"": 4}, ""src/version.c"": {""insertions"": 2, ""deletions"": 0, ""lines"": 2}, ""src/vim9compile.c"": {""insertions"": 2, ""deletions"": 1, ""lines"": 3}}"
2021-06-08 18:13:31,445f11d5bcfddfa194ebd12b029228c7e957f94c,Bram Moolenaar,15,3,18,5,"{""src/gui.c"": {""insertions"": 4, ""deletions"": 1, ""lines"": 5}, ""src/keymap.h"": {""insertions"": 3, ""deletions"": 2, ""lines"": 5}, ""src/term.c"": {""insertions"": 4, ""deletions"": 0, ""lines"": 4}, ""src/version.c"": {""insertions"": 2, ""deletions"": 0, ""lines"": 2}, ""src/vim.h"": {""insertions"": 2, ""deletions"": 0, ""lines"": 2}}"
2021-06-08 16:32:36,dc73b4b75de0134db3dffa6e631daf6cae817545,K.Takata,6,4,10,2,"{""src/os_win32.c"": {""insertions"": 4, ""deletions"": 4, ""lines"": 8}, ""src/version.c"": {""insertions"": 2, ""deletions"": 0, ""lines"": 2}}"
2021-06-07 20:04:52,c41badb748bbaa78cbadfcda9ca965e8a283fb9b,Bram Moolenaar,23,10,33,8,"{""src/debugger.c"": {""insertions"": 1, ""deletions"": 1, ""lines"": 2}, ""src/evalfunc.c"": {""insertions"": 1, ""deletions"": 1, ""lines"": 2}, ""src/ex_docmd.c"": {""insertions"": 1, ""deletions"": 1, ""lines"": 2}, ""src/getchar.c"": {""insertions"": 3, ""deletions"": 2, ""lines"": 5}, ""src/proto/getchar.pro"": {""insertions"": 1, ""deletions"": 1, ""lines"": 2}, ""src/proto/ui.pro"": {""insertions"": 1, ""deletions"": 1, ""lines"": 2}, ""src/ui.c"": {""insertions"": 13, ""deletions"": 3, ""lines"": 16}, ""src/version.c"": {""insertions"": 2, ""deletions"": 0, ""lines"": 2}}"
2021-06-07 18:41:22,8cf02e5cf8fb14a5009f12e7af0a47617a0ce88d,Yegappan Lakshmanan,102,0,102,2,"{""src/testdir/test_recover.vim"": {""insertions"": 100, ""deletions"": 0, ""lines"": 100}, ""src/version.c"": {""insertions"": 2, ""deletions"": 0, ""lines"": 2}}"
2021-06-07 18:28:45,2f9c209ba089d81fd727122bbe0ae1da00585d80,Dominique Pelle,13,14,27,3,"{""src/sound.c"": {""insertions"": 2, ""deletions"": 3, ""lines"": 5}, ""src/testdir/test_sound.vim"": {""insertions"": 9, ""deletions"": 11, ""lines"": 20}, ""src/version.c"": {""insertions"": 2, ""deletions"": 0, ""lines"": 2}}"
2021-06-07 16:50:01,f7a023e580c695e86f68228adcf5c9e6ea00a4d5,Bram Moolenaar,4,1,5,3,"{""runtime/doc/usr_41.txt"": {""insertions"": 1, ""deletions"": 0, ""lines"": 1}, ""src/testdir/test_function_lists.vim"": {""insertions"": 1, ""deletions"": 1, ""lines"": 2}, ""src/version.c"": {""insertions"": 2, ""deletions"": 0, ""lines"": 2}}"
2021-06-07 16:29:17,3a7503c34c65ed15cc08deb5b54aaf2ea51525b4,Bram Moolenaar,70,5,75,6,"{""runtime/doc/eval.txt"": {""insertions"": 18, ""deletions"": 1, ""lines"": 19}, ""src/evalfunc.c"": {""insertions"": 3, ""deletions"": 1, ""lines"": 4}, ""src/getchar.c"": {""insertions"": 39, ""deletions"": 3, ""lines"": 42}, ""src/proto/getchar.pro"": {""insertions"": 1, ""deletions"": 0, ""lines"": 1}, ""src/testdir/test_functions.vim"": {""insertions"": 7, ""deletions"": 0, ""lines"": 7}, ""src/version.c"": {""insertions"": 2, ""deletions"": 0, ""lines"": 2}}"
2021-06-06 20:02:16,f05d2fc539c389c3b8142d9fb06fb0443de14902,Bram Moolenaar,44,27,71,3,"{""src/ex_cmdidxs.h"": {""insertions"": 27, ""deletions"": 27, ""lines"": 54}, ""src/ex_cmds.h"": {""insertions"": 15, ""deletions"": 0, ""lines"": 15}, ""src/version.c"": {""insertions"": 2, ""deletions"": 0, ""lines"": 2}}"
2021-06-06 19:38:09,e729ce294f9756165020ad86e3b98b4112e1a6ab,Bram Moolenaar,63,5,68,6,"{""src/ex_cmds.c"": {""insertions"": 24, ""deletions"": 0, ""lines"": 24}, ""src/ex_docmd.c"": {""insertions"": 8, ""deletions"": 2, ""lines"": 10}, ""src/proto/ex_cmds.pro"": {""insertions"": 1, ""deletions"": 0, ""lines"": 1}, ""src/testdir/test_vim9_cmd.vim"": {""insertions"": 8, ""deletions"": 0, ""lines"": 8}, ""src/version.c"": {""insertions"": 2, ""deletions"": 0, ""lines"": 2}, ""src/vim9compile.c"": {""insertions"": 20, ""deletions"": 3, ""lines"": 23}}"
2021-06-06 18:15:53,6db7b6375a3ea3afef5295b1366896902012e640,Brennon M,4,2,6,3,"{""runtime/filetype.vim"": {""insertions"": 1, ""deletions"": 1, ""lines"": 2}, ""src/testdir/test_filetype.vim"": {""insertions"": 1, ""deletions"": 1, ""lines"": 2}, ""src/version.c"": {""insertions"": 2, ""deletions"": 0, ""lines"": 2}}"
2021-06-06 15:34:13,518df27ebe23033a25304d3826187c27bfa53c01,Bram Moolenaar,9,1,10,2,"{""src/version.c"": {""insertions"": 2, ""deletions"": 0, ""lines"": 2}, ""src/vim9execute.c"": {""insertions"": 7, ""deletions"": 1, ""lines"": 8}}"
2021-06-06 15:12:46,99285550a9957e2c8669f183557944c6513c4875,Yegappan Lakshmanan,39,7,46,3,"{""src/testdir/test_recover.vim"": {""insertions"": 36, ""deletions"": 6, ""lines"": 42}, ""src/testdir/test_swap.vim"": {""insertions"": 1, ""deletions"": 1, ""lines"": 2}, ""src/version.c"": {""insertions"": 2, ""deletions"": 0, ""lines"": 2}}"
2021-06-06 15:02:53,2067733b5c76e996238af938af36b8196366b7ce,Bram Moolenaar,182,15,197,7,"{""src/testdir/test_vim9_disassemble.vim"": {""insertions"": 17, ""deletions"": 0, ""lines"": 17}, ""src/testdir/test_vim9_func.vim"": {""insertions"": 28, ""deletions"": 0, ""lines"": 28}, ""src/userfunc.c"": {""insertions"": 37, ""deletions"": 4, ""lines"": 41}, ""src/version.c"": {""insertions"": 2, ""deletions"": 0, ""lines"": 2}, ""src/vim9.h"": {""insertions"": 1, ""deletions"": 0, ""lines"": 1}, ""src/vim9compile.c"": {""insertions"": 45, ""deletions"": 11, ""lines"": 56}, ""src/vim9execute.c"": {""insertions"": 52, ""deletions"": 0, ""lines"": 52}}"
2021-06-06 13:07:09,c64ed2b714e605930e7c4102d4e80a2b1d9ff9bf,Dominique Pelle,38,3,41,2,"{""src/testdir/test_sound.vim"": {""insertions"": 36, ""deletions"": 3, ""lines"": 39}, ""src/version.c"": {""insertions"": 2, ""deletions"": 0, ""lines"": 2}}"
2021-06-06 12:14:39,3cfa5b16b06bcc034f6de77070fa779d698ab5e9,Bram Moolenaar,46,19,65,12,"{""src/evalfunc.c"": {""insertions"": 3, ""deletions"": 2, ""lines"": 5}, ""src/filepath.c"": {""insertions"": 3, ""deletions"": 1, ""lines"": 4}, ""src/findfile.c"": {""insertions"": 1, ""deletions"": 1, ""lines"": 2}, ""src/float.c"": {""insertions"": 1, ""deletions"": 1, ""lines"": 2}, ""src/json.c"": {""insertions"": 10, ""deletions"": 1, ""lines"": 11}, ""src/testdir/test_eval_stuff.vim"": {""insertions"": 1, ""deletions"": 1, ""lines"": 2}, ""src/testdir/test_execute_func.vim"": {""insertions"": 4, ""deletions"": 2, ""lines"": 6}, ""src/testdir/test_float_func.vim"": {""insertions"": 4, ""deletions"": 1, ""lines"": 5}, ""src/testdir/test_functions.vim"": {""insertions"": 10, ""deletions"": 5, ""lines"": 15}, ""src/testdir/test_glob2regpat.vim"": {""insertions"": 4, ""deletions"": 1, ""lines"": 5}, ""src/testdir/test_listdict.vim"": {""insertions"": 3, ""deletions"": 3, ""lines"": 6}, ""src/version.c"": {""insertions"": 2, ""deletions"": 0, ""lines"": 2}}"
2021-06-06 10:33:49,7a2217bedd223df4c8bbebe731bf0b5fe8532533,Bram Moolenaar,17,2,19,3,"{""src/testdir/test_substitute.vim"": {""insertions"": 8, ""deletions"": 0, ""lines"": 8}, ""src/typval.c"": {""insertions"": 7, ""deletions"": 2, ""lines"": 9}, ""src/version.c"": {""insertions"": 2, ""deletions"": 0, ""lines"": 2}}"
2021-06-06 10:07:54,f5bfa8faa7bbe025c10148d37e8b47217a430a3b,Bram Moolenaar,4,0,4,2,"{""src/eval.c"": {""insertions"": 2, ""deletions"": 0, ""lines"": 2}, ""src/version.c"": {""insertions"": 2, ""deletions"": 0, ""lines"": 2}}"
2021-06-05 19:36:19,2752360646545a9ae4853d2d5ca91cdb07c14eea,Bram Moolenaar,10,1,11,3,"{""src/testdir/test_vim9_cmd.vim"": {""insertions"": 7, ""deletions"": 0, ""lines"": 7}, ""src/version.c"": {""insertions"": 2, ""deletions"": 0, ""lines"": 2}, ""src/vim9execute.c"": {""insertions"": 1, ""deletions"": 1, ""lines"": 2}}"
2021-06-05 18:59:22,59b262362f26b3aaea1eeb0078adc33eed59863e,Yegappan Lakshmanan,217,1,218,6,"{""src/termlib.c"": {""insertions"": 1, ""deletions"": 1, ""lines"": 2}, ""src/testdir/test_excmd.vim"": {""insertions"": 8, ""deletions"": 0, ""lines"": 8}, ""src/testdir/test_recover.vim"": {""insertions"": 127, ""deletions"": 0, ""lines"": 127}, ""src/testdir/test_swap.vim"": {""insertions"": 75, ""deletions"": 0, ""lines"": 75}, ""src/testdir/test_visual.vim"": {""insertions"": 4, ""deletions"": 0, ""lines"": 4}, ""src/version.c"": {""insertions"": 2, ""deletions"": 0, ""lines"": 2}}"
2021-06-05 18:51:38,1328bde9d406aa1292e92673fa8a026889424e79,Bram Moolenaar,76,34,110,9,"{""src/channel.c"": {""insertions"": 18, ""deletions"": 0, ""lines"": 18}, ""src/eval.c"": {""insertions"": 2, ""deletions"": 1, ""lines"": 3}, ""src/job.c"": {""insertions"": 30, ""deletions"": 0, ""lines"": 30}, ""src/proto/channel.pro"": {""insertions"": 1, ""deletions"": 0, ""lines"": 1}, ""src/proto/job.pro"": {""insertions"": 1, ""deletions"": 0, ""lines"": 1}, ""src/testdir/test_vim9_builtin.vim"": {""insertions"": 11, ""deletions"": 1, ""lines"": 12}, ""src/typval.c"": {""insertions"": 9, ""deletions"": 31, ""lines"": 40}, ""src/version.c"": {""insertions"": 2, ""deletions"": 0, ""lines"": 2}, ""src/vim9execute.c"": {""insertions"": 2, ""deletions"": 1, ""lines"": 3}}"
2021-06-05 16:49:38,c6d71532dda0b3a244907bb5d1826f9340f7571d,Bram Moolenaar,4,1,5,2,"{""src/version.c"": {""insertions"": 2, ""deletions"": 0, ""lines"": 2}, ""src/vim9execute.c"": {""insertions"": 2, ""deletions"": 1, ""lines"": 3}}"
2021-06-05 16:15:09,8da6d6db340069b3307e6bce3cdd40441197efce,Bram Moolenaar,23,0,23,4,"{""src/errors.h"": {""insertions"": 4, ""deletions"": 0, ""lines"": 4}, ""src/testdir/test_vim9_builtin.vim"": {""insertions"": 9, ""deletions"": 0, ""lines"": 9}, ""src/version.c"": {""insertions"": 2, ""deletions"": 0, ""lines"": 2}, ""src/vim9execute.c"": {""insertions"": 8, ""deletions"": 0, ""lines"": 8}}"
2021-06-05 15:10:55,b288ba9f1dd29ba34f236e3099f779d5ab130227,Bram Moolenaar,30,5,35,3,"{""src/testdir/test_vim9_cmd.vim"": {""insertions"": 4, ""deletions"": 0, ""lines"": 4}, ""src/version.c"": {""insertions"": 2, ""deletions"": 0, ""lines"": 2}, ""src/vim9execute.c"": {""insertions"": 24, ""deletions"": 5, ""lines"": 29}}"
2021-06-05 14:25:32,4f2417ffeedbb687a59a36547e8143724a86bb31,K.Takata,57,6,63,2,"{""src/gui_w32.c"": {""insertions"": 55, ""deletions"": 6, ""lines"": 61}, ""src/version.c"": {""insertions"": 2, ""deletions"": 0, ""lines"": 2}}"
2021-06-05 14:07:37,84e9ade826e7a6a03e0ff5cd9a35b48c4d88367e,Bram Moolenaar,5,0,5,2,"{""src/gui_gtk.c"": {""insertions"": 3, ""deletions"": 0, ""lines"": 3}, ""src/version.c"": {""insertions"": 2, ""deletions"": 0, ""lines"": 2}}"
2021-06-04 19:57:57,21492743e80c6740bac65a91311c28bede8ef2f8,Bram Moolenaar,12,0,12,3,"{""src/normal.c"": {""insertions"": 1, ""deletions"": 0, ""lines"": 1}, ""src/testdir/test_visual.vim"": {""insertions"": 9, ""deletions"": 0, ""lines"": 9}, ""src/version.c"": {""insertions"": 2, ""deletions"": 0, ""lines"": 2}}"
2021-06-04 19:09:55,56cddb38790ba535919524d9d2f32dbec9f3f07a,Dominique Pelle,11,5,16,2,"{""src/testdir/test_popup.vim"": {""insertions"": 9, ""deletions"": 5, ""lines"": 14}, ""src/version.c"": {""insertions"": 2, ""deletions"": 0, ""lines"": 2}}"
2021-06-04 19:00:32,5fa9b24440d677c1aa00084d0cf84638b1e1a0d5,Bram Moolenaar,104,34,138,6,"{""src/testdir/test_vim9_disassemble.vim"": {""insertions"": 2, ""deletions"": 2, ""lines"": 4}, ""src/testdir/test_vim9_expr.vim"": {""insertions"": 19, ""deletions"": 0, ""lines"": 19}, ""src/version.c"": {""insertions"": 2, ""deletions"": 0, ""lines"": 2}, ""src/vim9.h"": {""insertions"": 16, ""deletions"": 2, ""lines"": 18}, ""src/vim9compile.c"": {""insertions"": 28, ""deletions"": 15, ""lines"": 43}, ""src/vim9execute.c"": {""insertions"": 37, ""deletions"": 15, ""lines"": 52}}"
2021-06-04 17:17:07,6c4c404c580fadd69e39297a6cb4b214f2fcb6d6,Bram Moolenaar,14,8,22,2,"{""src/register.c"": {""insertions"": 12, ""deletions"": 8, ""lines"": 20}, ""src/version.c"": {""insertions"": 2, ""deletions"": 0, ""lines"": 2}}"
2021-06-04 16:33:49,24951a67c24e75ec4ff7506f8e2e789ccd786e89,Bram Moolenaar,6,3,9,2,"{""src/register.c"": {""insertions"": 4, ""deletions"": 3, ""lines"": 7}, ""src/version.c"": {""insertions"": 2, ""deletions"": 0, ""lines"": 2}}"
2021-06-04 15:11:47,6e0b553fa12fc5ad5d8ee3d8457e7cb16f38b56f,Bram Moolenaar,12,7,19,4,"{""src/clipboard.c"": {""insertions"": 1, ""deletions"": 1, ""lines"": 2}, ""src/mbyte.c"": {""insertions"": 0, ""deletions"": 2, ""lines"": 2}, ""src/register.c"": {""insertions"": 9, ""deletions"": 4, ""lines"": 13}, ""src/version.c"": {""insertions"": 2, ""deletions"": 0, ""lines"": 2}}"
2021-06-03 20:11:08,4f3c57f7980592b25f483e5953799c010a8ae196,Bram Moolenaar,18,9,27,4,"{""src/mouse.c"": {""insertions"": 5, ""deletions"": 5, ""lines"": 10}, ""src/normal.c"": {""insertions"": 10, ""deletions"": 4, ""lines"": 14}, ""src/proto/normal.pro"": {""insertions"": 1, ""deletions"": 0, ""lines"": 1}, ""src/version.c"": {""insertions"": 2, ""deletions"": 0, ""lines"": 2}}"
2021-06-03 19:56:10,5072b47a223fb044041b8e7db59a17b3b1d8a625,Bram Moolenaar,10,2,12,3,"{""src/scriptfile.c"": {""insertions"": 5, ""deletions"": 2, ""lines"": 7}, ""src/testdir/test_vim9_script.vim"": {""insertions"": 3, ""deletions"": 0, ""lines"": 3}, ""src/version.c"": {""insertions"": 2, ""deletions"": 0, ""lines"": 2}}"
2021-06-03 18:34:57,85eee5b969485142b54337cadadd65a38e7d7396,Bram Moolenaar,12,1,13,4,"{""src/mouse.c"": {""insertions"": 8, ""deletions"": 1, ""lines"": 9}, ""src/normal.c"": {""insertions"": 1, ""deletions"": 0, ""lines"": 1}, ""src/proto/mouse.pro"": {""insertions"": 1, ""deletions"": 0, ""lines"": 1}, ""src/version.c"": {""insertions"": 2, ""deletions"": 0, ""lines"": 2}}"
2021-06-02 17:22:45,0a808598e4edb3f1a167ac8c5c1f9084af625c4d,Bram Moolenaar,3,1,4,2,"{""src/Makefile"": {""insertions"": 1, ""deletions"": 1, ""lines"": 2}, ""src/version.c"": {""insertions"": 2, ""deletions"": 0, ""lines"": 2}}"
2021-06-02 15:07:18,01c798c31a94a50ad0c4a022fc21c1a31553be21,Yegappan Lakshmanan,544,547,1091,14,"{""Filelist"": {""insertions"": 2, ""deletions"": 0, ""lines"": 2}, ""src/Make_ami.mak"": {""insertions"": 1, ""deletions"": 0, ""lines"": 1}, ""src/Make_cyg_ming.mak"": {""insertions"": 1, ""deletions"": 0, ""lines"": 1}, ""src/Make_mvc.mak"": {""insertions"": 4, ""deletions"": 0, ""lines"": 4}, ""src/Make_vms.mms"": {""insertions"": 5, ""deletions"": 0, ""lines"": 5}, ""src/Makefile"": {""insertions"": 22, ""deletions"": 7, ""lines"": 29}, ""src/README.md"": {""insertions"": 1, ""deletions"": 0, ""lines"": 1}, ""src/eval.c"": {""insertions"": 0, ""deletions"": 37, ""lines"": 37}, ""src/evalfunc.c"": {""insertions"": 0, ""deletions"": 502, ""lines"": 502}, ""src/float.c"": {""insertions"": 477, ""deletions"": 0, ""lines"": 477}, ""src/proto.h"": {""insertions"": 1, ""deletions"": 0, ""lines"": 1}, ""src/proto/eval.pro"": {""insertions"": 0, ""deletions"": 1, ""lines"": 1}, ""src/proto/float.pro"": {""insertions"": 28, ""deletions"": 0, ""lines"": 28}, ""src/version.c"": {""insertions"": 2, ""deletions"": 0, ""lines"": 2}}"
2021-06-02 14:49:32,a83d06026d0e0dad873de296bff97707ad2faff3,Bram Moolenaar,16,12,28,2,"{""src/testdir/test_startup.vim"": {""insertions"": 14, ""deletions"": 12, ""lines"": 26}, ""src/version.c"": {""insertions"": 2, ""deletions"": 0, ""lines"": 2}}"
2021-06-02 14:47:53,c3cb1c92a335be818971acd89f631e82aa30ad3f,Bram Moolenaar,34,0,34,4,"{""src/errors.h"": {""insertions"": 2, ""deletions"": 0, ""lines"": 2}, ""src/testdir/test_vim9_func.vim"": {""insertions"": 9, ""deletions"": 0, ""lines"": 9}, ""src/version.c"": {""insertions"": 2, ""deletions"": 0, ""lines"": 2}, ""src/vim9compile.c"": {""insertions"": 21, ""deletions"": 0, ""lines"": 21}}"
2021-06-02 13:28:15,0f37e3561db95b0ef0b636588bbd30297e377384,Bram Moolenaar,22,1,23,3,"{""src/scriptfile.c"": {""insertions"": 2, ""deletions"": 1, ""lines"": 3}, ""src/testdir/test_vim9_script.vim"": {""insertions"": 18, ""deletions"": 0, ""lines"": 18}, ""src/version.c"": {""insertions"": 2, ""deletions"": 0, ""lines"": 2}}"
2021-06-02 13:08:50,a2e468fcac7523ae6a0ab65db5196684801fa2d1,K.Takata,2,2,4,2,"{""src/main.c"": {""insertions"": 0, ""deletions"": 2, ""lines"": 2}, ""src/version.c"": {""insertions"": 2, ""deletions"": 0, ""lines"": 2}}"
2021-06-02 12:56:39,eecf2b35a146d7d5512f2525ad631d796e19edac,K.Takata,30,28,58,4,"{""src/eval.c"": {""insertions"": 0, ""deletions"": 27, ""lines"": 27}, ""src/evalfunc.c"": {""insertions"": 27, ""deletions"": 0, ""lines"": 27}, ""src/proto/evalfunc.pro"": {""insertions"": 1, ""deletions"": 1, ""lines"": 2}, ""src/version.c"": {""insertions"": 2, ""deletions"": 0, ""lines"": 2}}"
2021-06-02 11:28:16,eeec2548785b2dd245a31ab25d7bde0f88ea1a6d,K.Takata,80,90,170,43,"{""src/arabic.c"": {""insertions"": 1, ""deletions"": 3, ""lines"": 4}, ""src/blowfish.c"": {""insertions"": 0, ""deletions"": 2, ""lines"": 2}, ""src/cindent.c"": {""insertions"": 1, ""deletions"": 1, ""lines"": 2}, ""src/cmdexpand.c"": {""insertions"": 1, ""deletions"": 1, ""lines"": 2}, ""src/cmdhist.c"": {""insertions"": 1, ""deletions"": 1, ""lines"": 2}, ""src/dosinst.c"": {""insertions"": 2, ""deletions"": 3, ""lines"": 5}, ""src/eval.c"": {""insertions"": 1, ""deletions"": 1, ""lines"": 2}, ""src/evalfunc.c"": {""insertions"": 2, ""deletions"": 2, ""lines"": 4}, ""src/ex_docmd.c"": {""insertions"": 3, ""deletions"": 3, ""lines"": 6}, ""src/fileio.c"": {""insertions"": 1, ""deletions"": 1, ""lines"": 2}, ""src/gui_athena.c"": {""insertions"": 1, ""deletions"": 1, ""lines"": 2}, ""src/gui_gtk_x11.c"": {""insertions"": 3, ""deletions"": 3, ""lines"": 6}, ""src/gui_haiku.cc"": {""insertions"": 1, ""deletions"": 1, ""lines"": 2}, ""src/gui_photon.c"": {""insertions"": 0, ""deletions"": 1, ""lines"": 1}, ""src/gui_w32.c"": {""insertions"": 2, ""deletions"": 2, ""lines"": 4}, ""src/gui_xmebw.c"": {""insertions"": 1, ""deletions"": 1, ""lines"": 2}, ""src/hardcopy.c"": {""insertions"": 12, ""deletions"": 14, ""lines"": 26}, ""src/help.c"": {""insertions"": 1, ""deletions"": 1, ""lines"": 2}, ""src/highlight.c"": {""insertions"": 2, ""deletions"": 2, ""lines"": 4}, ""src/if_mzsch.c"": {""insertions"": 1, ""deletions"": 1, ""lines"": 2}, ""src/macros.h"": {""insertions"": 3, ""deletions"": 0, ""lines"": 3}, ""src/main.c"": {""insertions"": 3, ""deletions"": 3, ""lines"": 6}, ""src/map.c"": {""insertions"": 2, ""deletions"": 3, ""lines"": 5}, ""src/mbyte.c"": {""insertions"": 3, ""deletions"": 3, ""lines"": 6}, ""src/memline.c"": {""insertions"": 1, ""deletions"": 1, ""lines"": 2}, ""src/menu.c"": {""insertions"": 1, ""deletions"": 1, ""lines"": 2}, ""src/misc2.c"": {""insertions"": 1, ""deletions"": 2, ""lines"": 3}, ""src/normal.c"": {""insertions"": 1, ""deletions"": 1, ""lines"": 2}, ""src/ops.c"": {""insertions"": 1, ""deletions"": 1, ""lines"": 2}, ""src/option.c"": {""insertions"": 2, ""deletions"": 3, ""lines"": 5}, ""src/optiondefs.h"": {""insertions"": 1, ""deletions"": 1, ""lines"": 2}, ""src/os_win32.c"": {""insertions"": 5, ""deletions"": 6, ""lines"": 11}, ""src/popupwin.c"": {""insertions"": 2, ""deletions"": 4, ""lines"": 6}, ""src/quickfix.c"": {""insertions"": 1, ""deletions"": 1, ""lines"": 2}, ""src/regexp.c"": {""insertions"": 1, ""deletions"": 1, ""lines"": 2}, ""src/screen.c"": {""insertions"": 2, ""deletions"": 2, ""lines"": 4}, ""src/search.c"": {""insertions"": 1, ""deletions"": 1, ""lines"": 2}, ""src/syntax.c"": {""insertions"": 1, ""deletions"": 1, ""lines"": 2}, ""src/term.c"": {""insertions"": 1, ""deletions"": 1, ""lines"": 2}, ""src/terminal.c"": {""insertions"": 1, ""deletions"": 1, ""lines"": 2}, ""src/time.c"": {""insertions"": 1, ""deletions"": 2, ""lines"": 3}, ""src/usercmd.c"": {""insertions"": 2, ""deletions"": 2, ""lines"": 4}, ""src/version.c"": {""insertions"": 6, ""deletions"": 4, ""lines"": 10}}"
2021-06-02 09:49:23,b54abeeafb074248597878a874fed9a66b114c06,Bram Moolenaar,13,4,17,3,"{""src/dict.c"": {""insertions"": 3, ""deletions"": 2, ""lines"": 5}, ""src/testdir/test_functions.vim"": {""insertions"": 8, ""deletions"": 2, ""lines"": 10}, ""src/version.c"": {""insertions"": 2, ""deletions"": 0, ""lines"": 2}}"
2021-06-01 19:21:55,6f1d2aa437744a7cb0206fdaa543a788c5a56c79,Bram Moolenaar,28,6,34,5,"{""src/dict.c"": {""insertions"": 18, ""deletions"": 0, ""lines"": 18}, ""src/eval.c"": {""insertions"": 2, ""deletions"": 6, ""lines"": 8}, ""src/proto/dict.pro"": {""insertions"": 1, ""deletions"": 0, ""lines"": 1}, ""src/testdir/test_functions.vim"": {""insertions"": 5, ""deletions"": 0, ""lines"": 5}, ""src/version.c"": {""insertions"": 2, ""deletions"": 0, ""lines"": 2}}"
2021-06-01 18:48:40,6a43b37b760347b9a1bedf12e41b458000922969,Bram Moolenaar,2,5,7,2,"{""src/os_unix.c"": {""insertions"": 0, ""deletions"": 5, ""lines"": 5}, ""src/version.c"": {""insertions"": 2, ""deletions"": 0, ""lines"": 2}}"
2021-05-31 20:15:26,3d9c4eefe656ee8bf58c0496a48bd56bac180056,Bram Moolenaar,17,0,17,3,"{""src/eval.c"": {""insertions"": 7, ""deletions"": 0, ""lines"": 7}, ""src/testdir/test_functions.vim"": {""insertions"": 8, ""deletions"": 0, ""lines"": 8}, ""src/version.c"": {""insertions"": 2, ""deletions"": 0, ""lines"": 2}}"
2021-05-31 18:04:07,bb162367ac77db877586086d7456685f2aeb8754,Dominique Pelle,58,0,58,2,"{""src/testdir/test_spellfile.vim"": {""insertions"": 56, ""deletions"": 0, ""lines"": 56}, ""src/version.c"": {""insertions"": 2, ""deletions"": 0, ""lines"": 2}}"
2021-05-31 17:23:01,2ac7184d34cd01e2b76bd1f704fd6a4b4af10239,Yegappan Lakshmanan,166,1,167,5,"{""src/ops.c"": {""insertions"": 2, ""deletions"": 1, ""lines"": 3}, ""src/testdir/test_netbeans.vim"": {""insertions"": 40, ""deletions"": 0, ""lines"": 40}, ""src/testdir/test_normal.vim"": {""insertions"": 30, ""deletions"": 0, ""lines"": 30}, ""src/testdir/test_visual.vim"": {""insertions"": 92, ""deletions"": 0, ""lines"": 92}, ""src/version.c"": {""insertions"": 2, ""deletions"": 0, ""lines"": 2}}"
2021-05-31 16:40:49,ef8706fb84cfe8bd58b1b26b0742e42caf09655b,K.Takata,11,3,14,3,"{""runtime/doc/options.txt"": {""insertions"": 4, ""deletions"": 3, ""lines"": 7}, ""src/mbyte.c"": {""insertions"": 5, ""deletions"": 0, ""lines"": 5}, ""src/version.c"": {""insertions"": 2, ""deletions"": 0, ""lines"": 2}}"
2021-05-30 20:17:25,2fa9384ca1b600b934bec81a72c5fb7ce757503a,Christian Brabandt,56,10,66,8,"{""runtime/doc/change.txt"": {""insertions"": 8, ""deletions"": 0, ""lines"": 8}, ""runtime/doc/index.txt"": {""insertions"": 2, ""deletions"": 0, ""lines"": 2}, ""src/normal.c"": {""insertions"": 8, ""deletions"": 2, ""lines"": 10}, ""src/register.c"": {""insertions"": 12, ""deletions"": 7, ""lines"": 19}, ""src/testdir/test_normal.vim"": {""insertions"": 1, ""deletions"": 1, ""lines"": 2}, ""src/testdir/test_visual.vim"": {""insertions"": 22, ""deletions"": 0, ""lines"": 22}, ""src/version.c"": {""insertions"": 2, ""deletions"": 0, ""lines"": 2}, ""src/vim.h"": {""insertions"": 1, ""deletions"": 0, ""lines"": 1}}"
2021-05-30 18:54:13,d2ea7cf10a4d026ebd402594d656af7d5c811c24,Bram Moolenaar,320,223,543,91,"{""runtime/doc/autocmd.txt"": {""insertions"": 5, ""deletions"": 4, ""lines"": 9}, ""runtime/doc/cmdline.txt"": {""insertions"": 2, ""deletions"": 2, ""lines"": 4}, ""runtime/doc/diff.txt"": {""insertions"": 6, ""deletions"": 4, ""lines"": 10}, ""runtime/doc/editing.txt"": {""insertions"": 4, ""deletions"": 4, ""lines"": 8}, ""runtime/doc/ft_sql.txt"": {""insertions"": 1, ""deletions"": 1, ""lines"": 2}, ""runtime/doc/if_tcl.txt"": {""insertions"": 4, ""deletions"": 4, ""lines"": 8}, ""runtime/doc/index.txt"": {""insertions"": 3, ""deletions"": 3, ""lines"": 6}, ""runtime/doc/options.txt"": {""insertions"": 3, ""deletions"": 1, ""lines"": 4}, ""runtime/doc/quickfix.txt"": {""insertions"": 3, ""deletions"": 2, ""lines"": 5}, ""runtime/doc/spell.txt"": {""insertions"": 3, ""deletions"": 3, ""lines"": 6}, ""runtime/doc/syntax.txt"": {""insertions"": 9, ""deletions"": 1, ""lines"": 10}, ""runtime/doc/tags"": {""insertions"": 4, ""deletions"": 1, ""lines"": 5}, ""runtime/doc/textprop.txt"": {""insertions"": 4, ""deletions"": 3, ""lines"": 7}, ""runtime/doc/todo.txt"": {""insertions"": 34, ""deletions"": 4, ""lines"": 38}, ""runtime/doc/usr_08.txt"": {""insertions"": 2, ""deletions"": 2, ""lines"": 4}, ""runtime/doc/usr_09.txt"": {""insertions"": 1, ""deletions"": 1, ""lines"": 2}, ""runtime/doc/version6.txt"": {""insertions"": 2, ""deletions"": 2, ""lines"": 4}, ""runtime/doc/vim9.txt"": {""insertions"": 4, ""deletions"": 3, ""lines"": 7}, ""runtime/doc/visual.txt"": {""insertions"": 2, ""deletions"": 2, ""lines"": 4}, ""runtime/indent/python.vim"": {""insertions"": 2, ""deletions"": 2, ""lines"": 4}, ""runtime/pack/dist/opt/termdebug/plugin/termdebug.vim"": {""insertions"": 36, ""deletions"": 10, ""lines"": 46}, ""runtime/syntax/c.vim"": {""insertions"": 4, ""deletions"": 1, ""lines"": 5}, ""runtime/syntax/cpp.vim"": {""insertions"": 27, ""deletions"": 13, ""lines"": 40}, ""runtime/syntax/sh.vim"": {""insertions"": 25, ""deletions"": 21, ""lines"": 46}, ""runtime/syntax/vim.vim"": {""insertions"": 38, ""deletions"": 37, ""lines"": 75}, ""runtime/tutor/tutor"": {""insertions"": 2, ""deletions"": 2, ""lines"": 4}, ""runtime/tutor/tutor.bar"": {""insertions"": 1, ""deletions"": 1, ""lines"": 2}, ""runtime/tutor/tutor.bar.utf-8"": {""insertions"": 1, ""deletions"": 1, ""lines"": 2}, ""runtime/tutor/tutor.bg.utf-8"": {""insertions"": 2, ""deletions"": 2, ""lines"": 4}, ""runtime/tutor/tutor.ca"": {""insertions"": 2, ""deletions"": 2, ""lines"": 4}, ""runtime/tutor/tutor.ca.utf-8"": {""insertions"": 2, ""deletions"": 2, ""lines"": 4}, ""runtime/tutor/tutor.cs"": {""insertions"": 2, ""deletions"": 2, ""lines"": 4}, ""runtime/tutor/tutor.cs.cp1250"": {""insertions"": 2, ""deletions"": 2, ""lines"": 4}, ""runtime/tutor/tutor.cs.utf-8"": {""insertions"": 2, ""deletions"": 2, ""lines"": 4}, ""runtime/tutor/tutor.da"": {""insertions"": 1, ""deletions"": 1, ""lines"": 2}, ""runtime/tutor/tutor.da.utf-8"": {""insertions"": 1, ""deletions"": 1, ""lines"": 2}, ""runtime/tutor/tutor.de"": {""insertions"": 1, ""deletions"": 1, ""lines"": 2}, ""runtime/tutor/tutor.de.utf-8"": {""insertions"": 1, ""deletions"": 1, ""lines"": 2}, ""runtime/tutor/tutor.el"": {""insertions"": 2, ""deletions"": 2, ""lines"": 4}, ""runtime/tutor/tutor.el.cp737"": {""insertions"": 2, ""deletions"": 2, ""lines"": 4}, ""runtime/tutor/tutor.el.utf-8"": {""insertions"": 2, ""deletions"": 2, ""lines"": 4}, ""runtime/tutor/tutor.eo"": {""insertions"": 1, ""deletions"": 1, ""lines"": 2}, ""runtime/tutor/tutor.eo.utf-8"": {""insertions"": 1, ""deletions"": 1, ""lines"": 2}, ""runtime/tutor/tutor.fr"": {""insertions"": 1, ""deletions"": 1, ""lines"": 2}, ""runtime/tutor/tutor.fr.utf-8"": {""insertions"": 1, ""deletions"": 1, ""lines"": 2}, ""runtime/tutor/tutor.hr"": {""insertions"": 1, ""deletions"": 1, ""lines"": 2}, ""runtime/tutor/tutor.hr.cp1250"": {""insertions"": 1, ""deletions"": 1, ""lines"": 2}, ""runtime/tutor/tutor.hr.utf-8"": {""insertions"": 1, ""deletions"": 1, ""lines"": 2}, ""runtime/tutor/tutor.hu"": {""insertions"": 2, ""deletions"": 2, ""lines"": 4}, ""runtime/tutor/tutor.hu.cp1250"": {""insertions"": 2, ""deletions"": 2, ""lines"": 4}, ""runtime/tutor/tutor.hu.utf-8"": {""insertions"": 2, ""deletions"": 2, ""lines"": 4}, ""runtime/tutor/tutor.it"": {""insertions"": 1, ""deletions"": 1, ""lines"": 2}, ""runtime/tutor/tutor.it.utf-8"": {""insertions"": 1, ""deletions"": 1, ""lines"": 2}, ""runtime/tutor/tutor.ja.euc"": {""insertions"": 2, ""deletions"": 2, ""lines"": 4}, ""runtime/tutor/tutor.ja.sjis"": {""insertions"": 2, ""deletions"": 2, ""lines"": 4}, ""runtime/tutor/tutor.ja.utf-8"": {""insertions"": 2, ""deletions"": 2, ""lines"": 4}, ""runtime/tutor/tutor.ko"": {""insertions"": 2, ""deletions"": 2, ""lines"": 4}, ""runtime/tutor/tutor.ko.euc"": {""insertions"": 2, ""deletions"": 2, ""lines"": 4}, ""runtime/tutor/tutor.ko.utf-8"": {""insertions"": 2, ""deletions"": 2, ""lines"": 4}, ""runtime/tutor/tutor.lv.utf-8"": {""insertions"": 2, ""deletions"": 2, ""lines"": 4}, ""runtime/tutor/tutor.nb"": {""insertions"": 1, ""deletions"": 1, ""lines"": 2}, ""runtime/tutor/tutor.nb.utf-8"": {""insertions"": 1, ""deletions"": 1, ""lines"": 2}, ""runtime/tutor/tutor.nl"": {""insertions"": 1, ""deletions"": 1, ""lines"": 2}, ""runtime/tutor/tutor.nl.utf-8"": {""insertions"": 1, ""deletions"": 1, ""lines"": 2}, ""runtime/tutor/tutor.no"": {""insertions"": 1, ""deletions"": 1, ""lines"": 2}, ""runtime/tutor/tutor.no.utf-8"": {""insertions"": 1, ""deletions"": 1, ""lines"": 2}, ""runtime/tutor/tutor.pl"": {""insertions"": 1, ""deletions"": 1, ""lines"": 2}, ""runtime/tutor/tutor.pl.cp1250"": {""insertions"": 1, ""deletions"": 1, ""lines"": 2}, ""runtime/tutor/tutor.pl.utf-8"": {""insertions"": 1, ""deletions"": 1, ""lines"": 2}, ""runtime/tutor/tutor.pt"": {""insertions"": 1, ""deletions"": 1, ""lines"": 2}, ""runtime/tutor/tutor.pt.utf-8"": {""insertions"": 2, ""deletions"": 2, ""lines"": 4}, ""runtime/tutor/tutor.ru"": {""insertions"": 1, ""deletions"": 1, ""lines"": 2}, ""runtime/tutor/tutor.ru.cp1251"": {""insertions"": 1, ""deletions"": 1, ""lines"": 2}, ""runtime/tutor/tutor.ru.utf-8"": {""insertions"": 1, ""deletions"": 1, ""lines"": 2}, ""runtime/tutor/tutor.sk"": {""insertions"": 1, ""deletions"": 1, ""lines"": 2}, ""runtime/tutor/tutor.sk.cp1250"": {""insertions"": 1, ""deletions"": 1, ""lines"": 2}, ""runtime/tutor/tutor.sk.utf-8"": {""insertions"": 1, ""deletions"": 1, ""lines"": 2}, ""runtime/tutor/tutor.sr.cp1250"": {""insertions"": 1, ""deletions"": 1, ""lines"": 2}, ""runtime/tutor/tutor.sr.utf-8"": {""insertions"": 1, ""deletions"": 1, ""lines"": 2}, ""runtime/tutor/tutor.sv"": {""insertions"": 2, ""deletions"": 2, ""lines"": 4}, ""runtime/tutor/tutor.sv.utf-8"": {""insertions"": 2, ""deletions"": 2, ""lines"": 4}, ""runtime/tutor/tutor.tr.iso9"": {""insertions"": 1, ""deletions"": 1, ""lines"": 2}, ""runtime/tutor/tutor.tr.utf-8"": {""insertions"": 1, ""deletions"": 1, ""lines"": 2}, ""runtime/tutor/tutor.uk.utf-8"": {""insertions"": 2, ""deletions"": 2, ""lines"": 4}, ""runtime/tutor/tutor.utf-8"": {""insertions"": 2, ""deletions"": 2, ""lines"": 4}, ""runtime/tutor/tutor.vi.utf-8"": {""insertions"": 2, ""deletions"": 2, ""lines"": 4}, ""runtime/tutor/tutor.zh.big5"": {""insertions"": 1, ""deletions"": 1, ""lines"": 2}, ""runtime/tutor/tutor.zh.euc"": {""insertions"": 1, ""deletions"": 1, ""lines"": 2}, ""runtime/tutor/tutor.zh.utf-8"": {""insertions"": 1, ""deletions"": 1, ""lines"": 2}, ""runtime/tutor/tutor.zh_cn.utf-8"": {""insertions"": 1, ""deletions"": 1, ""lines"": 2}, ""runtime/tutor/tutor.zh_tw.utf-8"": {""insertions"": 1, ""deletions"": 1, ""lines"": 2}}"
2021-05-30 17:29:41,6ef5ab59043681a51e8ca2ab0a1e4ff8f0f4bb47,Wez Furlong,29,7,36,2,"{""src/os_win32.c"": {""insertions"": 27, ""deletions"": 7, ""lines"": 34}, ""src/version.c"": {""insertions"": 2, ""deletions"": 0, ""lines"": 2}}"
2021-05-30 16:04:19,f883d9027c750967b115b82de984ee449ab17aa8,K.Takata,19,5,24,6,"{""runtime/doc/options.txt"": {""insertions"": 2, ""deletions"": 1, ""lines"": 3}, ""src/mbyte.c"": {""insertions"": 1, ""deletions"": 1, ""lines"": 2}, ""src/option.c"": {""insertions"": 8, ""deletions"": 1, ""lines"": 9}, ""src/option.h"": {""insertions"": 5, ""deletions"": 1, ""lines"": 6}, ""src/testdir/test_writefile.vim"": {""insertions"": 1, ""deletions"": 1, ""lines"": 2}, ""src/version.c"": {""insertions"": 2, ""deletions"": 0, ""lines"": 2}}"
2021-05-30 14:43:11,e71c0ebe2cee4a4916c49e206733200299e4c065,Bram Moolenaar,35,1,36,4,"{""src/regexp.c"": {""insertions"": 4, ""deletions"": 1, ""lines"": 5}, ""src/testdir/dumps/Test_hlsearch_block_visual_match.dump"": {""insertions"": 9, ""deletions"": 0, ""lines"": 9}, ""src/testdir/test_search.vim"": {""insertions"": 20, ""deletions"": 0, ""lines"": 20}, ""src/version.c"": {""insertions"": 2, ""deletions"": 0, ""lines"": 2}}"
2021-05-30 12:21:57,0b49648486c5857047433c11d0871f79b53613a5,Bram Moolenaar,3,0,3,2,"{""src/testdir/test_cmdline.vim"": {""insertions"": 1, ""deletions"": 0, ""lines"": 1}, ""src/version.c"": {""insertions"": 2, ""deletions"": 0, ""lines"": 2}}"
2021-05-30 12:02:05,e0a7658bc8048aa29ff5c26b377dc5c6816fe422,Bram Moolenaar,5,3,8,2,"{""src/version.c"": {""insertions"": 2, ""deletions"": 0, ""lines"": 2}, ""src/vim.h"": {""insertions"": 3, ""deletions"": 3, ""lines"": 6}}"
2021-05-30 11:54:03,e5b4486c4279a9674a9bb76130b4db53fb9303a0,Bram Moolenaar,37,0,37,5,"{""src/errors.h"": {""insertions"": 2, ""deletions"": 0, ""lines"": 2}, ""src/terminal.c"": {""insertions"": 7, ""deletions"": 0, ""lines"": 7}, ""src/testdir/dumps/Test_cmdwin_no_terminal.dump"": {""insertions"": 12, ""deletions"": 0, ""lines"": 12}, ""src/testdir/test_cmdline.vim"": {""insertions"": 14, ""deletions"": 0, ""lines"": 14}, ""src/version.c"": {""insertions"": 2, ""deletions"": 0, ""lines"": 2}}"
2021-05-29 20:34:19,28cf44f761a7bf261bcd0760a1c5f61070f69595,Dominique Pelle,3,0,3,2,"{""src/term.c"": {""insertions"": 1, ""deletions"": 0, ""lines"": 1}, ""src/version.c"": {""insertions"": 2, ""deletions"": 0, ""lines"": 2}}"
2021-05-29 20:25:17,a5787c3742b43a8e662045a4e38c7a6ba957acbf,Bram Moolenaar,14,11,25,2,"{""src/testdir/test_startup.vim"": {""insertions"": 12, ""deletions"": 11, ""lines"": 23}, ""src/version.c"": {""insertions"": 2, ""deletions"": 0, ""lines"": 2}}"
2021-05-29 17:53:50,1d3a14ecf0cdde026984894c592dc140a2b46887,Christian Brabandt,26,3,29,5,"{""runtime/doc/starting.txt"": {""insertions"": 1, ""deletions"": 1, ""lines"": 2}, ""src/errors.h"": {""insertions"": 2, ""deletions"": 0, ""lines"": 2}, ""src/main.c"": {""insertions"": 8, ""deletions"": 2, ""lines"": 10}, ""src/testdir/test_startup.vim"": {""insertions"": 13, ""deletions"": 0, ""lines"": 13}, ""src/version.c"": {""insertions"": 2, ""deletions"": 0, ""lines"": 2}}"
2021-05-29 17:18:01,74ede80aeb272ac81d41a256057c4f250372dd00,Bram Moolenaar,38,3,41,3,"{""src/normal.c"": {""insertions"": 11, ""deletions"": 0, ""lines"": 11}, ""src/testdir/test_normal.vim"": {""insertions"": 25, ""deletions"": 3, ""lines"": 28}, ""src/version.c"": {""insertions"": 2, ""deletions"": 0, ""lines"": 2}}"
2021-05-29 15:56:37,a06e345af5b8261c072c95b0446e67cfda439848,Bram Moolenaar,25,0,25,3,"{""src/drawline.c"": {""insertions"": 6, ""deletions"": 0, ""lines"": 6}, ""src/testdir/test_display.vim"": {""insertions"": 17, ""deletions"": 0, ""lines"": 17}, ""src/version.c"": {""insertions"": 2, ""deletions"": 0, ""lines"": 2}}"
2021-05-29 15:29:33,5a6cfb3ff2f2f422a3732f3855616c89dd19c19d,Dominique Pelle,95,2,97,2,"{""src/testdir/test_spellfile.vim"": {""insertions"": 93, ""deletions"": 2, ""lines"": 95}, ""src/version.c"": {""insertions"": 2, ""deletions"": 0, ""lines"": 2}}"
2021-05-29 14:30:12,3e72dcad8b752a42b6eaf71213e3f5d534175256,Bram Moolenaar,167,12,179,6,"{""src/testdir/test_cpoptions.vim"": {""insertions"": 1, ""deletions"": 0, ""lines"": 1}, ""src/testdir/test_increment.vim"": {""insertions"": 17, ""deletions"": 0, ""lines"": 17}, ""src/testdir/test_normal.vim"": {""insertions"": 31, ""deletions"": 0, ""lines"": 31}, ""src/testdir/test_virtualedit.vim"": {""insertions"": 27, ""deletions"": 0, ""lines"": 27}, ""src/testdir/test_visual.vim"": {""insertions"": 89, ""deletions"": 12, ""lines"": 101}, ""src/version.c"": {""insertions"": 2, ""deletions"": 0, ""lines"": 2}}"
2021-05-29 12:30:43,1174b018a6d705ddb8c04f3d21f78ae760aa0856,Bram Moolenaar,31,8,39,3,"{""src/ex_docmd.c"": {""insertions"": 8, ""deletions"": 8, ""lines"": 16}, ""src/testdir/test_writefile.vim"": {""insertions"": 21, ""deletions"": 0, ""lines"": 21}, ""src/version.c"": {""insertions"": 2, ""deletions"": 0, ""lines"": 2}}"
2021-05-29 10:42:47,f89be8de14cc9055d12f7b0f2c270a5bc09fc86c,K.Takata,16,6,22,2,"{""ci/appveyor.bat"": {""insertions"": 14, ""deletions"": 6, ""lines"": 20}, ""src/version.c"": {""insertions"": 2, ""deletions"": 0, ""lines"": 2}}"
2021-05-29 10:21:58,3552e742898cd57adaf9b8ce32a9056271eab8d2,Bram Moolenaar,9,5,14,4,"{""src/ex_docmd.c"": {""insertions"": 2, ""deletions"": 2, ""lines"": 4}, ""src/gui.c"": {""insertions"": 3, ""deletions"": 2, ""lines"": 5}, ""src/proto/ex_docmd.pro"": {""insertions"": 2, ""deletions"": 1, ""lines"": 3}, ""src/version.c"": {""insertions"": 2, ""deletions"": 0, ""lines"": 2}}"
2021-05-28 19:06:08,d0edaf9dc253e619ccc321ceaac321aee11c1ea5,Bram Moolenaar,39,19,58,6,"{""src/eval.c"": {""insertions"": 3, ""deletions"": 0, ""lines"": 3}, ""src/proto/vim9script.pro"": {""insertions"": 1, ""deletions"": 0, ""lines"": 1}, ""src/testdir/test_vim9_assign.vim"": {""insertions"": 7, ""deletions"": 0, ""lines"": 7}, ""src/version.c"": {""insertions"": 2, ""deletions"": 0, ""lines"": 2}, ""src/vim9compile.c"": {""insertions"": 2, ""deletions"": 17, ""lines"": 19}, ""src/vim9script.c"": {""insertions"": 24, ""deletions"": 2, ""lines"": 26}}"
2021-05-28 16:32:12,dc3275a1ac73b6c4d0c9d2e238ea80b477705b6f,Dominique Pelle,68,0,68,2,"{""src/testdir/test_spellfile.vim"": {""insertions"": 66, ""deletions"": 0, ""lines"": 66}, ""src/version.c"": {""insertions"": 2, ""deletions"": 0, ""lines"": 2}}"
2021-05-28 15:52:40,4ac198c61cb3097d4839d5a697cc8b2b256ac575,mityu,63,9,72,4,"{""src/eval.c"": {""insertions"": 10, ""deletions"": 7, ""lines"": 17}, ""src/testdir/test_vim9_expr.vim"": {""insertions"": 50, ""deletions"": 1, ""lines"": 51}, ""src/version.c"": {""insertions"": 2, ""deletions"": 0, ""lines"": 2}, ""src/vim9compile.c"": {""insertions"": 1, ""deletions"": 1, ""lines"": 2}}"
